Chromosome	Start	Stop	Name	Size	Orientation	RefSeq	CStart	CStop	NumExons
chr1	11873	14409	DDX11L1	2536	+	NR_046018	14409	14409	3
chr1	14361	29370	WASH7P	15009	-	NR_024540	29370	29370	11
chr1	17368	17436	MIR6859-1	68	-	NR_106918	17436	17436	1
chr1	17368	17436	MIR6859-2	68	-	NR_107062	17436	17436	1
chr1	17368	17436	MIR6859-3	68	-	NR_107063	17436	17436	1
chr1	17368	17436	MIR6859-4	68	-	NR_128720	17436	17436	1
chr1	30365	30503	MIR1302-2	138	+	NR_036051	30503	30503	1
chr1	30365	30503	MIR1302-9	138	+	NR_036266	30503	30503	1
chr1	30365	30503	MIR1302-10	138	+	NR_036267	30503	30503	1
chr1	30365	30503	MIR1302-11	138	+	NR_036268	30503	30503	1
chr1	34610	36081	FAM138A	1471	-	NR_026818	36081	36081	3
chr1	34610	36081	FAM138F	1471	-	NR_026820	36081	36081	3
chr1	69090	70008	OR4F5	918	+	NM_001005484	69090	70008	1
chr1	134772	140566	LOC729737	5794	-	NR_039983	140566	140566	3
chr1	323891	328581	LOC100132062	4690	+	NR_028325	328581	328581	3
chr1	323891	328581	LOC100132287	4690	+	NR_028322	328581	328581	3
chr1	323891	328581	LOC100133331	4690	+	NR_028327	328581	328581	4
chr1	367658	368597	OR4F3	939	+	NM_001005224	367658	368597	1
chr1	367658	368597	OR4F16	939	+	NM_001005277	367658	368597	1
chr1	367658	368597	OR4F29	939	+	NM_001005221	367658	368597	1
chr1	562759	564389	LOC101928626	1630	-	NR_125957	564389	564389	3
chr1	567704	567793	MIR6723	89	-	NR_106781	567793	567793	1
chr1	700244	714068	LOC100288069	13824	-	NR_033908	714068	714068	7
chr1	752750	755214	FAM87B	2464	+	NR_103536	755214	755214	2
chr1	761585	762902	LINC00115	1317	-	NR_024321	762902	762902	1
chr1	762970	794826	LINC01128	31856	+	NR_047519	794826	794826	6
chr1	803450	812182	FAM41C	8732	-	NR_027055	812182	812182	3
chr1	852197	855072	LOC100130417	2875	-	NR_122045	855072	855072	4
chr1	861120	879961	SAMD11	18841	+	NM_152486	861321	879533	14
chr1	879582	894679	NOC2L	15097	-	NM_015658	880073	894620	19
chr1	895966	901099	KLHL17	5133	+	NM_198317	896073	900571	12
chr1	901876	910484	PLEKHN1	8608	+	NM_032129	901911	909955	16
chr1	910578	917497	PERM1	6919	-	NM_001291367	911551	917497	5
chr1	934341	935552	HES4	1211	-	NM_021170	934438	935353	4
chr1	948846	949919	ISG15	1073	+	NM_005101	948953	949858	2
chr1	955502	991499	AGRN	35997	+	NM_001305275	955552	990361	38
chr1	1007125	1009687	RNF223	2562	-	NM_001205252	1007196	1007946	2
chr1	1017197	1051736	C1orf159	34539	-	NM_017891	1018272	1026923	10
chr1	1072396	1079434	LINC01342	7038	+	NR_038869	1079434	1079434	3
chr1	1102483	1102578	MIR200B	95	+	NR_029639	1102578	1102578	1
chr1	1103242	1103332	MIR200A	90	+	NR_029834	1103332	1103332	1
chr1	1104384	1104467	MIR429	83	+	NR_029957	1104467	1104467	1
chr1	1109285	1133313	TTLL10	24028	+	NM_001130045	1114595	1133227	16
chr1	1138887	1142089	TNFRSF18	3202	-	NM_004195	1139223	1141951	5
chr1	1146705	1149548	TNFRSF4	2843	-	NM_003327	1146934	1149507	7
chr1	1152287	1167447	SDF4	15160	-	NM_016547	1153049	1164173	7
chr1	1167628	1170420	B3GALT6	2792	+	NM_080605	1167658	1168648	1
chr1	1177825	1182102	FAM132A	4277	-	NM_001014980	1177927	1182070	8
chr1	1189291	1209234	UBE2J2	19943	-	NM_194315	1190582	1203372	8
chr1	1215815	1227409	SCNN1D	11594	+	NM_001130413	1216041	1226990	18
chr1	1227763	1243269	ACAP3	15506	-	NM_030649	1228943	1243195	24
chr1	1231489	1231550	MIR6726	61	-	NR_106784	1231550	1231550	1
chr1	1243993	1247057	PUSL1	3064	+	NM_153339	1244023	1246759	8
chr1	1246964	1260067	CPSF3L	13103	-	NM_001256456	1247238	1257333	19
chr1	1247881	1247946	MIR6727	65	-	NR_106785	1247946	1247946	1
chr1	1260142	1264276	CPTP	4134	+	NM_001029885	1262290	1263143	3
chr1	1266725	1270700	TAS1R3	3975	+	NM_152228	1266725	1269844	6
chr1	1270657	1284492	DVL1	13835	-	NM_004421	1271521	1284445	15
chr1	1275029	1275088	MIR6808	59	-	NR_106866	1275088	1275088	1
chr1	1288068	1298921	MXRA8	10853	-	NM_001282582	1288983	1293884	11
chr1	1309109	1310818	AURKAIP1	1709	-	NM_017900	1309180	1310136	4
chr1	1321090	1334718	CCNL2	13628	-	NM_030937	1322610	1334686	11
chr1	1334909	1337426	LOC148413	2517	+	NR_015434	1337426	1337426	3
chr1	1337275	1342693	MRPL20	5418	-	NM_017971	1337462	1342597	4
chr1	1353799	1356824	ANKRD65	3025	-	NM_001145210	1354479	1356385	4
chr1	1361507	1363167	TMEM88B	1660	+	NM_001146685	1361507	1363167	2
chr1	1365536	1369953	LOC102724312	4417	-	NR_125994	1369953	1369953	2
chr1	1370902	1378262	VWA1	7360	+	NM_199121	1371128	1372823	3
chr1	1385068	1405538	ATAD3C	20470	+	NM_001039211	1386063	1403910	12
chr1	1407134	1431584	ATAD3B	24450	+	NM_031921	1407264	1431197	16
chr1	1447522	1470067	ATAD3A	22545	+	NM_018188	1447648	1469452	16
chr1	1470157	1475740	TMEM240	5583	-	NM_001114748	1470738	1475726	4
chr1	1477052	1510262	SSU72	33210	-	NM_014188	1477445	1509937	5
chr1	1533387	1535476	C1orf233	2089	-	NM_001242659	1534714	1535395	1
chr1	1550794	1565990	MIB2	15196	+	NM_001170687	1550839	1565910	20
chr1	1567559	1570030	MMP23B	2471	+	NM_006983	1567597	1570001	8
chr1	1570602	1655859	CDK11B	85257	-	NM_033489	1571125	1654035	21
chr1	1592938	1624243	SLC35E2B	31305	-	NM_001290264	1597220	1608138	10
chr1	1631377	1633247	MMP23A	1870	+	NR_002946	1633247	1633247	6
chr1	1633822	1656004	CDK11A	22182	-	NM_001313896	1634345	1654257	20
chr1	1656276	1677438	SLC35E2	21162	-	NM_001199787	1656852	1670996	7
chr1	1682670	1711508	NADK	28838	-	NM_001198994	1684342	1696845	14
chr1	1716723	1822556	GNB1	105833	-	NM_002074	1718769	1756892	12
chr1	1846265	1848733	CALML6	2468	+	NM_138705	1846719	1848632	6
chr1	1849028	1850740	TMEM52	1712	-	NM_178545	1849320	1850704	5
chr1	1853389	1935276	CFAP74	81887	-	NM_001304360	1853725	1922395	39
chr1	1950767	1962192	GABRD	11425	+	NM_000815	1950862	1961721	9
chr1	1981908	2116834	PRKCZ	134926	+	NM_002744	1982069	2116448	18
chr1	2115898	2139172	FAAP20	23274	-	NM_001146310	2116716	2132537	8
chr1	2160133	2241652	SKI	81519	+	NM_003036	2160205	2238204	7
chr1	2252691	2323190	MORN1	70499	-	NM_024848	2252821	2322972	14
chr1	2281852	2284100	LOC100129534	2248	-	NR_024489	2284100	2284100	1
chr1	2323213	2336885	RER1	13672	+	NM_007033	2327229	2334563	7
chr1	2336240	2344010	PEX10	7770	-	NM_153818	2337204	2343941	6
chr1	2398897	2436969	PLCH2	38072	+	NM_001303012	2399058	2435066	22
chr1	2439969	2458067	PANK4	18098	-	NM_018216	2440285	2458050	19
chr1	2460183	2461684	HES5	1501	-	NM_001010926	2460907	2461603	3
chr1	2481358	2488450	LOC115110	7092	-	NR_037844	2488450	2488450	7
chr1	2487803	2497061	TNFRSF14	9258	+	NM_003820	2488103	2494712	8
chr1	2497973	2515973	LOC100996583	18000	+	NR_121638	2515973	2515973	4
chr1	2517898	2522908	FAM213B	5010	+	NR_036638	2522908	2522908	7
chr1	2522080	2564481	MMEL1	42401	-	NM_033467	2522428	2560923	24
chr1	2572806	2706230	TTC34	133424	-	NM_001242672	2572806	2706156	7
chr1	2938045	2939467	ACTRT2	1422	+	NM_080431	2938250	2939384	1
chr1	2976180	2984289	LINC00982	8109	-	NR_015440	2984289	2984289	6
chr1	2985741	3355185	PRDM16	369444	+	NM_199454	2985823	3350375	17
chr1	3044538	3044599	MIR4251	61	+	NR_036215	3044599	3044599	1
chr1	3371146	3397677	ARHGEF16	26531	+	NM_014448	3379648	3397151	15
chr1	3404505	3528059	MEGF6	123554	-	NM_001409	3407091	3527832	37
chr1	3477259	3477354	MIR551A	95	-	NR_030277	3477354	3477354	1
chr1	3541555	3546694	TPRG1L	5139	+	NM_182752	3541636	3545167	5
chr1	3547330	3566671	WRAP73	19341	-	NM_017818	3547538	3566563	12
chr1	3569128	3652765	TP73	83637	+	NM_005427	3598929	3649643	14
chr1	3652547	3663937	TP73-AS1	11390	-	NR_033710	3663937	3663937	6
chr1	3668964	3688209	CCDC27	19245	+	NM_152492	3669045	3688087	12
chr1	3689324	3692546	SMIM1	3222	+	NM_001288583	3691937	3692485	4
chr1	3696783	3713068	LRRC47	16285	-	NM_020710	3697651	3713040	7
chr1	3728644	3773797	CEP104	45153	-	NM_014704	3731965	3768971	22
chr1	3773830	3801993	DFFB	28163	+	NR_104222	3801993	3801993	8
chr1	3805696	3816857	C1orf174	11161	-	NM_207356	3806523	3816750	4
chr1	3816967	3832011	LINC01134	15044	+	NR_024455	3832011	3832011	4
chr1	4000671	4012643	LINC01346	11972	+	NR_040065	4012643	4012643	3
chr1	4472110	4484744	LOC284661	12634	+	NR_027088	4484744	4484744	6
chr1	4715104	4843851	AJAP1	128747	+	NM_018836	4715485	4834559	6
chr1	5624130	5624203	MIR4417	73	+	NR_039612	5624203	5624203	1
chr1	5922731	5922801	MIR4689	70	-	NR_039838	5922801	5922801	1
chr1	5922867	6052533	NPHP4	129666	-	NR_111987	6052533	6052533	33
chr1	6052357	6161253	KCNAB2	108896	+	NM_001199861	6100628	6158634	16
chr1	6161846	6240194	CHD5	78348	-	NM_015557	6166339	6240083	42
chr1	6245079	6259679	RPL22	14600	-	NM_000983	6246731	6259633	4
chr1	6264899	6265840	LOC102724450	941	-	NR_125997	6265840	6265840	3
chr1	6266188	6281359	RNF207	15171	+	NM_207396	6266595	6279467	18
chr1	6281252	6296044	ICMT	14792	-	NM_012405	6285139	6295971	5
chr1	6296299	6299502	LINC00337	3203	+	NR_103534	6299502	6299502	5
chr1	6304251	6305638	HES3	1387	+	NM_001024598	6304425	6305567	4
chr1	6307405	6321035	GPR153	13630	-	NM_207370	6309397	6314965	6
chr1	6324331	6453826	ACOT7	129495	-	NM_007274	6324656	6453459	9
chr1	6475293	6479979	HES2	4686	-	NM_019089	6478932	6479880	4
chr1	6484847	6521004	ESPN	36157	+	NM_031475	6485015	6520206	13
chr1	6489893	6489956	MIR4252	63	-	NR_036218	6489956	6489956	1
chr1	6521213	6526255	TNFRSF25	5042	-	NM_003790	6521493	6526167	10
chr1	6526151	6580121	PLEKHG5	53970	-	NM_198681	6527622	6579571	22
chr1	6581406	6614658	NOL9	33252	-	NM_024654	6585913	6614562	12
chr1	6615337	6639817	TAS1R1	24480	+	NM_138697	6615433	6639644	6
chr1	6640050	6649340	ZBTB48	9290	+	NM_005341	6640669	6649272	11
chr1	6650783	6662958	KLHL21	12175	-	NM_014851	6653424	6662877	4
chr1	6673755	6684093	PHF13	10338	+	NM_153812	6674126	6681697	4
chr1	6685209	6695646	THAP3	10437	+	NM_138350	6685278	6694148	5
chr1	6694227	6761966	DNAJC11	67739	-	NM_018198	6695734	6761860	16
chr1	6784804	6790072	LOC100505887	5268	+	NR_104620	6790072	6790072	2
chr1	6845383	7829766	CAMTA1	984383	+	NM_015215	6845590	7826551	23
chr1	7831328	7841492	VAMP3	10164	+	NM_004781	7831443	7839705	5
chr1	7844488	7905240	PER3	60752	+	NM_001289863	7844937	7902815	23
chr1	7907671	7913551	UTS2	5880	-	NM_021995	7907825	7913491	5
chr1	7975930	8003225	TNFRSF9	27295	-	NM_001561	7980894	8000054	9
chr1	8021713	8045342	PARK7	23629	+	NM_001123377	8022845	8045114	7
chr1	8071778	8086393	ERRFI1	14615	-	NM_018948	8073269	8075679	4
chr1	8268731	8275268	LOC102724539	6537	+	NR_125998	8275268	8275268	4
chr1	8378144	8404227	SLC45A1	26083	+	NM_001080397	8378168	8404073	9
chr1	8412463	8877699	RERE	465236	-	NM_012102	8415146	8716356	24
chr1	8484704	8495076	LOC102724552	10372	+	NR_125999	8495076	8495076	4
chr1	8554859	8554973	SNORD128	114	-	NR_132752	8554973	8554973	1
chr1	8921058	8939151	ENO1	18093	-	NM_001428	8921418	8934967	12
chr1	8926560	8926649	MIR6728	89	-	NR_106786	8926649	8926649	1
chr1	8938893	8939943	ENO1-AS1	1050	+	NR_038351	8939943	8939943	2
chr1	9005892	9035148	CA6	29256	+	NM_001215	9005945	9034763	8
chr1	9063358	9086404	SLC2A7	23046	-	NM_207420	9063358	9086404	12
chr1	9097004	9129887	SLC2A5	32883	-	NM_003039	9097644	9129595	12
chr1	9164475	9189229	GPR157	24754	-	NM_024980	9164477	9189086	4
chr1	9208069	9242397	MIR34AHG	34328	-	NR_132742	9242397	9242397	2
chr1	9211726	9211836	MIR34A	110	-	NR_029610	9211836	9211836	1
chr1	9242262	9252144	LOC102724571	9882	+	NR_132738	9252144	9252144	3
chr1	9294862	9331394	H6PD	36532	+	NM_004285	9304993	9324928	5
chr1	9352940	9429590	SPSB1	76650	+	NM_025106	9415950	9427634	3
chr1	9485152	9489055	LOC100506022	3903	-	NR_104622	9489055	9489055	2
chr1	9599527	9642831	SLC25A33	43304	+	NM_032315	9599750	9642559	7
chr1	9648931	9674935	TMEM201	26004	+	NM_001130924	9648988	9673141	11
chr1	9711789	9789172	PIK3CD	77383	+	NM_005026	9770513	9787104	24
chr1	9712667	9714644	PIK3CD-AS1	1977	-	NR_027045	9714644	9714644	2
chr1	9732483	9747632	PIK3CD-AS2	15149	-	NR_126366	9747632	9747632	3
chr1	9789078	9884584	CLSTN1	95506	-	NM_001009566	9790565	9883791	19
chr1	9908333	9970316	CTNNBIP1	61983	-	NM_020248	9910775	9932122	6
chr1	9982170	10003485	LZIC	21315	-	NM_001316975	9982312	9996677	8
chr1	10002980	10045556	NMNAT1	42576	+	NM_001297778	10032131	10042759	5
chr1	10027438	10027516	MIR5697	78	+	NR_049882	10027516	10027516	1
chr1	10057254	10076078	RBP7	18824	+	NM_052960	10057316	10075890	4
chr1	10093040	10241296	UBE4B	148256	+	NM_001105562	10093728	10240014	28
chr1	10270763	10441661	KIF1B	170898	+	NM_015074	10292386	10436645	47
chr1	10459048	10480568	PGD	21520	+	NM_002631	10459174	10479806	13
chr1	10490158	10502872	APITD1	12714	+	NM_199294	10490574	10502462	5
chr1	10490158	10512060	APITD1-CORT	21902	+	NM_001270517	10490574	10502462	6
chr1	10509775	10512060	CORT	2285	+	NM_001302	10510280	10511652	2
chr1	10520602	10532613	DFFA	12011	-	NM_004401	10521546	10532515	6
chr1	10535002	10690815	PEX14	155813	+	NM_004565	10535023	10690044	9
chr1	10696665	10856733	CASZ1	160068	-	NM_001079843	10698998	10753946	21
chr1	11006529	11042094	C1orf127	35565	-	NM_001170754	11007719	11042094	13
chr1	11072678	11085549	TARDBP	12871	+	NM_007375	11073784	11082711	6
chr1	11086579	11107296	MASP2	20717	-	NM_006610	11086941	11107264	11
chr1	11114648	11120091	SRM	5443	-	NM_003132	11114921	11120000	8
chr1	11126669	11159967	EXOSC10	33298	-	NM_001001998	11126774	11159888	25
chr1	11166587	11322608	MTOR	156021	-	NM_004958	11167541	11319466	58
chr1	11203954	11209595	MTOR-AS1	5641	+	NR_046600	11209595	11209595	4
chr1	11249345	11256038	ANGPTL7	6693	+	NM_021146	11249636	11255080	5
chr1	11333254	11348491	UBIAD1	15237	+	NM_013319	11333588	11346188	2
chr1	11539294	11597640	PTCHD2	58346	+	NM_020780	11561049	11596743	21
chr1	11669587	11673411	LOC101929181	3824	+	NR_104624	11673411	11673411	3
chr1	11708417	11714888	FBXO2	6471	-	NM_012168	11708750	11714397	6
chr1	11714431	11723384	FBXO44	8953	+	NM_001304791	11715892	11721330	6
chr1	11724149	11734409	FBXO6	10260	+	NM_018438	11728715	11733908	6
chr1	11734536	11751678	MAD2L2	17142	-	NM_001127325	11734831	11740658	9
chr1	11751780	11780336	DRAXIN	28556	+	NM_198545	11766315	11779753	7
chr1	11796141	11810828	AGTRAP	14687	+	NM_001040197	11796265	11808650	6
chr1	11822249	11849642	C1orf167	27393	+	NM_001010881	11824457	11849503	21
chr1	11837133	11839676	LOC102724659	2543	-	NR_126000	11839676	11839676	3
chr1	11845786	11866160	MTHFR	20374	-	NM_005957	11850736	11863173	12
chr1	11866152	11903201	CLCN6	37049	+	NM_001286	11866319	11900280	23
chr1	11900375	11907673	NPPA-AS1	7298	+	NR_037806	11907673	11907673	4
chr1	11905766	11907840	NPPA	2074	-	NM_006172	11906065	11907741	3
chr1	11917520	11918992	NPPB	1472	-	NM_002521	11917711	11918890	3
chr1	11979644	11986485	KIAA2013	6841	-	NM_138346	11980371	11986294	3
chr1	11994723	12035599	PLOD1	40876	+	NM_001316320	11994836	12034865	20
chr1	12040237	12073572	MFN2	33335	+	NM_014874	12049225	12071622	19
chr1	12079298	12092106	MIIP	12808	+	NM_021933	12081783	12091865	10
chr1	12089214	12089279	MIR6729	65	+	NR_106787	12089279	12089279	1
chr1	12123433	12204264	TNFRSF8	80831	+	NM_001243	12123655	12202588	15
chr1	12226999	12227095	MIR7846	96	+	NR_107000	12227095	12227095	1
chr1	12227059	12269277	TNFRSF1B	42218	+	NM_001066	12227148	12267077	10
chr1	12251769	12251830	MIR4632	61	+	NR_039775	12251830	12251830	1
chr1	12290095	12572098	VPS13D	282003	+	NM_015378	12294323	12569078	70
chr1	12567299	12567451	SNORA59A	152	+	NR_003025	12567451	12567451	1
chr1	12567299	12567451	SNORA59B	152	+	NR_003022	12567451	12567451	1
chr1	12627938	12677737	DHRS3	49799	-	NM_004753	12628368	12677353	6
chr1	12638984	12639051	MIR6730	67	-	NR_106788	12639051	12639051	1
chr1	12704565	12727097	AADACL4	22532	+	NM_001013630	12704565	12726746	4
chr1	12776117	12788726	AADACL3	12609	+	NM_001103170	12776179	12785963	4
chr1	12806133	12821102	C1orf158	14969	+	NM_152290	12806378	12820884	4
chr1	12834990	12838048	PRAMEF12	3058	+	NM_001080830	12835010	12837742	3
chr1	12851545	12856777	PRAMEF1	5232	+	NM_023013	12853376	12856145	4
chr1	12884617	12891264	PRAMEF11	6647	-	NM_001146344	12884799	12888648	4
chr1	12907229	12908157	HNRNPCL4	928	-	NM_001302551	12907260	12908142	1
chr1	12907229	12908235	HNRNPCL3	1006	-	NM_001146181	12907260	12908142	1
chr1	12907229	12908609	HNRNPCL1	1380	-	NM_001013631	12907260	12908142	2
chr1	12916940	12921764	PRAMEF2	4824	+	NM_023014	12918864	12921634	4
chr1	12939032	12946025	PRAMEF4	6993	-	NM_001009611	12939364	12943215	4
chr1	12976466	12980300	PRAMEF7	3834	+	NM_001012277	12977512	12980233	4
chr1	12976466	12980300	PRAMEF8	3834	+	NM_001012276	12977512	12980233	4
chr1	12998301	13007406	PRAMEF6	9105	-	NM_001010889	12998504	13002348	4
chr1	12998504	13002353	PRAMEF9	3849	-	NM_001010890	12998504	13002353	3
chr1	13035542	13038381	PRAMEF22	2839	+	NM_001100631	13035542	13038381	3
chr1	13052239	13112702	PRAMEF25	60463	-	NM_001310134	13052725	13112686	4
chr1	13052393	13112702	PRAMEF26	60309	-	NM_001306072	13052725	13112686	4
chr1	13182959	13184326	HNRNPCL2	1367	-	NM_001136561	13182990	13183872	2
chr1	13194517	13199727	PRAMEF34P	5210	+	NR_111947	13199727	13199727	4
chr1	13194517	13199727	PRAMEF36P	5210	+	NR_111945	13199727	13199727	4
chr1	13328195	13698405	PRAMEF18	370210	-	NM_001099850	13328832	13698358	3
chr1	13359818	13369057	PRAMEF5	9239	+	NM_001013407	13364890	13368733	4
chr1	13421175	13428190	PRAMEF15	7015	+	NM_001098376	13424002	13427859	4
chr1	13424002	13427859	PRAMEF27	3857	+	NM_001300891	13424002	13427859	3
chr1	13447413	13452656	PRAMEF13	5243	-	NM_001291380	13448049	13450836	4
chr1	13447413	13452656	PRAMEF14	5243	-	NM_001024661	13448049	13450836	4
chr1	13474052	13477569	PRAMEF19	3517	-	NM_001099790	13474688	13477522	3
chr1	13495253	13498259	PRAMEF16	3006	+	NM_001045480	13495283	13498128	3
chr1	13495257	13498257	PRAMEF17	3000	+	NM_001099851	13495283	13498128	3
chr1	13629924	13635299	PRAMEF10	5375	+	NM_001039361	13632347	13635279	4
chr1	13629931	13635299	PRAMEF33P	5368	+	NM_001291381	13632347	13635279	4
chr1	13736906	13747803	PRAMEF20	10897	+	NM_001099852	13742811	13747733	4
chr1	13801444	13840242	LRRC38	38798	-	NM_001010847	13802313	13840088	2
chr1	13910251	13944452	PDPN	34201	+	NM_006474	13910300	13942406	6
chr1	14026734	14151574	PRDM2	124840	+	NM_001135610	14042100	14149679	8
chr1	14925212	15444544	KAZN	519332	+	NM_201628	14925493	15441131	15
chr1	15438310	15478960	TMEM51-AS1	40650	-	NR_027136	15478960	15478960	5
chr1	15479027	15546974	TMEM51	67947	+	NM_001136216	15541583	15546239	4
chr1	15490691	15498120	C1orf195	7429	-	NM_001278502	15490839	15497774	3
chr1	15573767	15724622	FHAD1	150855	+	NM_052929	15578280	15723909	31
chr1	15736390	15756839	EFHD2	20449	+	NM_024329	15736467	15755220	4
chr1	15764937	15773153	CTRC	8216	+	NM_007272	15764960	15773084	8
chr1	15783222	15798586	CELA2A	15364	+	NM_033440	15783248	15798502	8
chr1	15802595	15817895	CELA2B	15300	+	NM_015849	15802620	15817807	8
chr1	15817895	15851285	CASP9	33390	-	NM_032996	15819437	15844773	9
chr1	15853307	15898228	DNAJC16	44921	+	NR_109898	15898228	15898228	15
chr1	15898193	15911605	AGMAT	13412	-	NM_024758	15900145	15911462	7
chr1	15943952	15987552	DDI2	43600	+	NM_032341	15944165	15983128	10
chr1	15986207	15988525	RSC1A1	2318	+	NM_006511	15986363	15988217	1
chr1	16010826	16061264	PLEKHM2	50438	+	NM_015164	16011053	16060429	20
chr1	16062808	16067887	SLC25A34	5079	+	NM_207348	16062980	16065901	5
chr1	16068986	16074292	TMEM82	5306	+	NM_001013641	16069054	16074127	6
chr1	16085254	16113084	FBLIM1	27830	+	NM_017556	16091478	16111156	9
chr1	16133656	16134194	UQCRHL	538	-	NM_001089591	16133868	16134144	1
chr1	16160709	16174642	FLJ37453	13933	-	NR_024279	16174642	16174642	2
chr1	16174358	16266950	SPEN	92592	+	NM_015001	16174562	16265922	15
chr1	16268363	16302627	ZBTB17	34264	-	NM_001287604	16268463	16273595	16
chr1	16330730	16333190	C1orf64	2460	+	NM_178840	16330798	16332841	2
chr1	16340522	16345285	HSPB7	4763	-	NM_014424	16342074	16344458	3
chr1	16348485	16360545	CLCNKA	12060	+	NM_001042704	16349114	16360153	20
chr1	16370230	16383821	CLCNKB	13591	+	NM_000085	16370987	16383411	20
chr1	16384263	16400127	FAM131C	15864	-	NM_182623	16384931	16399937	7
chr1	16450831	16482582	EPHA2	31751	-	NM_004431	16451709	16482427	17
chr1	16524598	16539104	ARHGEF19	14506	-	NM_153213	16525081	16535549	16
chr1	16558181	16563659	RSG1	5478	-	NM_030907	16558542	16563237	5
chr1	16573334	16678986	FBXO42	105652	-	NM_018994	16577164	16641913	10
chr1	16693524	16724643	SZRD1	31119	+	NR_073501	16724643	16724643	5
chr1	16725137	16763919	SPATA21	38782	-	NM_198546	16725259	16757866	13
chr1	16767166	16786584	NECAP2	19418	+	NM_001145278	16767256	16785385	8
chr1	16793930	16819196	CROCCP3	25266	-	NR_023386	16819196	16819196	15
chr1	16865218	16866530	FAM231B	1312	+	NM_001310155	16865560	16866070	1
chr1	16875408	16875482	MIR3675	74	+	NR_037446	16875482	16875482	1
chr1	16888921	16940100	NBPF1	51179	-	NM_017940	16890437	16918516	29
chr1	16944750	16957401	CROCCP2	12651	-	NR_026752	16957401	16957401	7
chr1	16972068	16976915	MST1P2	4847	+	NR_027504	16976915	16976915	14
chr1	16999497	17000007	FAM231A	510	+	NM_001282321	16999497	17000007	1
chr1	16999497	17000152	FAM231C	655	+	NM_001310138	16999497	17000007	1
chr1	17017712	17046652	ESPNP	28940	-	NR_026567	17046652	17046652	11
chr1	17081128	17090975	MST1L	9847	-	NM_001271733	17083726	17090975	15
chr1	17248444	17299474	CROCC	51030	+	NM_014675	17248513	17298941	37
chr1	17300998	17308081	MFAP2	7083	-	NM_001135247	17301414	17304768	9
chr1	17312452	17338467	ATP13A2	26015	-	NM_001141973	17312715	17338233	29
chr1	17345224	17380665	SDHB	35441	-	NM_003000	17345375	17380514	8
chr1	17393255	17445948	PADI2	52693	-	NM_007365	17395538	17445866	16
chr1	17531620	17572501	PADI1	40881	+	NM_013358	17531712	17570738	16
chr1	17575592	17610727	PADI3	35135	+	NM_016233	17575632	17609574	16
chr1	17604383	17604470	MIR3972	87	+	NR_039768	17604470	17604470	1
chr1	17634689	17690495	PADI4	55806	+	NM_012387	17634717	17690250	16
chr1	17698690	17728195	PADI6	29505	+	NM_207421	17698740	17727934	17
chr1	17733250	17766250	RCC2	33000	-	NM_018715	17735585	17765010	13
chr1	17866329	18024370	ARHGEF10L	158041	+	NM_018125	17907090	18023875	29
chr1	18081807	18153558	ACTL8	71751	+	NM_030812	18149503	18153014	3
chr1	18392150	18400905	LOC101927876	8755	+	NR_125946	18400905	18400905	3
chr1	18434239	18704977	IGSF21	270738	+	NM_032880	18434622	18704820	10
chr1	18807423	18812480	KLHDC7A	5057	+	NM_152375	18807475	18809809	1
chr1	18957499	19075360	PAX7	117861	+	NM_001135254	18958097	19071423	9
chr1	19166092	19186155	TAS1R2	20063	-	NM_152232	19166092	19186154	6
chr1	19197923	19229293	ALDH4A1	31370	-	NM_170726	19199338	19229017	16
chr1	19209695	19209769	MIR4695	74	-	NR_039844	19209769	19209769	1
chr1	19223564	19223642	MIR1290	78	-	NR_031622	19223642	19223642	1
chr1	19230773	19282826	IFFO2	52053	-	NM_001136265	19235054	19282826	9
chr1	19400999	19536746	UBR4	135747	-	NM_020765	19401325	19536742	106
chr1	19542157	19578053	EMC1	35896	-	NM_015047	19545796	19578003	23
chr1	19578074	19586622	MRTO4	8548	+	NM_016183	19578329	19585324	8
chr1	19592475	19600568	AKR7L	8093	-	NR_040288	19600568	19600568	7
chr1	19609056	19615280	AKR7A3	6224	-	NM_012067	19609224	19615203	7
chr1	19619740	19622230	LOC100506730	2490	-	NR_037847	19622230	19622230	1
chr1	19629201	19638640	AKR7A2	9439	-	NM_003689	19630718	19638618	7
chr1	19638739	19658922	PQLC2	20183	+	NR_109848	19658922	19658922	10
chr1	19665266	19812135	CAPZB	146869	-	NM_001206540	19669255	19811932	10
chr1	19923470	19956315	MINOS1	32845	+	NM_001204083	19923539	19952086	5
chr1	19923470	19984949	MINOS1-NBL1	61479	+	NM_001204088	19927442	19983622	5
chr1	19934300	19935138	RPS14P3	838	+	NR_077246	19935138	19935138	1
chr1	19969722	19984949	NBL1	15227	+	NM_182744	19969805	19983622	4
chr1	19991779	20007459	HTR6	15680	+	NM_000871	19992246	20005861	3
chr1	20008705	20126410	TMCO4	117705	-	NM_181719	20009532	20107251	16
chr1	20140521	20141771	RNF186	1250	-	NM_019062	20140910	20141594	1
chr1	20208887	20239437	OTUD3	30550	+	NM_015207	20209006	20234239	8
chr1	20246799	20250110	PLA2G2E	3311	-	NM_014589	20246799	20250052	4
chr1	20301923	20306932	PLA2G2A	5009	-	NM_000300	20302193	20305266	6
chr1	20396700	20418394	PLA2G5	21694	+	NM_000929	20411323	20417185	5
chr1	20439142	20446059	PLA2G2D	6917	-	NM_012400	20440606	20445991	4
chr1	20465822	20476879	PLA2G2F	11057	+	NM_022819	20465920	20474894	5
chr1	20489584	20503857	PLA2G2C	14273	-	NM_001316722	20489752	20503856	5
chr1	20510735	20512979	UBXN10-AS1	2244	-	NR_110078	20512979	20512979	2
chr1	20512570	20522541	UBXN10	9971	+	NM_152376	20517054	20517897	2
chr1	20617411	20681387	VWA5B1	63976	+	NM_001039500	20637094	20680756	22
chr1	20686293	20755287	LINC01141	68994	-	NR_033887	20755287	20755287	12
chr1	20808883	20812728	CAMK2N1	3845	-	NM_018584	20810141	20811872	2
chr1	20825940	20834674	MUL1	8734	-	NM_024544	20827182	20834517	4
chr1	20878931	20881513	FAM43B	2582	+	NM_207334	20879466	20880456	1
chr1	20915443	20945400	CDA	29957	+	NM_001785	20915622	20945061	4
chr1	20959947	20978004	PINK1	18057	+	NM_032409	20960041	20977184	8
chr1	20960171	20960281	MIR6084	110	+	NR_106732	20960281	20960281	1
chr1	20969149	20978686	PINK1-AS	9537	-	NR_046507	20978686	20978686	3
chr1	20978259	20988037	DDOST	9778	-	NM_005216	20978871	20987894	11
chr1	20990506	21044510	KIF17	54004	-	NM_020816	20991076	21044199	15
chr1	21046224	21059133	SH2D5	12909	-	NM_001103161	21048284	21054537	10
chr1	21069170	21113181	HP1BP3	44011	-	NM_016287	21071289	21106933	13
chr1	21132784	21503381	EIF4G3	370597	-	NM_001198801	21133811	21329235	35
chr1	21314806	21314925	MIR1256	119	-	NR_031657	21314925	21314925	1
chr1	21543739	21672034	ECE1	128295	-	NM_001113348	21546447	21671871	19
chr1	21619782	21626362	LOC100506801	6580	+	NR_038404	21626362	21626362	3
chr1	21766582	21811393	NBPF3	44811	+	NR_046176	21811393	21811393	18
chr1	21835857	21904905	ALPL	69048	+	NM_000478	21880574	21904141	12
chr1	21922707	21995856	RAP1GAP	73149	-	NM_001145657	21924212	21946525	27
chr1	22004791	22109688	USP48	104897	-	NM_032236	22005909	22109450	27
chr1	22138757	22151714	LDLRAD2	12957	+	NM_001013693	22138944	22148708	5
chr1	22148724	22263790	HSPG2	115066	-	NM_005529	22149808	22263710	97
chr1	22303417	22315847	CELA3B	12430	+	NM_007352	22303532	22315772	8
chr1	22328148	22339035	CELA3A	10887	+	NM_005747	22328167	22338960	8
chr1	22350486	22352541	LOC101928043	2055	-	NR_110692	22352541	22352541	3
chr1	22351683	22357717	LINC00339	6034	+	NR_023918	22357717	22357717	2
chr1	22379119	22419436	CDC42	40317	+	NM_001039802	22404971	22418010	7
chr1	22443797	22469519	WNT4	25722	-	NM_030761	22446542	22469415	5
chr1	22592731	22592793	MIR4418	62	+	NR_039613	22592793	22592793	1
chr1	22778343	22857650	ZBTB40	79307	+	NM_001083621	22816441	22852889	19
chr1	22890003	22930087	EPHA8	40084	+	NM_020526	22890128	22928234	17
chr1	22959750	22959859	MIR6127	109	-	NR_106742	22959859	22959859	1
chr1	22963117	22966175	C1QA	3058	+	NM_015991	22964109	22965900	3
chr1	22970117	22974603	C1QC	4486	+	NM_001114101	22970516	22974276	3
chr1	22979681	22988029	C1QB	8348	+	NM_000491	22985949	22987879	3
chr1	23037330	23247993	EPHB2	210663	+	NM_001309193	23037475	23240363	17
chr1	23046009	23046091	MIR4684	82	+	NR_039832	23046091	23046091	1
chr1	23189651	23189719	MIR4253	68	-	NR_036214	23189719	23189719	1
chr1	23279535	23291923	LACTBL1	12388	-	NM_001289974	23279535	23291923	6
chr1	23337326	23342343	C1orf234	5017	-	NM_001242521	23337393	23342266	3
chr1	23345940	23410184	KDM1A	64244	+	NM_001009999	23346089	23409857	21
chr1	23370797	23370865	MIR3115	68	+	NR_036057	23370865	23370865	1
chr1	23384350	23384427	MIR4419A	77	-	NR_039614	23384427	23384427	1
chr1	23410515	23495351	LUZP1	84836	-	NM_033631	23415387	23420754	5
chr1	23518387	23521222	HTR1D	2835	-	NM_000864	23519578	23520712	1
chr1	23607801	23612011	LINC01355	4210	-	NR_110616	23612011	23612011	2
chr1	23631180	23670857	HNRNPR	39677	-	NM_001102398	23636946	23667501	11
chr1	23685940	23696357	ZNF436	10417	-	NM_001077195	23688461	23694498	4
chr1	23695463	23698330	ZNF436-AS1	2867	+	NR_033690	23698330	23698330	1
chr1	23707401	23751272	TCEA3	43871	-	NM_003196	23707958	23751126	11
chr1	23755055	23810750	ASAP3	55695	-	NM_017707	23756348	23810626	25
chr1	23832919	23857712	E2F2	24793	-	NM_004091	23836371	23857285	7
chr1	23848421	23854911	LOC101928163	6490	+	NR_110799	23854911	23854911	3
chr1	23884420	23886285	ID3	1865	-	NM_002167	23885450	23885917	3
chr1	23953823	23967056	MDS2	13233	+	NR_027042	23967056	23967056	7
chr1	24018268	24022915	RPL11	4647	+	NM_001199802	24018313	24022863	6
chr1	24069855	24088549	TCEB3	18694	+	NM_003198	24069915	24086063	11
chr1	24086871	24104787	TCEB3-AS1	17916	-	NR_038280	24104787	24104787	4
chr1	24104875	24114722	PITHD1	9847	+	NM_020362	24105005	24113866	6
chr1	24117645	24122029	LYPLA2	4384	+	NM_007260	24119172	24121222	10
chr1	24122088	24127294	GALE	5206	-	NM_001008216	24122438	24125497	12
chr1	24128366	24151949	HMGCL	23583	-	NM_000191	24128952	24151905	9
chr1	24171571	24194859	FUCA1	23288	-	NM_000147	24172204	24194776	8
chr1	24200459	24239817	CNR2	39358	-	NM_001841	24201024	24202107	2
chr1	24255559	24255637	MIR378F	78	+	NR_039615	24255637	24255637	1
chr1	24286300	24289949	PNRC2	3649	+	NM_017761	24287947	24288367	3
chr1	24290836	24306953	SRSF10	16117	-	NR_034035	24306953	24306953	7
chr1	24382530	24438665	MYOM3	56135	-	NM_152372	24383853	24435126	37
chr1	24446260	24469775	IL22RA1	23515	-	NM_021258	24447294	24469572	7
chr1	24480646	24513765	IFNLR1	33119	-	NM_173064	24483619	24513738	7
chr1	24526729	24538180	LOC284632	11451	+	NR_027087	24538180	24538180	3
chr1	24645811	24690970	GRHL3	45159	+	NM_198174	24646041	24690861	16
chr1	24683488	24741587	STPG1	58099	-	NM_001199012	24685032	24727878	9
chr1	24742244	24799473	NIPAL3	57229	+	NM_020448	24746037	24795675	12
chr1	24822822	24828850	RCAN3AS	6028	-	NR_045409	24828850	24828850	3
chr1	24828840	24863510	RCAN3	34670	+	NM_001251979	24840862	24861767	5
chr1	24865763	24882515	LOC100506985	16752	-	NR_109781	24882515	24882515	3
chr1	24882566	24935818	NCMAP	53252	+	NM_001010980	24921921	24932238	4
chr1	24969593	24999772	SRRM1	30179	+	NM_001303448	24969817	24998777	18
chr1	25071759	25170815	CLIC4	99056	+	NM_013943	25072044	25167428	6
chr1	25226001	25291501	RUNX3	65500	-	NM_001031680	25228612	25291062	6
chr1	25245835	25245907	MIR6731	72	-	NR_106789	25245907	25245907	1
chr1	25349993	25350077	MIR4425	84	+	NR_039623	25350077	25350077	1
chr1	25548766	25559013	SYF2	10247	-	NM_015484	25549756	25558958	7
chr1	25568739	25573985	RSRP1	5246	-	NM_020317	25569079	25573454	5
chr1	25598976	25656936	RHD	57960	+	NM_016124	25599038	25655415	10
chr1	25664788	25688852	TMEM50A	24064	+	NM_014313	25666977	25687196	7
chr1	25688739	25747363	RHCE	58624	-	NM_020485	25689017	25747277	10
chr1	25757348	25826698	TMEM57	69350	+	NM_018202	25757589	25824957	11
chr1	25870075	25895377	LDLRAP1	25302	+	NM_015627	25870189	25893483	9
chr1	25943958	26112698	MAN1C1	168740	+	NM_001289010	25944288	26110341	12
chr1	26126666	26144713	SEPN1	18047	+	NM_020451	26126721	26142209	13
chr1	26146396	26159433	MTFR1L	13037	+	NM_001099627	26149595	26156275	7
chr1	26146444	26150097	LOC646471	3653	-	NR_024498	26150097	26150097	1
chr1	26158403	26185949	AUNIP	27546	-	NM_001287490	26158578	26185848	4
chr1	26187974	26197744	PAQR7	9770	-	NM_178422	26189289	26190330	2
chr1	26210676	26232993	STMN1	22317	-	NM_001145454	26212213	26231167	5
chr1	26232852	26232945	MIR3917	93	-	NR_037481	26232945	26232945	1
chr1	26286257	26324648	PAFAH2	38391	-	NM_000437	26288479	26317307	11
chr1	26348270	26362954	EXTL1	14684	+	NM_004455	26349137	26361838	11
chr1	26364512	26372629	SLC30A2	8117	-	NM_001004434	26365650	26372387	8
chr1	26377795	26394125	TRIM63	16330	-	NM_032588	26378363	26393985	9
chr1	26437655	26452039	PDIK1L	14384	+	NM_001243532	26440799	26449068	3
chr1	26485510	26489119	FAM110D	3609	+	NM_024869	26487782	26488598	2
chr1	26496387	26497364	ZNF593	977	+	NM_015871	26496474	26497207	3
chr1	26503980	26516376	CNKSR1	12396	+	NM_001297648	26510240	26516039	21
chr1	26517118	26529033	CATSPER4	11915	+	NM_198137	26517118	26529033	10
chr1	26551810	26556331	LOC101928303	4521	+	NR_110698	26556331	26556331	4
chr1	26560643	26605529	CEP85	44886	+	NM_022778	26566274	26603784	14
chr1	26606212	26608013	SH3BGRL3	1801	+	NM_031286	26606646	26607614	3
chr1	26608772	26644756	UBXN11	35984	-	NM_145345	26608789	26629374	15
chr1	26644410	26647014	CD52	2604	+	NM_001803	26644508	26646793	2
chr1	26648349	26680621	AIM1L	32272	-	NM_001039775	26648458	26673148	20
chr1	26688124	26699285	ZNF683	11161	-	NM_001307925	26688141	26695062	7
chr1	26737258	26756219	LIN28A	18961	+	NM_024674	26737382	26752949	4
chr1	26758772	26797795	DHDDS	39023	+	NM_205861	26759436	26795622	9
chr1	26789247	26794028	LOC101928324	4781	-	NR_125952	26794028	26794028	4
chr1	26798901	26803133	HMGN2	4232	+	NM_005517	26799103	26801639	6
chr1	26856248	26901520	RPS6KA1	45272	+	NM_002953	26856411	26900692	22
chr1	26881032	26881084	MIR1976	52	+	NR_031740	26881084	26881084	1
chr1	27022521	27108601	ARID1A	86080	+	NM_006015	27022894	27107247	20
chr1	27114453	27124894	PIGV	10441	+	NM_017837	27117306	27124335	4
chr1	27153200	27182211	ZDHHC18	29011	+	NM_032283	27153295	27180334	8
chr1	27189632	27190947	SFN	1315	+	NM_006142	27189703	27190450	1
chr1	27205872	27216869	GPN2	10997	-	NM_018066	27206167	27216587	5
chr1	27216978	27226962	GPATCH3	9984	-	NM_022078	27217500	27226933	7
chr1	27237974	27240567	NR0B2	2593	-	NM_021969	27238335	27240431	2
chr1	27248212	27273362	NUDC	25150	+	NM_006600	27248339	27272672	9
chr1	27276046	27286901	KDF1	10855	-	NM_152365	27276559	27278871	4
chr1	27320194	27327377	TRNP1	7183	+	NM_001013642	27320277	27320961	2
chr1	27331510	27339333	FAM46B	7823	-	NM_052943	27332434	27339161	2
chr1	27425299	27481621	SLC9A1	56322	-	NM_003047	27426797	27480825	12
chr1	27561006	27635124	WDTC1	74118	+	NM_015023	27587545	27632874	16
chr1	27648635	27662891	TMEM222	14256	+	NR_037580	27662891	27662891	8
chr1	27650364	27653016	ACTG1P20	2652	+	NR_033926	27653016	27653016	1
chr1	27668482	27680423	SYTL1	11941	+	NM_032872	27671825	27680343	15
chr1	27681669	27693357	MAP3K6	11688	-	NM_004672	27681881	27693088	29
chr1	27695600	27701315	FCN3	5715	-	NM_003665	27695726	27701309	8
chr1	27705589	27709823	CD164L2	4234	-	NM_207397	27706536	27709729	5
chr1	27719147	27722317	GPR3	3170	+	NM_005281	27720302	27721295	2
chr1	27730729	27816698	WASF2	85969	-	NM_006990	27734682	27755400	9
chr1	27860755	27930005	AHDC1	69250	-	NM_001029882	27873814	27878626	7
chr1	27938800	27961727	FGR	22927	-	NM_005248	27939424	27950427	13
chr1	27992571	27998724	IFI6	6153	-	NM_002038	27992891	27995825	5
chr1	28052489	28089423	FAM76A	36934	+	NM_001143912	28052591	28087092	10
chr1	28099693	28150963	STX12	51270	+	NM_177424	28099818	28148840	9
chr1	28157251	28178183	PPP1R8	20932	+	NM_014110	28157346	28176957	7
chr1	28160911	28161077	SCARNA1	166	+	NR_002997	28161077	28161077	1
chr1	28199053	28213196	THEMIS2	14143	+	NM_001286113	28199082	28212433	7
chr1	28218035	28241308	RPA2	23273	-	NM_001297558	28218673	28241171	9
chr1	28261465	28285668	SMPDL3B	24203	+	NM_001304579	28280965	28285349	8
chr1	28285972	28294607	XKR8	8635	+	NM_018053	28286580	28293711	3
chr1	28296854	28415148	EYA3	118294	-	NM_001990	28300976	28384537	18
chr1	28473676	28520447	PTAFR	46771	-	NM_001164721	28476503	28477532	3
chr1	28526789	28559542	DNAJC8	32753	-	NM_014280	28527758	28559509	9
chr1	28562601	28564616	ATPIF1	2015	+	NM_178190	28562694	28564308	3
chr1	28585962	28609002	SESN2	23040	+	NM_031459	28586358	28607313	10
chr1	28655512	28662478	MED18	6966	+	NM_017638	28657173	28661481	3
chr1	28696092	28826881	PHACTR4	130789	+	NM_001048183	28733958	28823061	14
chr1	28832454	28837404	SNHG3	4950	+	NR_036473	28837404	28837404	4
chr1	28832454	28865708	RCC1	33254	+	NR_030726	28865708	28865708	13
chr1	28835069	28835227	SNORA73B	158	+	NR_004404	28835227	28835227	1
chr1	28879528	28905057	TRNAU1AP	25529	+	NR_003109	28905057	28905057	10
chr1	28905049	28908366	SNHG12	3317	-	NR_024127	28908366	28908366	6
chr1	28905254	28905334	SNORD99	80	-	NR_003077	28905334	28905334	1
chr1	28906275	28906405	SNORA61	130	-	NR_002987	28906405	28906405	1
chr1	28906892	28907024	SNORA44	132	-	NR_002976	28907024	28907024	1
chr1	28907431	28907565	SNORA16A	134	-	NR_003035	28907565	28907565	1
chr1	28918711	28921088	RAB42	2377	+	NM_152304	28920311	28920629	2
chr1	28929608	28969604	TAF12	39996	-	NM_001135218	28930050	28948593	6
chr1	28975111	28975246	RNU11	135	+	NR_004407	28975246	28975246	1
chr1	28995239	29042115	GMEB1	46876	+	NM_024482	29010124	29041285	10
chr1	29063132	29096287	YTHDF2	33155	+	NM_001173128	29063632	29095464	6
chr1	29138653	29190208	OPRD1	51555	+	NM_000911	29138895	29189795	3
chr1	29213602	29446558	EPB41	232956	+	NM_203342	29320000	29442309	21
chr1	29445936	29450421	TMEM200B	4485	-	NM_001003682	29447416	29448340	2
chr1	29474249	29508637	SRSF4	34388	-	NM_005626	29474921	29508264	6
chr1	29519168	29557470	MECR	38302	-	NM_001024732	29520533	29543145	10
chr1	29563027	29653325	PTPRU	90298	+	NM_005704	29563156	29652173	31
chr1	29656131	29676626	LOC101928460	20495	-	NR_110758	29676626	29676626	3
chr1	30486798	30510459	LOC101929406	23661	-	NR_110790	30510459	30510459	7
chr1	31184123	31196432	MATN1	12309	-	NM_002379	31186428	31196398	8
chr1	31191618	31199593	MATN1-AS1	7975	+	NR_034182	31199593	31199593	4
chr1	31205314	31230683	LAPTM5	25369	-	NM_006762	31206674	31230592	8
chr1	31212002	31212079	MIR4420	77	-	NR_039616	31212079	31212079	1
chr1	31342312	31381480	SDC3	39168	-	NM_014654	31346057	31381433	5
chr1	31404352	31538564	PUM1	134212	-	NM_014676	31406057	31532413	22
chr1	31408535	31408623	SNORD103B	88	-	NR_033295	31408623	31408623	1
chr1	31421964	31422052	SNORD103A	88	-	NR_004054	31422052	31422052	1
chr1	31441009	31441084	SNORD103C	75	-	NR_003066	31441084	31441084	1
chr1	31652591	31712734	NKAIN1	60143	-	NM_024522	31654549	31712394	7
chr1	31732414	31769644	SNRNP40	37230	-	NM_004814	31732918	31769598	10
chr1	31769828	31837800	ZCCHC17	67972	+	NM_001282569	31791041	31837040	9
chr1	31838099	31845923	FABP3	7824	-	NM_004102	31838732	31845861	4
chr1	31882411	31907527	SERINC2	25116	+	NM_001199038	31882684	31907046	11
chr1	31971838	31974167	LINC01225	2329	+	NR_034112	31974167	31974167	3
chr1	31984035	31989846	LINC01226	5811	+	NR_027085	31989846	31989846	3
chr1	32042085	32053287	TINAGL1	11202	+	NM_022164	32042749	32052580	12
chr1	32083300	32092919	HCRTR1	9619	+	NM_001525	32084793	32092581	9
chr1	32095462	32110838	PEF1	15376	-	NM_012392	32096213	32110465	5
chr1	32117847	32169768	COL16A1	51921	-	NM_001856	32118251	32167794	71
chr1	32192705	32229664	ADGRB2	36959	-	NM_001294335	32193020	32222822	33
chr1	32224260	32224336	MIR4254	76	-	NR_036216	32224336	32224336	1
chr1	32256022	32281652	SPOCD1	25630	-	NM_144569	32256203	32280934	16
chr1	32372021	32403988	PTP4A2	31967	-	NM_080391	32374452	32384666	6
chr1	32479294	32526460	KHDRBS1	47166	+	NR_073499	32526460	32526460	11
chr1	32538502	32568467	TMEM39B	29965	+	NM_018056	32538648	32568274	9
chr1	32552549	32552608	MIR5585	59	+	NR_049850	32552608	32552608	1
chr1	32573643	32642168	KPNA6	68525	+	NM_012316	32573731	32636495	14
chr1	32645344	32663886	TXLNA	18542	+	NM_175852	32645946	32660796	11
chr1	32665986	32670991	CCDC28B	5005	+	NM_024296	32667536	32670849	6
chr1	32671235	32674288	IQCC	3053	+	NM_001160042	32671282	32673683	5
chr1	32674694	32681797	DCDC2B	7103	+	NM_001099434	32674694	32681498	9
chr1	32680077	32687972	TMEM234	7895	-	NR_133636	32687972	32687972	11
chr1	32687970	32697205	EIF3I	9235	+	NM_003757	32688042	32696797	11
chr1	32697260	32707311	MTMR9LP	10051	-	NR_026850	32707311	32707311	7
chr1	32712817	32714461	FAM167B	1644	+	NM_032648	32713022	32714202	2
chr1	32716839	32751768	LCK	34929	+	NM_005356	32739930	32751317	13
chr1	32757707	32799224	HDAC1	41517	+	NM_004964	32757770	32798645	14
chr1	32799429	32801840	MARCKSL1	2411	-	NR_052852	32801840	32801840	2
chr1	32826870	32827844	FAM229A	974	-	NM_001167676	32827033	32827692	3
chr1	32827861	32829924	TSSK3	2063	+	NM_052841	32828302	32829857	2
chr1	32830233	32860062	BSDC1	29829	-	NR_125352	32860062	32860062	12
chr1	32930657	32953459	ZBTB8B	22802	+	NM_001145720	32936225	32951019	4
chr1	33004745	33071551	ZBTB8A	66806	+	NM_001291496	33058532	33065898	5
chr1	33086816	33116191	ZBTB8OS	29375	-	NM_178547	33087462	33116166	7
chr1	33116748	33151812	RBBP4	35064	+	NM_001135255	33116907	33145306	12
chr1	33145506	33168361	SYNC	22855	-	NM_030786	33147450	33168261	5
chr1	33207511	33240571	KIAA1522	33060	+	NM_020888	33207555	33238488	7
chr1	33240839	33283633	YARS	42794	-	NM_003680	33241581	33282845	13
chr1	33283042	33324480	S100PBP	41438	+	NM_001256121	33291700	33321639	7
chr1	33327868	33338093	FNDC5	10225	-	NM_001171941	33330210	33333974	5
chr1	33352097	33360247	HPCA	8150	+	NM_002143	33354499	33359463	4
chr1	33360195	33366953	TMEM54	6758	-	NM_033504	33360405	33366839	6
chr1	33402046	33430414	RNF19B	28368	-	NM_001127361	33402888	33430286	9
chr1	33473540	33502512	AK2	28972	-	NR_037591	33502512	33502512	8
chr1	33546713	33586132	AZIN2	39419	+	NM_052998	33547850	33585783	12
chr1	33611002	33647671	TRIM62	36669	-	NM_018207	33612777	33647033	5
chr1	33722173	33766320	ZNF362	44147	+	NM_152493	33736175	33764647	9
chr1	33772366	33786699	A3GALT2	14333	-	NM_001080438	33772366	33786699	5
chr1	33789223	33841194	PHC2	51971	-	NM_198040	33790465	33841140	14
chr1	33797993	33798093	MIR3605	100	-	NR_037400	33798093	33798093	1
chr1	33815952	33828846	LOC101929464	12894	+	NR_125978	33828846	33828846	3
chr1	33938231	33961995	ZSCAN20	23764	+	NM_145238	33944889	33961076	8
chr1	33979598	34631443	CSMD2	651845	-	NM_052896	33985117	34631414	70
chr1	34326075	34330392	HMGB4	4317	+	NM_145205	34329792	34330353	2
chr1	34334556	34351059	CSMD2-AS1	16503	+	NR_038372	34351059	34351059	8
chr1	34632483	34684731	C1orf94	52248	+	NM_032884	34663075	34684362	7
chr1	35135199	35135295	MIR552	96	-	NR_030278	35135295	35135295	1
chr1	35220647	35224113	GJB5	3466	+	NM_005268	35222931	35223753	2
chr1	35225341	35229325	GJB4	3984	+	NM_153212	35226855	35227656	2
chr1	35246789	35251965	GJB3	5176	+	NM_024009	35250363	35251176	2
chr1	35258598	35261348	GJA4	2750	+	NM_002060	35259814	35260816	2
chr1	35315962	35325417	SMIM12	9455	-	NM_138428	35321299	35321578	2
chr1	35331036	35395186	DLGAP3	64150	-	NM_001080418	35331683	35370984	12
chr1	35441299	35444307	LOC653160	3008	-	NR_037869	35444307	35444307	3
chr1	35447126	35450948	ZMYM6NB	3822	-	NM_001195156	35447544	35450906	3
chr1	35451766	35497569	ZMYM6	45803	-	NM_007167	35452704	35496240	16
chr1	35525386	35581459	ZMYM1	56073	+	NM_001289088	35559588	35580860	11
chr1	35649200	35658743	SFPQ	9543	-	NM_005066	35650056	35658650	10
chr1	35734567	35887545	ZMYM4	152978	+	NM_005095	35734647	35885278	30
chr1	35899090	36023037	KIAA0319L	123947	-	NM_024874	35900494	36020092	21
chr1	36023392	36032380	NCDN	8988	+	NM_001014839	36023791	36031264	8
chr1	36038970	36060927	TFAP2E	21957	+	NM_178548	36039178	36060277	7
chr1	36065142	36107445	PSMB2	42303	-	NM_002794	36068867	36107033	6
chr1	36179476	36184790	C1orf216	5314	-	NM_152374	36181232	36181922	2
chr1	36197712	36235551	CLSPN	37839	-	NM_022111	36202096	36235471	25
chr1	36273827	36323490	AGO4	49663	+	NM_017629	36274017	36319206	18
chr1	36335408	36389899	AGO1	54491	+	NM_001317123	36358173	36385208	19
chr1	36396682	36522063	AGO3	125381	+	NM_024852	36397027	36521346	19
chr1	36549675	36553876	TEKT2	4201	+	NM_014466	36550522	36553787	10
chr1	36554452	36559533	ADPRHL2	5081	+	NM_017825	36554505	36558987	6
chr1	36560836	36590685	COL8A2	29849	-	NM_005202	36563169	36565843	4
chr1	36602169	36621654	TRAPPC3	19485	-	NM_001270895	36602803	36605671	5
chr1	36621565	36646451	MAP7D1	24886	+	NM_001286366	36622018	36645859	18
chr1	36690016	36770957	THRAP3	80941	+	NM_005119	36748164	36769618	12
chr1	36771993	36786948	SH3D21	14955	+	NM_001162530	36772021	36786728	16
chr1	36787630	36789755	EVA1B	2125	-	NM_018166	36787895	36788638	3
chr1	36805219	36851528	STK40	46309	-	NM_032017	36807355	36826933	12
chr1	36859020	36863560	LSM10	4540	-	NM_032881	36859358	36859730	2
chr1	36883506	36916086	OSCP1	32580	-	NM_145047	36883739	36915970	10
chr1	36921361	36930040	MRPS15	8679	-	NM_031280	36921388	36929876	8
chr1	36931643	36948915	CSF3R	17272	-	NM_172313	36931696	36945097	18
chr1	37261127	37499844	GRIK3	238717	-	NM_000831	37267451	37499709	16
chr1	37627163	37627235	MIR4255	72	+	NR_036217	37627235	37627235	1
chr1	37920479	37940044	LINC01137	19565	-	NR_038842	37940044	37940044	3
chr1	37940118	37949978	ZC3H12A	9860	+	NM_025079	37941097	37949212	6
chr1	37945830	37945890	MIR6732	60	+	NR_106790	37945890	37945890	1
chr1	37955560	37980420	MEAF6	24860	-	NR_073092	37980420	37980420	9
chr1	37966535	37966595	MIR5581	60	-	NR_049844	37966595	37966595	1
chr1	38000049	38019945	SNIP1	19896	-	NM_024700	38003348	38019830	4
chr1	38022519	38032458	DNALI1	9939	+	NM_003462	38022529	38030662	6
chr1	38032412	38061586	GNL2	29174	-	NM_013285	38032455	38061423	16
chr1	38076950	38100595	RSPO1	23645	-	NM_001038633	38078426	38095333	9
chr1	38147241	38156267	C1orf109	9026	-	NM_001303031	38148794	38156070	5
chr1	38158072	38175391	CDCA8	17319	+	NM_018101	38158362	38174038	11
chr1	38181645	38230824	EPHA10	49179	-	NM_001099439	38184043	38230738	17
chr1	38259773	38267278	MANEAL	7505	+	NM_001031740	38259854	38265531	4
chr1	38268613	38273865	YRDC	5252	-	NM_024640	38269596	38273852	5
chr1	38273472	38275126	C1orf122	1654	+	NM_198446	38274076	38274745	3
chr1	38275238	38325292	MTF1	50054	-	NM_005955	38280807	38323330	11
chr1	38326368	38412729	INPP5B	86361	-	NM_005540	38327986	38411980	24
chr1	38422651	38455761	SF3A3	33110	-	NM_006802	38423857	38455637	17
chr1	38462441	38471187	FHL3	8746	-	NM_004468	38463076	38465084	6
chr1	38478383	38490497	UTP11L	12114	+	NM_016037	38478474	38489300	8
chr1	38509522	38512450	POU3F1	2928	-	NM_002699	38511059	38512415	1
chr1	38554902	38555001	MIR3659	99	+	NR_037432	38555001	38555001	1
chr1	38674705	38680439	LINC01343	5734	-	NR_038928	38680439	38680439	4
chr1	39303868	39325495	RRAGC	21627	-	NM_022157	39305224	39325318	7
chr1	39328161	39339050	MYCBP	10889	-	NM_012333	39330341	39338977	5
chr1	39328161	39347298	GJA9-MYCBP	19137	-	NR_037634	39347298	39347298	7
chr1	39339738	39347298	GJA9	7560	-	NM_030772	39340222	39341770	2
chr1	39351477	39407502	RHBDL2	56025	-	NM_017821	39352175	39384884	8
chr1	39456915	39471737	AKIRIN1	14822	+	NM_024595	39457052	39469727	5
chr1	39491966	39500308	NDUFS5	8342	+	NM_004552	39494396	39500168	3
chr1	39549838	39952810	MACF1	402972	+	NM_012090	39549890	39951466	93
chr1	39875175	39882154	KIAA0754	6979	+	NM_015038	39875937	39880221	1
chr1	39957317	39995541	BMP8A	38224	+	NM_181809	39957663	39991470	7
chr1	39980537	39982341	OXCT2P1	1804	+	NR_132962	39982341	39982341	1
chr1	39987951	40025370	PPIEL	37419	-	NR_003929	40025370	40025370	9
chr1	40026484	40042521	PABPC4	16037	-	NM_001135653	40027369	40041623	16
chr1	40030741	40038875	LOC101929516	8134	+	NR_125979	40038875	40038875	4
chr1	40033045	40033182	SNORA55	137	-	NR_002983	40033182	40033182	1
chr1	40089102	40105348	HEYL	16246	-	NM_014571	40092178	40105297	5
chr1	40124792	40137710	NT5C1A	12918	-	NM_032526	40124792	40137710	6
chr1	40144319	40157382	HPCAL4	13063	-	NM_016257	40148207	40150275	4
chr1	40204516	40229586	PPIE	25070	+	NM_001195007	40204572	40228296	11
chr1	40223902	40254533	BMP8B	30631	-	NM_001720	40226090	40254157	7
chr1	40235196	40237020	OXCT2	1824	-	NM_022120	40235373	40236927	1
chr1	40306705	40349183	TRIT1	42478	-	NR_132415	40349183	40349183	11
chr1	40361095	40367687	MYCL	6592	-	NM_001033082	40363043	40367560	3
chr1	40420783	40435640	MFSD2A	14857	+	NM_001287809	40420964	40435240	14
chr1	40506254	40538321	CAP1	32067	+	NM_006367	40525018	40537205	13
chr1	40538381	40563142	PPT1	24761	-	NM_000310	40539732	40562910	9
chr1	40627040	40706593	RLF	79553	+	NM_012421	40627071	40706119	8
chr1	40713572	40717365	TMCO2	3793	+	NM_001008740	40713665	40717266	2
chr1	40723721	40759856	ZMPSTE24	36135	+	NM_005857	40723943	40758341	10
chr1	40766162	40782939	COL9A2	16777	-	NM_001852	40766853	40782869	32
chr1	40839377	40888998	SMAP2	49621	+	NM_022733	40839792	40887773	10
chr1	40916336	40929390	ZFP69B	13054	+	NM_023070	40916633	40929261	5
chr1	40943301	40962015	ZFP69	18714	+	NM_198494	40945033	40961731	6
chr1	40974432	40982214	EXO5	7782	+	NM_022774	40980216	40981338	3
chr1	40997232	41013841	ZNF684	16609	+	NM_152373	40998838	41013132	5
chr1	41086351	41131324	RIMS3	44973	-	NM_014747	41092188	41107597	8
chr1	41154751	41157933	NFYC-AS1	3182	-	NR_024567	41157933	41157933	1
chr1	41157241	41237275	NFYC	80034	+	NM_001142588	41204515	41236500	11
chr1	41220026	41220118	MIR30E	92	+	NR_029846	41220118	41220118	1
chr1	41222955	41223044	MIR30C1	89	+	NR_029833	41223044	41223044	1
chr1	41249683	41306124	KCNQ4	56441	+	NM_004700	41249765	41304195	14
chr1	41326727	41328018	CITED4	1291	-	NM_133467	41327244	41327799	1
chr1	41444970	41478237	CTPS1	33267	+	NM_001905	41448962	41475917	19
chr1	41480261	41509562	SLFNL1-AS1	29301	+	NR_037868	41509562	41509562	4
chr1	41481268	41487427	SLFNL1	6159	-	NM_001168247	41481777	41486332	6
chr1	41492870	41707815	SCMH1	214945	-	NM_001172218	41493865	41608748	16
chr1	41827602	41849263	FOXO6	21661	+	NM_001291281	41827602	41848353	2
chr1	41944445	41950354	EDN2	5909	-	NR_126098	41950354	41950354	5
chr1	41972035	42384378	HIVEP3	412343	-	NM_024503	41976121	42050468	9
chr1	42619091	42621495	GUCA2B	2404	+	NM_007102	42619121	42621267	3
chr1	42628361	42630395	GUCA2A	2034	-	NM_033553	42628576	42630383	3
chr1	42642209	42801548	FOXJ3	159339	-	NM_001198850	42645380	42776764	13
chr1	42846467	42889900	RIMKLA	43433	+	NM_173642	42846605	42880645	5
chr1	42896000	42921938	ZMYND12	25938	-	NM_032257	42896406	42921668	8
chr1	42922164	42939049	PPCS	16885	+	NM_001287511	42922236	42938915	3
chr1	43000559	43120335	CCDC30	119776	+	NM_001080850	43002155	43119699	16
chr1	43124047	43142429	PPIH	18382	+	NM_006347	43124117	43133090	10
chr1	43147905	43169474	YBX1	21569	+	NM_004559	43148236	43166686	8
chr1	43198763	43205925	CLDN19	7162	-	NM_148960	43200756	43205734	5
chr1	43212005	43232755	P3H1	20750	-	NM_022356	43212367	43232642	15
chr1	43232915	43241413	C1orf50	8498	+	NM_024097	43232982	43241065	5
chr1	43242336	43250566	LOC105378683	8230	-	NR_133055	43250566	43250566	3
chr1	43253660	43263901	LOC100129924	10241	+	NM_001242750	43255103	43263896	7
chr1	43272722	43283059	SVBP	10337	-	NM_199342	43273084	43282215	3
chr1	43282775	43310660	ERMAP	27885	+	NM_001017922	43296119	43308903	12
chr1	43312243	43318146	ZNF691	5903	+	NM_001242739	43315329	43317484	4
chr1	43323292	43354463	LOC339539	31171	+	NR_104171	43354463	43354463	4
chr1	43391045	43424847	SLC2A1	33802	-	NM_006516	43392711	43424322	10
chr1	43424719	43449029	SLC2A1-AS1	24310	+	NR_033967	43449029	43449029	4
chr1	43613593	43622067	FAM183A	8474	+	NM_001101376	43613622	43621984	4
chr1	43629844	43638241	EBNA1BP2	8397	-	NM_001159936	43630113	43638092	10
chr1	43637322	43637383	MIR6733	61	-	NR_106791	43637383	43637383	1
chr1	43638000	43720029	CFAP57	82029	+	NM_001195831	43638424	43719862	24
chr1	43735664	43739673	TMEM125	4009	+	NM_144626	43738393	43739053	4
chr1	43747556	43751288	C1orf210	3732	-	NM_001164829	43748455	43748941	3
chr1	43766565	43788781	TIE1	22216	+	NM_001253357	43766794	43788393	23
chr1	43803474	43820135	MPL	16661	+	NM_005373	43803519	43818443	12
chr1	43824625	43828873	CDC20	4248	+	NM_001255	43824886	43828800	11
chr1	43829067	43833745	ELOVL1	4678	-	NM_022821	43829586	43831280	8
chr1	43830318	43830386	MIR6734	68	-	NR_106792	43830386	43830386	1
chr1	43849578	43855483	MED8	5905	-	NM_052877	43850120	43855435	8
chr1	43855555	43919918	SZT2	64363	+	NM_015284	43855639	43916151	71
chr1	43914209	43914282	MIR6735	73	+	NR_106793	43914282	43914282	1
chr1	43916673	43919660	HYI	2987	-	NM_001243526	43916980	43919464	9
chr1	43996546	44089343	PTPRF	92797	+	NM_002840	44010746	44087674	34
chr1	44115796	44171189	KDM4A	55393	+	NM_014663	44118846	44170041	22
chr1	44165408	44173012	KDM4A-AS1	7604	-	NR_033827	44173012	44173012	5
chr1	44173203	44396837	ST3GAL3	223634	+	NM_174968	44201933	44395893	13
chr1	44175075	44193014	LOC101929592	17939	-	NR_125986	44193014	44193014	4
chr1	44304293	44304355	MIR6079	62	+	NR_106727	44304355	44304355	1
chr1	44398991	44402912	ARTN	3921	+	NM_057091	44401328	44402437	5
chr1	44412477	44433694	IPO13	21217	+	NM_014652	44413272	44433354	20
chr1	44435652	44439043	DPH2	3391	+	NM_001384	44435847	44438211	6
chr1	44440319	44443972	ATP6V0B	3653	+	NM_004047	44440712	44443679	8
chr1	44444873	44456843	B4GALT2	11970	+	NM_003780	44446832	44456120	7
chr1	44457279	44462198	CCDC24	4919	+	NM_152499	44457550	44461832	9
chr1	44462154	44497164	SLC6A9	35010	-	NM_001024845	44463216	44489949	14
chr1	44584521	44600809	KLF17	16288	+	NM_173484	44584579	44596428	4
chr1	44679124	44686351	DMAP1	7227	+	NM_001034023	44679425	44686290	11
chr1	44686741	44820951	ERI3	134210	-	NM_024066	44687229	44820698	9
chr1	44688266	44709955	ERI3-IT1	21689	-	NR_110056	44709955	44709955	4
chr1	44718015	44718231	SNORA110	216	-	NR_132966	44718231	44718231	1
chr1	44870959	45117396	RNF220	246437	+	NM_018150	44877769	45116447	15
chr1	45011164	45011224	MIR5584	60	+	NR_049849	45011224	45011224	1
chr1	45118918	45140280	TMEM53	21362	-	NM_001300748	45120230	45140063	3
chr1	45140393	45191263	C1orf228	50870	+	NM_001145636	45155369	45191075	12
chr1	45205489	45233438	KIF2C	27949	+	NM_006845	45205604	45232851	21
chr1	45241245	45244412	RPS8	3167	+	NM_001012	45241268	45244357	6
chr1	45241536	45241610	SNORD55	74	+	NR_000015	45241610	45241610	1
chr1	45242163	45242261	SNORD46	98	+	NR_000024	45242261	45242261	1
chr1	45243513	45243584	SNORD38A	71	+	NR_001456	45243584	45243584	1
chr1	45244061	45244130	SNORD38B	69	+	NR_001457	45244130	45244130	1
chr1	45249256	45253426	BEST4	4170	-	NM_153274	45249881	45253377	9
chr1	45265896	45271667	PLK3	5771	+	NM_004073	45266135	45271350	15
chr1	45271581	45272957	TCTEX1D4	1376	-	NM_001013632	45271674	45272340	2
chr1	45274153	45279801	BTBD19	5648	+	NM_001136537	45274492	45279444	8
chr1	45285515	45308616	PTCH2	23101	-	NM_001166292	45286360	45308604	23
chr1	45316193	45452394	EIF2B3	136201	-	NM_020365	45316622	45446840	12
chr1	45468219	45477027	HECTD3	8808	-	NM_024602	45469163	45476929	21
chr1	45477804	45481341	UROD	3537	+	NR_036510	45481341	45481341	10
chr1	45482075	45672250	ZSWIM5	190175	-	NM_020883	45484125	45672022	14
chr1	45769581	45771291	LINC01144	1710	+	NR_024270	45771291	45771291	1
chr1	45792544	45794346	HPDL	1802	+	NM_032756	45792820	45793936	1
chr1	45794913	45806142	MUTYH	11229	-	NM_012222	45794977	45805926	16
chr1	45805341	45809650	TOE1	4309	+	NM_025077	45805924	45809374	8
chr1	45809554	45956840	TESK2	147286	-	NM_007170	45810511	45923457	11
chr1	45959597	45965751	CCDC163P	6154	-	NR_033298	45965751	45965751	6
chr1	45965855	45976739	MMACHC	10884	+	NM_015506	45966004	45974887	4
chr1	45976706	45988562	PRDX1	11856	-	NM_001202431	45977000	45984715	6
chr1	46016454	46035723	AKR1A1	19269	+	NM_001202414	46027466	46035628	11
chr1	46049659	46084578	NASP	34919	+	NM_002482	46049818	46083813	15
chr1	46085715	46089731	CCDC17	4016	-	NM_001114938	46085946	46089581	13
chr1	46092975	46152302	GPBP1L1	59327	-	NM_021639	46093927	46124759	13
chr1	46111451	46112357	RPS15AP10	906	-	NR_026768	46112357	46112357	1
chr1	46153846	46160108	TMEM69	6262	+	NM_016486	46156740	46159577	3
chr1	46159997	46216485	IPP	56488	-	NM_001145349	46160089	46212083	10
chr1	46269284	46501796	MAST2	232512	+	NM_015112	46269567	46501738	29
chr1	46505811	46642167	PIK3R3	136356	-	NM_001303427	46509344	46642143	10
chr1	46599042	46604752	LOC101929626	5710	+	NR_125987	46604752	46604752	3
chr1	46640748	46651634	TSPAN1	10886	+	NM_005727	46646779	46651205	9
chr1	46654352	46685977	POMGNT1	31625	-	NM_001243766	46654390	46663493	23
chr1	46669005	46686928	LURAP1	17923	+	NM_001013615	46669098	46685892	2
chr1	46713366	46744145	RAD54L	30779	+	NM_001142548	46714077	46743954	19
chr1	46744071	46769038	LRRC41	24967	-	NM_006369	46744536	46768994	10
chr1	46769284	46782449	UQCRH	13165	+	NM_001297565	46775653	46782256	5
chr1	46805848	46830824	NSUN4	24976	+	NR_045789	46830824	46830824	7
chr1	46859938	46879520	FAAH	19582	+	NM_001441	46860020	46879247	15
chr1	46899498	46911374	FAAHP1	11876	+	NR_045483	46911374	46911374	9
chr1	46912344	46915376	LINC01398	3032	-	NR_121680	46915376	46915376	3
chr1	46972667	46979886	DMBX1	7219	+	NM_147192	46972682	46978166	4
chr1	47004367	47035927	MKNK1-AS1	31560	+	NR_038403	47035927	47035927	8
chr1	47011315	47016887	KNCN	5572	-	NM_001097611	47013401	47016887	3
chr1	47023078	47069966	MKNK1	46888	-	NM_003684	47024246	47059818	14
chr1	47073386	47082563	MOB3C	9177	-	NM_201403	47075326	47078993	4
chr1	47100710	47134099	ATPAF1	33389	-	NM_022745	47101447	47134063	9
chr1	47137504	47139256	TEX38	1752	+	NM_001145474	47137606	47139128	2
chr1	47139707	47157769	EFCAB14-AS1	18062	+	NR_038827	47157769	47157769	4
chr1	47140830	47184736	EFCAB14	43906	-	NM_014774	47144132	47183759	11
chr1	47264669	47285021	CYP4B1	20352	+	NM_000779	47264753	47284486	12
chr1	47308766	47366147	CYP4Z2P	57381	-	NR_002788	47366147	47366147	12
chr1	47394845	47407156	CYP4A11	12311	-	NM_000778	47395786	47407105	12
chr1	47489239	47516423	CYP4X1	27184	+	NM_178033	47489489	47515846	12
chr1	47533159	47583992	CYP4Z1	50833	+	NM_178134	47533162	47583606	12
chr1	47603096	47614526	CYP4A22	11430	+	NM_001010969	47603157	47614469	12
chr1	47644921	47646011	LINC00853	1090	+	NR_047498	47646011	47646011	2
chr1	47649260	47655771	PDZK1IP1	6511	-	NM_005764	47649642	47655604	4
chr1	47681961	47698007	TAL1	16046	-	NM_003189	47685391	47691560	6
chr1	47715810	47779819	STIL	64009	-	NM_001282939	47716807	47775991	19
chr1	47799468	47844511	CMPK1	45043	+	NM_016308	47799617	47842417	6
chr1	47846467	47902989	LINC01389	56522	-	NR_126355	47902989	47902989	5
chr1	47881743	47883724	FOXE3	1981	+	NM_012186	47881987	47882947	1
chr1	47897806	47900313	FOXD2-AS1	2507	-	NR_026878	47900313	47900313	1
chr1	47901688	47906363	FOXD2	4675	+	NM_004474	47903807	47905295	1
chr1	48226199	48462562	TRABD2B	236363	-	NM_001194986	48231573	48462461	7
chr1	48567386	48648100	SKINTL	80714	-	NR_026749	48648100	48648100	10
chr1	48688356	48714316	SLC5A9	25960	+	NM_001135181	48688408	48713215	15
chr1	48761043	48937880	SPATA6	176837	-	NM_019073	48764384	48937680	13
chr1	48998526	50489626	AGBL4	1491100	-	NM_032785	48999844	50489468	14
chr1	49193194	49242641	BEND5	49447	-	NM_001302082	49193557	49224809	6
chr1	49723082	49734966	LOC101929721	11884	+	NR_125988	49734966	49734966	4
chr1	49839872	49937757	AGBL4-IT1	97885	-	NR_046839	49937757	49937757	4
chr1	50513685	50669457	ELAVL4	155772	+	NM_001144777	50513836	50666850	7
chr1	50883222	50889119	DMRTA2	5897	-	NM_032110	50884336	50887208	3
chr1	50906934	51425936	FAF1	519002	-	NM_007051	50907111	51425483	19
chr1	51434366	51440306	CDKN2C	5940	+	NM_001262	51436040	51439942	3
chr1	51525508	51525577	MIR4421	69	+	NR_039617	51525577	51525577	1
chr1	51525689	51525775	MIR6500	86	+	NR_106754	51525775	51525775	1
chr1	51567905	51613754	C1orf185	45849	+	NM_001136508	51567905	51613443	5
chr1	51701944	51739119	RNF11	37175	+	NM_014372	51702428	51736994	3
chr1	51752929	51810788	TTC39A	57859	-	NM_001144832	51753828	51810715	18
chr1	51795325	51796953	TTC39A-AS1	1628	+	NR_123731	51796953	51796953	3
chr1	51819934	51984995	EPS15	165061	-	NM_001981	51822371	51984903	25
chr1	52082545	52254891	OSBPL9	172346	+	NM_148909	52082782	52253461	24
chr1	52254865	52344609	NRDC	89744	-	NM_002525	52254907	52344287	33
chr1	52302015	52302074	MIR761	59	-	NR_031580	52302074	52302074	1
chr1	52373627	52456436	RAB3B	82809	-	NM_002867	52385598	52442789	5
chr1	52485803	52521843	TXNDC12	36040	-	NM_015913	52486604	52520768	7
chr1	52497776	52499472	KTI12	1696	-	NM_138417	52498368	52499433	1
chr1	52516589	52518355	TXNDC12-AS1	1766	+	NR_126385	52518355	52518355	3
chr1	52521856	52556388	BTF3L4	34532	+	NM_152265	52525519	52552430	6
chr1	52607765	52812358	ZFYVE9	204593	+	NM_004799	52698878	52811893	19
chr1	52816264	52831877	CC2D1B	15613	-	NM_032449	52819190	52830292	24
chr1	52838500	52870143	ORC1	31643	-	NM_004153	52838852	52867895	17
chr1	52870218	52883992	PRPF38A	13774	+	NM_032864	52870421	52882362	10
chr1	52888947	53018762	ZCCHC11	129815	-	NM_001009881	52889606	52991952	30
chr1	53068042	53074723	GPX7	6681	+	NM_015696	53068081	53074097	3
chr1	53099065	53122737	FAM159A	23672	+	NM_001042693	53099165	53122712	3
chr1	53152013	53164038	COA7	12025	-	NM_023077	53153391	53163998	3
chr1	53192130	53293013	ZYG11B	100883	+	NM_024646	53192325	53287301	14
chr1	53308182	53360247	ZYG11A	52065	+	NM_001004339	53308555	53358629	14
chr1	53361581	53387446	ECHDC2	25865	-	NM_001198961	53362191	53387345	10
chr1	53392900	53517289	SCP2	124389	+	NM_002979	53393068	53516376	16
chr1	53394345	53394444	MIR1273F	99	+	NR_039971	53394444	53394444	1
chr1	53405985	53406085	MIR1273G	100	+	NR_039972	53406085	53406085	1
chr1	53527723	53551174	PODN	23451	+	NM_001199080	53532507	53547833	13
chr1	53552850	53608304	SLC1A7	55454	-	NM_006671	53553680	53608121	11
chr1	53662100	53679869	CPT2	17769	+	NM_000098	53662615	53679267	5
chr1	53679771	53686311	C1orf123	6540	-	NM_017887	53680330	53686247	8
chr1	53692563	53704282	MAGOH	11719	-	NM_002370	53692716	53704120	5
chr1	53704281	53708455	LOC100507564	4174	+	NR_038953	53708455	53708455	3
chr1	53708040	53793821	LRP8	85781	-	NM_004631	53712689	53793584	19
chr1	53793904	53802181	LOC105378732	8277	+	NR_131923	53802181	53802181	3
chr1	53904042	53905693	SLC25A3P1	1651	-	NR_002314	53905693	53905693	2
chr1	53925071	53933160	DMRTB1	8089	+	NM_033067	53925126	53932335	4
chr1	53971905	54199877	GLIS1	227972	-	NM_147193	53972291	54060575	10
chr1	54231133	54304225	NDC1	73092	-	NM_001168551	54233642	54303934	18
chr1	54317391	54355487	YIPF1	38096	-	NR_036639	54355487	54355487	12
chr1	54359860	54376759	DIO1	16899	+	NM_000792	54359883	54375672	4
chr1	54387233	54411981	HSPB11	24748	-	NM_001316935	54387323	54405755	6
chr1	54411998	54433841	LRRC42	21843	+	NM_001256409	54417672	54433612	9
chr1	54472970	54483859	LDLRAD1	10889	-	NM_001010978	54474654	54483785	6
chr1	54492353	54519246	TMEM59	26893	-	NM_001305051	54497822	54509195	8
chr1	54519244	54578192	TCEANC2	58948	+	NR_130900	54578192	54578192	5
chr1	54519751	54519827	MIR4781	76	+	NR_039942	54519827	54519827	1
chr1	54604667	54618679	CDCP2	14012	-	NM_201546	54605192	54618595	4
chr1	54638026	54665746	CYB5RL	27720	-	NM_001031672	54640291	54661289	8
chr1	54665839	54684056	MRPL37	18217	+	NM_016491	54665916	54683922	7
chr1	54691103	54872068	SSBP3	180965	-	NM_145716	54692803	54871681	18
chr1	54702115	54704736	SSBP3-AS1	2621	+	NR_103541	54704736	54704736	1
chr1	55013806	55100417	ACOT11	86611	+	NM_015547	55013982	55100402	17
chr1	55074849	55089200	FAM151A	14351	-	NM_176782	55074940	55089068	8
chr1	55107412	55175940	MROH7	68528	+	NM_001039464	55118599	55175860	24
chr1	55107412	55208328	MROH7-TTC4	100916	+	NR_037641	55208328	55208328	33
chr1	55181494	55208328	TTC4	26834	+	NM_004623	55181581	55207186	10
chr1	55222570	55230226	PARS2	7656	-	NM_152268	55223406	55224834	2
chr1	55246751	55266941	TTC22	20190	-	NM_001114108	55246915	55266836	7
chr1	55271735	55307937	LEXM	36202	+	NM_152607	55271789	55307349	11
chr1	55315299	55352921	DHCR24	37622	-	NM_014762	55317905	55352792	9
chr1	55446336	55457966	TMEM61	11630	+	NM_182532	55446738	55457776	3
chr1	55464616	55474465	BSND	9849	+	NM_057176	55464859	55474301	4
chr1	55505148	55530526	PCSK9	25378	+	NM_174936	55505510	55529257	12
chr1	55532031	55681039	USP24	149008	-	NM_015306	55534717	55680786	68
chr1	55681080	55683128	LOC100507634	2048	+	NR_038320	55683128	55683128	1
chr1	55691313	55691396	MIR4422	83	+	NR_039618	55691396	55691396	1
chr1	56960418	57045257	PLPP3	84839	-	NM_003713	56962222	57044689	6
chr1	57110989	57181008	PRKAA2	70019	+	NM_006252	57111060	57173386	9
chr1	57184476	57285369	C1orf168	100893	-	NM_001004303	57185343	57284963	20
chr1	57320442	57383894	C8A	63452	+	NM_000562	57320574	57383389	11
chr1	57394882	57431813	C8B	36931	-	NM_001278544	57395076	57425264	13
chr1	57463578	58716211	DAB1	1252633	-	NM_021080	57476367	57756702	17
chr1	58326214	58328786	DAB1-AS1	2572	+	NR_104364	58328786	58328786	2
chr1	58946390	59012471	OMA1	66081	-	NM_145243	58946636	59004966	9
chr1	59041094	59043166	TACSTD2	2072	-	NM_002353	59041856	59042828	1
chr1	59120410	59165747	MYSM1	45337	-	NM_001085487	59125668	59165724	20
chr1	59246462	59249785	JUN	3323	-	NM_002228	59247746	59248742	1
chr1	59250822	59365384	LINC01135	114562	+	NR_034014	59365384	59365384	4
chr1	59486147	59553919	LINC01358	67772	+	NR_110626	59553919	59553919	3
chr1	59597607	59612479	HSD52	14872	-	NR_027120	59612479	59612479	3
chr1	59762624	60228402	FGGY	465778	+	NM_001113411	59787221	60228256	17
chr1	60198898	60198968	MIR4711	70	-	NR_039861	60198968	60198968	1
chr1	60238466	60254501	LOC101926944	16035	+	NR_110627	60254501	60254501	3
chr1	60280532	60342050	HOOK1	61518	+	NM_015888	60280789	60338637	22
chr1	60358979	60392423	CYP2J2	33444	-	NM_000775	60359322	60392418	9
chr1	60456065	60539442	C1orf87	83377	-	NM_152377	60456344	60538315	12
chr1	61125302	61291256	LOC101926964	165954	-	NR_110628	61291256	61291256	6
chr1	61405915	61436448	NFIA-AS2	30533	-	NR_110617	61436448	61436448	7
chr1	61542945	61928460	NFIA	385515	+	NM_001145511	61543297	61920992	11
chr1	61714616	61719190	NFIA-AS1	4574	-	NR_104180	61719190	61719190	4
chr1	62119913	62121800	MGC34796	1887	+	NR_073400	62121800	62121800	1
chr1	62146718	62191095	TM2D1	44377	-	NM_032027	62149107	62190792	7
chr1	62208148	62629591	INADL	421443	+	NM_176877	62228564	62626607	43
chr1	62544457	62544531	MIR3116-1	74	+	NR_036058	62544531	62544531	1
chr1	62544460	62544528	MIR3116-2	68	-	NR_036059	62544528	62544528	1
chr1	62660473	62678001	L1TD1	17528	+	NM_001164835	62672300	62677044	5
chr1	62701836	62785083	KANK4	83247	-	NM_181712	62703948	62747236	10
chr1	62901974	62917475	USP1	15501	+	NM_001017415	62905538	62916652	9
chr1	62920396	63154039	DOCK7	233643	-	NM_001272000	62921084	63153935	49
chr1	63063157	63071976	ANGPTL3	8819	+	NM_014495	63063237	63070488	7
chr1	63249776	63330941	ATG4C	81165	+	NM_178221	63269457	63329830	11
chr1	63624753	63782928	LINC00466	158175	-	NR_038252	63782928	63782928	12
chr1	63786554	63790112	FOXD3-AS1	3558	-	NR_121637	63790112	63790112	3
chr1	63788729	63790797	FOXD3	2068	+	NM_012183	63788729	63790166	1
chr1	63792595	63792655	MIR6068	60	-	NR_106716	63792655	63792655	1
chr1	63833260	63904233	ALG6	70973	+	NM_013339	63836648	63902691	15
chr1	63906440	63988944	ITGB3BP	82504	-	NM_001206739	63912477	63988804	10
chr1	63988971	64038364	EFCAB7	49393	+	NM_032437	63991243	64038187	14
chr1	64014650	64016307	DLEU2L	1657	+	NR_002771	64016307	64016307	1
chr1	64058946	64125916	PGM1	66970	+	NM_002633	64059159	64125346	11
chr1	64239689	64647179	ROR1	407490	+	NM_005012	64240088	64644538	9
chr1	64560124	64577888	ROR1-AS1	17764	-	NR_110666	64577888	64577888	6
chr1	64669489	64710027	UBE2U	40538	+	NM_152489	64669733	64709816	9
chr1	64936475	65158741	CACHD1	222266	+	NM_020925	64936580	65157244	27
chr1	65045529	65045604	MIR4794	75	+	NR_039957	65045604	65045604	1
chr1	65210777	65298914	RAVER2	88137	+	NM_018211	65210855	65296668	12
chr1	65298905	65432187	JAK1	133282	-	NM_002227	65300244	65351947	25
chr1	65445259	65468159	LINC01359	22900	-	NR_119383	65468159	65468159	7
chr1	65523437	65523525	MIR3671	88	-	NR_037443	65523525	65523525	1
chr1	65524116	65524191	MIR101-1	75	-	NR_029516	65524191	65524191	1
chr1	65613231	65697828	AK4	84597	+	NM_203464	65614090	65691860	6
chr1	65730376	65881552	DNAJC6	151176	+	NM_001256865	65830334	65878708	20
chr1	65886130	65901690	LEPROT	15560	+	NM_017526	65886407	65897602	4
chr1	65886334	66103176	LEPR	216842	+	NM_002303	66031248	66102698	20
chr1	66258192	66840262	PDE4B	582070	+	NM_001037341	66378997	66838361	17
chr1	66508182	66516401	LOC101927139	8219	-	NR_123718	66516401	66516401	3
chr1	66999251	67216822	SGIP1	217571	+	NM_001308203	67000041	67208778	22
chr1	67094122	67094200	MIR3117	78	+	NR_036060	67094200	67094200	1
chr1	67218139	67244730	TCTEX1D1	26591	+	NM_152665	67220341	67243137	5
chr1	67263423	67266942	INSL5	3519	-	NM_005478	67263695	67266904	2
chr1	67278571	67390570	WDR78	111999	-	NM_024763	67279812	67390514	17
chr1	67390577	67454302	MIER1	63725	+	NM_001077702	67394586	67452156	16
chr1	67465014	67520080	SLC35D1	55066	-	NM_015139	67470022	67519696	12
chr1	67557858	67600654	C1orf141	42796	-	NR_075077	67600654	67600654	10
chr1	67632168	67725650	IL23R	93482	+	NM_144701	67633803	67724811	11
chr1	67773046	67862583	IL12RB2	89537	+	NR_047584	67862583	67862583	17
chr1	67873492	67896123	SERBP1	22631	-	NM_015640	67878889	67895983	8
chr1	68150859	68154021	GADD45A	3162	+	NM_001924	68151177	68153457	4
chr1	68167148	68299155	GNG12	132007	-	NM_018841	68171133	68173369	4
chr1	68297970	68668670	GNG12-AS1	370700	+	NR_040077	68668670	68668670	10
chr1	68511644	68517314	DIRAS3	5670	-	NM_004675	68512290	68512980	4
chr1	68564141	68698229	WLS	134088	-	NM_001002292	68564314	68697982	12
chr1	68649200	68649293	MIR1262	93	-	NR_031664	68649293	68649293	1
chr1	68894506	68915642	RPE65	21136	-	NM_000329	68895458	68915588	14
chr1	68939834	68962904	DEPDC1	23070	-	NM_001114120	68942614	68962682	12
chr1	68962358	69004310	DEPDC1-AS1	41952	+	NR_110671	69004310	69004310	3
chr1	70225857	70589171	LRRC7	363314	+	NM_020794	70225887	70587570	25
chr1	70385004	70386000	PIN1P1	996	+	NR_023916	70386000	70386000	1
chr1	70610484	70671361	LRRC40	60877	-	NM_017768	70611482	70671223	15
chr1	70671364	70717701	SRSF11	46337	+	NM_001190987	70687319	70716488	13
chr1	70724684	70820417	ANKRD13C	95733	-	NM_030816	70728399	70820091	13
chr1	70820492	70833705	HHLA3	13213	+	NR_027404	70833705	70833705	4
chr1	70876900	70905534	CTH	28634	+	NM_001902	70877098	70904810	12
chr1	71172135	71252151	LOC101927244	80016	+	NR_125938	71252151	71252151	7
chr1	71318035	71513491	PTGER3	195456	-	NR_028292	71513491	71513491	6
chr1	71512188	71532865	ZRANB2-AS1	20677	+	NR_038420	71532865	71532865	3
chr1	71528973	71546972	ZRANB2	17999	-	NM_005455	71531401	71546678	11
chr1	71533313	71533399	MIR186	86	-	NR_029707	71533399	71533399	1
chr1	71547006	71703406	ZRANB2-AS2	156400	+	NR_046217	71703406	71703406	4
chr1	71868624	72748277	NEGR1	879653	-	NM_173808	71873128	72748177	7
chr1	72259914	72302695	NEGR1-IT1	42781	-	NR_046218	72302695	72302695	3
chr1	73771852	73804560	LINC01360	32708	+	NR_110676	73804560	73804560	4
chr1	74491701	74663871	LRRIQ3	172170	-	NM_001105659	74492496	74649368	8
chr1	74663895	74674386	FPGT	10491	+	NM_001199328	74663923	74671516	5
chr1	74663895	75010116	FPGT-TNNI3K	346221	+	NM_001112808	74663923	75009666	27
chr1	74701070	75010116	TNNI3K	309046	+	NM_015978	74701135	75009666	25
chr1	75033794	75139422	ERICH3	105628	-	NM_001002912	75036800	75139203	15
chr1	75043113	75091782	ERICH3-AS1	48669	+	NR_121671	75091782	75091782	3
chr1	75171171	75199092	CRYZ	27921	-	NM_001130042	75171979	75190505	10
chr1	75198835	75232360	TYW3	33525	+	NM_001162916	75198928	75229797	5
chr1	75594118	75627218	LHX8	33100	+	NM_001001933	75596399	75626580	10
chr1	75667815	76076799	SLC44A5	408984	-	NM_001130058	75669411	76007132	24
chr1	76190031	76229363	ACADM	39332	+	NM_001286043	76190472	76228448	13
chr1	76207686	76210698	DLSTP1	3012	-	NR_130749	76210698	76210698	1
chr1	76251878	76260775	RABGGTB	8897	+	NR_073562	76260775	76260775	11
chr1	76252756	76252834	SNORD45C	78	+	NR_003042	76252834	76252834	1
chr1	76253573	76253657	SNORD45A	84	+	NR_002749	76253657	76253657	1
chr1	76255161	76255232	SNORD45B	71	+	NR_002748	76255232	76255232	1
chr1	76262555	76378923	MSH4	116368	+	NM_002440	76262670	76378572	20
chr1	76384557	76398116	ASB17	13559	-	NM_080868	76384636	76397976	3
chr1	76477008	76485041	LOC101927342	8033	+	NR_125939	76485041	76485041	3
chr1	76540388	77096669	ST6GALNAC3	556281	+	NM_152996	76540551	77094491	5
chr1	77333185	77529737	ST6GALNAC5	196552	+	NM_030965	77333360	77528891	5
chr1	77525827	77525887	MIR7156	60	+	NR_106978	77525887	77525887	1
chr1	77554666	77685132	PIGK	130466	-	NM_005482	77558058	77685087	11
chr1	77747661	78025654	AK5	277993	+	NM_174858	77747998	78024355	14
chr1	78028100	78149112	ZZZ3	121012	-	NM_001308237	78031324	78105156	14
chr1	78161673	78225564	USP33	63891	-	NM_015017	78163001	78211147	25
chr1	78245308	78345225	FAM73A	99917	+	NM_001270384	78245340	78340749	16
chr1	78347032	78355224	NEXN-AS1	8192	-	NR_103535	78355224	78355224	3
chr1	78354199	78409578	NEXN	55379	+	NM_144573	78381791	78408514	13
chr1	78412166	78444889	FUBP1	32723	-	NR_130152	78444889	78444889	21
chr1	78444841	78483648	DNAJB4	38807	+	NM_001317100	78458459	78481931	4
chr1	78510645	78604133	GIPC2	93488	+	NM_001304725	78510760	78601427	6
chr1	78695282	78835147	MGC27382	139865	+	NR_027310	78835147	78835147	6
chr1	78956727	79006386	PTGFR	49659	+	NM_001039585	78958428	79002115	4
chr1	79086066	79111830	IFI44L	25764	+	NM_006820	79093600	79107494	9
chr1	79115476	79129763	IFI44	14287	+	NM_006417	79115880	79129496	9
chr1	79355448	79472495	ADGRL4	117047	-	NM_022159	79356838	79472339	15
chr1	81001439	81112473	LOC101927412	111034	+	NR_125940	81112473	81112473	4
chr1	81979564	82023387	LOC101927434	43823	-	NR_125943	82023387	82023387	4
chr1	82165454	82458422	ADGRL2	292968	+	NM_001297704	82302669	82456829	21
chr1	83439565	83451891	LINC01361	12326	-	NR_110633	83451891	83451891	3
chr1	84041470	84326679	LOC101927587	285209	-	NR_119375	84326679	84326679	3
chr1	84259597	84379059	MIR548AP	119462	-	NR_049805	84379059	84379059	5
chr1	84267198	84326229	LOC101927560	59031	-	NR_119374	84326229	84326229	3
chr1	84335056	84464833	TTLL7	129777	-	NM_024686	84335644	84417894	21
chr1	84543657	84704181	PRKACB	160524	+	NM_002731	84544008	84700988	10
chr1	84764048	84816481	SAMD13	52433	+	NM_001010971	84764240	84815457	4
chr1	84830640	84850484	UOX	19844	-	NR_003927	84850484	84850484	7
chr1	84864214	84880691	DNASE2B	16477	+	NM_021233	84864247	84880551	6
chr1	84944919	84964033	RPF1	19114	+	NM_025065	84944964	84963153	9
chr1	84964005	84972262	GNG5	8257	-	NM_005274	84967527	84971774	4
chr1	84971983	85022178	SPATA1	50195	+	NM_001310156	84981976	85018807	14
chr1	85018803	85040163	CTBS	21360	-	NM_004388	85020681	85040098	7
chr1	85063646	85086714	LINC01461	23068	-	NR_125761	85086714	85086714	3
chr1	85093912	85100703	LINC01555	6791	-	NR_027379	85100703	85100703	3
chr1	85109389	85156240	SSX2IP	46851	-	NM_014021	85113115	85136902	15
chr1	85279085	85358896	LPAR3	79811	-	NM_012152	85279528	85331803	3
chr1	85391265	85462805	MCOLN2	71540	-	NM_153259	85392367	85462555	14
chr1	85483764	85514223	MCOLN3	30459	-	NM_018298	85484805	85511043	13
chr1	85527980	85598821	WDR63	70841	+	NM_145172	85537624	85598681	23
chr1	85599476	85599556	MIR4423	80	+	NR_039619	85599556	85599556	1
chr1	85623355	85666728	SYDE2	43373	-	NM_032184	85624432	85666679	7
chr1	85715636	85725355	C1orf52	9719	-	NR_024113	85725355	85725355	4
chr1	85731459	85742587	BCL10	11128	-	NM_003921	85733309	85742035	3
chr1	85742040	85743771	LOC646626	1731	+	NR_045484	85743771	85743771	2
chr1	85784167	86044046	DDAH1	259879	-	NM_001134445	85787134	85824524	7
chr1	86046443	86049648	CYR61	3205	+	NM_001554	86046667	86048725	5
chr1	86115105	86174116	ZNHIT6	59011	-	NM_001170670	86119740	86173967	11
chr1	86194915	86622121	COL24A1	427206	-	NM_152890	86196228	86622079	60
chr1	86812506	86862025	ODF2L	49519	-	NM_001184765	86814432	86852710	17
chr1	86823314	86823370	MIR7856	56	-	NR_107010	86823370	86823370	1
chr1	86889768	86922240	CLCA2	32472	+	NM_006536	86889930	86921210	14
chr1	86934525	86965974	CLCA1	31449	+	NM_001285	86934654	86965728	14
chr1	87012758	87046432	CLCA4	33674	+	NM_012128	87012802	87046028	14
chr1	87099958	87121059	CLCA3P	21101	+	NR_024604	87121059	87121059	15
chr1	87170252	87213867	SH3GLB1	43615	+	NM_001206652	87170582	87208918	11
chr1	87328127	87380107	SEP15	51980	-	NM_004261	87329156	87379794	5
chr1	87380334	87575681	HS2ST1	195347	+	NM_012262	87380719	87570379	7
chr1	87595447	87634886	LINC01140	39439	+	NR_026989	87634886	87634886	3
chr1	87678351	87717014	LOC101927844	38663	+	NM_001290053	87709297	87716508	4
chr1	87794150	87814607	LMO4	20457	+	NM_006769	87797698	87810479	5
chr1	87819209	87837338	LINC01364	18129	-	NR_038324	87837338	87837338	4
chr1	89003195	89150887	PKN2-AS1	147692	-	NR_110682	89150887	89150887	4
chr1	89149921	89301938	PKN2	152017	+	NM_006256	89150263	89299131	22
chr1	89318320	89357301	GTF2B	38981	-	NM_001514	89318895	89357182	7
chr1	89401455	89458643	CCBL2	57188	-	NM_001008661	89401865	89454033	14
chr1	89445138	89458643	RBMXL1	13505	-	NM_001162536	89448336	89449509	3
chr1	89472359	89488549	GBP3	16190	-	NM_018284	89473406	89486404	11
chr1	89517986	89531043	GBP1	13057	-	NM_002053	89519037	89528917	11
chr1	89571815	89591842	GBP2	20027	-	NM_004120	89573857	89587649	11
chr1	89597433	89641723	GBP7	44290	-	NM_207398	89597831	89637618	11
chr1	89646830	89664633	GBP4	17803	-	NM_052941	89650936	89664517	11
chr1	89724633	89738544	GBP5	13911	-	NM_052942	89726386	89735238	12
chr1	89754940	89756045	LOC729930	1105	-	NR_077244	89756045	89756045	1
chr1	89829435	89853719	GBP6	24284	+	NM_198460	89834110	89851028	11
chr1	89873237	89890493	GBP1P1	17256	+	NR_003133	89890493	89890493	5
chr1	89990396	90063420	LRRC8B	73024	+	NM_001134476	90048209	90058602	8
chr1	90090407	90098453	FLJ27354	8046	-	NR_033981	90098453	90098453	3
chr1	90098643	90185094	LRRC8C	86451	+	NM_032270	90152032	90180541	3
chr1	90286572	90401989	LRRC8D	115417	+	NM_001134479	90398627	90401204	3
chr1	90458823	90460525	GEMIN8P4	1702	-	NR_002830	90460525	90460525	1
chr1	90460677	90494094	ZNF326	33417	+	NM_182976	90460816	90493260	12
chr1	91177578	91182794	BARHL2	5216	-	NM_020063	91177868	91182752	3
chr1	91380856	91487812	ZNF644	106956	-	NM_201269	91382354	91447910	6
chr1	91726322	91870426	HFM1	144104	-	NM_001017975	91726846	91866639	39
chr1	91966403	91991321	CDC7	24918	+	NM_001134419	91967273	91989992	12
chr1	92145899	92371559	TGFBR3	225660	-	NM_001195684	92149295	92327088	18
chr1	92414927	92479985	BRDT	65058	+	NM_001242805	92428311	92479831	20
chr1	92495532	92529093	EPHX4	33561	+	NM_173567	92495636	92528843	7
chr1	92539992	92541029	SETSIP	1037	-	NM_001287737	92540089	92540998	1
chr1	92545861	92613401	BTBD8	67540	+	NM_183242	92546128	92613358	9
chr1	92632608	92650280	KIAA1107	17672	+	NM_015237	92633413	92649887	9
chr1	92683572	92711367	C1orf146	27795	+	NM_001012425	92696977	92711231	6
chr1	92711954	92764566	GLMN	52612	-	NM_053274	92712086	92763556	19
chr1	92764521	92853732	RPAP2	89211	+	NM_024813	92764630	92852568	13
chr1	92940317	92952433	GFI1	12116	-	NM_005263	92941585	92949044	7
chr1	92974252	93257961	EVI5	283709	-	NM_001308248	92979212	93257951	19
chr1	93297593	93307481	RPL5	9888	+	NM_000969	93297671	93307422	8
chr1	93298285	93427079	FAM69A	128794	-	NM_001252273	93298576	93426986	5
chr1	93302845	93302940	SNORD21	95	+	NR_000006	93302940	93302940	1
chr1	93306275	93306408	SNORA66	133	+	NR_002444	93306408	93306408	1
chr1	93544791	93604638	MTF2	59847	+	NM_001164391	93580264	93602584	16
chr1	93615298	93646246	TMED5	30948	-	NM_001167830	93620383	93645799	5
chr1	93646272	93744287	CCDC18	98015	+	NM_001306076	93648918	93744034	29
chr1	93775665	93811368	CCDC18-AS1	35703	-	NR_034089	93811368	93811368	9
chr1	93811477	93828148	DR1	16671	+	NM_001938	93812202	93826196	3
chr1	93913687	94020218	FNBP1L	106531	+	NM_001164473	93913838	94017973	17
chr1	94027342	94312706	BCAR3	285364	-	NM_001261408	94027797	94140486	14
chr1	94057524	94065587	LOC100129046	8063	+	NR_034091	94065587	94065587	4
chr1	94312387	94312467	MIR760	80	+	NR_030621	94312467	94312467	1
chr1	94335013	94344762	DNTTIP2	9749	-	NM_014597	94335406	94344704	7
chr1	94350755	94375154	GCLM	24399	-	NM_002061	94354545	94374719	7
chr1	94458393	94586705	ABCA4	128312	-	NM_000350	94458792	94586601	50
chr1	94634462	94703307	ARHGAP29	68845	-	NM_004815	94639424	94697167	23
chr1	94883932	94984219	ABCD3	100287	+	NM_002858	94884034	94982685	23
chr1	94994731	95007413	F3	12682	-	NM_001993	94996015	95007192	6
chr1	95123088	95285837	LINC01057	162749	-	NR_104131	95285837	95285837	5
chr1	95211415	95211456	MIR378G	41	-	NR_039620	95211456	95211456	1
chr1	95285897	95360803	SLC44A3	74906	+	NM_001258340	95286007	95360478	15
chr1	95362504	95392779	CNN3	30275	-	NM_001839	95363297	95392450	7
chr1	95393583	95428826	LOC729970	35243	+	NR_033998	95428826	95428826	4
chr1	95448278	95538507	ALG14	90229	-	NM_001305242	95448851	95538454	5
chr1	95527151	95533101	LOC101928098	5950	+	NR_132786	95533101	95533101	2
chr1	95558072	95663161	TMEM56	105089	+	NM_001199679	95609457	95657424	7
chr1	95583478	95710509	TMEM56-RWDD3	127031	+	NM_001199691	95609457	95709806	8
chr1	95628774	95699538	LOC101928118	70764	-	NR_125948	95699538	95699538	5
chr1	95699710	95712781	RWDD3	13071	+	NM_001278248	95705425	95712426	5
chr1	95940292	95944912	FLJ31662	4620	+	NR_033966	95944912	95944912	4
chr1	95975671	95981020	LOC100996635	5349	+	NR_110621	95981020	95981020	3
chr1	96457623	96488436	LOC102723661	30813	+	NR_125991	96488436	96488436	5
chr1	96719624	96839681	LOC101928241	120057	-	NR_110693	96839681	96839681	6
chr1	97187160	97280605	PTBP2	93445	+	NM_001300987	97215170	97278961	15
chr1	97543299	98386615	DPYD	843316	-	NM_000110	97544531	98386478	23
chr1	97561478	97788511	DPYD-AS1	227033	+	NR_046590	97788511	97788511	5
chr1	98262476	98263607	DPYD-AS2	1131	+	NR_046591	98263607	98263607	3
chr1	98453555	98515249	MIR137HG	61694	-	NR_046105	98515249	98515249	5
chr1	98510798	98510907	MIR2682	109	-	NR_039604	98510907	98510907	1
chr1	98511625	98511727	MIR137	102	-	NR_029679	98511727	98511727	1
chr1	98676266	98738214	LOC729987	61948	+	NR_046088	98738214	98738214	3
chr1	99127235	99226056	SNX7	98821	+	NR_033716	99226056	99226056	9
chr1	99355800	99470449	PLPPR5	114649	-	NM_001010861	99358627	99470227	6
chr1	99469831	99614408	LOC100129620	144577	+	NR_033940	99614408	99614408	3
chr1	99729847	99775138	PLPPR4	45291	+	NM_014839	99730005	99772566	7
chr1	99937975	99953360	LOC101928270	15385	-	NR_125951	99953360	99953360	3
chr1	100111430	100160097	PALMD	48667	+	NM_017734	100111873	100159618	8
chr1	100154610	100178513	MIR548AA1	23903	+	NR_037516	100178513	100178513	3
chr1	100154610	100178513	MIR548D1	23903	-	NR_030382	100178513	100178513	3
chr1	100174258	100231349	FRRS1	57091	-	NM_001013660	100174453	100214324	17
chr1	100315639	100389579	AGL	73940	+	NM_000642	100316598	100387207	34
chr1	100435344	100492534	SLC35A3	57190	+	NM_012243	100459110	100488032	8
chr1	100503788	100548929	MFSD14A	45141	+	NM_033055	100503788	100547765	12
chr1	100549100	100598651	SASS6	49551	-	NM_194292	100550883	100598370	17
chr1	100598705	100616054	TRMT13	17349	+	NM_019083	100598724	100614376	11
chr1	100614003	100643829	LRRC39	29826	-	NM_001256385	100614923	100634072	11
chr1	100652477	100715409	DBT	62932	-	NM_001918	100661810	100715376	11
chr1	100730297	100731730	RTCA-AS1	1433	-	NR_110435	100731730	100731730	3
chr1	100731713	100758325	RTCA	26612	+	NM_001130841	100731931	100757060	12
chr1	100746796	100746864	MIR553	68	+	NR_030279	100746864	100746864	1
chr1	100818022	100985833	CDC14A	167811	+	NM_003672	100818510	100983836	16
chr1	101003727	101007583	GPR88	3856	+	NM_022049	101004522	101005677	2
chr1	101092605	101112560	LINC01349	19955	-	NR_038914	101112560	101112560	5
chr1	101185195	101204601	VCAM1	19406	+	NM_001199834	101185416	101203839	9
chr1	101337927	101360735	EXTL2	22808	-	NM_001261441	101339497	101354313	6
chr1	101361631	101447311	SLC30A7	85680	+	NM_001144884	101361818	101440413	12
chr1	101455179	101491362	DPH5	36183	-	NM_001077394	101455963	101490999	8
chr1	101491401	101552935	LOC102606465	61534	+	NR_109849	101552935	101552935	5
chr1	101700428	101702084	LOC101928370	1656	-	NR_104626	101702084	101702084	2
chr1	101702304	101707076	S1PR1	4772	+	NM_001400	101704540	101705689	2
chr1	101789392	101842869	LINC01307	53477	+	NR_126402	101842869	101842869	5
chr1	102268122	102462790	OLFM3	194668	-	NR_110210	102462790	102462790	8
chr1	102337567	102360299	DNAJA1P5	22732	+	NR_033424	102360299	102360299	2
chr1	103342022	103574052	COL11A1	232030	-	NM_080629	103343574	103573734	67
chr1	103960700	104068105	LOC101928436	107405	-	NM_001286997	103960796	103975684	4
chr1	104068577	104097859	RNPC3	29282	+	NM_017619	104068692	104094402	15
chr1	104097265	104122156	AMY2B	24891	+	NM_020978	104114224	104122122	12
chr1	104112025	104114008	ACTG1P4	1983	+	NR_024438	104114008	104114008	1
chr1	104159953	104168402	AMY2A	8449	+	NM_000699	104160062	104168368	10
chr1	104230039	104239073	AMY1A	9034	-	NM_001008221	104230070	104238261	11
chr1	104230040	104238889	AMY1B	8849	-	NM_001008218	104230070	104238261	11
chr1	104230040	104238911	AMY1C	8871	-	NM_001008219	104230070	104238261	11
chr1	104615644	104619693	LOC100129138	4049	+	NR_033990	104619693	104619693	2
chr1	106132315	106161557	LOC101928476	29242	-	NR_125955	106161557	106161557	4
chr1	107599266	107601916	PRMT6	2650	+	NM_018137	107599337	107600465	1
chr1	107682539	108027521	NTNG1	344982	+	NM_001312688	107691215	108023462	8
chr1	108113781	108507545	VAV3	393764	-	NM_006113	108115952	108507491	27
chr1	108439844	108439926	MIR7852	82	+	NR_107006	108439926	108439926	1
chr1	108507064	108537229	VAV3-AS1	30165	+	NR_046653	108537229	108537229	3
chr1	108677343	108742980	SLC25A24	65637	-	NM_013386	108679274	108742760	10
chr1	108765962	108786703	NBPF4	20741	-	NM_001143989	108766326	108786383	15
chr1	108992903	109013260	NBPF6	20357	+	NM_001143987	108993223	109013260	16
chr1	109102970	109181949	FAM102B	78979	+	NM_001010883	109103050	109177772	11
chr1	109190909	109204148	HENMT1	13239	-	NM_144584	109191187	109202506	8
chr1	109234931	109244422	PRPF38B	9491	+	NM_018061	109235213	109242642	6
chr1	109255555	109285367	FNDC7	29812	+	NM_001144937	109255555	109284426	13
chr1	109289284	109352148	STXBP3	62864	+	NM_007269	109289359	109351499	19
chr1	109358519	109400864	AKNAD1	42345	-	NR_049760	109400864	109400864	14
chr1	109399838	109401146	SPATA42	1308	+	NR_034168	109401146	109401146	3
chr1	109419602	109473044	GPSM2	53442	+	NM_013296	109428144	109472562	15
chr1	109472129	109506121	CLCC1	33992	-	NM_015127	109477291	109493059	12
chr1	109512837	109584850	WDR47	72013	-	NM_001142551	109514051	109566134	15
chr1	109606997	109618624	TAF13	11627	-	NM_005645	109607144	109618569	4
chr1	109633402	109639554	TMEM167B	6152	+	NM_020141	109633494	109637121	3
chr1	109642814	109643234	SCARNA2	420	+	NR_003023	109643234	109643234	1
chr1	109648572	109656479	C1orf194	7907	-	NM_001122961	109648649	109656299	5
chr1	109656584	109749403	KIAA1324	92819	+	NM_020775	109656805	109745634	22
chr1	109756514	109780804	SARS	24290	+	NM_006513	109756614	109780510	11
chr1	109792640	109818378	CELSR2	25738	+	NM_001408	109792701	109816671	34
chr1	109822175	109825790	PSRC1	3615	-	NM_032636	109822774	109825320	8
chr1	109834986	109849663	MYBPHL	14677	-	NM_001010985	109836860	109849613	9
chr1	109852187	109940567	SORT1	88380	-	NM_002959	109856664	109940514	20
chr1	109941652	109969108	PSMA5	27456	-	NM_001199774	109944634	109957907	9
chr1	110009099	110024764	SYPL2	15665	+	NM_001040709	110009465	110022170	6
chr1	110026560	110035420	ATXN7L2	8860	+	NM_153340	110026575	110035222	11
chr1	110036657	110043063	CYB561D1	6406	+	NM_001134402	110036761	110038881	2
chr1	110049445	110052336	AMIGO1	2891	-	NM_020703	110050052	110051534	2
chr1	110082493	110088455	GPR61	5962	+	NM_031936	110085644	110087000	3
chr1	110091185	110138454	GNAI3	47269	+	NM_006496	110091342	110134855	9
chr1	110141514	110141589	MIR197	75	+	NR_029583	110141589	110141589	1
chr1	110145888	110155705	GNAT2	9817	-	NM_005272	110145975	110155492	8
chr1	110162434	110174677	AMPD2	12243	+	NM_001257360	110163635	110173774	19
chr1	110198697	110208123	GSTM4	9426	+	NM_147148	110199011	110207653	8
chr1	110210643	110226619	GSTM2	15976	+	NM_001142368	110210737	110224439	9
chr1	110230417	110236367	GSTM1	5950	+	NM_000561	110230495	110235917	8
chr1	110254863	110260890	GSTM5	6027	+	NM_000851	110254934	110260048	8
chr1	110276553	110283660	GSTM3	7107	-	NM_000849	110279692	110282909	9
chr1	110292701	110306644	EPS8L3	13943	-	NM_133181	110293012	110304371	19
chr1	110453232	110473616	CSF1	20384	+	NM_000757	110453645	110467811	9
chr1	110527386	110566364	AHCYL1	38978	+	NM_001242673	110551676	110564302	17
chr1	110574198	110597263	STRIP1	23065	+	NM_001270768	110581339	110596534	21
chr1	110602996	110613322	ALX3	10326	-	NM_006492	110603354	110613234	4
chr1	110625309	110652341	LINC01397	27032	+	NR_126382	110652341	110652341	4
chr1	110655061	110656569	UBL4B	1508	+	NM_203412	110655156	110655681	1
chr1	110693131	110744823	SLC6A17	51692	+	NM_001010898	110709551	110741066	12
chr1	110751072	110752609	KCNC4-AS1	1537	-	NR_046546	110752609	110752609	2
chr1	110753335	110776674	KCNC4	23339	+	NR_036437	110776674	110776674	5
chr1	110828998	110881793	LOC440600	52795	-	NR_036595	110881793	110881793	4
chr1	110881944	110889303	RBM15	7359	+	NM_022768	110882027	110888231	3
chr1	110905472	110933704	SLC16A4	28232	-	NM_004696	110906387	110931945	9
chr1	110943876	110950546	LAMTOR5	6670	-	NM_006402	110944144	110950488	4
chr1	110950430	110958896	LAMTOR5-AS1	8466	+	NR_102697	110958896	110958896	3
chr1	110993787	110999976	PROK1	6189	+	NM_032414	110993838	110998973	3
chr1	111023387	111033891	CYMP	10504	+	NR_003599	111033891	111033891	9
chr1	111030301	111032880	LOC440602	2579	-	NR_108042	111032880	111032880	2
chr1	111059838	111061797	KCNA10	1959	-	NM_005549	111059873	111061409	1
chr1	111136201	111174096	KCNA2	37895	-	NM_001204269	111136514	111147404	5
chr1	111196185	111216076	KCNA3	19891	-	NR_109845	111216076	111216076	3
chr1	111413820	111442558	CD53	28738	+	NM_001040033	111434030	111441817	9
chr1	111489811	111506566	LRIF1	16755	-	NM_018372	111490580	111506310	4
chr1	111659953	111682838	DRAM2	22885	-	NM_178454	111660781	111674176	9
chr1	111682248	111727724	CEPT1	45476	+	NM_001007794	111690336	111726932	9
chr1	111728590	111747160	DENND2D	18570	-	NM_001271833	111730226	111746975	12
chr1	111770280	111786062	CHI3L2	15782	+	NM_004000	111770351	111784986	11
chr1	111823145	111828730	CHIAP2	5585	+	NR_003928	111828730	111828730	8
chr1	111833473	111863188	CHIA	29715	+	NM_201653	111853089	111863088	12
chr1	111889181	111895639	PIFO	6458	+	NM_181643	111889274	111893949	6
chr1	111927140	111932473	PGCP1	5333	-	NR_029429	111932473	111932473	5
chr1	111956936	111970399	OVGP1	13463	-	NM_002557	111957085	111970343	11
chr1	111982511	111991930	WDR77	9419	-	NM_001317062	111983851	111991791	10
chr1	111991742	112004525	ATP5F1	12783	+	NM_001688	111992163	112003616	7
chr1	112016490	112021134	C1orf162	4644	+	NM_174896	112018650	112020745	6
chr1	112025969	112106625	TMIGD3	80656	-	NM_001081976	112026308	112106574	6
chr1	112042050	112046743	ADORA3	4693	-	NM_000677	112042571	112045976	2
chr1	112141628	112150940	LINC01160	9312	-	NR_034126	112150940	112150940	5
chr1	112162404	112259317	RAP1A	96913	+	NM_001010935	112233982	112251857	9
chr1	112264685	112298419	FAM212B	33734	-	NM_198926	112269589	112298334	2
chr1	112282462	112290420	FAM212B-AS1	7958	+	NR_038951	112290420	112290420	3
chr1	112287938	112298131	LOC101928718	10193	-	NR_125963	112298131	112298131	3
chr1	112298189	112310199	DDX20	12010	+	NM_007204	112298546	112309521	11
chr1	112318453	112531777	KCND3	213324	-	NM_004980	112318698	112525348	8
chr1	112396383	112399527	KCND3-IT1	3144	-	NR_046783	112399527	112399527	2
chr1	112452278	112453552	KCND3-AS1	1274	+	NR_046619	112453552	112453552	4
chr1	112533189	112541463	LOC643355	8274	+	NM_001270945	112533518	112539135	2
chr1	112938799	113003786	CTTNBP2NL	64987	+	NM_018704	112958787	113000034	6
chr1	113004391	113004455	MIR4256	64	-	NR_036210	113004455	113004455	1
chr1	113009162	113063910	WNT2B	54748	+	NM_004185	113010159	113063131	6
chr1	113066140	113162040	ST7L	95900	-	NM_138727	113068634	113161735	15
chr1	113162074	113214241	CAPZA1	52167	+	NM_006135	113162466	113212754	10
chr1	113216933	113243368	MOV10	26435	+	NM_001286072	113231587	113243129	22
chr1	113243748	113250025	RHOC	6277	-	NM_175744	113244161	113246421	6
chr1	113252615	113257950	PPM1J	5335	-	NM_005167	113252784	113257923	10
chr1	113263188	113269856	FAM19A3	6668	+	NM_182759	113264855	113269262	5
chr1	113362790	113393265	LINC01356	30475	-	NR_103746	113393265	113393265	7
chr1	113454469	113498975	SLC16A1	44506	-	NM_003051	113456512	113471930	5
chr1	113465971	113467295	AKR7A2P1	1324	+	NR_002796	113467295	113467295	1
chr1	113499036	113506690	SLC16A1-AS1	7654	+	NR_103744	113506690	113506690	3
chr1	113554308	113615724	LOC100996251	61416	-	NR_103777	113615724	113615724	3
chr1	113615791	113667824	LRIG2	52033	+	NM_001312686	113635831	113666723	19
chr1	113739403	113748875	LOC643441	9472	-	NR_038846	113748875	113748875	3
chr1	113933474	114228545	MAGI3	295071	+	NM_001142782	113933655	114226636	21
chr1	114239823	114301777	PHTF1	61954	-	NM_006608	114240326	114301325	18
chr1	114304453	114355098	RSBN1	50645	-	NR_130896	114355098	114355098	8
chr1	114355233	114443859	AP4B1-AS1	88626	+	NR_125965	114443859	114443859	5
chr1	114356432	114414381	PTPN22	57949	-	NM_015967	114357526	114414245	21
chr1	114419435	114430169	BCL2L15	10734	-	NM_001010922	114423744	114429997	4
chr1	114436816	114447746	AP4B1	10930	-	NM_006594	114437686	114447339	11
chr1	114447914	114456708	DCLRE1B	8794	+	NM_022836	114448208	114454813	4
chr1	114466622	114472147	HIPK1-AS1	5525	-	NR_110726	114472147	114472147	3
chr1	114471995	114520491	HIPK1	48496	+	NM_198268	114483005	114516134	16
chr1	114522012	114524876	OLFML3	2864	+	NM_001286352	114522694	114524391	4
chr1	114631913	114696472	SYT6	64559	-	NM_001270805	114636407	114682493	8
chr1	114935398	115053781	TRIM33	118383	-	NM_015906	114940269	115053697	20
chr1	115110180	115124265	BCAS2	14085	-	NM_005872	115110750	115124212	7
chr1	115127195	115212732	DENND2C	85537	-	NM_001256404	115128220	115168605	21
chr1	115215719	115238239	AMPD1	22520	-	NM_000036	115215734	115238191	16
chr1	115247084	115259515	NRAS	12431	-	NM_002524	115251155	115258781	7
chr1	115259533	115300671	CSDE1	41138	-	NM_001242891	115260789	115284285	21
chr1	115312104	115323308	SIKE1	11204	-	NM_001102396	115316891	115323228	5
chr1	115397423	115537990	SYCP1	140567	+	NR_104211	115537990	115537990	33
chr1	115572444	115576930	TSHB	4486	+	NM_000549	115575983	115576848	3
chr1	115590632	115632121	TSPAN2	41489	-	NM_005725	115593110	115632053	8
chr1	115828536	115880857	NGF	52321	-	NM_002506	115828690	115829416	3
chr1	116184573	116240845	VANGL1	56272	+	NM_001172411	116194034	116234000	8
chr1	116242625	116311426	CASQ2	68801	-	NM_001232	116243861	116311162	11
chr1	116378998	116383747	NHLH2	4749	-	NM_005599	116380585	116380993	3
chr1	116461996	116468529	LOC101928995	6533	+	NR_125969	116468529	116468529	3
chr1	116465193	116519897	LOC101928977	54704	-	NR_125970	116519897	116519897	5
chr1	116519118	116612675	SLC22A15	93557	+	NM_018420	116519248	116609729	12
chr1	116654375	116677861	MAB21L3	23486	+	NM_152367	116655236	116675986	7
chr1	116915794	116947396	ATP1A1	31602	+	NM_000701	116916133	116947066	23
chr1	116935486	116961244	ATP1A1-AS1	25758	-	NR_027646	116961244	116961244	3
chr1	116966345	117021448	LOC101929023	55103	-	NR_125972	117021448	117021448	4
chr1	117057155	117113715	CD58	56560	-	NM_001779	117057434	117113594	6
chr1	117117019	117210377	IGSF3	93358	-	NM_001007237	117119933	117208948	11
chr1	117214370	117214449	MIR320B1	79	+	NR_031564	117214449	117214449	1
chr1	117236733	117249225	C1orf137	12492	+	NM_001013643	117236751	117249154	4
chr1	117297085	117311851	CD2	14766	+	NM_001767	117297114	117311405	5
chr1	117452544	117532980	PTGFRN	80436	+	NM_020440	117452825	117529589	9
chr1	117544371	117579173	CD101	34802	+	NM_004258	117544439	117576723	10
chr1	117568103	117602112	LOC101929099	34009	-	NR_110786	117602112	117602112	4
chr1	117602948	117645491	TTF2	42543	+	NM_003594	117602968	117644146	23
chr1	117637264	117637350	MIR942	86	+	NR_030640	117637350	117637350	1
chr1	117653676	117664411	TRIM45	10735	-	NM_001145635	117654926	117663823	6
chr1	117686208	117753582	VTCN1	67374	-	NM_024626	117690279	117753477	6
chr1	117838087	117863958	LINC01525	25871	+	NR_126408	117863958	117863958	3
chr1	117910084	118068320	MAN1A2	158236	+	NM_006699	117910805	118065579	13
chr1	118139453	118148392	LOC100996263	8939	-	NR_121626	118148392	118148392	3
chr1	118148603	118171011	FAM46C	22408	+	NM_017709	118165490	118166666	2
chr1	118406106	118472302	GDAP2	66196	-	NM_017686	118413190	118462980	14
chr1	118472371	118503049	WDR3	30678	+	NM_006784	118475942	118502070	27
chr1	118496287	118727848	SPAG17	231561	-	NM_206996	118506421	118727780	49
chr1	119425665	119532179	TBX15	106514	-	NM_152380	119427354	119474342	8
chr1	119573838	119683295	WARS2	109457	-	NM_201263	119575982	119683267	6
chr1	119590027	119605910	WARS2-IT1	15883	+	NR_126447	119605910	119605910	2
chr1	119683018	119818596	LOC101929147	135578	+	NR_125975	119818596	119818596	7
chr1	119911398	119936753	HAO2	25355	+	NM_001005783	119923315	119936463	9
chr1	119911568	119912953	HAO2-IT1	1385	+	NR_046780	119912953	119912953	2
chr1	119957553	119965662	HSD3B2	8109	+	NM_001166120	119958042	119965243	4
chr1	120049825	120057681	HSD3B1	7856	+	NM_000862	120050099	120057268	4
chr1	120106502	120115199	HSD3BP4	8697	+	NR_033781	120115199	120115199	1
chr1	120140324	120141914	LINC00622	1590	-	NR_036540	120141914	120141914	1
chr1	120161999	120190390	ZNF697	28391	-	NM_001080470	120165327	120168723	3
chr1	120254418	120286849	PHGDH	32431	+	NM_006623	120254645	120286663	12
chr1	120290618	120311555	HMGCS2	20937	-	NM_005518	120293424	120311467	10
chr1	120336640	120354203	REG4	17563	-	NM_001159352	120337240	120351392	7
chr1	120377387	120387503	NBPF7	10116	-	NM_001047980	120377387	120387158	8
chr1	120436155	120439147	ADAM30	2992	-	NM_021794	120436586	120438959	1
chr1	120454175	120612317	NOTCH2	158142	-	NM_024408	120457928	120612020	34
chr1	120839004	120855681	FAM72B	16677	+	NM_001100910	120839833	120854586	4
chr1	120906033	120914842	HIST2H2BA	8809	+	NR_027337	120914842	120914842	2
chr1	120926127	120935944	FCGR1B	9817	-	NR_045213	120935944	120935944	6
chr1	121102016	121139765	SRGAP2-AS1	37749	-	NR_104189	121139765	121139765	4
chr1	121107151	121134685	SRGAP2B	27534	+	NM_001271870	121107151	121129716	6
chr1	121260909	121313686	EMBP1	52777	+	NR_003955	121313686	121313686	8
chr1	142697420	142713605	ANKRD20A12P	16185	-	NR_046228	142713605	142713605	5
chr1	143134602	143202239	LOC102723769	67637	-	NR_110761	143202239	143202239	3
chr1	143672920	143673002	MIR6077	82	+	NR_106967	143673002	143673002	1
chr1	143687126	143717173	LOC100132057	30047	+	NR_111930	143717173	143717173	9
chr1	143717587	143744519	LINC01138	26932	-	NR_027468	143744519	143744519	5
chr1	143767143	143767881	PPIAL4G	738	-	NM_001123068	143767353	143767848	1
chr1	143896451	143913143	FAM72D	16692	-	NM_207418	143897546	143912295	4
chr1	143896524	143913160	FAM72C	16636	-	NM_001287385	143897546	143912295	4
chr1	144146810	146467744	NBPF20	2320934	+	NM_001278267	144158383	146466121	131
chr1	144610814	144612719	PFN1P2	1905	-	NR_003242	144612719	144612719	1
chr1	144614958	145370304	NBPF9	755346	+	NM_001277444	144615130	145368684	25
chr1	144851423	145039995	PDE4DIP	188572	-	NM_001198832	144852457	145039609	46
chr1	145096406	145116997	SEC22B	20591	+	NM_004892	145096546	145115889	6
chr1	145209112	145286270	NOTCH2NL	77158	+	NM_203458	145248856	145282031	5
chr1	145293370	146466121	NBPF10	1172751	+	NM_001302371	145293405	146466121	90
chr1	145376205	145382404	LOC101928979	6199	-	NR_125967	145382404	145382404	4
chr1	145413190	145417545	HFE2	4355	+	NM_213653	145414781	145416936	4
chr1	145438437	145442644	TXNIP	4207	+	NM_006472	145438802	145441218	8
chr1	145456235	145470387	POLR3GL	14152	-	NM_032305	145456636	145460222	8
chr1	145470507	145475647	ANKRD34A	5140	+	NM_001039888	145473328	145474819	4
chr1	145477066	145501669	LIX1L	24603	+	NM_153713	145477158	145498778	6
chr1	145507556	145513535	RBM8A	5979	+	NM_005105	145507666	145509211	6
chr1	145509751	145516076	GNRHR2	6325	-	NR_002328	145516076	145516076	3
chr1	145516164	145523732	PEX11B	7568	+	NM_003846	145516400	145522919	4
chr1	145524890	145543868	ITGA10	18978	+	NM_003637	145525065	145542278	30
chr1	145549208	145568526	ANKRD35	19318	+	NM_144698	145549316	145567756	14
chr1	145575987	145586546	PIAS3	10559	+	NM_006099	145576078	145585622	14
chr1	145584422	145584481	MIR6736	59	+	NR_106794	145584481	145584481	1
chr1	145586492	145589435	NUDT17	2943	-	NM_001012758	145586588	145589427	8
chr1	145590666	145611044	POLR3C	20378	-	NM_006468	145592689	145609336	16
chr1	145610989	145689005	RNF115	78016	+	NM_014455	145611239	145688220	9
chr1	145695797	145715639	CD160	19842	-	NM_007053	145696592	145706758	6
chr1	145727665	145764206	PDZK1	36541	+	NM_002614	145747043	145763623	10
chr1	145764594	145827103	GPR89A	62509	-	NM_001097613	145765018	145818793	15
chr1	146373856	146467639	NBPF12	93783	+	NM_001278141	146395341	146466121	37
chr1	146490894	146514599	LOC728989	23705	-	NR_024442	146514599	146514599	6
chr1	146556162	146556303	RNVU1-8	141	-	NR_121645	146556303	146556303	1
chr1	146571065	146585928	NBPF13P	14863	-	NR_103466	146585928	146585928	6
chr1	146626684	146644168	PRKAB2	17484	-	NM_005399	146631143	146643723	8
chr1	146649429	146651528	PDIA3P1	2099	+	NR_002305	146651528	146651528	1
chr1	146655883	146697230	FMO5	41347	-	NM_001144829	146656070	146696621	9
chr1	146714290	146767447	CHD1L	53157	+	NM_004284	146714353	146767190	23
chr1	146853913	146989699	LINC00624	135786	-	NR_038423	146989699	146989699	4
chr1	147013270	147098020	BCL9	84750	+	NM_004326	147083635	147096760	10
chr1	147119167	147142634	ACP6	23467	-	NM_016361	147119224	147142170	10
chr1	147228331	147245466	GJA5	17135	-	NM_005266	147230269	147231346	2
chr1	147374945	147381395	GJA8	6450	+	NM_005267	147380082	147381384	2
chr1	147400505	147465753	GPR89B	65248	+	NM_016334	147400649	147465149	14
chr1	147466093	147487188	PDZK1P1	21095	-	NR_111936	147487188	147487188	10
chr1	147574322	147624469	NBPF11	50147	-	NR_046188	147624469	147624469	25
chr1	147574322	148346929	NBPF8	772607	-	NM_001037501	147575945	148346756	20
chr1	147680369	147719342	LOC101927468	38973	-	NR_120331	147719342	147719342	5
chr1	147806602	147806678	MIR5087	76	-	NR_049810	147806678	147806678	1
chr1	147994145	147994313	RNVU1-19	168	+	NR_104086	147994313	147994313	1
chr1	148201751	148202536	PPIAL4D	785	-	NM_001164261	148201966	148202461	1
chr1	148201751	148202536	PPIAL4E	785	-	NM_001144032	148201966	148202461	1
chr1	148201751	148202536	PPIAL4F	785	-	NM_001164262	148201966	148202461	1
chr1	148250248	148346756	NBPF14	96508	-	NM_015383	148251874	148346756	66
chr1	148250249	149109725	NBPF25P	859476	-	NR_104217	149109725	149109725	18
chr1	148558187	148596267	NBPF15	38080	+	NM_001170755	148577649	148594640	22
chr1	148901844	148904054	DRD5P2	2210	+	NR_111001	148904054	148904054	1
chr1	148901844	148904054	LOC101060524	2210	+	NR_111000	148904054	148904054	1
chr1	148928312	148951595	LOC645166	23283	+	NR_027355	148951595	148951595	4
chr1	149287129	149291743	LOC388692	4614	+	NR_111933	149291743	149291743	2
chr1	149287450	149291743	FAM231D	4293	+	NR_111934	149291743	149291743	2
chr1	149369293	149378303	FCGR1C	9010	+	NR_027484	149378303	149378303	7
chr1	149553002	149553787	PPIAL4A	785	+	NM_001143883	149553077	149553572	1
chr1	149553002	149553787	PPIAL4C	785	+	NM_001135789	149553077	149553572	1
chr1	149575481	149619134	LINC00623	43653	+	NR_024584	149619134	149619134	4
chr1	149576160	149651107	LINC00869	74947	+	NR_111950	149651107	149651107	9
chr1	149576261	149672983	LOC103091866	96722	+	NR_111957	149672983	149672983	4
chr1	149605916	149606079	RNVU1-20	163	+	NR_125392	149606079	149606079	1
chr1	149754244	149783928	HIST2H2BF	29684	-	NM_001161334	149754788	149783878	2
chr1	149754249	149764074	FCGR1A	9825	+	NM_000566	149754299	149763073	6
chr1	149784779	149785236	HIST2H3D	457	-	NM_001123375	149784825	149785236	1
chr1	149804220	149804616	HIST2H4A	396	+	NM_003548	149804248	149804560	1
chr1	149804220	149804616	HIST2H4B	396	+	NM_001034077	149804248	149804560	1
chr1	149812258	149812765	HIST2H3A	507	-	NM_001005464	149812318	149812729	1
chr1	149812258	149812765	HIST2H3C	507	-	NM_021059	149812318	149812729	1
chr1	149813784	149814318	HIST2H2AA3	534	-	NM_003516	149813872	149814265	1
chr1	149813784	149814318	HIST2H2AA4	534	-	NM_001040874	149813872	149814265	1
chr1	149821758	149822340	HIST2H2BC	582	-	NR_036461	149822340	149822340	1
chr1	149856009	149858232	HIST2H2BE	2223	-	NM_003528	149857809	149858190	1
chr1	149858524	149858961	HIST2H2AC	437	+	NM_003517	149858524	149858914	1
chr1	149859018	149859466	HIST2H2AB	448	-	NM_175065	149859073	149859466	1
chr1	149871154	149872348	BOLA1	1194	+	NM_016074	149871612	149872026	2
chr1	149874871	149889434	SV2A	14563	-	NM_014849	149876565	149885392	13
chr1	149895208	149900144	SF3B4	4936	-	NM_005850	149895433	149899651	6
chr1	149900542	149908791	MTMR11	8249	-	NM_001145862	149901020	149908540	17
chr1	149912228	149982686	OTUD7B	70458	-	NM_020205	149915755	149949445	12
chr1	150039349	150117505	VPS45	78156	+	NM_007259	150039914	150116974	15
chr1	150121623	150132260	PLEKHO1	10637	+	NM_001304722	150129671	150131718	6
chr1	150190716	150208504	ANP32E	17788	-	NM_001280559	150192992	150208134	7
chr1	150230137	150237480	CA14	7343	+	NM_012113	150230523	150237059	11
chr1	150237798	150241609	APH1A	3811	-	NM_001077628	150238529	150241210	7
chr1	150244686	150253335	C1orf54	8649	+	NM_001301040	150245220	150252149	7
chr1	150254942	150259504	CIART	4562	+	NM_001300838	150255677	150259366	6
chr1	150266261	150281414	MRPS21	15153	+	NM_031901	150266786	150280662	3
chr1	150293927	150325704	PRPF3	31777	+	NM_004698	150297400	150325455	16
chr1	150336586	150449041	RPRD2	112455	+	NM_001297673	150337190	150444447	11
chr1	150459839	150480085	TARS2	20246	+	NM_025150	150459926	150479540	18
chr1	150464820	150464886	MIR6878	66	+	NR_106938	150464886	150464886	1
chr1	150480486	150486265	ECM1	5779	+	NM_001202858	150480685	150485943	10
chr1	150488232	150490508	FALEC	2276	+	NR_051960	150490508	150490508	2
chr1	150521844	150533412	ADAMTSL4	11568	+	NM_001288608	150524764	150532672	20
chr1	150524404	150524490	MIR4257	86	+	NR_036211	150524490	150524490	1
chr1	150533370	150547028	ADAMTSL4-AS1	13658	-	NR_104133	150547028	150547028	4
chr1	150547026	150552214	MCL1	5188	-	NM_001197320	150549850	150552006	4
chr1	150594598	150602098	ENSA	7500	-	NM_207042	150595319	150601946	5
chr1	150618700	150669672	GOLPH3L	50972	-	NM_018178	150620796	150667314	5
chr1	150670534	150693364	HORMAD1	22830	-	NM_032132	150671129	150691981	15
chr1	150702671	150738433	CTSS	35762	-	NM_004079	150705521	150737239	8
chr1	150768683	150780917	CTSK	12234	-	NM_000396	150769274	150779281	8
chr1	150782180	150849244	ARNT	67064	-	NM_001286035	150784496	150830934	23
chr1	150898814	150937220	SETDB1	38406	+	NM_001145415	150900190	150936840	22
chr1	150937648	150947479	CERS2	9831	-	NM_022075	150938623	150941566	11
chr1	150954498	150968114	ANXA9	13616	+	NM_003568	150955581	150967798	14
chr1	150969300	150980854	FAM63A	11554	-	NM_001163258	150969762	150978631	11
chr1	150980866	151008189	PRUNE	27323	+	NM_021222	150981108	151006710	8
chr1	151009028	151020076	BNIPL	11048	+	NM_138278	151009201	151019163	10
chr1	151020258	151023871	C1orf56	3613	+	NM_017860	151020323	151022934	2
chr1	151023446	151032125	CDC42SE1	8679	-	NM_001038707	151026722	151028206	6
chr1	151032150	151040973	MLLT11	8823	+	NM_006818	151039700	151039973	2
chr1	151043079	151091007	GABPB2	47928	+	NM_144618	151060665	151090732	9
chr1	151104162	151119140	SEMA6C	14978	-	NM_001178061	151104959	151115097	20
chr1	151129104	151132225	TNFAIP8L2	3121	+	NM_024575	151131173	151131728	2
chr1	151129104	151142773	TNFAIP8L2-SCNM1	13669	+	NM_001204848	151139000	151141561	7
chr1	151132223	151138424	LYSMD1	6201	-	NM_001136543	151133357	151138258	3
chr1	151138497	151142773	SCNM1	4276	+	NM_024041	151138628	151141561	7
chr1	151142462	151148547	TMOD4	6085	-	NM_013353	151142556	151147351	10
chr1	151148775	151162689	VPS72	13914	-	NM_005997	151149119	151162597	6
chr1	151171020	151222007	PIP5K1A	50987	+	NM_001135638	151171472	151220341	16
chr1	151227196	151239954	PSMD4	12758	+	NM_002810	151227258	151239819	10
chr1	151254030	151264381	ZNF687	10351	+	NM_001304764	151258767	151263685	9
chr1	151264272	151300191	PI4KB	35919	-	NM_001198774	151265327	151288957	11
chr1	151313115	151319769	RFX5	6654	-	NM_000449	151314661	151318796	11
chr1	151319485	151320367	GBAT2	882	+	NR_131972	151320367	151320367	2
chr1	151336777	151345210	SELENBP1	8433	-	NM_001258289	151337018	151342375	12
chr1	151372040	151374412	PSMB4	2372	+	NM_002796	151372063	151374305	7
chr1	151375199	151431941	POGZ	56742	-	NM_001194937	151377277	151414680	19
chr1	151483861	151511167	CGN	27306	+	NM_020770	151490995	151509822	21
chr1	151512780	151556059	TUFT1	43279	+	NM_020127	151512842	151554183	13
chr1	151518271	151518367	MIR554	96	+	NR_030280	151518367	151518367	1
chr1	151584661	151671559	SNX27	86898	+	NM_030918	151584677	151666077	12
chr1	151672533	151689296	CELF3	16763	-	NM_007185	151677516	151688496	13
chr1	151694012	151702082	RIIAD1	8070	+	NM_001144956	151694012	151701312	5
chr1	151732118	151736392	MRPL9	4274	-	NM_031420	151732525	151735955	7
chr1	151735444	151743806	OAZ3	8362	+	NM_001134939	151735611	151743695	5
chr1	151744040	151763010	TDRKH	18970	-	NM_006862	151746927	151755498	14
chr1	151772739	151777918	LINGO4	5179	-	NM_001004432	151773398	151775180	2
chr1	151778546	151804348	RORC	25802	-	NM_005060	151779947	151804240	11
chr1	151810338	151813033	C2CD4D	2695	-	NM_001136003	151810403	151811465	2
chr1	151810944	151816641	LOC100132111	5697	+	NR_024237	151816641	151816641	4
chr1	151819576	151826173	THEM5	6597	-	NM_182578	151819846	151826041	6
chr1	151843342	151882361	THEM4	39019	-	NM_053055	151847363	151881934	6
chr1	151955385	151966714	S100A10	11329	-	NM_002966	151955638	151958706	3
chr1	151990753	151994985	NBPF18P	4232	+	NR_103561	151994985	151994985	6
chr1	152004981	152009511	S100A11	4530	-	NM_005620	152005137	152009391	3
chr1	152051888	152053400	LOC100131107	1512	-	NM_001310142	152052032	152053283	1
chr1	152056619	152061540	TCHHL1	4921	-	NM_001008536	152057442	152060619	3
chr1	152078792	152087930	TCHH	9138	-	NM_007113	152079860	152086556	3
chr1	152126070	152131704	RPTN	5634	-	NM_001122965	152127219	152130365	3
chr1	152184551	152196672	HRNR	12121	-	NM_001009931	152185551	152195729	3
chr1	152274650	152297679	FLG	23029	-	NM_002016	152275175	152287932	3
chr1	152285934	152339168	FLG-AS1	53234	+	NR_103778	152339168	152339168	7
chr1	152321212	152332482	FLG2	11270	-	NM_001014342	152323085	152331360	3
chr1	152381718	152386750	CRNN	5032	-	NM_016190	152382069	152384709	3
chr1	152483319	152484653	LCE5A	1334	+	NM_178438	152484010	152484367	2
chr1	152486977	152488481	CRCT1	1504	+	NM_019060	152487859	152488159	2
chr1	152538174	152539229	LCE3E	1055	-	NM_178435	152538405	152538684	2
chr1	152551859	152552980	LCE3D	1121	-	NM_032563	152552133	152552412	2
chr1	152573137	152573562	LCE3C	425	+	NM_178434	152573207	152573492	1
chr1	152586286	152586574	LCE3B	288	+	NM_178433	152586286	152586574	1
chr1	152595309	152595579	LCE3A	270	-	NM_178431	152595309	152595579	1
chr1	152635886	152637135	LCE2D	1249	+	NM_178430	152636581	152636914	2
chr1	152647790	152649049	LCE2C	1259	+	NM_178429	152648491	152648824	2
chr1	152658598	152659876	LCE2B	1278	+	NM_014357	152659319	152659652	2
chr1	152670839	152671918	LCE2A	1079	+	NM_178428	152671377	152671698	2
chr1	152681522	152681910	LCE4A	388	+	NM_178356	152681551	152681851	1
chr1	152691997	152692905	C1orf68	908	+	NM_001024679	152691997	152692750	1
chr1	152730505	152734529	KPRP	4024	+	NM_001025231	152732064	152733804	2
chr1	152748847	152749445	LCE1F	598	+	NM_178354	152748847	152749204	1
chr1	152758752	152760901	LCE1E	2149	+	NM_178353	152759775	152760132	2
chr1	152769226	152770657	LCE1D	1431	+	NM_178352	152770270	152770615	2
chr1	152777310	152779107	LCE1C	1797	-	NM_001276331	152777597	152777954	3
chr1	152784446	152785585	LCE1B	1139	+	NM_178349	152784922	152785279	1
chr1	152799948	152800573	LCE1A	625	+	NM_178348	152799948	152800281	1
chr1	152815329	152816459	LCE6A	1130	+	NM_001128600	152815996	152816239	2
chr1	152850797	152857523	SMCP	6726	+	NM_030663	152856898	152857249	2
chr1	152881038	152884362	IVL	3324	+	NM_005547	152882273	152884031	2
chr1	152943128	152945049	SPRR4	1921	+	NM_173080	152944366	152944606	2
chr1	152956563	152958290	SPRR1A	1727	+	NM_001199828	152957706	152957976	2
chr1	152974222	152976332	SPRR3	2110	+	NM_005416	152975496	152976006	3
chr1	153003678	153005376	SPRR1B	1698	+	NM_003125	153004821	153005091	2
chr1	153012200	153013594	SPRR2D	1394	-	NM_006945	153012603	153012822	2
chr1	153028595	153029988	SPRR2A	1393	-	NM_005988	153028992	153029211	2
chr1	153042703	153044084	SPRR2B	1381	-	NM_001017418	153043096	153043315	2
chr1	153065610	153067004	SPRR2E	1394	-	NM_001024209	153066008	153066227	2
chr1	153084599	153085991	SPRR2F	1392	-	NM_001014450	153084990	153085209	2
chr1	153112593	153113969	SPRR2C	1376	-	NR_003062	153113969	153113969	2
chr1	153122057	153123427	SPRR2G	1370	-	NM_001014291	153122364	153122586	2
chr1	153146993	153164152	LOC101928009	17159	+	NR_110685	153164152	153164152	3
chr1	153175905	153177601	LELP1	1696	+	NM_001010857	153177183	153177480	2
chr1	153190059	153191793	PRR9	1734	+	NM_001195571	153190620	153190971	2
chr1	153232178	153234600	LOR	2422	+	NM_000427	153233425	153234364	2
chr1	153270337	153283194	PGLYRP3	12857	-	NM_052891	153270431	153283141	7
chr1	153302596	153321317	PGLYRP4	18721	-	NM_020393	153303242	153320408	9
chr1	153330329	153333503	S100A9	3174	+	NM_002965	153330759	153333314	3
chr1	153346183	153348075	S100A12	1892	-	NM_005621	153346302	153347068	3
chr1	153362507	153363664	S100A8	1157	-	NM_002964	153362578	153363011	3
chr1	153388999	153395701	S100A7A	6702	+	NM_176823	153390558	153391785	3
chr1	153409470	153412503	S100A7L2	3033	-	NM_001045479	153409533	153412425	3
chr1	153430219	153433137	S100A7	2918	-	NM_002963	153430281	153431489	3
chr1	153507075	153508717	S100A6	1642	-	NM_014624	153507171	153507815	3
chr1	153509622	153514241	S100A5	4619	-	NM_002962	153509771	153512667	4
chr1	153516094	153518282	S100A4	2188	-	NM_019554	153516234	153517270	4
chr1	153518217	153524245	LOC101928034	6028	+	NR_125947	153524245	153524245	3
chr1	153519808	153521734	S100A3	1926	-	NM_002960	153520157	153520961	3
chr1	153533584	153538306	S100A2	4722	-	NM_005978	153533914	153536350	3
chr1	153579358	153585644	S100A16	6286	-	NM_080388	153580009	153580627	3
chr1	153586731	153588808	S100A14	2077	-	NM_020672	153587360	153588334	4
chr1	153591275	153606568	S100A13	15293	-	NM_001024210	153591370	153598948	5
chr1	153600872	153604513	S100A1	3641	+	NM_006271	153602997	153604317	3
chr1	153606457	153618782	CHTOP	12325	+	NM_015607	153609064	153617745	6
chr1	153631129	153634328	SNAPIN	3199	+	NM_012437	153631219	153633777	4
chr1	153634263	153643504	ILF2	9241	-	NM_004515	153634871	153643398	14
chr1	153651163	153666468	NPR1	15305	+	NM_000906	153651584	153665890	22
chr1	153662180	153662269	MIR8083	89	-	NR_107050	153662269	153662269	1
chr1	153700566	153746555	INTS3	45989	+	NM_023015	153701110	153745746	30
chr1	153747767	153752633	SLC27A3	4866	+	NM_024330	153747832	153752478	10
chr1	153766422	153768778	LOC343052	2356	+	NR_126565	153768778	153768778	3
chr1	153777202	153895451	GATAD2B	118249	-	NM_020699	153782652	153800823	11
chr1	153901976	153919154	DENND4B	17178	-	NM_014856	153902772	153916850	28
chr1	153920147	153931132	CRTC2	10985	-	NM_181715	153920584	153930973	14
chr1	153931574	153940660	SLC39A1	9086	-	NM_001271960	153932573	153935191	5
chr1	153934826	153934896	MIR6737	70	-	NR_106795	153934896	153934896	1
chr1	153940314	153946840	CREB3L4	6526	+	NM_001255980	153941001	153946541	10
chr1	153946744	153950451	JTB	3707	-	NM_006694	153947154	153949728	5
chr1	153954092	153958853	RAB13	4761	-	NM_002870	153954574	153958712	8
chr1	153963238	153964631	RPS27	1393	+	NM_001030	153963272	153964569	4
chr1	153965167	154127592	NUP210L	162425	-	NM_207308	153965310	154127520	40
chr1	154134288	154164611	TPM3	30323	-	NM_152263	154140412	154164494	10
chr1	154166140	154166219	MIR190B	79	-	NR_030600	154166219	154166219	1
chr1	154171561	154178841	C1orf189	7280	-	NM_001010979	154171902	154178783	4
chr1	154179176	154193273	C1orf43	14097	-	NM_001297718	154179928	154192374	7
chr1	154193324	154243986	UBAP2L	50662	+	NM_001287816	154197599	154243395	27
chr1	154245038	154248355	HAX1	3317	+	NM_006118	154245199	154248177	7
chr1	154293591	154297801	AQP10	4210	+	NM_080429	154293631	154296956	6
chr1	154300275	154323780	ATP8B2	23505	+	NM_020452	154300275	154321594	28
chr1	154377668	154441926	IL6R	64258	+	NM_000565	154378105	154437856	10
chr1	154451953	154474526	SHE	22573	-	NM_001010846	154456624	154474502	6
chr1	154474694	154520623	TDRD10	45929	+	NM_182499	154479379	154520186	13
chr1	154521050	154531120	UBE2Q1	10070	-	NM_017582	154522913	154531029	13
chr1	154526084	154527504	UBE2Q1-AS1	1420	+	NR_046668	154527504	154527504	2
chr1	154540256	154552353	CHRNB2	12097	+	NM_000748	154540520	154548408	6
chr1	154554533	154600456	ADAR	45923	-	NM_001025107	154557281	154574232	15
chr1	154669941	154842754	KCNN3	172813	-	NM_001204087	154680451	154842440	9
chr1	154897207	154909484	PMVK	12277	-	NM_006556	154897604	154909161	5
chr1	154916558	154928639	PBXIP1	12081	-	NM_020524	154917499	154926197	11
chr1	154929501	154934258	PYGO2	4757	-	NM_138300	154931254	154934052	3
chr1	154934773	154946959	SHC1	12186	-	NM_001202859	154936278	154942537	13
chr1	154947117	154951725	CKS1B	4608	+	NM_001826	154947221	154951253	3
chr1	154948168	154948259	MIR4258	91	+	NR_036212	154948259	154948259	1
chr1	154955769	154965587	FLAD1	9818	+	NM_201398	154956461	154965513	8
chr1	154966061	154966791	LENEP	730	+	NM_018655	154966083	154966269	2
chr1	154975105	154991001	ZBTB7B	15896	+	NR_045515	154991001	154991001	6
chr1	154991002	155006257	DCST2	15255	-	NM_144622	154991019	155006177	15
chr1	155006281	155023406	DCST1	17125	+	NM_152494	155006512	155023344	17
chr1	155017667	155036467	LOC100505666	18800	-	NR_040773	155036467	155036467	4
chr1	155023747	155035252	ADAM15	11505	+	NR_048577	155035252	155035252	23
chr1	155036212	155042029	EFNA4	5817	+	NM_005227	155036299	155041465	4
chr1	155051347	155060014	EFNA3	8667	+	NM_004952	155051417	155059019	5
chr1	155100348	155107386	EFNA1	7038	+	NM_004428	155100453	155106543	5
chr1	155107819	155111334	SLC50A1	3515	+	NM_001287591	155108790	155110757	6
chr1	155112366	155112996	DPM3	630	-	NM_153741	155112437	155112716	2
chr1	155141883	155145804	KRTCAP2	3921	-	NM_173852	155141915	155145778	5
chr1	155146262	155157447	TRIM46	11185	+	NM_001256600	155147093	155156666	11
chr1	155158299	155162706	MUC1	4407	-	NM_001204285	155158610	155162634	9
chr1	155164967	155165063	MIR92B	96	+	NR_030281	155165063	155165063	1
chr1	155165378	155177772	THBS3	12394	-	NM_007112	155165631	155177667	23
chr1	155178489	155183630	MTX1	5141	+	NM_002455	155178595	155183489	8
chr1	155183615	155197325	GBAP1	13710	-	NR_002188	155197325	155197325	13
chr1	155204238	155214653	GBA	10415	-	NM_001005742	155204785	155210903	12
chr1	155216995	155225274	FAM189B	8279	-	NM_006589	155217572	155224668	12
chr1	155225769	155232176	SCAMP3	6407	-	NM_005698	155226063	155231942	9
chr1	155232658	155243320	CLK2	10662	-	NM_003993	155233008	155240768	13
chr1	155247217	155259639	HCN3	12422	+	NM_020897	155247381	155258254	8
chr1	155259083	155271225	PKLR	12142	-	NM_000298	155260362	155271186	11
chr1	155278538	155290457	FDPS	11919	+	NM_002004	155279580	155290400	11
chr1	155290250	155293938	RUSC1-AS1	3688	-	NM_001039517	155290568	155291279	2
chr1	155290639	155300909	RUSC1	10270	+	NM_001105204	155291564	155300362	10
chr1	155305051	155532324	ASH1L	227273	-	NM_018489	155307450	155491310	28
chr1	155316140	155316236	MIR555	96	-	NR_030282	155316236	155316236	1
chr1	155402970	155404053	POU5F1P4	1083	+	NR_034180	155404053	155404053	1
chr1	155531771	155533735	ASH1L-AS1	1964	+	NR_027023	155533735	155533735	1
chr1	155579960	155584758	MSTO1	4798	+	NR_046293	155584758	155584758	14
chr1	155629232	155658823	YY1AP1	29591	-	NM_001198906	155630643	155658767	11
chr1	155648898	155649046	SCARNA26A	148	-	NR_132762	155649046	155649046	1
chr1	155658881	155708800	DAP3	49919	+	NM_001199849	155679570	155708033	14
chr1	155715558	155720479	MSTO2P	4921	+	NR_024117	155720479	155720479	13
chr1	155719448	155829191	GON4L	109743	-	NM_001282856	155720374	155823571	32
chr1	155753474	155753623	SCARNA26B	149	-	NR_132767	155753623	155753623	1
chr1	155829259	155854990	SYT11	25731	+	NM_152280	155829552	155851299	4
chr1	155867598	155881193	RIT1	13595	-	NM_006912	155870178	155880552	6
chr1	155882833	155904233	KIAA0907	21400	-	NM_014949	155883911	155904164	14
chr1	155889699	155889833	SNORA80E	134	-	NR_002974	155889833	155889833	1
chr1	155895748	155895877	SCARNA4	129	-	NR_003005	155895877	155895877	1
chr1	155911479	155912625	RXFP4	1146	+	NM_181885	155911500	155912625	1
chr1	155916629	155948336	ARHGEF2	31707	-	NM_001162384	155917732	155948218	22
chr1	155921063	155921127	MIR6738	64	-	NR_106796	155921127	155921127	1
chr1	155978838	155990758	SSR2	11920	-	NM_003145	155979330	155989958	6
chr1	156005084	156023616	UBQLN4	18532	-	NM_001304342	156006768	156023492	11
chr1	156024516	156028301	LAMTOR2	3785	+	NM_014017	156024680	156028162	4
chr1	156030939	156040305	RAB25	9366	+	NM_020387	156031191	156040078	5
chr1	156041803	156051789	MEX3A	9986	-	NM_001093725	156046364	156051789	2
chr1	156052336	156107657	LMNA	55321	+	NM_001282625	156084709	156107555	13
chr1	156119734	156147542	SEMA4A	27808	+	NM_001193301	156124369	156146788	15
chr1	156163722	156182587	SLC25A44	18865	+	NM_001286184	156169638	156180222	4
chr1	156182778	156209868	PMF1	27090	+	NM_007221	156182806	156209392	5
chr1	156182778	156213123	PMF1-BGLAP	30345	+	NM_001199662	156182806	156212585	7
chr1	156211752	156213123	BGLAP	1371	+	NM_199173	156212022	156212953	4
chr1	156213111	156217908	PAQR6	4797	-	NM_001272105	156213919	156216522	9
chr1	156219014	156252620	SMG5	33606	-	NM_015327	156220377	156252471	22
chr1	156252703	156262234	TMEM79	9531	+	NR_026678	156262234	156262234	4
chr1	156262477	156265480	GLMP	3003	-	NM_001256609	156262834	156264684	6
chr1	156268414	156269428	VHLL	1014	-	NM_001004319	156268560	156268980	1
chr1	156278751	156308206	CCT3	29455	-	NR_036565	156308206	156308206	15
chr1	156307104	156316785	TSACC	9681	+	NM_144627	156309548	156316773	4
chr1	156338979	156355013	RHBG	16034	+	NM_001256396	156339203	156354637	12
chr1	156374054	156399184	C1orf61	25130	-	NM_006365	156374345	156386631	7
chr1	156390132	156390221	MIR9-1	89	-	NR_029691	156390221	156390221	1
chr1	156433512	156470634	MEF2D	37122	-	NM_005920	156437436	156453084	12
chr1	156495196	156542396	IQGAP3	47200	-	NM_178229	156496277	156542321	38
chr1	156549518	156556562	TTC24	7044	+	NM_001105669	156551156	156556342	11
chr1	156561557	156564091	APOA1BP	2534	+	NM_144772	156561596	156563876	6
chr1	156564099	156571279	GPATCH4	7180	-	NM_182679	156565004	156568838	8
chr1	156589085	156595517	HAPLN2	6432	+	NM_021817	156593282	156595176	7
chr1	156611739	156629324	BCAN	17585	+	NM_021948	156615846	156628926	14
chr1	156638555	156647189	NES	8634	-	NM_006617	156639113	156647056	4
chr1	156669399	156675608	CRABP2	6209	-	NM_001199723	156669817	156675238	5
chr1	156691682	156698231	ISG20L2	6549	-	NM_001303095	156693140	156697444	4
chr1	156698262	156706752	RRNAD1	8490	+	NM_015997	156698896	156706545	8
chr1	156707093	156710923	MRPL24	3830	-	NM_024540	156707189	156708496	6
chr1	156711898	156722240	HDGF	10342	-	NM_001126050	156713240	156722155	6
chr1	156737273	156770609	PRCC	33336	+	NM_005973	156737563	156770252	7
chr1	156776034	156786640	SH2D2A	10606	-	NM_001161442	156776969	156786477	9
chr1	156785541	156851642	NTRK1	66101	+	NM_001007792	156785621	156851434	17
chr1	156810664	156828712	INSRR	18048	-	NM_014215	156810664	156828413	22
chr1	156863522	156886226	PEAR1	22704	+	NM_001080471	156873718	156884590	23
chr1	156890423	156902880	LRRC71	12457	+	NM_144702	156890595	156902761	15
chr1	156904631	157015162	ARHGEF11	110531	-	NM_198236	156905791	157014122	41
chr1	156905922	156906036	MIR765	114	-	NR_030527	156906036	156906036	1
chr1	157061834	157069600	ETV3L	7766	-	NM_001004341	157062440	157069315	5
chr1	157094458	157108383	ETV3	13925	-	NM_001145312	157094632	157106144	5
chr1	157098153	157098463	CYCSP52	310	+	NR_001560	157098463	157098463	1
chr1	157483166	157522310	FCRL5	39144	-	NM_001195388	157485391	157522152	17
chr1	157543538	157567870	FCRL4	24332	-	NM_031282	157545313	157567734	12
chr1	157647977	157670647	FCRL3	22670	-	NM_052939	157648499	157670279	15
chr1	157715522	157746922	FCRL2	31400	-	NM_030764	157716525	157746863	12
chr1	157764193	157789940	FCRL1	25747	-	NM_052938	157765888	157789827	11
chr1	157800703	157811634	CD5L	10931	-	NM_005894	157801753	157811491	6
chr1	157963062	158070052	KIRREL	106990	+	NM_018240	157963466	158064910	15
chr1	158101833	158110430	LOC646268	8597	-	NR_033946	158110430	158110430	3
chr1	158149736	158156216	CD1D	6480	+	NM_001766	158150891	158153940	7
chr1	158223926	158228058	CD1A	4132	+	NM_001763	158224459	158227480	6
chr1	158259562	158264564	CD1C	5002	+	NM_001765	158259854	158263266	6
chr1	158297739	158301321	CD1B	3582	-	NM_001764	158298025	158301213	6
chr1	158323485	158327343	CD1E	3858	+	NM_001042583	158323778	158326686	6
chr1	158368311	158369256	OR10T2	945	-	NM_001004475	158368311	158369256	1
chr1	158389717	158390656	OR10K2	939	-	NM_001004476	158389717	158390656	1
chr1	158435351	158436293	OR10K1	942	+	NM_001004473	158435351	158436293	1
chr1	158449667	158450675	OR10R2	1008	+	NM_001004472	158449667	158450675	1
chr1	158516917	158517895	OR6Y1	978	-	NM_001005189	158516917	158517895	1
chr1	158532440	158533394	OR6P1	954	-	NM_001160325	158532440	158533394	1
chr1	158548708	158549689	OR10X1	981	-	NM_001004477	158548708	158549689	1
chr1	158576228	158577170	OR10Z1	942	+	NM_001004478	158576228	158577170	1
chr1	158580495	158656506	SPTA1	76011	-	NM_003126	158581053	158656307	52
chr1	158669467	158670442	OR6K2	975	-	NM_001005279	158669467	158670442	1
chr1	158686957	158687905	OR6K3	948	-	NM_001005327	158686957	158687905	1
chr1	158724605	158725637	OR6K6	1032	+	NM_001005184	158724605	158725637	1
chr1	158735533	158736472	OR6N1	939	-	NM_001005185	158735533	158736472	1
chr1	158746471	158747425	OR6N2	954	-	NM_001005278	158746471	158747425	1
chr1	158801167	158819270	MNDA	18103	+	NM_002432	158811943	158819027	7
chr1	158901336	158946849	PYHIN1	45513	+	NM_198928	158906700	158943556	9
chr1	158979681	159024945	IFI16	45264	+	NM_001206567	158984470	159024691	11
chr1	159032274	159046647	AIM2	14373	-	NM_004833	159032481	159043289	6
chr1	159141376	159172932	CADM3	31556	+	NM_021189	159141555	159170712	10
chr1	159165774	159172212	CADM3-AS1	6438	-	NR_037870	159172212	159172212	4
chr1	159173802	159176290	ACKR1	2488	+	NM_002036	159174749	159176240	2
chr1	159259503	159278014	FCER1A	18511	+	NM_002001	159272154	159277722	6
chr1	159283459	159284449	OR10J3	990	-	NM_001004467	159283459	159284449	1
chr1	159409511	159410600	OR10J1	1089	+	NM_012351	159409548	159410511	1
chr1	159504867	159505797	OR10J5	930	-	NM_001004469	159504867	159505797	1
chr1	159557615	159558661	APCS	1046	+	NM_001639	159557711	159558498	2
chr1	159682078	159684379	CRP	2301	-	NM_000567	159683314	159684275	2
chr1	159750758	159752333	DUSP23	1575	+	NM_017823	159750890	159752128	3
chr1	159770300	159786047	FCRL6	15747	+	NM_001284217	159770387	159785372	11
chr1	159796478	159807282	SLAMF8	10804	+	NM_020125	159796688	159805050	5
chr1	159804263	159825137	C1orf204	20874	-	NM_001134233	159807707	159825027	6
chr1	159824105	159832447	VSIG8	8342	-	NM_001013661	159824542	159832311	7
chr1	159842153	159869906	CFAP45	27753	-	NM_012337	159842274	159869888	12
chr1	159869768	159869869	MIR4259	101	-	NR_130464	159869869	159869869	1
chr1	159887896	159895332	TAGLN2	7436	-	NM_003564	159888589	159890299	5
chr1	159896828	159915386	IGSF9	18558	-	NM_001135050	159897134	159913244	21
chr1	159921281	159924044	SLAMF9	2763	-	NM_033438	159921450	159923927	4
chr1	159931013	159948876	LINC01133	17863	+	NR_038849	159948876	159948876	3
chr1	159997461	160001783	PIGM	4322	-	NM_145167	160000257	160001529	1
chr1	160007256	160040051	KCNJ10	32795	-	NM_002241	160011182	160012322	2
chr1	160051359	160059212	KCNJ9	7853	+	NM_004983	160053820	160057607	3
chr1	160061128	160068618	IGSF8	7490	-	NM_001206665	160061612	160068262	8
chr1	160085519	160113374	ATP1A2	27855	+	NM_000702	160085651	160111112	23
chr1	160121351	160156767	ATP1A4	35416	+	NM_144699	160121830	160156489	22
chr1	160160284	160171676	CASQ1	11392	+	NM_001231	160160541	160171166	11
chr1	160171988	160178659	LOC729867	6671	-	NR_123725	160178659	160178659	5
chr1	160175108	160185166	PEA15	10058	+	NM_001297576	160178394	160183276	6
chr1	160185504	160232350	DCAF8	46846	-	NM_015726	160187381	160213798	14
chr1	160246598	160254941	PEX19	8343	-	NM_001193644	160249348	160254914	8
chr1	160258376	160313354	COPA	54978	-	NM_001098398	160259946	160312960	33
chr1	160287054	160288260	SUMO1P3	1206	+	NR_002190	160288260	160288260	1
chr1	160313062	160328742	NCSTN	15680	+	NM_001290184	160314379	160328061	18
chr1	160336860	160342638	NHLH1	5778	+	NM_005598	160340521	160340923	2
chr1	160370363	160398468	VANGL2	28105	+	NM_020335	160385627	160395168	8
chr1	160454819	160493052	SLAMF6	38233	-	NM_001184715	160456496	160492982	8
chr1	160510883	160549306	CD84	38423	-	NM_001184879	160518045	160549227	8
chr1	160579608	160617101	SLAMF1	37493	-	NM_003037	160580537	160616735	7
chr1	160648535	160681641	CD48	33106	-	NM_001778	160648841	160681553	4
chr1	160708846	160724608	SLAMF7	15762	+	NM_021181	160709091	160722967	7
chr1	160765863	160798045	LY9	32182	+	NM_001261456	160765977	160797606	10
chr1	160799949	160832692	CD244	32743	-	NM_001166663	160801136	160832467	9
chr1	160846329	160854960	ITLN1	8631	-	NM_017625	160846453	160854667	8
chr1	160902254	160919712	LOC101928372	17458	+	NR_110695	160919712	160919712	6
chr1	160914815	160924589	ITLN2	9774	-	NM_080878	160914929	160924531	8
chr1	160965000	160991133	F11R	26133	-	NM_016946	160968660	160990863	10
chr1	161007421	161008774	TSTD1	1353	-	NM_001113207	161007564	161008679	4
chr1	161009040	161015769	USF1	6729	-	NM_207005	161009709	161012004	11
chr1	161016731	161039760	ARHGAP30	23029	-	NM_181720	161017504	161039414	13
chr1	161040780	161059385	PVRL4	18605	-	NM_030916	161042450	161059086	9
chr1	161068150	161070138	KLHDC9	1988	+	NR_033386	161070138	161070138	5
chr1	161070345	161087866	PFDN2	17521	-	NM_012394	161070472	161087816	4
chr1	161087861	161095235	NIT1	7374	+	NM_001185092	161087966	161093945	7
chr1	161090768	161102478	DEDD	11710	-	NM_032998	161091936	161094252	6
chr1	161123533	161128646	UFC1	5113	+	NM_016406	161123787	161128282	6
chr1	161129253	161135516	USP21	6263	+	NM_001014443	161130430	161135237	14
chr1	161136180	161141010	PPOX	4830	+	NM_001122764	161136637	161140966	13
chr1	161141099	161147758	B4GALT3	6659	-	NM_001199874	161141605	161145850	8
chr1	161159537	161168845	ADAMTS4	9308	-	NM_005099	161160927	161168417	9
chr1	161169104	161184184	NDUFS2	15080	+	NM_004550	161172175	161183983	15
chr1	161185086	161189038	FCER1G	3952	+	NM_004106	161185111	161188733	5
chr1	161192082	161193418	APOA2	1336	-	NM_001643	161192194	161193191	4
chr1	161195728	161200536	TOMM40L	4808	+	NM_032174	161196279	161198885	10
chr1	161196975	161197051	MIR5187	76	+	NR_049819	161197051	161197051	1
chr1	161199455	161208000	NR1I3	8545	-	NM_001077482	161199586	161206355	9
chr1	161228516	161255240	PCP4L1	26724	+	NM_001102566	161228764	161254271	3
chr1	161274524	161279762	MPZ	5238	-	NM_000530	161275665	161279695	6
chr1	161284165	161334535	SDHC	50370	+	NR_103459	161334535	161334535	7
chr1	161334520	161337673	CFAP126	3153	-	NM_001013625	161334754	161337658	5
chr1	161475204	161489360	FCGR2A	14156	+	NM_001136219	161475257	161487938	7
chr1	161494329	161496687	HSPA6	2358	+	NM_002155	161494448	161496380	1
chr1	161511550	161520413	FCGR3A	8863	-	NM_001127593	161512801	161519526	6
chr1	161551128	161571010	FCGR2C	19882	+	NM_201563	161551227	161569593	7
chr1	161575848	161578341	HSPA7	2493	+	NR_024151	161578341	161578341	1
chr1	161592987	161601753	FCGR3B	8766	-	NM_000570	161594304	161600884	6
chr1	161632904	161648444	FCGR2B	15540	+	NM_004001	161633031	161647343	8
chr1	161653494	161655042	RPL31P11	1548	-	NR_002595	161655042	161655042	1
chr1	161676761	161684142	FCRLA	7381	+	NM_001184866	161677003	161683170	6
chr1	161691333	161697933	FCRLB	6600	+	NM_001002901	161692462	161697452	8
chr1	161719557	161726954	DUSP12	7397	+	NM_007240	161719591	161726737	6
chr1	161736033	161933860	ATF6	197827	+	NM_007348	161736150	161928444	16
chr1	161952981	161994255	OLFML2B	41274	-	NM_015441	161953464	161993220	8
chr1	162039580	162339813	NOS1AP	300233	+	NM_001164757	162039967	162337257	10
chr1	162126896	162126972	MIR4654	76	+	NR_039798	162126972	162126972	1
chr1	162312335	162312430	MIR556	95	+	NR_030283	162312430	162312430	1
chr1	162343514	162346644	C1orf111	3130	-	NM_182581	162343837	162346580	3
chr1	162351519	162356608	C1orf226	5089	+	NM_001085375	162351691	162353473	2
chr1	162365055	162381928	SH2D1B	16873	-	NM_053282	162367069	162381806	4
chr1	162466963	162499419	UHMK1	32456	+	NM_001184763	162467040	162492340	8
chr1	162531295	162569633	UAP1	38338	+	NM_003115	162535858	162569153	10
chr1	162602227	162750247	DDR2	148020	+	NM_001014796	162688853	162750036	19
chr1	162760491	162782608	HSD17B7	22117	+	NM_016371	162760590	162782210	9
chr1	162824086	162838605	CCDC190	14519	-	NM_178550	162824554	162829436	4
chr1	163038395	163046592	RGS4	8197	+	NM_001102445	163038724	163044350	6
chr1	163112088	163291581	RGS5	179493	-	NM_001254748	163117131	163122399	6
chr1	163131464	163182813	LOC101928404	51349	+	NR_110699	163182813	163182813	4
chr1	163291722	163325553	NUF2	33831	+	NM_145697	163295841	163325259	14
chr1	163390859	163392981	LOC100422212	2122	-	NR_104294	163392981	163392981	1
chr1	164528596	164821060	PBX1	292464	+	NM_001204963	164529059	164818639	9
chr1	164738352	164743878	LOC100505795	5526	-	NR_038072	164743878	164743878	4
chr1	165171103	165325952	LMX1A	154849	-	NM_177398	165173116	165324796	9
chr1	165370158	165414592	RXRG	44434	-	NM_001256570	165370499	165389179	11
chr1	165446078	165551392	LOC400794	105314	-	NR_026744	165551392	165551392	7
chr1	165513477	165533185	LRRC52	19708	+	NM_001005214	165513533	165533061	2
chr1	165600109	165625372	MGST3	25263	+	NM_004528	165619084	165624741	6
chr1	165631448	165667900	ALDH9A1	36452	-	NM_000696	165632286	165667795	11
chr1	165667986	165679199	LOC440700	11213	+	NR_036683	165679199	165679199	4
chr1	165693527	165738159	TMCO1	44632	-	NM_001256165	165697259	165737752	7
chr1	165738165	165744685	LOC100147773	6520	+	NR_125374	165744685	165744685	3
chr1	165796731	165880855	UCK2	84124	+	NM_012474	165797070	165877060	7
chr1	165877157	165877213	MIR3658	56	+	NR_037431	165877213	165877213	1
chr1	166039255	166135958	FAM78B	96703	-	NM_001017961	166039477	166135485	2
chr1	166123979	166124035	MIR921	56	-	NR_030626	166124035	166124035	1
chr1	166573152	166594473	FMO9P	21321	+	NR_002925	166594473	166594473	7
chr1	166808640	166825581	POGK	16941	+	NM_017542	166810193	166819646	6
chr1	166825748	166845654	TADA1	19906	-	NM_053053	166826803	166845470	8
chr1	166882440	166944561	ILDR2	62121	-	NM_199351	166888591	166944505	10
chr1	166944818	166991449	MAEL	46631	+	NM_001286378	166959009	166991092	13
chr1	167022072	167059868	GPA33	37796	-	NM_005814	167023570	167059524	7
chr1	167064086	167098402	DUSP27	34316	+	NM_001080426	167064086	167097845	5
chr1	167144598	167165042	LINC01363	20444	-	NR_110811	167165042	167165042	4
chr1	167190065	167396582	POU2F1	206517	+	NM_002697	167190134	167385047	16
chr1	167399876	167487847	CD247	87971	-	NM_000734	167400917	167487702	8
chr1	167510250	167523056	CREG1	12806	-	NM_003851	167511534	167522978	4
chr1	167599473	167675486	RCSD1	76013	+	NM_052862	167599660	167673933	7
chr1	167691186	167761156	MPZL1	69970	+	NM_003953	167691388	167757158	6
chr1	167778624	167883464	ADCY10	104840	-	NM_018417	167778914	167874378	33
chr1	167885912	167906307	MPC2	20395	-	NM_001143674	167887560	167905079	6
chr1	167905796	168045083	DCAF6	139287	+	NM_001198956	167906149	168044673	22
chr1	167967897	167967964	MIR1255B2	67	+	NR_031702	167967964	167967964	1
chr1	168048779	168106905	GPR161	58126	-	NM_001267610	168054768	168074088	7
chr1	168148082	168171351	TIPRL	23269	+	NM_152902	168148315	168169284	7
chr1	168195254	168212088	SFT2D2	16834	+	NM_199344	168195317	168211778	8
chr1	168214818	168216668	ANKRD36BP1	1850	-	NR_026844	168216668	168216668	1
chr1	168250277	168283664	TBX19	33387	+	NM_005149	168250328	168282240	8
chr1	168344761	168344859	MIR557	98	+	NR_030284	168344859	168344859	1
chr1	168369426	168391894	LOC100505918	22468	-	NR_037851	168391894	168391894	4
chr1	168433351	168464882	LOC101928565	31531	-	NR_125956	168464882	168464882	5
chr1	168510002	168513235	XCL2	3233	-	NM_003175	168510189	168513202	3
chr1	168545710	168551315	XCL1	5605	+	NM_002995	168545875	168550458	3
chr1	168664694	168698442	DPT	33748	-	NM_001937	168665786	168698412	4
chr1	168756178	168762126	LINC00626	5948	+	NR_024160	168762126	168762126	3
chr1	168873142	169056243	LINC00970	183101	-	NR_104091	169056243	169056243	5
chr1	169075946	169101960	ATP1B1	26014	+	NM_001677	169076067	169100793	6
chr1	169101767	169337201	NME7	235434	-	NR_104229	169337201	169337201	13
chr1	169337193	169365780	BLZF1	28587	+	NM_003666	169338760	169356420	8
chr1	169364107	169429907	CCDC181	65800	-	NM_001300968	169364284	169394165	7
chr1	169433148	169455208	SLC19A2	22060	-	NM_006996	169435086	169455004	6
chr1	169481191	169555769	F5	74578	-	NM_000130	169483550	169555624	25
chr1	169558087	169599377	SELP	41290	-	NM_003005	169559385	169599312	17
chr1	169659805	169680843	SELL	21038	-	NM_000655	169660924	169680678	9
chr1	169691780	169703220	SELE	11440	-	NM_000450	169694884	169702753	14
chr1	169761669	169764061	METTL18	2392	-	NM_033418	169761717	169762836	2
chr1	169764549	169822229	C1orf112	57680	+	NM_018186	169770046	169822128	24
chr1	169822214	169863100	SCYL3	40886	-	NM_181093	169822853	169857981	14
chr1	169890469	170043879	KIFAP3	153410	-	NM_001204514	169890816	170010902	21
chr1	170115187	170136923	METTL11B	21736	+	NM_001136107	170115248	170136898	4
chr1	170120518	170120603	MIR3119-1	85	-	NR_036064	170120603	170120603	1
chr1	170120518	170120603	MIR3119-2	85	+	NR_036065	170120603	170120603	1
chr1	170240545	170253349	LINC01142	12804	-	NR_026957	170253349	170253349	4
chr1	170430457	170501750	LOC101928650	71293	-	NR_125958	170501750	170501750	3
chr1	170501262	170522974	GORAB	21712	+	NR_027397	170522974	170522974	5
chr1	170633312	170708541	PRRX1	75229	+	NM_006902	170633359	170699472	5
chr1	170904611	171033906	MROH9	129295	+	NM_001163629	170914697	171033481	22
chr1	171060017	171086959	FMO3	26942	+	NM_006894	171061799	171086582	9
chr1	171070868	171070947	MIR1295A	79	-	NR_031627	171070947	171070947	1
chr1	171070879	171070939	MIR1295B	60	+	NR_049854	171070939	171070939	1
chr1	171106878	171130702	FMO6P	23824	+	NR_002601	171130702	171130702	7
chr1	171154346	171181822	FMO2	27476	+	NM_001460	171154852	171178284	9
chr1	171217609	171255117	FMO1	37508	+	NM_001282693	171227226	171254683	9
chr1	171283321	171311223	FMO4	27902	+	NM_002022	171288964	171310978	10
chr1	171308034	171310463	TOP1P1	2429	+	NR_002719	171310463	171310463	1
chr1	171454665	171562650	PRRC2C	107985	+	NM_015172	171481227	171560986	34
chr1	171604556	171621773	MYOC	17217	-	NM_000261	171605064	171621751	3
chr1	171669295	171711379	VAMP4	42084	-	NR_033704	171711379	171711379	9
chr1	171750760	171766856	METTL13	16096	+	NM_015935	171751107	171765896	8
chr1	171810617	172381857	DNM3	571240	+	NM_015569	171810796	172376981	21
chr1	171833331	171833827	DNM3-IT1	496	+	NR_046845	171833827	171833827	2
chr1	172106018	172113975	DNM3OS	7957	-	NR_103486	172113975	172113975	4
chr1	172107937	172108047	MIR214	110	-	NR_029627	172108047	172108047	1
chr1	172107947	172108028	MIR3120	81	+	NR_036066	172108028	172108028	1
chr1	172113674	172113784	MIR199A2	110	-	NR_029618	172113784	172113784	1
chr1	172389827	172437969	C1orf105	48142	+	NM_139240	172390025	172437734	7
chr1	172410596	172413230	PIGC	2634	-	NM_002642	172410868	172411762	2
chr1	172501488	172580975	SUCO	79487	+	NM_016227	172501612	172579399	23
chr1	172628147	172636012	FASLG	7865	+	NM_000639	172628341	172635156	4
chr1	173010359	173020103	TNFSF18	9744	-	NM_005092	173010506	173020102	3
chr1	173152869	173176452	TNFSF4	23583	-	NM_003326	173155654	173176315	3
chr1	173204198	173446294	LOC100506023	242096	-	NR_037845	173446294	173446294	3
chr1	173386927	173430501	LOC101928673	43574	-	NR_125960	173430501	173430501	2
chr1	173446485	173457946	PRDX6	11461	+	NM_004905	173446536	173457002	5
chr1	173469603	173572233	SLC9C2	102630	-	NM_178527	173470232	173570915	28
chr1	173577474	173639001	ANKRD45	61527	-	NM_198493	173579283	173628557	6
chr1	173604660	173606272	LOC730159	1612	+	NM_001195190	173604660	173606175	2
chr1	173684079	173755840	KLHL20	71761	+	NM_014458	173685182	173754385	12
chr1	173768687	173793777	CENPL	25090	-	NM_001127181	173769585	173780437	7
chr1	173793796	173827682	DARS2	33886	+	NM_018122	173794367	173826843	17
chr1	173832385	173833079	GAS5-AS1	694	+	NR_037605	173833079	173833079	1
chr1	173833038	173837125	GAS5	4087	-	NR_002578	173837125	173837125	12
chr1	173833312	173833355	SNORD81	43	-	NR_003938	173833355	173833355	1
chr1	173833506	173833583	SNORD47	77	-	NR_002746	173833583	173833583	1
chr1	173833970	173834041	SNORD80	71	-	NR_003940	173834041	173834041	1
chr1	173834487	173834568	SNORD79	81	-	NR_003939	173834568	173834568	1
chr1	173834770	173834824	SNORD78	54	-	NR_003944	173834824	173834824	1
chr1	173835105	173835166	SNORD44	61	-	NR_002750	173835166	173835166	1
chr1	173835342	173835428	SNORA103	86	-	NR_132783	173835428	173835428	1
chr1	173835448	173835509	SNORD77	61	-	NR_003943	173835509	173835509	1
chr1	173835772	173835853	SNORD76	81	-	NR_003942	173835853	173835853	1
chr1	173836016	173836076	SNORD75	60	-	NR_003941	173836076	173836076	1
chr1	173836811	173836883	SNORD74	72	-	NR_002579	173836883	173836883	1
chr1	173837492	173855774	ZBTB37	18282	+	NM_001122770	173839363	173855262	5
chr1	173872941	173886516	SERPINC1	13575	-	NM_000488	173873026	173886397	7
chr1	173900221	173962210	RC3H1	61989	-	NM_001300850	173907858	173962123	19
chr1	174090775	174128425	LOC102724601	37650	-	NR_121197	174128425	174128425	4
chr1	174128551	174927327	RABGAP1L	798776	+	NM_014857	174188295	174927042	21
chr1	174417211	174418683	GPR52	1472	+	NM_005684	174417249	174418335	1
chr1	174904083	174923398	LOC101928696	19315	-	NR_121196	174923398	174923398	6
chr1	174968570	174981163	CACYBP	12593	+	NM_001007214	174973863	174979215	6
chr1	174982093	174992591	MRPS14	10498	-	NM_022100	174983804	174992544	3
chr1	175036993	175117202	TNN	80209	+	NM_022093	175046554	175116207	19
chr1	175126122	175162229	KIAA0040	36107	-	NM_001162893	175129849	175130149	5
chr1	175291934	175712752	TNR	420818	-	NM_003285	175292492	175375850	23
chr1	175846478	175849600	LOC101928751	3122	+	NR_125964	175849600	175849600	3
chr1	175913961	176176380	RFWD2	262419	-	NM_022457	175914288	176176114	20
chr1	175937532	175937676	SCARNA3	144	-	NR_002998	175937676	175937676	1
chr1	176432306	176811970	PAPPA2	379664	+	NM_020318	176525458	176811590	23
chr1	176826440	177134040	ASTN1	307600	-	NM_001286164	176826746	177133812	23
chr1	176998498	176998581	MIR488	83	-	NR_030163	176998581	176998581	1
chr1	177140523	177251558	BRINP2	111035	+	NM_021165	177199012	177250664	8
chr1	177320721	177335594	LOC102724661	14873	+	NR_126001	177335594	177335594	4
chr1	177669658	177679465	LOC101928778	9807	+	NR_110722	177679465	177679465	4
chr1	177898241	177939050	SEC16B	40809	-	NM_033127	177898992	177937116	26
chr1	177975274	178007142	LOC730102	31868	-	NR_037167	178007142	178007142	10
chr1	178060642	178063128	RASAL2-AS1	2486	-	NR_027982	178063128	178063128	2
chr1	178062863	178448648	RASAL2	385785	+	NM_170692	178063627	178442374	18
chr1	178482211	178492635	TEX35	10424	+	NM_001170722	178482323	178492474	9
chr1	178511930	178518024	C1orf220	6094	+	NR_033186	178518024	178518024	3
chr1	178646883	178646969	MIR4424	86	+	NR_039622	178646969	178646969	1
chr1	178694281	178890977	RALGPS2	196696	+	NM_152663	178745899	178885494	20
chr1	178818669	178840215	ANGPTL1	21546	-	NM_004673	178820263	178834911	6
chr1	178995073	179045702	FAM20B	50629	+	NM_014864	179012982	179041279	8
chr1	179051111	179065129	TOR3A	14018	+	NM_022371	179051263	179064353	6
chr1	179068461	179198819	ABL2	130358	-	NM_001168237	179076852	179198532	13
chr1	179262848	179327814	SOAT1	64966	+	NM_003101	179271819	179322776	16
chr1	179334854	179523870	AXDND1	189016	+	NM_144696	179335644	179523654	26
chr1	179519673	179545087	NPHS2	25414	-	NM_014625	179520307	179544999	8
chr1	179560747	179660407	TDRD5	99660	+	NM_001199091	179561750	179660078	17
chr1	179712297	179785333	FAM163A	73036	+	NM_173509	179782232	179783324	5
chr1	179809101	179846941	TOR1AIP2	37840	-	NM_001199260	179815205	179821800	7
chr1	179851176	179889212	TOR1AIP1	38036	+	NM_015602	179851637	179887374	10
chr1	179923907	180084015	CEP350	160108	+	NM_014810	179955316	180080296	38
chr1	180123967	180167169	QSOX1	43202	+	NM_001004128	180124042	180166476	13
chr1	180167143	180169859	FLJ23867	2716	+	NR_026900	180169859	180169859	1
chr1	180199432	180244188	LHX4	44756	+	NM_033343	180199664	180243714	6
chr1	180238797	180243816	LHX4-AS1	5019	-	NR_037642	180243816	180243816	5
chr1	180257351	180472022	ACBD6	214671	-	NM_032360	180257497	180471401	8
chr1	180407448	180407525	MIR3121	77	-	NR_036067	180407525	180407525	1
chr1	180528109	180535654	OVAAL	7545	+	NR_125716	180535654	180535654	3
chr1	180601145	180859415	XPR1	258270	+	NM_004736	180601337	180853202	15
chr1	180882312	180915239	KIAA1614	32927	+	NM_020950	180882379	180914724	9
chr1	180941849	180992257	STX6	50408	-	NM_005819	180945705	180991809	8
chr1	181002560	181031074	MR1	28514	+	NM_001194999	181003143	181024401	7
chr1	181057637	181059979	IER5	2342	+	NM_016545	181058038	181059022	1
chr1	181143619	181151342	LOC101928973	7723	+	NR_125966	181151342	181151342	3
chr1	181205523	181207740	GM140	2217	+	NR_046249	181207740	181207740	3
chr1	181452685	181775921	CACNA1E	323236	+	NM_001205293	181452880	181767970	48
chr1	182023704	182030847	ZNF648	7143	-	NM_001009992	182025438	182027145	2
chr1	182173079	182283196	LINC01344	110117	-	NR_104175	182283196	182283196	3
chr1	182347227	182361341	GLUL	14114	-	NM_002065	182353539	182357872	8
chr1	182367251	182369751	TEDDM1	2500	-	NM_172000	182368798	182369620	1
chr1	182376755	182383948	LINC00272	7193	+	NR_034131	182383948	182383948	4
chr1	182419255	182529732	RGSL1	110477	+	NM_001137669	182419300	182525192	22
chr1	182542768	182558394	RNASEL	15626	-	NM_021133	182544526	182555941	7
chr1	182567757	182573548	RGS16	5791	-	NM_002928	182569426	182573394	5
chr1	182584274	182585764	LOC284648	1490	+	NR_036490	182585764	182585764	1
chr1	182615791	182642067	RGS8	26276	-	NM_001102450	182615869	182638784	7
chr1	182758583	182799519	NPL	40936	+	NM_001200056	182763506	182798814	13
chr1	182808438	182857117	DHX9	48679	+	NR_033302	182857117	182857117	29
chr1	182868999	182922553	SHCBP1L	53554	-	NM_030933	182869117	182922268	10
chr1	182992594	183114727	LAMC1	122133	+	NM_002293	182992851	183111925	28
chr1	183155173	183214262	LAMC2	59089	+	NM_005562	183155487	183212535	23
chr1	183217371	183387634	NMNAT2	170263	-	NM_015039	183221775	183387402	11
chr1	183430010	183441117	SMG7-AS1	11107	-	NR_040063	183441117	183441117	5
chr1	183441505	183523328	SMG7	81823	+	NM_201569	183441755	183522336	23
chr1	183524696	183560056	NCF2	35360	-	NM_001127651	183525252	183559464	16
chr1	183595327	183605076	ARPC5	9749	-	NM_005717	183596666	183604794	4
chr1	183605181	183897685	RGL1	292504	+	NM_015149	183711292	183895426	19
chr1	183615410	183622448	APOBEC4	7038	-	NM_203454	183616812	183617916	2
chr1	183898795	184006904	COLGALT2	108109	-	NM_001303420	183899362	184006491	12
chr1	184020784	184043344	TSEN15	22560	+	NR_125335	184043344	184043344	6
chr1	184356149	184598155	C1orf21	242006	+	NM_030806	184446643	184588690	6
chr1	184659624	184724041	EDEM3	64417	-	NM_025191	184663196	184723780	20
chr1	184760158	184943718	FAM129A	183560	-	NM_052966	184764110	184943488	14
chr1	185014550	185071740	RNF2	57190	+	NM_007212	185056685	185069433	7
chr1	185087217	185126230	TRMT1L	39013	-	NM_001202423	185089150	185116370	15
chr1	185126191	185260913	SWT1	134722	+	NM_001105518	185129973	185259935	19
chr1	185265521	185286461	IVNS1ABP	20940	-	NM_006469	185267166	185278625	15
chr1	185292978	185304171	GS1-279B7.1	11193	-	NR_038424	185304171	185304171	4
chr1	185527511	185597620	LINC01350	70109	-	NR_110793	185597620	185597620	4
chr1	185703682	186160085	HMCN1	456403	+	NM_031935	185703911	186159010	107
chr1	186029866	186446655	MIR548F1	416789	-	NR_031642	186446655	186446655	4
chr1	186265404	186283694	PRG4	18290	+	NM_005807	186266007	186282910	13
chr1	186280785	186344457	TPR	63672	-	NM_003292	186283102	186344160	51
chr1	186344889	186390503	C1orf27	45614	+	NM_017847	186348917	186388208	14
chr1	186369703	186370587	OCLM	884	+	NM_022375	186370177	186370312	1
chr1	186404292	186439423	LOC102724919	35131	+	NR_126002	186439423	186439423	5
chr1	186412697	186430240	PDC	17543	-	NM_002597	186413110	186418591	4
chr1	186640943	186649559	PTGS2	8616	-	NM_000963	186643484	186649422	10
chr1	186649785	186650578	PACERR	793	+	NR_125801	186650578	186650578	1
chr1	186798031	186958113	PLA2G4A	160082	+	NM_024420	186823486	186957640	18
chr1	187061973	187329376	LINC01036	267403	+	NR_126347	187329376	187329376	4
chr1	187412759	187446354	LINC01037	33595	+	NR_132374	187446354	187446354	3
chr1	190066796	190447012	BRINP3	380216	-	NM_199051	190067147	190424020	8
chr1	190447389	190450524	LINC01351	3135	+	NR_110716	190450524	190450524	3
chr1	190594019	190770788	LOC440704	176769	+	NR_033922	190770788	190770788	5
chr1	192127591	192154945	RGS18	27354	+	NM_130782	192127767	192153684	5
chr1	192286121	192336414	RGS21	50293	+	NM_001039152	192312166	192335254	5
chr1	192544856	192549159	RGS1	4303	+	NM_002922	192544922	192548452	5
chr1	192605267	192629440	RGS13	24173	+	NM_002927	192613464	192628653	7
chr1	192778168	192781407	RGS2	3239	+	NM_002923	192778201	192780726	5
chr1	192904873	192917387	LINC01032	12514	-	NR_126003	192917387	192917387	3
chr1	192981495	193028523	UCHL5	47028	-	NM_001199261	192985480	193028390	11
chr1	193029003	193060906	TROVE2	31903	+	NM_001173525	193038184	193054132	11
chr1	193065594	193075244	GLRX2	9650	-	NM_016066	193065754	193074768	4
chr1	193091087	193223942	CDC73	132855	+	NM_024529	193091330	193219842	17
chr1	193105632	193105713	MIR1278	81	+	NR_031691	193105713	193105713	1
chr1	193147859	193155743	B3GALT2	7884	-	NM_003783	193149423	193150692	2
chr1	193273874	193335083	LINC01031	61209	+	NR_125789	193335083	193335083	4
chr1	196194909	196577561	KCNT2	382652	-	NM_198503	196197353	196577439	28
chr1	196551542	196551611	MIR4735	69	-	NR_039888	196551611	196551611	1
chr1	196621007	196716634	CFH	95627	+	NM_000186	196621247	196716443	22
chr1	196743929	196763203	CFHR3	19274	+	NM_021023	196744016	196762643	6
chr1	196788860	196801319	CFHR1	12459	+	NM_002113	196788974	196801129	6
chr1	196857143	196887843	CFHR4	30700	+	NM_001201551	196857280	196887536	10
chr1	196912897	196928356	CFHR2	15459	+	NM_005666	196913010	196928210	5
chr1	196946666	196978803	CFHR5	32137	+	NM_030787	196946794	196977813	10
chr1	197008320	197036397	F13B	28077	-	NM_001994	197008507	197036353	12
chr1	197053256	197115824	ASPM	62568	-	NM_018136	197053453	197115567	28
chr1	197122813	197169672	ZBTB41	46859	-	NM_194314	197128488	197169603	10
chr1	197170591	197447585	CRB1	276994	+	NM_001257965	197297688	197447009	15
chr1	197473878	197744623	DENND1B	270745	-	NM_001195215	197479589	197744285	23
chr1	197871681	197876497	C1orf53	4816	+	NM_001024594	197871779	197876350	3
chr1	197881634	197899273	LHX9	17639	+	NM_001014434	197881661	197898389	6
chr1	198126107	198291548	NEK7	165441	+	NM_133494	198201710	198288652	10
chr1	198492351	198510075	ATP6V1G3	17724	-	NM_133326	198498259	198509780	5
chr1	198608097	198726605	PTPRC	118508	+	NM_002838	198608398	198725310	33
chr1	198777131	198906558	MIR181A1HG	129427	-	NR_040073	198906558	198906558	3
chr1	198828001	198828111	MIR181B1	110	-	NR_029612	198828111	198828111	1
chr1	198828172	198828282	MIR181A1	110	-	NR_029626	198828282	198828282	1
chr1	198961717	198988093	LINC01222	26376	-	NR_110525	198988093	198988093	3
chr1	198985261	199045864	LINC01221	60603	+	NR_126351	199045864	199045864	3
chr1	199996729	200146550	NR5A2	149821	+	NM_205860	199996975	200143338	8
chr1	200311671	200342920	LINC00862	31249	-	NR_040064	200342920	200342920	5
chr1	200374074	200379186	ZNF281	5112	-	NM_001281294	200376145	200378833	3
chr1	200520624	200589862	KIF14	69238	-	NM_014875	200522515	200587851	30
chr1	200613164	200639126	DDX59	25962	-	NM_001031725	200613381	200635868	8
chr1	200638634	200663378	LOC101929224	24744	+	NR_110787	200663378	200663378	3
chr1	200708685	200829835	CAMSAP2	121150	+	NM_001297707	200708955	200827187	18
chr1	200842082	200843306	GPR25	1224	+	NM_005298	200842165	200843251	1
chr1	200860626	200884864	C1orf106	24238	+	NM_018265	200860626	200882757	10
chr1	200938513	200992828	KIF21B	54315	-	NM_001252100	200943222	200992511	35
chr1	201008639	201081694	CACNA1S	73055	-	NM_000069	201008958	201081467	44
chr1	201083080	201084500	ASCL5	1420	-	NM_001270601	201083879	201084500	1
chr1	201103898	201140710	TMEM9	36812	-	NM_001288564	201104790	201123051	6
chr1	201159952	201198080	IGFN1	38128	+	NM_001164586	201162421	201197527	24
chr1	201252579	201302121	PKP1	49542	+	NM_000299	201252830	201297964	15
chr1	201328135	201346828	TNNT2	18693	-	NM_001276345	201328337	201342382	17
chr1	201349965	201368669	LAD1	18704	-	NM_005558	201351015	201368434	10
chr1	201372894	201390874	TNNI1	17980	-	NM_003281	201379455	201386921	8
chr1	201433411	201438299	PHLDA3	4888	-	NM_012396	201437530	201437914	2
chr1	201452657	201476387	CSRP1	23730	-	NM_001193570	201453840	201465431	6
chr1	201489031	201489720	RPS10P7	689	+	NR_026667	201489720	201489720	1
chr1	201617449	201796102	NAV1	178653	+	NM_020443	201617796	201789060	30
chr1	201657383	201798687	IPO9-AS1	141304	-	NR_046696	201798687	201798687	3
chr1	201688635	201688755	MIR5191	120	+	NR_049823	201688755	201688755	1
chr1	201777738	201777830	MIR1231	92	+	NR_031599	201777830	201777830	1
chr1	201798287	201853422	IPO9	55135	+	NM_018085	201798337	201845182	24
chr1	201832500	201832575	MIR6739	75	+	NR_106797	201832575	201832575	1
chr1	201857796	201861715	SHISA4	3919	+	NR_030775	201861715	201861715	5
chr1	201865583	201915716	LMOD1	50133	-	NM_012134	201867499	201915468	3
chr1	201924618	201939789	TIMM17A	15171	+	NM_006335	201924654	201938682	6
chr1	201951765	201975275	RNPEP	23510	+	NM_020216	201951794	201974844	11
chr1	201972251	201972364	MIR6740	113	+	NR_106798	201972364	201972364	1
chr1	201979689	201986315	ELF3	6626	+	NM_004433	201980264	201984451	9
chr1	202092028	202098634	GPR37L1	6606	+	NM_004767	202092091	202097684	2
chr1	202102531	202113871	ARL8A	11340	-	NM_138795	202103594	202113700	7
chr1	202116140	202130716	PTPN7	14576	-	NM_001199797	202117733	202130688	10
chr1	202137178	202158577	PTPRVP	21399	+	NR_002930	202158577	202158577	22
chr1	202163117	202288889	LGR6	125772	+	NM_001017403	202163117	202288335	18
chr1	202300784	202311094	UBE2T	10310	-	NM_001310326	202300962	202304788	7
chr1	202317829	202557697	PPP1R12B	239868	+	NM_002481	202317979	202549688	24
chr1	202559724	202679551	SYT2	119827	-	NM_177402	202565884	202574900	9
chr1	202694312	202778598	KDM5B	84286	-	NM_001314042	202698163	202777433	28
chr1	202780073	202781041	PCAT6	968	+	NR_046326	202781041	202781041	2
chr1	202789384	202796341	MGAT4EP	6957	+	NR_038135	202796341	202796341	3
chr1	202830881	202844369	LOC148709	13488	+	NR_002929	202844369	202844369	3
chr1	202847409	202858385	RABIF	10976	-	NM_002871	202850105	202858226	2
chr1	202860223	202897772	KLHL12	37549	-	NM_001303051	202861660	202897677	12
chr1	202909952	202927700	ADIPOR1	17748	-	NM_001290629	202910700	202920198	9
chr1	202931000	202936404	CYB5R1	5404	-	NM_016243	202931654	202936333	9
chr1	202955579	202976393	LOC100506747	20814	-	NR_036557	202976393	202976393	5
chr1	202976533	202993197	TMEM183A	16664	+	NM_138391	202976593	202992168	8
chr1	202976535	202992668	TMEM183B	16133	+	NM_001079809	202976593	202992168	8
chr1	202995648	203047864	PPFIA4	52216	+	NM_001304331	203008136	203045518	30
chr1	203052256	203055166	MYOG	2910	-	NM_002479	203053037	203055089	3
chr1	203096835	203136533	ADORA1	39698	+	NM_000674	203097969	203135028	4
chr1	203136938	203144942	MYBPH	8004	-	NM_004997	203137786	203144883	11
chr1	203148058	203155922	CHI3L1	7864	-	NM_001276	203148572	203155751	10
chr1	203185206	203198860	CHIT1	13654	-	NR_045784	203198860	203198860	13
chr1	203256279	203257924	LINC01353	1645	+	NR_117097	203257924	203257924	3
chr1	203267885	203274453	LINC01136	6568	-	NR_034151	203274453	203274453	4
chr1	203274663	203278729	BTG2	4066	+	NM_006763	203274734	203276566	2
chr1	203309748	203320557	FMOD	10809	-	NM_002023	203311470	203317398	3
chr1	203444882	203460479	PRELP	15597	+	NM_002725	203452312	203456009	3
chr1	203463270	203478077	OPTC	14807	+	NM_014359	203465133	203472848	8
chr1	203595914	203713209	ATP2B4	117295	+	NM_001001396	203652333	203708699	22
chr1	203698708	203698833	SNORA77	125	+	NR_003019	203698833	203698833	1
chr1	203699704	203700979	LINC00260	1275	+	NR_046213	203700979	203700979	1
chr1	203734283	203745480	LAX1	11197	+	NM_001136190	203734470	203743809	5
chr1	203764750	203823256	ZC3H11A	58506	+	NM_014827	203786198	203821527	20
chr1	203766650	203769590	ZBED6	2940	+	NM_001174108	203766650	203769590	1
chr1	203830712	203840280	SNRPE	9568	+	NM_003094	203830787	203839060	5
chr1	204001574	204010392	LINC00303	8818	-	NR_027902	204010392	204010392	6
chr1	204042245	204096871	SOX13	54626	+	NM_005686	204082043	204095262	14
chr1	204100188	204121310	ETNK2	21122	-	NM_001297760	204103651	204120980	8
chr1	204110535	204112137	LOC101929441	1602	+	NR_123739	204112137	204112137	3
chr1	204123943	204135465	REN	11522	-	NM_000537	204124143	204135421	10
chr1	204159468	204165619	KISS1	6151	-	NM_002256	204159611	204162004	3
chr1	204167287	204183220	GOLT1A	15933	-	NM_198447	204167585	204183034	5
chr1	204187978	204329057	PLEKHA6	141079	-	NM_014935	204192597	204242855	23
chr1	204337557	204338847	LINC00628	1290	-	NR_027022	204338847	204338847	1
chr1	204372491	204380945	PPP1R15B	8454	-	NM_032833	204375219	204380539	2
chr1	204391757	204459474	PIK3C2B	67717	-	NM_002646	204393979	204438930	34
chr1	204485506	204527248	MDM4	41742	+	NM_002393	204494646	204518810	11
chr1	204586302	204654597	LRRN2	68295	-	NM_201630	204586978	204589120	2
chr1	204797781	204991950	NFASC	194169	+	NM_001005388	204913443	204985667	30
chr1	205012339	205047171	CNTN2	34832	+	NM_005076	205022313	205042893	23
chr1	205052256	205053588	TMEM81	1332	-	NM_203376	205052680	205053448	1
chr1	205055269	205091150	RBBP5	35881	-	NM_001193273	205057914	205073125	14
chr1	205111630	205180727	DSTYK	69097	-	NM_015375	205116685	205180663	13
chr1	205197037	205242471	TMCC2	45434	+	NM_014858	205197692	205241252	5
chr1	205271190	205290919	NUAK2	19729	-	NM_030952	205272577	205290888	7
chr1	205305192	205326218	KLHDC8A	21026	-	NM_001271863	205306526	205312732	9
chr1	205342379	205356568	LEMD1-AS1	14189	+	NR_038425	205356568	205356568	4
chr1	205350505	205391214	LEMD1	40709	-	NM_001199050	205350785	205389664	6
chr1	205404013	205425214	BLACAT1	21201	-	NR_103783	205425214	205425214	2
chr1	205417429	205417526	MIR135B	97	-	NR_029893	205417526	205417526	1
chr1	205473683	205501921	CDK18	28238	+	NM_002596	205492295	205500506	16
chr1	205523400	205525763	LOC284578	2363	-	NR_027086	205525763	205525763	1
chr1	205538111	205572046	MFSD4	33935	+	NM_181644	205538197	205569589	10
chr1	205577070	205602000	ELK4	24930	-	NM_001973	205585673	205593010	5
chr1	205626980	205649630	SLC45A3	22650	-	NM_033102	205628361	205633784	5
chr1	205681946	205719372	NUCKS1	37426	-	NM_022731	205687407	205719101	7
chr1	205737113	205744610	RAB29	7497	-	NM_001135662	205739469	205744084	6
chr1	205758220	205782324	SLC41A1	24104	-	NM_173854	205760660	205779569	11
chr1	205797149	205819276	PM20D1	22127	-	NM_152491	205797747	205819200	13
chr1	205831206	205865215	LOC284581	34009	+	NR_046097	205865215	205865215	3
chr1	205882176	205912588	SLC26A9	30412	-	NM_134325	205884019	205904948	22
chr1	206137264	206155151	FAM72A	17887	+	NM_001317901	206137334	206154051	4
chr1	206224282	206231482	AVPR1B	7200	+	NM_000707	206224440	206231142	2
chr1	206238871	206288647	C1orf186	49776	-	NM_001007544	206239378	206243502	6
chr1	206317458	206332104	CTSE	14646	+	NM_001910	206317576	206331185	9
chr1	206516199	206581301	SRGAP2C	65102	+	NM_001271872	206516199	206579957	7
chr1	206516199	206637783	SRGAP2	121584	+	NM_001170637	206516199	206634765	20
chr1	206557366	206581301	SRGAP2D	23935	+	NR_120535	206581301	206581301	6
chr1	206643585	206670223	IKBKE	26638	+	NM_014002	206646570	206669478	22
chr1	206648145	206648207	MIR6769B	62	+	NR_106919	206648207	206648207	1
chr1	206680862	206762616	RASSF5	81754	+	NM_182663	206680935	206760310	6
chr1	206764973	206785904	EIF2D	20931	-	NM_006893	206765106	206785695	15
chr1	206808880	206822542	DYRK3	13662	+	NM_001004023	206810296	206822310	4
chr1	206858364	206907630	MAPKAPK2	49266	+	NM_032960	206858574	206906063	10
chr1	206940947	206945839	IL10	4892	-	NM_000572	206941980	206945780	5
chr1	206972214	207016326	IL19	44112	+	NM_153758	206972239	207015967	6
chr1	207039153	207042568	IL20	3415	+	NM_018724	207039197	207041909	5
chr1	207070787	207077484	IL24	6697	+	NM_006850	207071177	207076404	7
chr1	207076630	207095378	FCMR	18748	-	NM_005449	207078363	207095199	8
chr1	207101866	207119811	PIGR	17945	-	NM_002644	207103662	207113876	11
chr1	207131311	207143970	FCAMR	12659	-	NM_001170631	207131860	207143470	8
chr1	207191865	207206101	C1orf116	14236	-	NM_023938	207195302	207200943	4
chr1	207217193	207226325	YOD1	9132	-	NM_001276320	207222364	207225580	4
chr1	207226619	207254368	PFKFB2	27749	+	NM_001018053	207228062	207252364	15
chr1	207262186	207273337	C4BPB	11151	+	NM_001017366	207262876	207273274	7
chr1	207277606	207318317	C4BPA	40711	+	NM_000715	207286370	207318062	12
chr1	207494816	207534311	CD55	39495	+	NM_001114752	207495110	207533014	11
chr1	207627644	207663240	CR2	35596	+	NM_001006658	207627763	207658899	20
chr1	207669472	207815110	CR1	145638	+	NM_000651	207669612	207812754	47
chr1	207818457	207897036	CR1L	78579	+	NM_175710	207818578	207897030	12
chr1	207925382	207968861	CD46	43479	+	NM_002389	207925557	207963649	14
chr1	207975196	207975284	MIR29C	88	-	NR_029832	207975284	207975284	1
chr1	207975787	207975868	MIR29B2	81	-	NR_029518	207975868	207975868	1
chr1	207991723	207995941	LOC148696	4218	+	NR_026817	207995941	207995941	1
chr1	208059882	208084683	CD34	24801	-	NM_001025109	208061082	208084425	8
chr1	208195587	208417665	PLXNA2	222078	-	NM_025179	208200587	208391267	32
chr1	209602167	209605892	MIR205HG	3725	+	NM_001104548	209602642	209605694	4
chr1	209605477	209605587	MIR205	110	+	NR_029622	209605587	209605587	1
chr1	209757044	209787284	CAMK1G	30240	+	NM_020439	209768328	209786220	13
chr1	209788217	209825820	LAMB3	37603	-	NM_000228	209788615	209824289	23
chr1	209796788	209796855	MIR4260	67	-	NR_036213	209796855	209796855	1
chr1	209848669	209849735	G0S2	1066	+	NM_015714	209849029	209849341	2
chr1	209859524	209908295	HSD11B1	48771	+	NM_001206741	209878287	209907866	7
chr1	209929376	209955668	TRAF3IP3	26292	+	NM_025228	209933384	209955493	17
chr1	209952552	209958075	C1orf74	5523	-	NM_152485	209956169	209956979	2
chr1	209958967	209979520	IRF6	20553	-	NM_006147	209961764	209974758	9
chr1	210001311	210030910	DIEXF	29599	+	NM_014388	210001408	210024792	12
chr1	210111518	210337633	SYT14	226115	+	NM_001146261	210111595	210334387	10
chr1	210404803	210407466	SERTAD4-AS1	2663	-	NR_024337	210407466	210407466	2
chr1	210406194	210416440	SERTAD4	10246	+	NM_019605	210411305	210415682	4
chr1	210501595	210849638	HHAT	348043	+	NM_001122834	210522319	210847721	12
chr1	210851656	211307457	KCNH1	455801	-	NM_172362	210856622	211307287	11
chr1	211432707	211489725	RCOR3	57018	+	NM_001136223	211432902	211487110	12
chr1	211499956	211548286	TRAF5	48330	+	NM_004619	211526581	211546044	11
chr1	211556096	211605877	LINC00467	49781	+	NR_026761	211605877	211605877	6
chr1	211649863	211666259	RD3	16396	-	NM_001164688	211652377	211654757	3
chr1	211748380	211752099	SLC30A1	3719	-	NM_021194	211748729	211751954	2
chr1	211813149	211827963	LOC105748977	14814	+	NR_131925	211827963	211827963	3
chr1	211831598	211848972	NEK2	17374	-	NM_001204182	211831998	211848821	8
chr1	211916798	212004114	LPGAT1	87316	-	NM_014873	211923240	212002638	8
chr1	212113740	212209002	INTS7	95262	-	NR_037667	212209002	212209002	21
chr1	212208894	212278348	DTL	69454	+	NM_016448	212209232	212276282	15
chr1	212250954	212251027	MIR3122	73	+	NR_036068	212251027	212251027	1
chr1	212398619	212458363	LOC101929541	59744	-	NR_125984	212458363	212458363	4
chr1	212458878	212535205	PPP2R5A	76327	+	NM_006243	212459452	212534112	13
chr1	212526159	212526292	SNORA16B	133	+	NR_004389	212526292	212526292	1
chr1	212537815	212588267	TMEM206	50452	-	NM_018252	212538556	212588099	8
chr1	212606228	212619721	NENF	13493	+	NM_013349	212606285	212619348	4
chr1	212719035	212729408	LOC101929565	10373	+	NR_125985	212729408	212729408	3
chr1	212738675	212794119	ATF3	55444	+	NM_001030287	212788363	212792897	4
chr1	212797788	212800120	FAM71A	2332	+	NM_153606	212798219	212800004	1
chr1	212859758	212873327	BATF3	13569	-	NM_018664	212860132	212873104	3
chr1	212899494	212965139	NSL1	65645	-	NM_001042549	212912885	212965105	7
chr1	212965169	212990167	TATDN3	24998	+	NM_001146169	212965263	212988409	10
chr1	213003484	213020991	SPATA45	17507	-	NM_001024601	213003583	213009491	3
chr1	213029945	213031480	FLVCR1-AS1	1535	-	NR_027286	213031480	213031480	2
chr1	213031596	213072705	FLVCR1	41109	+	NM_014053	213031794	213068632	10
chr1	213123861	213164927	VASH2	41066	+	NM_001136474	213125079	213161926	9
chr1	213165523	213189217	ANGEL2	23694	-	NM_144567	213168382	213189013	9
chr1	213224574	213446808	RPS6KC1	222234	+	NM_012424	213224746	213445977	15
chr1	213992983	214159496	PROX1-AS1	166513	-	NR_037850	214159496	214159496	6
chr1	214098091	214099996	LINC00538	1905	+	NR_046189	214099996	214099996	1
chr1	214161277	214214847	PROX1	53570	+	NM_001270616	214169878	214209177	5
chr1	214454564	214510477	SMYD2	55913	+	NM_020197	214454597	214510127	12
chr1	214522038	214725024	PTPN14	202986	-	NM_005401	214531264	214638146	19
chr1	214776531	214837914	CENPF	61383	+	NM_016343	214787097	214837137	20
chr1	215178884	215410436	KCNK2	231552	+	NM_001017424	215179264	215408488	7
chr1	215740734	215795149	KCTD3	54415	+	NM_016121	215741028	215793960	18
chr1	215796235	216596738	USH2A	800503	-	NM_206933	215799122	216595678	72
chr1	216245806	216260259	LOC102723833	14453	+	NR_125992	216260259	216260259	3
chr1	216676587	217311097	ESRRG	634510	-	NM_001243510	216680280	216850820	9
chr1	217600334	217804444	GPATCH2	204110	-	NM_018040	217604486	217804313	10
chr1	217804665	218041495	SPATA17	236830	+	NM_138796	217804720	218036196	11
chr1	217954539	217958462	SPATA17-AS1	3923	-	NR_125784	217958462	217958462	3
chr1	218066241	218094146	LINC00210	27905	+	NR_048550	218094146	218094146	4
chr1	218216846	218232482	LOC101929631	15636	+	NR_110794	218232482	218232482	4
chr1	218458628	218511325	RRP15	52697	+	NM_016052	218458658	218504433	5
chr1	218517537	218519020	TGFB2-AS1	1483	-	NR_046268	218519020	218519020	3
chr1	218518675	218617961	TGFB2	99286	+	NM_001135599	218520043	218614704	8
chr1	218610974	219281452	MIR548F3	670478	+	NR_031644	219281452	219281452	7
chr1	218615967	218617337	TGFB2-OT1	1370	+	NR_125715	218617337	218617337	1
chr1	219254316	219347130	LYPLAL1-AS1	92814	-	NR_038845	219347130	219347130	5
chr1	219347172	219386207	LYPLAL1	39035	+	NM_138794	219347232	219385070	5
chr1	220046618	220292777	RNU5F-1	246159	+	NR_002753	220292777	220292777	3
chr1	220087605	220101993	SLC30A10	14388	-	NM_018713	220088790	220101782	4
chr1	220141941	220220000	EPRS	78059	-	NM_004446	220142147	220219730	32
chr1	220230823	220263195	BPNT1	32372	-	NM_006085	220232185	220253188	9
chr1	220267454	220321383	IARS2	53929	+	NM_018060	220267558	220320977	23
chr1	220291194	220291304	MIR215	110	-	NR_029628	220291304	220291304	1
chr1	220291498	220291583	MIR194-1	85	-	NR_029711	220291583	220291583	1
chr1	220321609	220445843	RAB3GAP2	124234	-	NM_012414	220324592	220445679	35
chr1	220373883	220373961	MIR664A	78	-	NR_031705	220373961	220373961	1
chr1	220373887	220374018	SNORA36B	131	-	NR_002994	220374018	220374018	1
chr1	220439520	220441057	AURKAPS1	1537	-	NR_001587	220441057	220441057	1
chr1	220701524	220837799	MARK1	136275	+	NM_018650	220702164	220835508	18
chr1	220863627	220872499	C1orf115	8872	+	NM_024709	220863744	220870073	2
chr1	220921587	220958157	MARC2	36570	+	NM_017898	220921873	220955243	8
chr1	220960038	220987741	MARC1	27703	+	NM_022746	220960286	220986760	7
chr1	221002596	221005770	LINC01352	3174	+	NR_110797	221005770	221005770	4
chr1	221006104	221053482	HLX-AS1	47378	-	NR_046901	221053482	221053482	3
chr1	221052742	221058400	HLX	5658	+	NM_021958	221053199	221058046	4
chr1	221503269	221509638	C1orf140	6369	-	NR_024236	221509638	221509638	2
chr1	221874761	221915518	DUSP10	40757	-	NM_007207	221875753	221913086	4
chr1	222001007	222014008	LOC101929771	13001	-	NR_125989	222014008	222014008	4
chr1	222695601	222721444	HHIPL2	25843	-	NM_024746	222695942	222721386	9
chr1	222731243	222763275	TAF1A	32032	-	NM_001201536	222732001	222761905	12
chr1	222763261	222765975	TAF1A-AS1	2714	+	NR_110613	222765975	222765975	3
chr1	222791443	222841354	MIA3	49911	+	NM_198551	222791452	222838961	28
chr1	222841354	222885864	AIDA	44510	-	NM_022831	222843234	222885659	10
chr1	222885894	222908538	BROX	22644	+	NM_144695	222889041	222906056	13
chr1	222910557	222924002	FAM177B	13445	+	NM_207468	222919887	222923400	6
chr1	222988430	223179337	DISP1	190907	+	NM_032890	223116165	223179314	10
chr1	223282747	223316624	TLR5	33877	-	NM_003268	223283796	223286373	6
chr1	223394160	223537544	SUSD4	143384	-	NM_017982	223395533	223536767	9
chr1	223566714	223568812	CCDC185	2098	+	NM_152610	223566817	223568689	1
chr1	223714971	223853436	CAPN8	138465	-	NM_001143962	223715198	223853348	17
chr1	223889294	223963720	CAPN2	74426	+	NM_001146068	223889530	223962559	21
chr1	223967594	224033674	TP53BP2	66080	-	NM_005426	223968554	223994634	19
chr1	224138967	224180346	GTF2IP20	41379	-	NR_132119	224180346	224180346	11
chr1	224301788	224349749	FBXO28	47961	+	NM_015176	224301831	224345448	5
chr1	224370909	224381142	DEGS1	10233	+	NM_003676	224371038	224380180	3
chr1	224396449	224400981	LOC101927143	4532	-	NR_110669	224400981	224400981	2
chr1	224407314	224415745	LOC101927164	8431	+	NR_110668	224415745	224415745	3
chr1	224415035	224517891	NVL	102856	-	NM_002533	224415327	224517829	23
chr1	224444705	224444843	MIR320B2	138	-	NR_031574	224444843	224444843	1
chr1	224544512	224567153	CNIH4	22641	+	NM_001277200	224544626	224566792	5
chr1	224572844	224622001	WDR26	49157	-	NM_001115113	224577536	224621807	14
chr1	224585928	224586013	MIR4742	85	-	NR_039896	224586013	224586013	1
chr1	224804178	224928249	CNIH3	124071	+	NM_152495	224804876	224927058	6
chr1	225117355	225586996	DNAH14	469641	+	NM_001373	225140404	225586971	84
chr1	225589203	225616557	LBR	27354	-	NM_194442	225591004	225611777	14
chr1	225674533	225840845	ENAH	166312	-	NM_001008493	225685476	225840392	15
chr1	225965514	225978168	SRP9	12654	+	NM_001130440	225965642	225974671	4
chr1	225997775	226033262	EPHX1	35487	+	NM_001136018	226016430	226033048	9
chr1	226033232	226070420	TMEM63A	37188	-	NM_014698	226034740	226065280	25
chr1	226073981	226076846	LEFTY1	2865	-	NM_020997	226074426	226076766	4
chr1	226107576	226112040	PYCR2	4464	-	NM_013328	226108154	226111810	7
chr1	226109779	226109842	MIR6741	63	-	NR_106799	226109842	226109842	1
chr1	226124297	226129083	LEFTY2	4786	-	NM_001172425	226125140	226128840	5
chr1	226170402	226187066	SDE2	16664	-	NM_152608	226173002	226187013	7
chr1	226250407	226259703	H3F3A	9296	+	NM_002107	226252052	226259180	4
chr1	226250427	226259703	H3F3AP4	9276	+	NR_002315	226259703	226259703	4
chr1	226332379	226374423	ACBD3	42044	-	NM_022735	226334310	226374376	8
chr1	226411318	226414756	MIXL1	3438	+	NM_031944	226411382	226413513	2
chr1	226418849	226497449	LIN9	78600	-	NM_001270410	226420201	226485422	15
chr1	226548391	226595801	PARP1	47410	-	NM_001618	226549160	226595630	23
chr1	226736500	226796915	C1orf95	60415	+	NM_001003665	226736605	226789741	4
chr1	226819390	226926876	ITPKB	107486	-	NM_002221	226822371	226925159	8
chr1	226843780	226862769	ITPKB-IT1	18989	-	NR_103784	226862769	226862769	2
chr1	227058272	227083804	PSEN2	25532	+	NM_000447	227069608	227083280	13
chr1	227127937	227175246	ADCK3	47309	+	NM_020247	227149086	227174438	15
chr1	227177565	227505826	CDC42BPA	328261	-	NM_003607	227181968	227504883	36
chr1	227751219	227865144	ZNF678	113925	+	NR_102302	227865144	227865144	6
chr1	227884732	227885408	ZNF847P	676	-	NR_036753	227885408	227885408	2
chr1	227916239	227922055	LOC100130093	5816	+	NR_024485	227922055	227922055	3
chr1	227918889	227923112	JMJD4	4223	-	NM_001161465	227920092	227923112	6
chr1	227922696	227968932	SNAP47	46236	+	NM_053052	227923110	227968374	5
chr1	228003417	228034171	PRSS38	30754	+	NM_183062	228003417	228033909	5
chr1	228109164	228135676	WNT9A	26512	-	NM_003395	228109218	228135588	4
chr1	228129290	228129384	MIR5008	94	-	NR_049806	228129384	228129384	1
chr1	228194722	228248972	WNT3A	54250	+	NM_033131	228194829	228247166	4
chr1	228270360	228286913	ARF1	16553	+	NM_001024226	228284815	228285714	5
chr1	228284963	228285042	MIR3620	79	+	NR_037415	228285042	228285042	1
chr1	228288427	228291163	C1orf35	2736	-	NR_130975	228291163	228291163	9
chr1	228294379	228297013	MRPL55	2634	-	NM_181462	228294460	228295961	6
chr1	228327784	228336655	GUK1	8871	+	NM_001242839	228333213	228336398	8
chr1	228337414	228347527	GJC2	10113	+	NM_020435	228345459	228346779	2
chr1	228351786	228353213	IBA57-AS1	1427	-	NR_103540	228353213	228353213	2
chr1	228353508	228369958	IBA57	16450	+	NM_001010867	228353517	228363214	3
chr1	228391206	228401356	C1orf145	10150	-	NR_073155	228401356	228401356	2
chr1	228395830	228566575	OBSCN	170745	+	NM_001271223	228399484	228566496	116
chr1	228581376	228594517	TRIM11	13141	-	NM_145214	228582405	228594262	6
chr1	228584748	228584810	MIR6742	62	-	NR_106800	228584810	228584810	1
chr1	228595635	228604583	TRIM17	8948	-	NM_016102	228595901	228602773	7
chr1	228612545	228613026	HIST3H3	481	-	NM_003493	228612615	228613026	1
chr1	228645064	228645560	HIST3H2A	496	-	NM_033445	228645125	228645518	1
chr1	228645807	228646259	HIST3H2BB	452	+	NM_175055	228645830	228646211	1
chr1	228649774	228649853	MIR4666A	79	+	NR_039812	228649853	228649853	1
chr1	228675067	228683889	RNF187	8822	+	NM_001010858	228675189	228681586	4
chr1	228698059	228699989	BTNL10	1930	-	NM_001287262	228698059	228699658	3
chr1	228780393	228882416	RHOU	102023	+	NR_037962	228882416	228882416	3
chr1	228780656	228788159	DUSP5P1	7503	+	NR_002834	228788159	228788159	2
chr1	229310429	229310548	MIR4454	119	-	NR_039659	229310548	229310548	2
chr1	229406808	229441640	RAB4A	34832	+	NM_004578	229407086	229438724	8
chr1	229440128	229441250	SPHAR	1122	+	NM_006542	229440881	229441073	1
chr1	229456751	229478688	CCSAP	21937	-	NM_145257	229460981	229478212	4
chr1	229566992	229569843	ACTA1	2851	-	NM_001100	229567245	229568862	7
chr1	229577043	229644088	NUP133	67045	-	NM_018230	229577650	229643996	26
chr1	229644176	229649834	LOC101927478	5658	+	NR_110630	229649834	229649834	3
chr1	229652328	229694442	ABCB10	42114	-	NM_012089	229653925	229694399	13
chr1	229728865	229761794	TAF5L	32929	-	NM_014409	229730043	229750229	5
chr1	229761962	229795947	URB2	33985	+	NM_014777	229763380	229795044	10
chr1	230193535	230417876	GALNT2	224341	+	NM_001291866	230193813	230415204	16
chr1	230457391	230561674	PGBD5	104283	-	NM_001258311	230459170	230561674	7
chr1	230778201	230829731	COG2	51530	+	NM_007357	230778352	230829139	18
chr1	230838271	230850336	AGT	12065	-	NM_000029	230838886	230846596	5
chr1	230883160	230937749	CAPN9	54589	+	NM_016452	230883242	230937342	19
chr1	230972864	231005335	C1orf198	32471	-	NM_001136494	230975597	231004144	6
chr1	231010591	231014761	LOC101927604	4170	+	NR_110681	231014761	231014761	3
chr1	231041986	231114618	TTC13	72632	-	NM_024525	231042650	231114576	23
chr1	231114822	231136479	ARV1	21657	+	NM_022786	231114851	231133009	6
chr1	231154703	231175995	FAM89A	21292	-	NM_198552	231155608	231175957	2
chr1	231155573	231155670	MIR1182	97	-	NR_031593	231155670	231155670	1
chr1	231298673	231357314	TRIM67	58641	+	NM_001300889	231298715	231351186	12
chr1	231319844	231323373	LOC149373	3529	-	NM_001256615	231320759	231323313	3
chr1	231359508	231376933	C1orf131	17425	-	NM_001300830	231360024	231376887	7
chr1	231376918	231413719	GNPAT	36801	+	NM_014236	231377124	231413288	16
chr1	231468476	231473618	EXOC8	5142	-	NM_175876	231471313	231473491	1
chr1	231473681	231490773	SPRTN	17092	+	NM_032018	231474129	231489107	5
chr1	231499496	231560790	EGLN1	61294	-	NM_022051	231502156	231557634	5
chr1	231611509	231612271	SNRPD2P2	762	-	NR_033826	231612271	231612271	1
chr1	231664398	231702269	TSNAX	37871	+	NM_005999	231664556	231700651	6
chr1	231664398	232177019	TSNAX-DISC1	512621	+	NR_028393	232177019	232177019	16
chr1	231727037	231747836	LINC00582	20799	-	NR_034037	231747836	231747836	2
chr1	231762560	232177019	DISC1	414459	+	NM_001164537	231762613	232172577	14
chr1	231950371	231954263	DISC2	3892	-	NR_002227	231954263	231954263	1
chr1	232061579	232080951	DISC1-IT1	19372	+	NR_126441	232080951	232080951	4
chr1	232533711	232651354	SIPA1L2	117643	-	NM_020808	232534872	232651085	21
chr1	232862999	232878461	LOC101927683	15462	-	NR_110683	232878461	232878461	4
chr1	232940637	232946092	MAP10	5455	+	NM_019090	232940769	232943913	1
chr1	233086369	233114219	NTPCR	27850	+	NM_032324	233086456	233113977	5
chr1	233119881	233431459	PCNXL2	311578	-	NM_014801	233120049	233431224	34
chr1	233463513	233520894	KIAA1804	57381	+	NM_032435	233463774	233518457	10
chr1	233749749	233808258	KCNK1	58509	+	NM_002245	233749917	233807276	3
chr1	233759897	233759965	MIR4427	68	+	NR_039625	233759965	233759965	1
chr1	234040457	234460264	SLC35F3	419807	+	NM_173508	234040823	234458989	8
chr1	234442212	234442285	MIR4671	73	+	NR_039818	234442285	234442285	1
chr1	234508552	234509339	LOC101927765	787	-	NR_125961	234509339	234509339	2
chr1	234509182	234519795	COA6	10613	+	NM_001206641	234509212	234519564	3
chr1	234527058	234614849	TARBP1	87791	-	NM_005646	234527322	234614849	30
chr1	234663636	234667525	LINC01354	3889	-	NR_038426	234667525	234667525	3
chr1	234740014	234745271	IRF2BP2	5257	-	NM_001077397	234742882	234745240	2
chr1	234765056	234770526	LINC00184	5470	+	NR_033927	234770526	234770526	2
chr1	234782034	234796670	LOC101927787	14636	+	NR_125944	234796670	234796670	4
chr1	234859788	234867390	LINC01132	7602	+	NR_038856	234867390	234867390	3
chr1	235093089	235099746	LOC101927851	6657	-	NR_125945	235099746	235099746	4
chr1	235272657	235292256	TOMM20	19599	-	NM_014765	235275378	235292030	5
chr1	235291117	235291252	SNORA14B	135	-	NR_002956	235291252	235291252	1
chr1	235294497	235324571	RBM34	30074	-	NM_015014	235295027	235324541	11
chr1	235330209	235491532	ARID4B	161323	-	NM_016374	235331839	235490234	24
chr1	235353348	235353431	MIR4753	83	-	NR_039908	235353431	235353431	1
chr1	235491752	235507844	GGPS1	16092	+	NM_001037277	235498579	235506087	4
chr1	235530674	235612283	TBCE	81609	+	NM_001287801	235543364	235612077	18
chr1	235610504	235667781	B3GALNT2	57277	-	NM_152490	235613520	235667552	12
chr1	235676124	235881413	MIR5096	205289	+	NR_039973	235881413	235881413	2
chr1	235710984	235814054	GNG4	103070	-	NM_001098721	235715408	235747138	4
chr1	235824330	236047008	LYST	222678	-	NM_001301365	235826239	235993717	53
chr1	236016299	236016360	MIR1537	61	-	NR_031718	236016360	236016360	1
chr1	236139131	236228481	NID1	89350	-	NM_002508	236141166	236228379	20
chr1	236305831	236372209	GPR137B	66378	+	NM_003272	236305922	236371458	7
chr1	236378421	236445339	ERO1B	66918	-	NM_019891	236381815	236445083	16
chr1	236557679	236648008	EDARADD	90329	+	NM_145861	236557744	236645949	6
chr1	236681513	236716279	LGALS8	34766	+	NM_201545	236689370	236711461	12
chr1	236686368	236687808	LGALS8-AS1	1440	-	NR_034040	236687808	236687808	1
chr1	236712304	236767841	HEATR1	55537	-	NM_018072	236714201	236767395	45
chr1	236849753	236927927	ACTN2	78174	+	NM_001278344	236898972	236925919	23
chr1	236958580	237067281	MTR	108701	+	NM_000254	236959003	237060944	33
chr1	237167402	237167718	MT1HL1	316	-	NM_001276687	237167486	237167672	1
chr1	237205701	237997288	RYR2	791587	+	NM_001035	237205821	237995947	105
chr1	237634418	237634491	MIR4428	73	+	NR_039626	237634491	237634491	1
chr1	238025474	238091619	LOC100130331	66145	+	NR_027247	238091619	238091619	12
chr1	238041163	238054222	ZP4	13059	-	NM_021186	238045721	238053935	13
chr1	238643683	238649317	LINC01139	5634	-	NR_015407	238649317	238649317	2
chr1	239792372	240072717	CHRM3	280345	+	NM_000740	240070751	240072524	5
chr1	239870425	239882419	CHRM3-AS2	11994	-	NR_103776	239882419	239882419	3
chr1	240061318	240063172	CHRM3-AS1	1854	-	NR_046582	240063172	240063172	2
chr1	240170823	240176560	RPS7P5	5737	+	NR_036695	240176560	240176560	2
chr1	240255184	240638489	FMN2	383305	+	NM_001305424	240255409	240637454	19
chr1	240640408	240912217	MIR1273E	271809	+	NR_128706	240912217	240912217	4
chr1	240652872	240775462	GREM2	122590	-	NM_022469	240656268	240656775	2
chr1	240938813	241520530	RGS7	581717	-	NM_001282775	240963946	241519076	18
chr1	241295571	241295646	MIR3123	75	+	NR_036069	241295646	241295646	1
chr1	241660856	241683085	FH	22229	-	NM_000143	241661127	241683022	10
chr1	241695433	241758949	KMO	63516	+	NM_003679	241695744	241755455	15
chr1	241756451	241803701	OPN3	47250	-	NM_014322	241757729	241803556	4
chr1	241792166	241799232	CHML	7066	-	NM_001821	241797097	241799068	1
chr1	241815579	241965434	WDR64	149855	+	NM_144625	241815786	241964517	27
chr1	242011492	242053241	EXO1	41749	+	NM_130398	242013727	242052902	16
chr1	242121068	242122364	BECN2	1296	+	NM_001290693	242121068	242122364	1
chr1	242158791	242162385	MAP1LC3C	3594	-	NM_001004343	242159464	242162310	4
chr1	242251688	242687998	PLD5	436310	-	NM_152666	242253155	242687578	11
chr1	243219615	243265046	LINC01347	45431	-	NR_029401	243265046	243265046	18
chr1	243287729	243418708	CEP170	130979	-	NM_014812	243289750	243388582	20
chr1	243419306	243663393	SDCCAG8	244087	+	NM_006642	243419475	243663087	18
chr1	243509477	243509557	MIR4677	80	+	NR_039824	243509557	243509557	1
chr1	243651534	244006584	AKT3	355050	-	NM_181690	243663044	244006472	14
chr1	244080703	244210619	LOC339529	129916	+	NR_033883	244210619	244210619	12
chr1	244212240	244220780	ZBTB18	8540	+	NM_001278196	244217103	244218672	2
chr1	244515936	244552388	C1orf100	36452	+	NM_001012970	244528002	244552371	5
chr1	244571793	244615436	ADSS	43643	-	NM_001126	244572887	244615119	13
chr1	244624672	244803662	C1orf101	178990	+	NM_001130957	244624731	244803383	22
chr1	244816349	244872336	DESI2	55987	+	NR_123735	244872336	244872336	5
chr1	244998607	245008365	COX20	9758	+	NM_001312871	244999016	245006478	5
chr1	245013601	245027827	HNRNPU	14226	-	NM_004501	245017751	245027609	14
chr1	245017388	245017519	SNORA100	131	-	NR_132782	245017519	245017519	1
chr1	245128505	245134171	LOC101928068	5666	-	NR_111907	245134171	245134171	2
chr1	245133630	245288530	EFCAB2	154900	+	NM_001143943	245133720	245285250	7
chr1	245318286	245866428	KIF26B	548142	+	NM_018012	245318726	245865908	15
chr1	245912641	246670644	SMYD3	758003	-	NM_001167740	245912864	246670519	12
chr1	246679340	246687589	LOC255654	8249	-	NR_040002	246687589	246687589	3
chr1	246703862	246729565	TFB2M	25703	-	NM_022366	246704332	246729440	8
chr1	246729638	246831884	CNST	102246	+	NM_152609	246754864	246829207	11
chr1	246887377	246931440	SCCPDH	44063	+	NM_016002	246887724	246930602	12
chr1	246952918	246954788	LINC01341	1870	+	NR_015422	246954788	246954788	2
chr1	247002401	247094726	AHCTF1	92325	-	NM_015446	247004107	247094629	36
chr1	247108848	247171395	ZNF695	62547	-	NM_001204221	247109098	247171210	6
chr1	247108848	247242115	ZNF670-ZNF695	133267	-	NR_037894	247242115	247242115	7
chr1	247197939	247242115	ZNF670	44176	-	NM_001204220	247200750	247241898	4
chr1	247263263	247267674	ZNF669	4411	-	NM_001142572	247263675	247267501	4
chr1	247273461	247275719	C1orf229	2258	-	NM_207401	247274812	247275526	1
chr1	247285276	247335319	ZNF124	50043	-	NM_001243740	247287169	247335179	4
chr1	247365268	247365362	MIR3916	94	-	NR_037480	247365362	247365362	1
chr1	247419373	247420447	VN1R5	1074	+	NM_173858	247419373	247420447	1
chr1	247463621	247495045	ZNF496	31424	-	NM_032752	247463820	247492880	9
chr1	247579457	247612406	NLRP3	32949	+	NM_001079821	247582096	247611806	11
chr1	247614330	247615284	OR2B11	954	-	NM_001004492	247614330	247615284	1
chr1	247654369	247655711	OR2W5	1342	+	NM_001004698	247654429	247655392	1
chr1	247670359	247740992	GCSAML	70633	+	NM_001281853	247712493	247737684	7
chr1	247687980	247694106	GCSAML-AS1	6126	-	NR_027309	247694106	247694106	4
chr1	247693433	247697141	OR2C3	3708	-	NM_198074	247694850	247695813	2
chr1	247751661	247752615	OR2G2	954	+	NM_001001915	247751661	247752615	1
chr1	247768887	247769817	OR2G3	930	+	NM_001001914	247768887	247769817	1
chr1	247835419	247836343	OR13G1	924	-	NM_001005487	247835419	247836343	1
chr1	247875130	247876057	OR6F1	927	-	NM_001005286	247875130	247876057	1
chr1	247920763	247921708	OR1C1	945	-	NM_012353	247920763	247921708	1
chr1	247978101	247979031	OR14A16	930	-	NM_001001966	247978101	247979031	1
chr1	248004229	248005198	OR11L1	969	-	NM_001001959	248004229	248005198	1
chr1	248020500	248043438	TRIM58	22938	+	NM_015431	248020548	248039791	6
chr1	248058888	248059833	OR2W3	945	+	NM_001001957	248058888	248059833	1
chr1	248084319	248085258	OR2T8	939	+	NM_001005522	248084319	248085258	1
chr1	248100330	248264224	OR2L13	163894	+	NM_175911	248262677	248263616	3
chr1	248112159	248113098	OR2L8	939	+	NM_001001963	248112159	248113098	1
chr1	248128633	248129641	OR2AK2	1008	+	NM_001004491	248128633	248129641	1
chr1	248153568	248154493	OR2L1P	925	+	NR_002145	248154493	248154493	1
chr1	248185249	248186188	OR2L5	939	+	NM_001258284	248185249	248186188	1
chr1	248201473	248202607	OR2L2	1134	+	NM_001004686	248201569	248202508	1
chr1	248223983	248224922	OR2L3	939	+	NM_001004687	248223983	248224922	1
chr1	248285437	248286082	OR2M1P	645	+	NR_002141	248286082	248286082	1
chr1	248308449	248309388	OR2M5	939	+	NM_001004690	248308449	248309388	1
chr1	248343287	248344331	OR2M2	1044	+	NM_001004688	248343287	248344331	1
chr1	248366369	248367308	OR2M3	939	+	NM_001004689	248366369	248367308	1
chr1	248402230	248403166	OR2M4	936	+	NM_017504	248402230	248403166	1
chr1	248436153	248437116	OR2T33	963	-	NM_001004695	248436153	248437116	1
chr1	248457917	248458880	OR2T12	963	-	NM_001004692	248457917	248458880	1
chr1	248486931	248487870	OR2M7	939	-	NM_001004691	248486931	248487870	1
chr1	248512076	248513015	OR14C36	939	+	NM_001001918	248512076	248513015	1
chr1	248524882	248525929	OR2T4	1047	+	NM_001004696	248524882	248525929	1
chr1	248550909	248551836	OR2T6	927	+	NM_001005471	248550909	248551836	1
chr1	248569295	248570405	OR2T1	1110	+	NM_030904	248569295	248570405	1
chr1	248616098	248617073	OR2T2	975	+	NM_001004136	248616098	248617073	1
chr1	248636651	248637608	OR2T3	957	+	NM_001005495	248636651	248637608	1
chr1	248651889	248652837	OR2T5	948	+	NM_001004697	248651889	248652837	1
chr1	248684947	248685898	OR2G6	951	+	NM_001013355	248684947	248685898	1
chr1	248721844	248722792	OR2T29	948	-	NM_001004694	248721844	248722792	1
chr1	248737101	248738058	OR2T34	957	-	NM_001001821	248737101	248738058	1
chr1	248756130	248757069	OR2T10	939	-	NM_001004693	248756130	248757069	1
chr1	248789478	248790429	OR2T11	951	-	NM_001001964	248789478	248790429	1
chr1	248801587	248802559	OR2T35	972	-	NM_001001827	248801587	248802559	1
chr1	248813231	248814185	OR2T27	954	-	NM_001001824	248813231	248814185	1
chr1	248844669	248845605	OR14I1	936	-	NM_001004734	248844669	248845605	1
chr1	248860362	248862411	LOC101928226	2049	+	NR_125950	248862411	248862411	2
chr1	248902716	248903151	LYPD8	435	-	NM_001085474	248902911	248903151	1
chr1	249104650	249120154	SH3BP5L	15504	-	NM_030645	249106098	249119134	7
chr1	249120575	249120642	MIR3124	67	+	NR_036070	249120642	249120642	1
chr1	249132376	249143716	ZNF672	11340	+	NM_024836	249141473	249142832	4
chr1	249144202	249153315	ZNF692	9113	-	NM_017865	249144408	249152508	12
chr1	249200441	249213345	PGBD2	12904	+	NM_001017434	249211536	249212562	3
chr1_gl000192_random	132568	407510	HYDIN2	274942	-	NR_103556	407510	407510	46
chr1_gl000192_random	429709	468683	CH17-408M7.1	38974	-	NR_120328	468683	468683	5
chr2	38813	46588	FAM110C	7775	-	NM_001077710	41607	46385	2
chr2	218135	264866	SH3YL1	46731	-	NM_001282682	218810	242800	11
chr2	264868	278282	ACP1	13414	+	NR_024080	278282	278282	7
chr2	279560	288308	FAM150B	8748	-	NM_001002919	280146	287835	6
chr2	667972	677439	TMEM18	9467	-	NM_152834	669579	677345	5
chr2	779836	864112	LINC01115	84276	-	NR_033880	864112	864112	4
chr2	895901	901137	LOC101060385	5236	-	NR_110179	901137	901137	4
chr2	946553	1371384	SNTG2	424831	+	NM_018968	946682	1371246	17
chr2	1417232	1546499	TPO	129267	+	NM_001206744	1418180	1546246	17
chr2	1635658	1748319	PXDN	112661	-	NM_012293	1637975	1748227	23
chr2	1792884	2335085	MYT1L	542201	-	NM_001303052	1795638	1983549	25
chr2	2323003	2330880	MYT1L-AS1	7877	+	NR_024468	2330880	2330880	2
chr2	2898819	3129798	LINC01250	230979	-	NR_110228	3129798	3129798	7
chr2	3192740	3381653	TSSC1	188913	-	NM_003310	3193104	3381460	9
chr2	3383445	3483342	TRAPPC12	99897	+	NM_016030	3391394	3483232	12
chr2	3501689	3523350	ADI1	21661	-	NM_018269	3502733	3523258	4
chr2	3592481	3605961	RNASEH1	13480	-	NM_001286837	3593374	3599791	8
chr2	3605975	3609340	RNASEH1-AS1	3365	+	NR_038429	3609340	3609340	3
chr2	3622852	3628509	RPS7	5657	+	NM_001011	3623199	3628472	7
chr2	3642421	3692234	COLEC11	49813	+	NR_045659	3692234	3692234	8
chr2	3705785	3750260	ALLC	44475	+	NM_018436	3718747	3750153	12
chr2	3751181	3895000	DCDC2C	143819	+	NM_001287444	3751341	3894773	11
chr2	4005244	4021622	LINC01304	16378	-	NR_037881	4021622	4021622	3
chr2	4675807	4703812	LINC01249	28005	-	NR_034134	4703812	4703812	5
chr2	5774272	5831250	LINC01248	56978	-	NR_110580	5831250	5831250	5
chr2	5832798	5841517	SOX11	8719	+	NM_003108	5832853	5834179	1
chr2	6072818	6120350	LINC01105	47532	+	NR_026832	6120350	6120350	2
chr2	6114793	6114864	MIR7158	71	+	NR_106980	6114864	6114864	1
chr2	6122109	6128364	LOC400940	6255	+	NR_026833	6128364	6128364	3
chr2	6506141	6515554	LINC01247	9413	-	NR_110251	6515554	6515554	3
chr2	6766240	6774838	LINC01246	8598	-	NR_110498	6774838	6774838	3
chr2	6789238	6790651	MIR7515HG	1413	-	NR_110497	6790651	6790651	2
chr2	6790504	6790571	MIR7515	67	+	NR_106986	6790571	6790571	1
chr2	6869299	6910442	LINC00487	41143	-	NR_038369	6910442	6910442	6
chr2	6968684	6980595	NRIR	11911	-	NR_126359	6980595	6980595	4
chr2	6980683	7005950	CMPK2	25267	-	NM_001256478	6980700	7005827	4
chr2	7017795	7038363	RSAD2	20568	+	NM_080657	7017931	7036073	6
chr2	7052406	7058813	RNF144A-AS1	6407	-	NR_033997	7058813	7058813	5
chr2	7057522	7184309	RNF144A	126787	+	NM_014746	7137057	7179891	9
chr2	7202857	7218011	LOC101929452	15154	-	NR_110252	7218011	7218011	3
chr2	7561391	7590381	LOC100506274	28990	+	NR_038432	7590381	7590381	6
chr2	8026897	8039786	LOC101929551	12889	-	NR_110256	8039786	8039786	6
chr2	8062555	8116945	LINC00298	54390	-	NR_015405	8116945	8116945	3
chr2	8147900	8468549	LINC00299	320649	-	NR_034135	8468549	8468549	9
chr2	8699962	8723922	LOC101929567	23960	-	NR_110257	8723922	8723922	6
chr2	8811113	8821993	ID2-AS1	10880	-	NR_110154	8821993	8821993	4
chr2	8822112	8824583	ID2	2471	+	NM_002166	8822295	8823029	3
chr2	8868986	8977755	KIDINS220	108769	-	NM_020738	8870849	8967223	30
chr2	8996700	9143876	MBOAT2	147176	-	NM_138799	8998808	9143743	13
chr2	9346893	9545812	ASAP2	198919	+	NM_003887	9347233	9543456	28
chr2	9545814	9563643	ITGB1BP1	17829	-	NM_004763	9546962	9558826	7
chr2	9563665	9613239	CPSF3	49574	+	NM_016207	9563902	9613146	18
chr2	9614669	9628591	IAH1	13922	+	NM_001039613	9614695	9628458	6
chr2	9629410	9695917	ADAM17	66507	-	NM_003183	9630305	9695734	19
chr2	9724095	9771184	YWHAQ	47089	-	NM_006826	9725414	9770581	6
chr2	9983570	10074545	TAF1B	90975	+	NM_005680	9983670	10074113	15
chr2	10091791	10142412	GRHL1	50621	+	NM_198182	10091962	10140835	16
chr2	10183681	10194963	KLF11	11282	+	NM_003597	10183843	10192634	4
chr2	10196925	10220538	CYS1	23613	-	NM_001037160	10198979	10220350	3
chr2	10262694	10271546	RRM2	8852	+	NM_001165931	10262745	10269513	10
chr2	10281508	10351856	C2orf48	70348	+	NM_182626	10282009	10350723	4
chr2	10332739	10332797	MIR4261	58	-	NR_036222	10332797	10332797	1
chr2	10443029	10567743	HPCAL1	124714	+	NM_002149	10559883	10566947	5
chr2	10580496	10588680	ODC1	8184	-	NM_002539	10580849	10585158	12
chr2	10586839	10586975	SNORA80B	136	-	NR_028374	10586975	10586975	1
chr2	10589853	10595678	LOC101929715	5825	+	NR_110597	10595678	10595678	5
chr2	10710891	10830113	NOL10	119222	-	NM_024894	10712196	10829987	21
chr2	10861774	10925236	ATP6V1C2	63462	+	NM_001039362	10862975	10923389	14
chr2	10923516	10978103	PDIA6	54587	-	NM_001282705	10924383	10977731	14
chr2	11018392	11025244	LOC101929733	6852	+	NR_110575	11025244	11025244	2
chr2	11052062	11054351	KCNF1	2289	+	NM_002236	11052552	11054037	1
chr2	11239976	11272302	FLJ33534	32326	-	NR_040080	11272302	11272302	9
chr2	11273178	11286916	C2orf50	13738	+	NM_182500	11273460	11284237	4
chr2	11295497	11318998	PQLC3	23501	+	NR_104231	11318998	11318998	8
chr2	11321777	11484711	ROCK2	162934	-	NM_004850	11323562	11484262	33
chr2	11534106	11543203	LINC00570	9097	+	NR_047499	11543203	11543203	3
chr2	11584500	11606303	E2F6	21803	-	NM_001278277	11586602	11593862	9
chr2	11674241	11782912	GREB1	108671	+	NM_014668	11696740	11780580	33
chr2	11680730	11680803	MIR4429	73	-	NR_039627	11680803	11680803	1
chr2	11798303	11810329	NTSR2	12026	-	NM_012344	11798604	11810255	4
chr2	11817704	11967533	LPIN1	149829	+	NM_001261428	11817773	11964917	22
chr2	11907569	11907651	MIR548S	82	+	NR_036071	11907651	11907651	1
chr2	11977058	11977112	MIR4262	54	-	NR_036226	11977112	11977112	1
chr2	12147241	12718474	MIR3681HG	571233	+	NR_110196	12718474	12718474	6
chr2	12339255	12339327	MIR3681	72	+	NR_037452	12339327	12339327	1
chr2	12856997	12882858	TRIB2	25861	+	NM_021643	12858433	12880920	3
chr2	12877492	12877570	MIR3125	78	+	NR_036072	12877570	12877570	1
chr2	13106907	13147138	LOC100506474	40231	-	NR_038434	13147138	13147138	6
chr2	14368997	14541082	LINC00276	172085	-	NR_103814	14541082	14541082	4
chr2	14772809	14780168	FAM84A	7359	+	NM_145175	14774103	14774982	2
chr2	14775214	14790943	LOC653602	15729	+	NM_001291410	14775326	14789447	2
chr2	15307031	15701472	NBAS	394441	-	NM_015909	15307171	15701428	52
chr2	15731744	15771235	DDX1	39491	+	NM_004939	15732057	15771030	26
chr2	15830905	15859085	LOC101926966	28180	+	NR_110201	15859085	15859085	6
chr2	16060520	16076140	MYCNUT	15620	+	NR_125783	16076140	16076140	3
chr2	16076386	16081845	MYCNOS	5459	-	NR_110230	16081845	16081845	4
chr2	16080559	16087129	MYCN	6570	+	NM_001293233	16080708	16082251	3
chr2	16190548	16225811	GACAT3	35263	+	NR_126559	16225811	16225811	4
chr2	16730729	16847134	FAM49A	116405	-	NM_030797	16734203	16769387	12
chr2	17691985	17699706	RAD51AP2	7721	-	NM_001099218	17692070	17699682	3
chr2	17721806	17837706	VSNL1	115900	+	NM_003385	17773341	17836661	4
chr2	17845078	17935096	SMC6	90018	-	NM_001142286	17846765	17927213	28
chr2	17935176	17966632	GEN1	31456	+	NM_182625	17941210	17963206	14
chr2	17997785	17998367	MSGN1	582	+	NM_001105569	17997785	17998367	1
chr2	18059113	18114225	KCNS3	55112	+	NM_001282428	18112275	18113751	3
chr2	18735988	18741959	RDH14	5971	-	NM_020905	18736456	18741838	2
chr2	18735988	18770846	NT5C1B-RDH14	34858	-	NM_001199104	18737049	18770734	11
chr2	18744136	18770846	NT5C1B	26710	-	NM_001199086	18745061	18770734	10
chr2	19548189	19548266	MIR4757	77	+	NR_039914	19548266	19548266	1
chr2	19551245	19558372	OSR1	7127	-	NM_145260	19552035	19553566	3
chr2	20068614	20084808	LINC00954	16194	+	NR_033875	20084808	20084808	10
chr2	20096391	20101747	TTC32	5356	-	NM_001008237	20096747	20101615	3
chr2	20110028	20189884	WDR35	79856	-	NM_001006657	20113318	20189776	28
chr2	20189964	20204567	LOC101928222	14603	+	NR_110235	20204567	20204567	3
chr2	20191812	20212455	MATN3	20643	-	NM_002381	20192871	20212392	8
chr2	20232410	20251789	LAPTM4A	19379	-	NM_014713	20232965	20251281	7
chr2	20400557	20425194	SDC1	24637	-	NM_001006946	20402526	20424628	6
chr2	20448452	20550611	PUM2	102159	-	NM_015317	20451345	20527121	21
chr2	20646831	20649204	RHOB	2373	+	NM_004040	20647226	20647817	1
chr2	20790534	20792308	HS1BP3-IT1	1774	-	NR_046836	20792308	20792308	2
chr2	20817563	20850864	HS1BP3	33301	-	NM_022460	20818746	20850823	7
chr2	20866423	20871250	GDF7	4827	+	NM_182828	20866999	20871185	2
chr2	20883773	21022890	LDAH	139117	-	NM_021925	20886662	21001223	7
chr2	21224300	21266945	APOB	42645	-	NM_000384	21224601	21266817	29
chr2	21346857	21367238	TDRD15	20381	+	NM_001306137	21360339	21366144	4
chr2	21910305	21933524	LOC645949	23219	-	NR_038837	21933524	21933524	3
chr2	22759350	22761159	LOC102723362	1809	+	NR_110577	22761159	22761159	3
chr2	23608297	23931483	KLHL29	323186	+	NM_052920	23785066	23929534	14
chr2	23971533	24149984	ATAD2B	178451	-	NR_125717	24149984	24149984	29
chr2	24163375	24223693	UBXN2A	60318	+	NM_181713	24181184	24222737	7
chr2	24232952	24247145	MFSD2B	14193	+	NM_001080473	24232966	24247145	13
chr2	24252205	24270296	C2orf44	18091	-	NM_025203	24253802	24262364	4
chr2	24272583	24286550	FKBP1B	13967	+	NM_004116	24272719	24286062	4
chr2	24290453	24299314	SF3B6	8861	-	NM_016047	24290631	24299099	4
chr2	24299743	24392507	FAM228B	92764	+	NM_001291328	24362290	24390538	11
chr2	24300302	24308085	TP53I3	7783	-	NM_147184	24300448	24307196	6
chr2	24337678	24346347	PFN4	8669	-	NM_199346	24338452	24345405	5
chr2	24397911	24414567	FAM228A	16656	+	NM_001040710	24398349	24413500	6
chr2	24425734	24583397	ITSN2	157663	-	NM_006277	24426494	24550951	40
chr2	24807345	24993570	NCOA1	186225	+	NM_147223	24881546	24990992	22
chr2	25013135	25016251	PTRHD1	3116	-	NM_001013663	25013279	25016246	2
chr2	25016174	25045245	CENPO	29071	+	NM_001199803	25016342	25040675	7
chr2	25042038	25142055	ADCY3	100017	-	NM_004036	25042800	25141856	21
chr2	25166504	25194963	DNAJC27	28459	-	NM_016544	25170484	25194773	7
chr2	25194980	25262563	DNAJC27-AS1	67583	+	NR_034113	25262563	25262563	3
chr2	25264972	25382004	EFR3B	117032	+	NM_014971	25265181	25377209	23
chr2	25383721	25391559	POMC	7838	-	NM_001035256	25383949	25387641	4
chr2	25427181	25432071	LINC01381	4890	+	NR_132378	25432071	25432071	2
chr2	25455829	25565459	DNMT3A	109630	-	NM_175629	25457147	25536853	23
chr2	25551508	25551590	MIR1301	82	-	NR_031570	25551590	25551590	1
chr2	25600111	25896516	DTNB	296405	-	NM_021907	25602187	25875529	21
chr2	25962252	26101312	ASXL2	139060	-	NM_018263	25964897	26101091	12
chr2	26149454	26205443	KIF3C	55989	-	NM_002254	26151846	26204786	8
chr2	26256728	26360323	RAB10	103595	+	NM_016131	26257477	26357890	6
chr2	26395959	26412532	GAREM2	16573	+	NM_001168241	26396089	26411126	6
chr2	26413503	26467594	HADHA	54091	-	NM_000182	26414118	26467464	20
chr2	26467615	26513333	HADHB	45718	+	NM_001281513	26483888	26512821	17
chr2	26531040	26569685	ADGRF3	38645	-	NM_153835	26531953	26569102	12
chr2	26568953	26618759	EPT1	49806	+	NM_033505	26569100	26611971	10
chr2	26624779	26679579	DRC1	54800	+	NM_145038	26624857	26679385	17
chr2	26680070	26781566	OTOF	101496	-	NM_194248	26682892	26781439	47
chr2	26785480	26802395	C2orf70	16915	+	NM_001105519	26785480	26802306	4
chr2	26804072	26864211	CIB4	60139	-	NM_001029881	26804230	26864182	7
chr2	26915580	26954066	KCNK3	38486	+	NM_002246	26915743	26951436	2
chr2	26987141	27004099	SLC35F6	16958	+	NM_017877	26987217	27001379	6
chr2	27008881	27017455	CENPA	8574	+	NM_001809	27009064	27016147	5
chr2	27070968	27173219	DPYSL5	102251	+	NM_020134	27121367	27169863	13
chr2	27193238	27250087	MAPRE3	56849	+	NM_012326	27245086	27249216	7
chr2	27255773	27264565	TMEM214	8792	+	NM_017727	27255883	27263705	17
chr2	27272550	27273132	AGBL5-AS1	582	-	NR_046730	27273132	27273132	2
chr2	27274490	27293490	AGBL5	19000	+	NR_104246	27293490	27293490	16
chr2	27293341	27294567	OST4	1226	-	NM_001134693	27294216	27294330	3
chr2	27301434	27309265	EMILIN1	7831	+	NM_007046	27301933	27308883	8
chr2	27309610	27323619	KHK	14009	+	NM_000221	27310127	27322618	8
chr2	27322220	27341995	CGREF1	19775	-	NM_001166240	27322651	27327234	6
chr2	27346656	27353680	ABHD1	7024	+	NM_032604	27346816	27353612	9
chr2	27353624	27357542	PREB	3918	-	NM_013388	27354281	27357289	9
chr2	27359714	27362332	PRR30	2618	-	NM_178553	27359958	27361197	3
chr2	27371944	27375819	TCF23	3875	+	NM_175769	27372001	27375735	3
chr2	27422454	27435175	SLC5A6	12721	-	NM_021095	27423303	27430518	17
chr2	27434898	27440046	ATRAID	5148	+	NM_080592	27435071	27439816	7
chr2	27440257	27466660	CAD	26403	+	NM_004341	27440419	27466386	44
chr2	27477439	27485960	SLC30A3	8521	-	NM_003459	27478179	27485774	8
chr2	27498288	27504298	DNAJC5G	6010	+	NM_173650	27499596	27503083	7
chr2	27505296	27530307	TRIM54	25011	+	NM_032546	27505599	27529409	10
chr2	27530264	27531130	UCN	866	-	NM_003353	27530388	27530763	2
chr2	27532359	27545969	MPV17	13610	-	NM_002437	27532779	27545384	8
chr2	27548715	27579901	GTF3C2	31186	-	NM_001521	27549541	27566421	20
chr2	27558408	27560670	GTF3C2-AS1	2262	+	NR_038427	27560670	27560670	4
chr2	27587218	27593324	EIF2B4	6106	-	NM_015636	27587266	27593181	13
chr2	27593362	27600400	SNX17	7038	+	NR_049783	27600400	27600400	16
chr2	27600097	27603611	ZNF513	3514	-	NM_144631	27600411	27603393	4
chr2	27604065	27632550	PPM1G	28485	-	NM_177983	27604465	27632289	10
chr2	27615489	27616443	FTH1P3	954	-	NR_002201	27616443	27616443	1
chr2	27651472	27665124	NRBP1	13652	+	NM_013392	27656140	27664679	18
chr2	27665232	27669348	KRTCAP3	4116	+	NM_001168364	27665279	27666923	7
chr2	27667239	27712678	IFT172	45439	-	NM_015662	27667298	27712520	48
chr2	27714749	27718126	FNDC4	3377	-	NM_022823	27715309	27717546	7
chr2	27719705	27746550	GCKR	26845	+	NM_001486	27719771	27746306	19
chr2	27799388	27805589	C2orf16	6201	+	NM_032266	27799439	27805394	1
chr2	27805835	27846082	ZNF512	40247	+	NM_001271318	27821075	27844328	15
chr2	27848505	27851898	CCDC121	3393	-	NM_024584	27849829	27850666	2
chr2	27851514	27873713	GPN1	22199	+	NM_001145047	27851574	27873067	15
chr2	27873675	27886707	SUPT7L	13032	-	NM_014860	27876351	27885059	6
chr2	27886337	27917847	SLC4A1AP	31510	+	NM_018158	27886619	27917550	14
chr2	27994583	28002608	MRPL33	8025	+	NM_004891	27994644	28002349	4
chr2	28004230	28113263	RBKS	109033	-	NM_001287580	28004481	28081326	9
chr2	28112322	28113981	BRE-AS1	1659	-	NR_028308	28113981	28113981	1
chr2	28113481	28561767	BRE	448286	+	NM_199193	28117423	28532991	14
chr2	28219233	28219316	MIR4263	83	+	NR_036230	28219316	28219316	1
chr2	28371423	28429828	LOC100505736	58405	-	NR_120504	28429828	28429828	3
chr2	28530557	28533326	LOC100505716	2769	-	NR_038319	28533326	28533326	3
chr2	28607275	28617539	FLJ31356	10264	-	NR_103831	28617539	28617539	2
chr2	28615778	28637516	FOSL2	21738	+	NM_005253	28616587	28635315	4
chr2	28718937	28866653	PLB1	147716	+	NM_153021	28718981	28865927	58
chr2	28974613	29025806	PPP1CB	51193	+	NM_206876	28974990	29022169	9
chr2	29033699	29073475	SPDYA	39776	+	NM_182756	29038880	29072807	8
chr2	29072687	29093175	TRMT61B	20488	-	NM_017910	29073064	29093143	7
chr2	29117508	29171086	WDR43	53578	+	NM_015131	29117564	29169645	18
chr2	29136527	29136616	SNORD92	89	+	NR_003074	29136616	29136616	1
chr2	29149932	29150008	SNORD53	76	+	NR_002741	29150008	29150008	1
chr2	29204163	29275096	FAM179A	70933	+	NM_199280	29217700	29274959	20
chr2	29284555	29297127	C2orf71	12572	-	NM_001029883	29287734	29297127	2
chr2	29320541	29397581	CLIP4	77040	+	NM_001287528	29344254	29397315	15
chr2	29415639	30144477	ALK	728838	-	NM_004304	29416089	30143525	29
chr2	30369749	30383399	YPEL5	13650	+	NM_001127401	30379517	30381709	5
chr2	30454396	30482899	LBH	28503	+	NM_030915	30454604	30480487	3
chr2	30569511	30573024	LOC285043	3513	+	NR_122048	30573024	30573024	2
chr2	30670091	30867091	LCLAT1	197000	+	NM_001304445	30748456	30863485	8
chr2	30945637	31030311	CAPN13	84674	-	NM_144575	30953625	31010191	23
chr2	31133330	31361592	GALNT14	228262	-	NR_045602	31361592	31361592	16
chr2	31395921	31440411	CAPN14	44490	-	NM_001145122	31397546	31428313	22
chr2	31456879	31491260	EHD3	34381	+	NM_014600	31457487	31489570	6
chr2	31557187	31637611	XDH	80424	-	NM_000379	31558823	31637532	36
chr2	31749655	31806040	SRD5A2	56385	-	NM_000348	31751265	31805969	5
chr2	32092878	32236121	MEMO1	143243	-	NM_001301833	32093429	32235316	10
chr2	32248971	32264844	DPY30	15873	-	NM_032574	32249252	32264525	5
chr2	32288679	32382706	SPAST	94027	+	NM_014946	32288900	32379565	17
chr2	32390909	32449181	SLC30A6	58272	+	NM_001193513	32390969	32445782	15
chr2	32449517	32490812	NLRC4	41295	-	NM_021209	32449541	32481844	9
chr2	32502957	32531658	YIPF4	28701	+	NM_032312	32503224	32530695	6
chr2	32582095	32843965	BIRC6	261870	+	NM_016252	32582229	32842971	74
chr2	32757219	32757313	MIR558	94	+	NR_030285	32757313	32757313	1
chr2	32782587	32799885	BIRC6-AS2	17298	-	NR_125793	32799885	32799885	2
chr2	32853086	33046118	TTC27	193032	+	NM_017735	32853359	33046005	20
chr2	32860321	32860398	MIR4765	77	+	NR_039922	32860398	32860398	1
chr2	33050509	33154206	LINC00486	103697	+	NR_027098	33154206	33154206	6
chr2	33152193	33171202	LOC100271832	19009	+	NR_027097	33171202	33171202	4
chr2	33172368	33624575	LTBP1	452207	+	NM_206943	33172391	33623612	34
chr2	33643582	33643631	MIR4430	49	+	NR_039628	33643631	33643631	1
chr2	33661415	33789798	RASGRP3	128383	+	NM_170672	33740203	33787804	19
chr2	33808727	33824429	FAM98A	15702	-	NM_015475	33809842	33824288	8
chr2	33931952	34522813	LINC01317	590861	+	NR_126403	34522813	34522813	6
chr2	33951127	33953284	MYADML	2157	-	NR_003143	33953284	33953284	1
chr2	34292292	34294617	LINC01318	2325	+	NR_132381	34294617	34294617	3
chr2	34902623	34947630	LINC01320	45007	+	NR_126404	34947630	34947630	3
chr2	36581891	36582713	LOC100288911	822	-	NR_037631	36582713	36582713	2
chr2	36583369	36778278	CRIM1	194909	+	NM_016441	36583435	36775844	17
chr2	36779403	36825332	FEZ2	45929	-	NM_001042548	36780305	36825285	9
chr2	36923832	37041937	VIT	118105	+	NM_053276	36943513	37041504	16
chr2	37064840	37193615	STRN	128775	-	NM_003162	37076598	37193606	18
chr2	37208143	37311488	HEATR5B	103345	-	NM_019024	37208632	37310557	36
chr2	37311593	37326387	GPATCH11	14794	+	NM_174931	37311660	37323406	9
chr2	37332283	37384190	EIF2AK2	51907	-	NM_001135651	37334415	37374949	17
chr2	37394962	37415690	SULT6B1	20728	-	NM_001032377	37395077	37415669	7
chr2	37423634	37431886	CEBPZOS	8252	+	NR_037879	37431886	37431886	6
chr2	37428774	37458740	CEBPZ	29966	-	NM_005760	37428906	37458710	16
chr2	37458773	37476303	NDUFAF7	17530	+	NM_144736	37458848	37475493	10
chr2	37477645	37544222	PRKD3	66577	-	NM_005813	37480319	37543667	18
chr2	37571752	37600465	QPCT	28713	+	NM_012413	37571874	37599970	7
chr2	37869024	37899678	CDC42EP3	30654	-	NM_001270436	37872965	37873730	2
chr2	38053389	38103006	LINC00211	49617	-	NR_110012	38103006	38103006	4
chr2	38177476	38263484	RMDN2-AS1	86008	-	NR_102712	38263484	38263484	4
chr2	38177586	38294285	RMDN2	116699	+	NM_144713	38177721	38294133	11
chr2	38294745	38303323	CYP1B1	8578	-	NM_000104	38297864	38302531	3
chr2	38358246	38408993	CYP1B1-AS1	50747	+	NR_027252	38408993	38408993	3
chr2	38521098	38604432	ATL2	83334	-	NM_001135673	38523135	38604402	13
chr2	38685779	38742882	LOC101929596	57103	-	NR_110259	38742882	38742882	5
chr2	38790327	38830178	HNRNPLL	39851	-	NM_001142650	38791323	38830009	14
chr2	38893051	38961909	GALM	68858	+	NM_138801	38893303	38960707	7
chr2	38970740	38978636	SRSF7	7896	-	NM_001031684	38972274	38978398	8
chr2	39005326	39009106	GEMIN6	3780	+	NM_024775	39006132	39009034	3
chr2	39024875	39103021	DHX57	78146	-	NM_198963	39025440	39095547	24
chr2	39103102	39109850	MORN2	6748	+	NM_001145450	39108582	39109656	5
chr2	39146503	39202590	ARHGEF33	56087	+	NM_001145451	39146588	39200984	16
chr2	39186428	39187485	LOC375196	1057	-	NR_028386	39187485	39187485	1
chr2	39208689	39347604	SOS1	138915	-	NM_005633	39212964	39347563	23
chr2	39405687	39456673	CDKL4	50986	-	NM_001009565	39406306	39456673	8
chr2	39476406	39664453	MAP4K3	188047	-	NM_003618	39477758	39664128	34
chr2	39664556	39828484	LOC728730	163928	+	NR_037875	39828484	39828484	6
chr2	39892637	39945104	TMEM178A	52467	+	NM_001167959	39934220	39944391	4
chr2	39963199	40006416	THUMPD2	43217	-	NR_028102	40006416	40006416	11
chr2	40144773	40482349	SLC8A1-AS1	337576	+	NR_038441	40482349	40482349	5
chr2	40339285	40739575	SLC8A1	400290	-	NM_001112802	40342392	40657420	8
chr2	42104694	42121186	LOC388942	16492	+	NR_033996	42121186	42121186	3
chr2	42158738	42160863	LOC101929723	2125	-	NR_110262	42160863	42160863	4
chr2	42162507	42180943	C2orf91	18436	-	NM_001242815	42165742	42180435	4
chr2	42275160	42285668	PKDCC	10508	+	NM_138370	42275339	42284828	7
chr2	42369574	42397371	LOC102723824	27797	-	NR_110584	42397371	42397371	4
chr2	42396477	42559688	EML4	163211	+	NM_019063	42396751	42557347	23
chr2	42577644	42588356	COX7A2L	10712	-	NM_004718	42578358	42588301	3
chr2	42669156	42721237	KCNG3	52081	-	NM_133329	42671073	42720641	2
chr2	42721708	42984087	MTA3	262379	+	NM_001282755	42806318	42980539	18
chr2	42989638	42991401	OXER1	1763	-	NM_148962	42990047	42991319	1
chr2	42994228	43019751	HAAO	25523	-	NM_012205	42994576	43019676	10
chr2	43254991	43266682	LOC102723854	11691	-	NR_110585	43266682	43266682	6
chr2	43449540	43453745	ZFP36L2	4205	-	NM_006887	43451457	43453454	2
chr2	43454349	43455994	LINC01126	1645	+	NR_027251	43455994	43455994	1
chr2	43457974	43823185	THADA	365211	-	NM_022065	43458086	43819531	38
chr2	43864438	43995126	PLEKHH2	130688	+	NM_172069	43871812	43992737	30
chr2	43902291	43903461	C1GALT1C1L	1170	-	NM_001101330	43902513	43903461	1
chr2	44001177	44037149	DYNC2LI1	35972	+	NM_016008	44001277	44036906	13
chr2	44039610	44065958	ABCG5	26348	-	NM_022436	44040254	44065818	13
chr2	44066102	44105605	ABCG8	39503	+	NM_022437	44066192	44105052	13
chr2	44113362	44223144	LRPPRC	109782	-	NM_133259	44115738	44223086	38
chr2	44395941	44461742	PPM1B	65801	+	NM_177968	44428338	44459484	6
chr2	44502596	44547962	SLC3A1	45366	+	NM_000341	44502674	44547778	10
chr2	44544747	44589001	PREPL	44254	-	NM_001171603	44548494	44586854	15
chr2	44589042	44999731	CAMKMT	410689	+	NM_024766	44589146	44999252	11
chr2	44776629	44776659	MIR548AD	30	-	NR_039629	44776659	44776659	1
chr2	45167292	45169017	SIX3-AS1	1725	-	NR_103786	45169017	45169017	2
chr2	45169036	45173216	SIX3	4180	+	NM_005413	45169243	45171899	2
chr2	45232323	45236542	SIX2	4219	-	NM_016932	45233308	45236249	2
chr2	45401479	45482080	LINC01121	80601	-	NR_033831	45482080	45482080	6
chr2	45615818	45838433	SRBD1	222615	-	NM_018079	45616448	45832580	21
chr2	45879042	46415129	PRKCE	536087	+	NM_005400	45879239	46412020	15
chr2	46524540	46613842	EPAS1	89302	+	NM_001430	46525050	46611799	16
chr2	46656328	46668972	LOC101805491	12644	+	NR_103805	46668972	46668972	4
chr2	46706703	46711564	TMEM247	4861	+	NM_001145051	46706724	46711564	3
chr2	46738985	46747096	ATP6V1E2	8111	-	NM_080653	46739169	46739850	2
chr2	46769866	46811827	RHOQ	41961	+	NM_012249	46770185	46808222	5
chr2	46795395	46807377	LOC100506142	11982	-	NR_104182	46807377	46807377	2
chr2	46808412	46844251	PIGF	35839	-	NM_173074	46815243	46842303	7
chr2	46844310	46857315	CRIPT	13005	+	NM_014171	46844421	46851366	5
chr2	46926098	46989927	SOCS5	63829	+	NM_014011	46985669	46987280	2
chr2	47043806	47049799	LINC01118	5993	+	NR_034099	47049799	47049799	4
chr2	47055002	47086145	LINC01119	31143	+	NR_024452	47086145	47086145	3
chr2	47129008	47168994	MCFD2	39986	-	NM_001171508	47132601	47136310	4
chr2	47143267	47303275	TTC7A	160008	+	NM_001288953	47144334	47301062	21
chr2	47314129	47382517	C2orf61	68388	-	NM_001163561	47314146	47382390	7
chr2	47387220	47404075	CALM2	16855	-	NM_001305625	47387914	47389727	6
chr2	47419543	47572213	LOC101927043	152670	-	NR_110208	47572213	47572213	5
chr2	47596286	47614167	EPCAM	17881	+	NM_002354	47596644	47613752	9
chr2	47604813	47604909	MIR559	96	+	NR_030286	47604909	47604909	1
chr2	47630205	47710367	MSH2	80162	+	NM_001258281	47630528	47710088	17
chr2	47747914	47797470	KCNK12	49556	-	NM_022055	47748045	47797470	2
chr2	47754675	47756303	HCG2040054	1628	+	NR_120602	47756303	47756303	3
chr2	48010220	48034092	MSH6	23872	+	NM_000179	48010372	48033999	10
chr2	48034058	48132932	FBXO11	98874	-	NM_001190274	48035256	48132859	23
chr2	48541794	48606434	FOXN2	64640	+	NM_002158	48573353	48602582	7
chr2	48667907	48742531	PPP1R21	74624	+	NM_001135629	48668092	48741883	22
chr2	48757063	49003656	STON1-GTF2A1L	246593	+	NM_001198593	48807772	49003454	11
chr2	48757307	48825654	STON1	68347	+	NM_001198595	48807772	48822441	5
chr2	48844918	48906751	GTF2A1L	61833	+	NM_006872	48845013	48906581	9
chr2	48913912	48982880	LHCGR	68968	-	NM_000233	48914835	48982810	11
chr2	49189295	49381666	FSHR	192371	-	NM_000145	49189871	49381556	10
chr2	49286741	49286797	MIR548BA	56	+	NR_107011	49286797	49286797	1
chr2	50145642	51259674	NRXN1	1114032	-	NM_001135659	50149081	51255411	24
chr2	50923309	50923400	MIR8485	91	-	NR_130470	50923400	50923400	1
chr2	52929659	52929753	MIR4431	94	-	NR_039630	52929753	52929753	1
chr2	53897116	54014146	ASB3	117030	-	NM_016115	53897639	53992709	10
chr2	53897449	54087170	GPR75-ASB3	189721	-	NM_001164165	53897639	54087065	10
chr2	53994928	54002287	CHAC2	7359	+	NM_001008708	53995023	54001662	3
chr2	54014067	54045956	ERLEC1	31889	+	NM_015701	54014347	54045106	14
chr2	54076258	54076342	MIR3682	84	-	NR_037453	54076342	54076342	1
chr2	54080049	54087170	GPR75	7121	-	NM_006794	54080270	54081893	2
chr2	54091203	54197977	PSME4	106774	-	NM_014614	54093225	54197921	47
chr2	54342409	54532435	ACYP2	190026	+	NM_138448	54342835	54531939	4
chr2	54480314	54483409	TSPYL6	3095	-	NM_001003937	54482055	54483288	1
chr2	54558070	54588714	C2orf73	30644	+	NM_001100396	54558112	54587699	5
chr2	54683453	54898583	SPTBN1	215130	+	NM_003128	54753555	54895706	36
chr2	54756358	54756978	RPL23AP32	620	+	NR_002229	54756978	54756978	1
chr2	54952148	55199156	EML6	247008	+	NM_001039753	54952198	55197231	41
chr2	55199326	55277734	RTN4	78408	-	NM_020532	55200291	55277436	9
chr2	55399686	55459699	CLHC1	60013	-	NM_001135598	55402925	55439941	11
chr2	55459038	55462989	RPS27A	3951	+	NM_001135592	55459960	55462713	6
chr2	55461299	55461985	MIR4426	686	+	NR_039624	55461985	55461985	2
chr2	55463755	55496384	MTIF2	32629	-	NM_002453	55463783	55490994	16
chr2	55509454	55511607	PRORSD1P	2153	+	NR_027258	55511607	55511607	1
chr2	55514977	55647057	CCDC88A	132080	-	NM_001254943	55518846	55646215	34
chr2	55746730	55772216	CFAP36	25486	+	NM_001282761	55746937	55772144	11
chr2	55774427	55844860	PPP4R3B	70433	-	NM_001122964	55777046	55844421	17
chr2	55861197	55921045	PNPT1	59848	-	NM_033109	55863371	55920958	28
chr2	56093096	56151298	EFEMP1	58202	-	NM_001039348	56094207	56149575	12
chr2	56190540	56274461	MIR217HG	83921	-	NR_126406	56274461	56274461	3
chr2	56210101	56210211	MIR217	110	-	NR_029630	56210211	56210211	1
chr2	56216084	56216194	MIR216A	110	-	NR_029629	56216194	56216194	1
chr2	56227848	56227930	MIR216B	82	-	NR_030623	56227930	56227930	1
chr2	56400668	56412905	LOC100129434	12237	-	NR_125368	56412905	56412905	3
chr2	56411257	56613309	CCDC85A	202052	+	NM_001080433	56411759	56611490	6
chr2	58134785	58387055	VRK2	252270	+	NM_001288838	58275966	58381897	16
chr2	58386377	58468515	FANCL	82138	-	NM_001114636	58386899	58468448	14
chr2	58747887	59290901	LINC01122	543014	+	NR_033873	59290901	59290901	14
chr2	59444842	59506535	LOC101927285	61693	+	NR_110219	59506535	59506535	3
chr2	60586350	60618510	MIR4432HG	32160	-	NR_132992	60618510	60618510	2
chr2	60614496	60614580	MIR4432	84	-	NR_039631	60614580	60614580	1
chr2	60678301	60780633	BCL11A	102332	-	NM_138559	60679699	60780405	5
chr2	60983364	61029221	PAPOLG	45857	+	NM_022894	60983613	61024295	22
chr2	61074894	61108449	LINC01185	33555	-	NR_033980	61108449	61108449	3
chr2	61108629	61155291	REL	46662	+	NM_002908	61108975	61149670	11
chr2	61167547	61245365	PUS10	77818	-	NM_144709	61169529	61239025	18
chr2	61244811	61279125	PEX13	34314	+	NM_002618	61244894	61275905	4
chr2	61293362	61365169	KIAA1841	71807	+	NM_032506	61297485	61361367	22
chr2	61368726	61372110	LOC339803	3384	-	NR_036496	61372110	61372110	2
chr2	61372202	61391964	C2orf74	19762	+	NM_001143960	61390193	61391662	4
chr2	61404554	61414686	AHSA2	10132	+	NM_152392	61411860	61413921	6
chr2	61414589	61697849	USP34	283260	-	NM_014709	61415236	61697827	80
chr2	61644378	61644512	SNORA70B	134	-	NR_003707	61644512	61644512	1
chr2	61705068	61765418	XPO1	60350	-	NM_003400	61705954	61761032	25
chr2	62051982	62081278	FAM161A	29296	-	NM_001201543	62053589	62081176	7
chr2	62095261	62115806	CCT4	20545	-	NM_006430	62095826	62115642	14
chr2	62132802	62363205	COMMD1	230403	+	NM_152516	62132813	62363076	3
chr2	62423261	62451866	B3GNT2	28605	+	NM_006577	62449355	62450549	2
chr2	62432960	62433052	MIR5192	92	+	NR_049824	62433052	62433052	1
chr2	62727355	62733604	TMEM17	6249	-	NM_198276	62728343	62733264	4
chr2	62900985	63273621	EHBP1	372636	+	NM_001142615	62934326	63272635	23
chr2	63271099	63275656	LOC100132215	4557	-	NR_033389	63275656	63275656	4
chr2	63277191	63284966	OTX1	7775	+	NM_001199770	63280125	63283451	5
chr2	63344985	63346677	DBIL5P2	1692	-	NR_036635	63346677	63346677	1
chr2	63348534	63815867	WDPCP	467333	-	NM_015910	63349140	63815405	18
chr2	63815742	63834330	MDH1	18588	+	NM_005917	63816177	63834121	9
chr2	64068097	64118696	UGP2	50599	+	NM_001001521	64083453	64118361	10
chr2	64119666	64246214	VPS54	126548	-	NM_016516	64120563	64211133	23
chr2	64319785	64371605	PELI1	51820	-	NM_020651	64321835	64335444	7
chr2	64412212	64432619	LINC00309	20407	-	NR_033837	64432619	64432619	6
chr2	64455534	64479665	LOC100507006	24131	+	NR_120420	64479665	64479665	5
chr2	64567880	64567982	MIR4433B	102	-	NR_106995	64567982	64567982	1
chr2	64567892	64567973	MIR4433A	81	+	NR_039632	64567973	64567973	1
chr2	64681326	64688517	LGALSL	7191	+	NM_014181	64681679	64685562	5
chr2	64751438	64820138	AFTPH	68700	+	NM_203437	64778608	64819169	10
chr2	64752646	64752699	MIR4434	53	+	NR_039633	64752699	64752699	1
chr2	64834445	64843616	LOC339807	9171	+	NR_034023	64843616	64843616	4
chr2	64858754	64881046	SERTAD2	22292	-	NM_014755	64863060	64864005	2
chr2	65073263	65090765	LOC101927438	17502	-	NR_110224	65090765	65090765	5
chr2	65128973	65159581	LOC400958	30608	-	NR_036586	65159581	65159581	3
chr2	65215578	65251000	SLC1A4	35422	+	NM_001193493	65237757	65248280	7
chr2	65283494	65314142	CEP68	30648	+	NM_015147	65296578	65309839	7
chr2	65313987	65357435	RAB1A	43448	-	NM_004161	65315626	65357049	6
chr2	65454828	65498390	ACTR2	43562	+	NM_001005386	65455043	65495868	10
chr2	65537984	65659656	SPRED2	121672	-	NM_181784	65540634	65659121	6
chr2	66585380	66585460	MIR4778	80	-	NR_039938	66585460	66585460	1
chr2	66610437	66619578	LOC729348	9141	+	NR_130931	66619578	66619578	3
chr2	66650474	66660602	MEIS1-AS3	10128	-	NR_046438	66660602	66660602	4
chr2	66662531	66799891	MEIS1	137360	+	NM_002398	66662988	66796240	13
chr2	66666226	66667462	MEIS1-AS2	1236	-	NR_046625	66667462	66667462	2
chr2	66801161	66922720	LOC100507073	121559	+	NR_110156	66922720	66922720	6
chr2	66924161	66930359	LOC101927577	6198	-	NR_110265	66930359	66930359	3
chr2	67131567	67198598	LOC101060019	67031	+	NR_110169	67198598	67198598	5
chr2	67148642	67149622	LINC01628	980	-	NR_110600	67149622	67149622	3
chr2	67313577	67516376	LOC102800447	202799	+	NR_110564	67516376	67516376	5
chr2	67350488	67442451	LOC644838	91963	-	NR_038844	67442451	67442451	8
chr2	67440539	67471706	LOC101927661	31167	+	NR_110568	67471706	67471706	4
chr2	67624441	67637533	ETAA1	13092	+	NM_019002	67624580	67637170	6
chr2	68023185	68052694	LOC101927701	29509	-	NR_110271	68052694	68052694	3
chr2	68269331	68290159	C1D	20828	-	NM_001190265	68270020	68274442	6
chr2	68357280	68384692	WDR92	27412	-	NM_138458	68358369	68384575	8
chr2	68385004	68403094	PNO1	18090	+	NM_020143	68385066	68401934	7
chr2	68405988	68479651	PPP3R1	73663	-	NM_000945	68408094	68479259	6
chr2	68511302	68547183	CNRIP1	35881	-	NM_001111101	68511559	68546532	3
chr2	68592321	68624585	PLEK	32264	+	NM_002664	68592483	68622948	9
chr2	68689504	68694449	FBXO48	4945	-	NM_001024680	68691340	68692277	4
chr2	68694690	68807294	APLF	112604	+	NM_173545	68694863	68805154	10
chr2	68872953	68882708	PROKR1	9755	+	NM_138964	68872953	68882708	2
chr2	68961912	69053957	ARHGAP25	92045	+	NM_001007231	68962331	69053326	11
chr2	69092612	69098649	BMP10	6037	-	NM_014482	69092762	69098490	2
chr2	69172363	69180102	GKN2	7739	-	NM_182536	69172499	69179993	6
chr2	69201704	69208112	GKN1	6408	+	NM_019617	69201767	69207955	6
chr2	69240275	69476459	ANTXR1	236184	+	NM_032208	69240631	69472617	18
chr2	69330813	69330887	MIR3126	74	+	NR_036073	69330887	69330887	1
chr2	69546900	69614386	GFPT1	67486	-	NM_001244710	69553320	69614203	20
chr2	69623244	69664760	NFU1	41516	-	NM_015700	69623377	69659127	8
chr2	69685126	69870977	AAK1	185851	-	NM_014911	69703000	69870172	22
chr2	69747176	69747303	SNORA36C	127	-	NR_003705	69747303	69747303	1
chr2	69969126	70053596	ANXA4	84470	+	NM_001153	70008697	70052647	13
chr2	70056817	70106727	GMCL1	49910	+	NM_178439	70057024	70106136	14
chr2	70121074	70132368	SNRNP27	11294	+	NR_037862	70132368	70132368	7
chr2	70142172	70170076	MXD1	27904	+	NM_001202513	70142462	70165416	6
chr2	70187223	70189397	ASPRV1	2174	-	NM_152792	70187788	70188820	1
chr2	70189394	70314147	PCBP1-AS1	124753	-	NR_033872	70314147	70314147	11
chr2	70314584	70316334	PCBP1	1750	+	NM_006196	70314875	70315946	1
chr2	70351167	70352448	LOC100133985	1281	-	NR_024444	70352448	70352448	2
chr2	70377016	70418151	C2orf42	41135	-	NM_017880	70377487	70409117	10
chr2	70436575	70475779	TIA1	39204	-	NM_022173	70439850	70475562	13
chr2	70485230	70508317	PCYOX1	23087	+	NM_016297	70485296	70504524	6
chr2	70508493	70520903	SNRPG	12410	-	NM_001317165	70508812	70520781	5
chr2	70523107	70529220	FAM136A	6113	-	NM_032822	70524420	70529143	3
chr2	70674411	70781147	TGFA	106736	-	NM_001099691	70677990	70780899	6
chr2	70694516	70708772	TGFA-IT1	14256	-	NR_046798	70708772	70708772	3
chr2	70889215	70995375	ADD2	106160	-	NM_017488	70900033	70933540	17
chr2	71004441	71017775	FIGLA	13334	-	NM_001004311	71004498	71017770	5
chr2	71035775	71047732	CLEC4F	11957	-	NM_001258027	71036325	71047655	7
chr2	71057342	71062953	CD207	5611	-	NM_015717	71058180	71062906	6
chr2	71115000	71117114	LINC01143	2114	+	NR_126384	71117114	71117114	4
chr2	71127719	71160575	VAX2	32856	+	NM_012476	71127751	71160334	3
chr2	71162997	71192561	ATP6V1B1	29564	+	NM_001692	71163084	71192251	14
chr2	71169142	71175741	ATP6V1B1-AS1	6599	-	NR_110273	71175741	71175741	3
chr2	71205574	71212629	ANKRD53	7055	+	NM_024933	71205775	71211742	7
chr2	71213067	71222001	TEX261	8934	-	NM_144582	71215729	71221887	6
chr2	71251204	71257060	OR7E91P	5856	+	NR_002185	71257060	71257060	3
chr2	71295407	71305998	NAGK	10591	+	NM_017567	71295675	71305638	10
chr2	71336805	71357394	MCEE	20589	-	NM_032601	71337099	71357349	3
chr2	71357443	71377232	MPHOSPH10	19789	+	NM_005791	71357795	71377145	11
chr2	71409867	71454233	PAIP2B	44366	-	NM_020459	71415608	71429719	4
chr2	71558884	71662191	ZNF638	103307	+	NM_001252613	71576084	71661937	28
chr2	71680752	71913893	DYSF	233141	+	NM_001130981	71681128	71913622	56
chr2	72356366	72374991	CYP26B1	18625	-	NM_019885	72359355	72374963	6
chr2	72406443	73053177	EXOC6B	646734	-	NM_015189	72406463	73053039	22
chr2	73114511	73119289	SPR	4778	+	NM_003124	73114561	73118666	3
chr2	73144603	73162020	EMX1	17417	+	NM_004097	73144981	73161083	3
chr2	73169164	73298965	SFXN5	129801	-	NM_144579	73172150	73298834	14
chr2	73300509	73340146	RAB11FIP5	39637	-	NM_015470	73302648	73339905	5
chr2	73429385	73438340	NOTO	8955	+	NM_001134462	73429794	73438057	3
chr2	73441365	73454355	SMYD5	12990	+	NM_006062	73441394	73453074	13
chr2	73455133	73460356	PRADC1	5223	-	NM_032319	73455581	73460288	5
chr2	73461363	73480150	CCT7	18787	+	NM_001166285	73466896	73479989	13
chr2	73481809	73496758	FBXO41	14949	-	NM_001080410	73486109	73496758	12
chr2	73518056	73520829	EGR4	2773	-	NM_001965	73518584	73520754	2
chr2	73612885	73837046	ALMS1	224161	+	NM_015120	73612996	73836739	23
chr2	73684229	73686604	ALMS1-IT1	2375	+	NR_046762	73686604	73686604	2
chr2	73867849	73869537	NAT8	1688	-	NM_003960	73868071	73868755	2
chr2	73872045	73912694	ALMS1P1	40649	+	NR_003683	73912694	73912694	7
chr2	73927635	73928467	NAT8B	832	-	NR_132338	73928467	73928467	1
chr2	73956956	73964517	TPRKB	7561	-	NM_016058	73957069	73961696	5
chr2	73989324	74007284	DUSP11	17960	-	NM_003584	73989787	74007242	9
chr2	74011315	74044274	C2orf78	32959	+	NM_001080474	74011436	74044119	3
chr2	74056042	74094295	STAMBP	38253	+	NM_201647	74057983	74089386	10
chr2	74120092	74146780	ACTG2	26688	+	NM_001615	74128438	74146702	9
chr2	74153952	74186088	DGUOK	32136	+	NM_080916	74154037	74185863	7
chr2	74185094	74208566	DGUOK-AS1	23472	-	NR_104029	74208566	74208566	2
chr2	74213530	74335302	TET3	121772	+	NM_001287491	74213530	74329303	11
chr2	74362527	74375039	BOLA3	12512	-	NM_212552	74362719	74375001	4
chr2	74375107	74379516	BOLA3-AS1	4409	+	NR_045636	74379516	74379516	3
chr2	74379724	74406094	MOB1A	26370	-	NM_001317110	74383694	74405801	6
chr2	74425689	74442424	MTHFD2	16735	+	NR_027405	74442424	74442424	9
chr2	74443368	74570534	SLC4A5	127166	-	NM_133478	74448593	74542150	31
chr2	74588280	74619214	DCTN1	30934	-	NM_001190836	74588625	74605354	28
chr2	74612844	74621008	DCTN1-AS1	8164	+	NR_024463	74621008	74621008	4
chr2	74641302	74648757	C2orf81	7455	-	NM_001316764	74641455	74648687	3
chr2	74648884	74652882	WDR54	3998	+	NM_032118	74649280	74652828	10
chr2	74652987	74669060	RTKN	16073	-	NM_001015055	74653369	74668943	12
chr2	74682149	74685087	INO80B	2938	+	NM_031288	74682243	74684991	5
chr2	74682149	74688018	INO80B-WBP1	5869	+	NR_037849	74688018	74688018	8
chr2	74685526	74688018	WBP1	2492	+	NM_012477	74685729	74687808	4
chr2	74688183	74692537	MOGS	4354	-	NM_001146158	74688401	74692056	5
chr2	74699084	74699942	MRPL53	858	-	NM_053050	74699245	74699787	3
chr2	74699958	74710357	CCDC142	10399	-	NM_032779	74701672	74709964	9
chr2	74710199	74721691	TTC31	11492	+	NM_022492	74710222	74720345	13
chr2	74724643	74730443	LBX2	5800	-	NM_001009812	74725053	74729986	2
chr2	74729743	74732192	LBX2-AS1	2449	+	NR_024606	74732192	74732192	1
chr2	74732169	74734821	PCGF1	2652	-	NM_032673	74732269	74734795	9
chr2	74741595	74744275	TLX2	2680	+	NM_016170	74741933	74743316	3
chr2	74745257	74753408	DQX1	8151	-	NM_133637	74745572	74752856	12
chr2	74753774	74757024	AUP1	3250	-	NM_181575	74753926	74756756	12
chr2	74756531	74760683	HTRA2	4152	+	NM_013247	74757133	74760112	8
chr2	74759385	74781091	LOXL3	21706	-	NM_032603	74760732	74779761	14
chr2	74776146	74784678	DOK1	8532	+	NM_001197260	74782758	74784241	5
chr2	74785009	74875465	M1AP	90456	-	NM_001281296	74785842	74867402	10
chr2	74881354	74910981	SEMA4F	29627	+	NM_004263	74881503	74907336	14
chr2	75059781	75120481	HK2	60700	+	NM_000189	75061707	75118068	18
chr2	75136257	75165545	LINC01291	29288	+	NR_125792	75165545	75165545	5
chr2	75185774	75196859	POLE4	11085	+	NM_019896	75185806	75196549	4
chr2	75273589	75426645	TACR1	153056	-	NM_001058	75276558	75426060	5
chr2	75317938	75318041	MIR5000	103	+	NR_049796	75318041	75318041	1
chr2	75719443	75796848	EVA1A	77405	-	NM_032181	75720361	75745266	4
chr2	75751193	75769832	LOC101927884	18639	+	NR_110281	75769832	75769832	3
chr2	75873908	75889334	MRPL19	15426	+	NM_014763	75873933	75882411	6
chr2	75889831	75938111	GCFC2	48280	-	NM_003203	75891791	75937981	17
chr2	76974849	77749502	LRRTM4	774653	-	NM_001282924	76975820	77748797	4
chr2	77213090	77236914	LOC101927907	23824	+	NR_110284	77236914	77236914	4
chr2	77970821	78517857	LOC101927967	547036	-	NR_110288	78517857	78517857	4
chr2	78143059	78145134	LOC101927926	2075	+	NR_110286	78145134	78145134	3
chr2	78182032	78182152	SNAR-H	120	-	NR_024342	78182152	78182152	1
chr2	78315855	78354932	LOC101927948	39077	+	NR_110287	78354932	78354932	6
chr2	79252811	79255630	REG3G	2819	+	NM_001008387	79253219	79255402	6
chr2	79312148	79315150	REG1B	3002	-	NM_006507	79312341	79314738	6
chr2	79347583	79350545	REG1A	2962	+	NM_002909	79347987	79350341	6
chr2	79362628	79365553	REG1CP	2925	-	NR_002714	79365553	79365553	1
chr2	79384131	79386880	REG3A	2749	-	NM_002580	79384351	79386531	6
chr2	79720841	79727970	LOC101927987	7129	-	NR_110289	79727970	79727970	5
chr2	79740059	80875988	CTNNA2	1135929	+	NM_001282597	79878682	80874997	19
chr2	79876419	79876485	MIR4264	66	-	NR_036231	79876485	79876485	1
chr2	80093620	80093709	MIR8080	89	-	NR_107047	80093709	80093709	1
chr2	80529002	80531487	LRRTM1	2485	-	NM_178839	80529375	80530944	2
chr2	81688482	81694070	LOC100507201	5588	-	NR_110161	81694070	81694070	3
chr2	83083926	83084893	LOC1720	967	+	NR_033423	83084893	83084893	1
chr2	84517805	84519324	FUNDC2P2	1519	+	NR_003663	84519324	84519324	1
chr2	84650646	84686586	SUCLG1	35940	-	NM_003849	84650869	84686393	9
chr2	84743578	85046713	DNAH6	303135	+	NM_001370	84744950	85046532	77
chr2	85048790	85108369	TRABD2A	59579	-	NM_001277053	85049040	85108163	7
chr2	85132762	85133799	TMSB10	1037	+	NM_021103	85133141	85133547	3
chr2	85198230	85286595	KCMF1	88365	+	NM_020122	85198574	85280532	7
chr2	85360582	85537511	TCF7L1	176929	+	NM_031283	85360807	85536585	12
chr2	85545140	85555419	TGOLN2	10279	-	NM_001206844	85549858	85555085	5
chr2	85569077	85581821	RETSAT	12744	-	NM_017750	85570364	85581630	11
chr2	85581842	85618875	ELMOD3	37033	+	NM_001135021	85584321	85618085	15
chr2	85621870	85641197	CAPG	19327	-	NM_001256139	85622015	85629268	10
chr2	85646053	85664152	SH2D6	18099	+	NM_201594	85661193	85663705	21
chr2	85764589	85766009	PARTICL	1420	-	NR_038942	85766009	85766009	1
chr2	85766100	85772403	MAT2A	6303	+	NM_005911	85766410	85770895	9
chr2	85771842	85788657	GGCX	16815	-	NM_000821	85777056	85788551	15
chr2	85804613	85809156	VAMP8	4543	+	NM_003761	85804769	85808839	3
chr2	85811530	85820511	VAMP5	8981	+	NM_006634	85811613	85820280	3
chr2	85822836	85824831	RNF181	1995	+	NM_016494	85822886	85824627	5
chr2	85825669	85829822	TMEM150A	4153	-	NM_001031738	85826198	85829071	8
chr2	85829964	85876407	USP39	46443	+	NR_046347	85876407	85876407	13
chr2	85832375	85839179	C2orf68	6804	-	NM_001013649	85836067	85839107	4
chr2	85884439	85895864	SFTPB	11425	-	NM_000542	85888595	85895342	12
chr2	85921413	85925974	GNLY	4561	+	NM_012483	85922112	85925697	6
chr2	85980908	86018506	ATOH8	37598	+	NM_032827	85981312	86014013	3
chr2	86010722	86010800	MIR6071	78	-	NR_106719	86010800	86010800	1
chr2	86042252	86053911	LOC284950	11659	+	NR_038888	86053911	86053911	3
chr2	86066270	86116157	ST3GAL5	49887	-	NM_003896	86067266	86116028	7
chr2	86116402	86119375	ST3GAL5-AS1	2973	+	NR_110569	86119375	86119375	3
chr2	86247338	86250991	LOC90784	3653	-	NR_026984	86250991	86250991	1
chr2	86253450	86333278	POLR1A	79828	-	NM_015425	86254545	86332899	34
chr2	86333304	86369280	PTCD3	35976	+	NM_017952	86333370	86364682	24
chr2	86362992	86363129	SNORD94	137	+	NR_004378	86363129	86363129	1
chr2	86371054	86422893	IMMT	51839	-	NM_001100170	86371390	86422505	15
chr2	86420148	86420231	MIR4779	83	-	NR_039939	86420231	86420231	1
chr2	86426555	86440477	MRPL35	13922	+	NM_145644	86426613	86439549	5
chr2	86441119	86565206	REEP1	124087	-	NM_001164730	86444222	86565199	7
chr2	86668270	86719839	KDM3A	51569	+	NM_018433	86669170	86719242	26
chr2	86730552	86790620	CHMP3	60068	-	NM_001193517	86732926	86790471	6
chr2	86730552	86948245	RNF103-CHMP3	217693	-	NM_001198954	86732926	86847584	8
chr2	86830515	86851000	RNF103	20485	-	NM_001198951	86830965	86850985	5
chr2	86947413	87005164	RMND5A	57751	+	NM_022780	86947790	87000534	9
chr2	87011727	87035519	CD8A	23792	-	NM_001145873	87013042	87017948	9
chr2	87042459	87089047	CD8B	46588	-	NM_172101	87049451	87088988	7
chr2	87088947	87122165	ANAPC1P1	33218	+	NR_037931	87122165	87122165	15
chr2	87140934	87239861	RGPD2	98927	+	NM_001078170	87140972	87239670	23
chr2	87257797	87303536	LOC285074	45739	-	NR_026846	87303536	87303536	11
chr2	87421908	87421982	MIR4771-1	74	+	NR_039928	87421982	87421982	1
chr2	87421908	87421982	MIR4771-2	74	+	NR_039929	87421982	87421982	1
chr2	87754973	87821030	LINC00152	66057	+	NR_024204	87821030	87821030	4
chr2	87929273	87929353	MIR4435-1	80	+	NR_039634	87929353	87929353	1
chr2	87929278	87929352	MIR4435-2	74	+	NR_039636	87929352	87929352	1
chr2	88047605	88058994	PLGLB2	11389	+	NM_002665	88047672	88053152	4
chr2	88047609	88058994	PLGLB1	11385	+	NM_001032392	88047672	88053152	4
chr2	88055478	88285309	RGPD1	229831	-	NM_001024457	88056910	88285293	23
chr2	88326721	88355320	KRCC1	28599	-	NM_016618	88327302	88328082	4
chr2	88367298	88412902	SMYD1	45604	+	NM_198274	88367383	88410031	10
chr2	88382037	88382118	MIR4780	81	-	NR_039940	88382118	88382118	1
chr2	88422507	88427650	FABP1	5143	-	NM_001443	88422572	88427536	4
chr2	88469813	88486156	THNSL2	16343	+	NM_001244676	88472669	88485210	9
chr2	88747725	88752053	FOXI3	4328	-	NM_001135649	88747725	88752053	2
chr2	88824168	88829103	TEX37	4935	+	NM_152670	88825162	88828992	4
chr2	88838237	88875128	LOC101928371	36891	+	NR_110236	88875128	88875128	3
chr2	88856257	88927094	EIF2AK3	70837	-	NM_004836	88857253	88926792	17
chr2	88991175	89050452	RPIA	59277	+	NM_144563	88991216	89049595	9
chr2	89065418	89106109	ANKRD36BP2	40691	+	NR_015424	89106109	89106109	17
chr2	89111883	89111968	MIR4436A	85	+	NR_039635	89111968	89111968	1
chr2	91824708	91847975	LOC654342	23267	-	NR_027238	91847975	91847975	4
chr2	91963367	91970153	GGT8P	6786	+	NR_003503	91970153	91970153	2
chr2	92129158	92130496	ACTR3BP2	1338	+	NR_027714	92130496	92130496	1
chr2	95421070	95426929	FAM95A	5859	-	NR_038409	95426929	95426929	3
chr2	95426672	95522820	ANKRD20A8P	96148	-	NR_003366	95522820	95522820	24
chr2	95534429	95613087	LOC442028	78658	-	NR_037597	95613087	95613087	10
chr2	95537177	95542574	TEKT4	5397	+	NM_144705	95537324	95542514	6
chr2	95691399	95719737	MAL	28338	+	NM_002371	95691537	95719200	4
chr2	95752951	95787754	MRPS5	34803	-	NM_031902	95753101	95787536	12
chr2	95810744	95825330	ZNF514	14586	-	NM_001318005	95815026	95824728	5
chr2	95831161	95850064	ZNF2	18903	+	NM_021088	95841971	95847854	5
chr2	95940200	95957055	PROM2	16855	+	NM_144707	95940333	95954744	24
chr2	95963071	96051825	KCNIP3	88754	+	NM_013434	95963186	96049797	9
chr2	96068447	96078879	FAHD2A	10432	+	NM_016044	96071306	96078705	8
chr2	96142714	96150479	TRIM43B	7765	-	NM_001164464	96142911	96148462	7
chr2	96257765	96265469	TRIM43	7704	+	NM_138800	96259771	96265321	7
chr2	96472799	96492729	LINC00342	19930	-	NR_103734	96492729	96492729	3
chr2	96515295	96658068	ANKRD36C	142773	-	NM_001310154	96516919	96657456	89
chr2	96676298	96688884	FAHD2CP	12586	+	NR_003698	96688884	96688884	4
chr2	96687693	96700727	GPAT2	13034	-	NM_207328	96687906	96698107	22
chr2	96778622	96781984	ADRA2B	3362	-	NM_000682	96780544	96781888	1
chr2	96789588	96804175	ASTL	14587	-	NM_001002036	96789588	96804175	9
chr2	96808907	96811179	DUSP2	2272	-	NM_004418	96809561	96811093	4
chr2	96850602	96874573	STARD7	23971	-	NM_020151	96852467	96874172	8
chr2	96874153	96908362	STARD7-AS1	34209	+	NR_046322	96908362	96908362	4
chr2	96915945	96931751	TMEM127	15806	-	NM_001193304	96919545	96931119	4
chr2	96931883	96939900	CIAO1	8017	+	NM_004804	96932088	96937089	7
chr2	96940073	96971307	SNRNP200	31234	-	NM_014014	96940749	96971175	45
chr2	96991061	96994091	ITPRIPL1	3030	+	NM_001008949	96991577	96994037	3
chr2	97001478	97042833	NCAPH	41355	+	NM_015341	97001567	97039089	18
chr2	97163379	97173846	NEURL3	10467	-	NR_104346	97173846	97173846	4
chr2	97202463	97218371	ARID5A	15908	+	NM_212481	97202563	97218050	7
chr2	97258891	97304116	KANSL3	45225	-	NR_047657	97304116	97304116	21
chr2	97308473	97370622	FER1L5	62149	+	NM_001293083	97308573	97370429	53
chr2	97371666	97405813	LMAN2L	34147	-	NM_001142292	97372992	97405777	9
chr2	97426638	97477628	CNNM4	50990	+	NM_020184	97426736	97475254	7
chr2	97464014	97464090	MIR3127	76	+	NR_036074	97464090	97464090	1
chr2	97481990	97501121	CNNM3	19131	+	NM_017623	97482014	97498353	8
chr2	97503650	97509758	ANKRD23	6108	-	NM_144994	97505285	97509729	9
chr2	97513723	97523756	ANKRD39	10033	-	NM_016466	97514037	97523724	4
chr2	97525472	97535735	SEMA4C	10263	-	NM_017789	97526362	97533623	15
chr2	97541618	97652301	FAM178B	110683	-	NM_001122646	97542012	97652050	17
chr2	97584842	97591574	LOC101927053	6732	+	NR_110209	97591574	97591574	3
chr2	97749322	97760582	FAHD2B	11260	-	NM_199336	97749491	97757443	8
chr2	97779232	97930257	ANKRD36	151025	+	NM_001164315	97779476	97915904	76
chr2	97944453	97957632	LOC100506076	13179	+	NR_103732	97957632	97957632	4
chr2	97949671	97957533	LOC100506123	7862	+	NR_130704	97957533	97957533	4
chr2	98121260	98206428	ANKRD36B	85168	-	NM_025190	98123504	98206148	44
chr2	98262520	98264657	COX5B	2137	+	NM_001862	98262549	98264571	4
chr2	98272401	98280561	ACTR1B	8160	-	NM_005735	98273320	98280353	11
chr2	98286205	98319529	LINC01125	33324	+	NR_038386	98319529	98319529	10
chr2	98330030	98356323	ZAP70	26293	+	NM_001079	98340499	98355961	14
chr2	98372800	98612354	TMEM131	239554	-	NM_015348	98373561	98612125	41
chr2	98703594	98929410	VWA3B	225816	+	NM_144992	98709555	98928812	28
chr2	98962617	99015064	CNGA3	52447	+	NM_001298	98986438	99013718	8
chr2	99061320	99207496	INPP4A	146176	+	NM_004027	99136511	99204071	26
chr2	99215785	99224981	COA5	9196	-	NM_001008215	99217214	99224868	3
chr2	99225041	99234977	UNC50	9936	+	NM_014044	99226222	99234767	6
chr2	99235568	99347589	MGAT4A	112021	-	NM_012214	99242028	99342795	16
chr2	99377525	99388361	LOC101927070	10836	-	NR_126337	99388361	99388361	4
chr2	99410308	99552684	KIAA1211L	142376	-	NM_207362	99410994	99463263	10
chr2	99613723	99771187	TSGA10	157464	-	NM_025244	99614659	99725902	21
chr2	99758075	99767928	C2orf15	9853	+	NM_001317992	99763930	99767297	5
chr2	99771417	99779613	LIPT1	8196	+	NM_145198	99778420	99779542	4
chr2	99785725	99797492	MITD1	11767	-	NM_138798	99785837	99797444	7
chr2	99797541	99816020	MRPL30	18479	+	NR_028356	99816020	99816020	7
chr2	99858710	99871570	LYG2	12860	-	NM_175735	99858826	99870723	6
chr2	99900700	99917639	LYG1	16939	-	NM_174898	99900855	99912133	7
chr2	99935486	99952860	TXNDC9	17374	-	NM_005783	99936144	99949673	5
chr2	99953833	100016728	EIF5B	62895	+	NM_015904	99954017	100015877	24
chr2	100016937	100106480	REV1	89543	-	NM_001037872	100017703	100081437	23
chr2	100163715	100759037	AFF3	595322	-	NM_002285	100167935	100720916	24
chr2	100824715	100867946	LINC01104	43231	+	NR_103730	100867946	100867946	3
chr2	100889752	100939195	LONRF2	49443	-	NM_198461	100900759	100938555	12
chr2	101008321	101034130	CHST10	25809	-	NM_004854	101009706	101023137	7
chr2	101086943	101099742	NMS	12799	+	NM_001011717	101086950	101099726	10
chr2	101179417	101193201	PDCL3	13784	+	NM_024065	101179529	101192958	6
chr2	101436612	101613287	NPAS2	176675	+	NM_002518	101521216	101612044	21
chr2	101589109	101593623	LOC101927142	4514	-	NR_110213	101593623	101593623	3
chr2	101618690	101636155	RPL31	17465	+	NM_001098577	101619163	101635500	5
chr2	101623689	101767846	TBC1D8	144157	-	NM_001102426	101624282	101767715	20
chr2	101869344	101886778	CNOT11	17434	+	NM_017546	101869426	101885875	7
chr2	101889397	101889511	SNORD89	114	-	NR_003070	101889511	101889511	1
chr2	101892062	101925178	RNF149	33116	-	NM_173647	101893699	101925050	7
chr2	101925911	101925996	MIR5696	85	+	NR_049881	101925996	101925996	1
chr2	101964815	102003965	CREG2	39150	-	NM_153836	101967384	102003919	4
chr2	102013822	102091165	RFX8	77343	-	NM_001145664	102014009	102083310	12
chr2	102314164	102511152	MAP4K4	196988	+	NM_001242560	102314542	102507711	31
chr2	102599926	102602007	LINC01127	2081	+	NR_103791	102602007	102602007	4
chr2	102608305	102644884	IL1R2	36579	+	NM_004633	102625037	102644854	9
chr2	102686835	102796334	IL1R1	109499	+	NM_001288706	102774184	102793219	12
chr2	102803432	102855811	IL1RL2	52379	+	NM_003854	102804327	102855701	12
chr2	102927961	102968497	IL1RL1	40536	+	NM_016232	102954724	102968381	11
chr2	102972742	103015235	IL18R1	42493	+	NM_001282399	102990450	103013346	11
chr2	103035249	103069024	IL18RAP	33775	+	NM_003853	103039737	103068641	12
chr2	103048748	103048826	MIR4772	78	+	NR_039930	103048826	103048826	1
chr2	103089761	103150431	SLC9A4	60670	+	NM_001011552	103090218	103149147	12
chr2	103236147	103327809	SLC9A2	91662	+	NM_003048	103236307	103324948	12
chr2	103333665	103353337	MFSD9	19672	-	NM_032718	103334878	103353269	6
chr2	103378489	103434138	TMEM182	55649	+	NM_144632	103378676	103431427	5
chr2	104995307	105024790	LOC100287010	29483	-	NR_037885	105024790	105024790	3
chr2	105050804	105129215	LINC01102	78411	+	NR_015399	105129215	105129215	4
chr2	105104913	105126967	LINC01103	22054	-	NR_110113	105126967	105126967	6
chr2	105363094	105374177	LINC01114	11083	-	NR_038231	105374177	105374177	4
chr2	105421882	105467934	LINC01158	46052	-	NR_037883	105467934	105467934	4
chr2	105470525	105475031	POU3F3	4506	+	NM_006236	105471968	105473471	1
chr2	105481954	105489053	LINC01159	7099	-	NR_110373	105489053	105489053	2
chr2	105552698	105654954	LOC102724691	102256	-	NR_110603	105654954	105654954	3
chr2	105654482	105716418	MRPS9	61936	+	NM_182640	105654550	105716219	11
chr2	105713509	105719402	UTAT33	5893	-	NR_110227	105719402	105719402	4
chr2	105858199	105859924	GPR45	1725	+	NM_007227	105858315	105859434	1
chr2	105880846	105946171	TGFBRAP1	65325	-	NM_001142621	105883839	105924758	12
chr2	105953815	105965271	C2orf49	11456	+	NM_001286537	105954044	105961828	5
chr2	105977282	106055230	FHL2	77948	-	NM_201557	105977739	106002973	6
chr2	106209553	106227016	LOC285000	17463	-	NR_038891	106227016	106227016	4
chr2	106361519	106510730	NCK2	149211	+	NM_003581	106471519	106509632	5
chr2	106682112	106694609	C2orf40	12497	+	NM_032411	106682220	106694382	4
chr2	106709758	106810795	UXS1	101037	-	NM_001253875	106710481	106810697	15
chr2	106998569	107007851	PLGLA	9282	+	NR_003506	107007851	107007851	4
chr2	107021135	107084801	RGPD3	63666	-	NM_001144013	107021674	107084744	23
chr2	107418055	107503563	ST6GAL2	85508	-	NM_032528	107423133	107460433	6
chr2	107766120	107965981	MIR548AU	199861	-	NR_049853	107965981	107965981	4
chr2	108370567	108438585	GACAT1	68018	+	NR_126370	108438585	108438585	5
chr2	108439519	108442583	RGPD4-AS1	3064	-	NR_024439	108442583	108442583	2
chr2	108443387	108509000	RGPD4	65613	+	NM_182588	108443469	108507187	23
chr2	108602969	108630443	SLC5A7	27474	+	NM_001305005	108604611	108627317	9
chr2	108784203	108834297	LINC01594	50094	-	NR_131251	108834297	108834297	5
chr2	108863650	108881807	SULT1C3	18157	+	NM_001008743	108863650	108881807	7
chr2	108905094	108926371	SULT1C2	21277	+	NM_176825	108910123	108924920	9
chr2	108938693	108970254	SULT1C2P1	31561	+	NR_037191	108970254	108970254	4
chr2	108994420	109004270	SULT1C4	9850	+	NM_006588	108994793	109003888	7
chr2	109065576	109125854	GCC2	60278	+	NM_181453	109065730	109124086	23
chr2	109150810	109303702	LIMS1	152892	+	NM_001193483	109151018	109300455	10
chr2	109335936	109402267	RANBP2	66331	+	NM_006267	109336062	109400357	29
chr2	109403205	109493047	CCDC138	89842	+	NM_144978	109403278	109492709	15
chr2	109510926	109605828	EDAR	94902	-	NM_022336	109513362	109547470	12
chr2	109743783	109746575	SH3RF3-AS1	2792	-	NR_029193	109746575	109746575	1
chr2	109745996	110262213	SH3RF3	516217	+	NM_001099289	109745996	110259248	10
chr2	109757945	109758044	MIR4265	99	-	NR_036223	109758044	109758044	1
chr2	109930026	109930081	MIR4266	55	-	NR_036224	109930081	109930081	1
chr2	110300373	110371783	SEPT10	71410	-	NM_144710	110301885	110371404	11
chr2	110371910	110376564	SOWAHC	4654	+	NM_023016	110372066	110373644	1
chr2	110550334	110615282	RGPD6	64948	+	NM_001123363	110552042	110613473	24
chr2	110656008	110683202	LIMS3L	27194	+	NR_038099	110683202	110683202	9
chr2	110656008	110683202	LIMS3	27194	+	NR_027467	110683202	110683202	9
chr2	110827537	110827619	MIR4267	82	-	NR_036225	110827619	110827619	1
chr2	110841446	110874143	MALL	32697	-	NM_005434	110843271	110873369	4
chr2	110844009	110844100	MIR4436B1	91	-	NR_039941	110844100	110844100	1
chr2	110844009	110844100	MIR4436B2	91	-	NR_049830	110844100	110844100	1
chr2	110880913	110962639	NPHP1	81726	-	NM_001128178	110881367	110962545	20
chr2	110969105	110980517	LINC00116	11412	-	NR_027063	110980517	110980517	8
chr2	111003214	111024135	LOC100507334	20921	+	NR_037626	111024135	111024135	4
chr2	111132685	111142113	LINC01106	9428	-	NR_027244	111142113	111142113	2
chr2	111133764	111142102	LINC01123	8338	-	NR_046110	111142102	111142102	4
chr2	111160495	111181393	LOC440895	20898	-	NR_027143	111181393	111181393	4
chr2	111160495	111181393	LOC100288570	20898	-	NR_037627	111181393	111181393	4
chr2	111160495	111230652	LIMS3-LOC440895	70157	-	NR_027145	111230652	111230652	18
chr2	111395274	111435684	BUB1	40410	-	NM_004336	111395540	111435572	25
chr2	111415726	111415826	SNORD132	100	-	NR_132975	111415826	111415826	1
chr2	111490149	111875799	ACOXL	385650	+	NM_001142807	111525966	111875393	18
chr2	111855917	111873165	LOC400997	17248	-	NR_122074	111873165	111873165	4
chr2	111878490	111926022	BCL2L11	47532	+	NM_001204107	111881322	111909428	6
chr2	112124590	112252692	MIR4435-2HG	128102	-	NR_015395	112252692	112252692	2
chr2	112525213	112641741	ANAPC1	116528	-	NM_022662	112526867	112638402	48
chr2	112656190	112786945	MERTK	130755	+	NM_006343	112656312	112786441	19
chr2	112812799	112876895	TMEM87B	64096	+	NM_032824	112813168	112873720	19
chr2	112895961	112945791	FBLN7	49830	+	NM_153214	112896232	112945083	8
chr2	112973438	113012664	ZC3H8	39226	-	NM_032494	112988494	113012558	9
chr2	113033177	113097640	ZC3H6	64463	+	NM_198581	113033571	113090065	12
chr2	113125945	113191222	RGPD8	65277	-	NM_001164463	113127754	113191030	23
chr2	113125964	113191107	RGPD5	65143	-	NM_005054	113127754	113191030	23
chr2	113239742	113290222	TTL	50480	+	NM_153712	113239921	113286372	7
chr2	113299491	113334729	POLR1B	35238	+	NM_001282777	113305069	113333306	16
chr2	113342013	113346617	CHCHD5	4604	+	NM_032309	113342224	113346466	4
chr2	113399406	113401757	FLJ42351	2351	-	NR_033871	113401757	113401757	5
chr2	113403433	113421400	SLC20A1	17967	+	NM_005415	113404405	113420602	11
chr2	113493926	113522254	CKAP2L	28328	-	NR_130712	113522254	113522254	10
chr2	113531491	113542975	IL1A	11484	-	NM_000575	113532643	113541347	7
chr2	113587336	113594356	IL1B	7020	-	NM_000576	113587937	113593806	7
chr2	113670547	113676458	IL37	5911	+	NM_014439	113670589	113676386	5
chr2	113735595	113743249	IL36G	7654	+	NM_019618	113736215	113742626	5
chr2	113763037	113765621	IL36A	2584	+	NM_014440	113763448	113765621	4
chr2	113779667	113810444	IL36B	30777	-	NM_014438	113780250	113789286	6
chr2	113816214	113822320	IL36RN	6106	+	NM_173170	113817015	113820254	5
chr2	113825546	113833427	IL1F10	7881	+	NM_173161	113830315	113832941	5
chr2	113875469	113891593	IL1RN	16124	+	NM_173843	113885303	113890448	6
chr2	113931559	113960677	PSD4	29118	+	NM_012455	113940033	113958992	17
chr2	113973573	114036498	PAX8	62925	-	NM_003466	113976109	114035971	12
chr2	113993845	114024600	PAX8-AS1	30755	+	NR_015377	114024600	114024600	6
chr2	114195267	114253781	CBWD2	58514	+	NM_172003	114195445	114253320	15
chr2	114256660	114258727	FOXD4L1	2067	+	NM_012184	114256833	114258060	1
chr2	114286223	114300267	PGM5P4-AS1	14044	-	NR_121185	114300267	114300267	4
chr2	114334958	114336429	FAM138B	1471	+	NR_026821	114336429	114336429	3
chr2	114340535	114340673	MIR1302-3	138	-	NR_031632	114340673	114340673	1
chr2	114341229	114356613	WASH2P	15384	+	NR_024077	114356613	114356613	11
chr2	114356604	114361294	DDX11L2	4690	-	NR_024004	114361294	114361294	3
chr2	114368815	114384715	RPL23AP7	15900	-	NR_024528	114384715	114384715	4
chr2	114384805	114400975	RABL2A	16170	+	NM_007082	114386183	114399706	10
chr2	114470368	114514400	SLC35F5	44032	-	NM_025181	114475351	114513986	16
chr2	114478866	114478945	MIR4782	79	-	NR_039943	114478945	114478945	1
chr2	114588759	114648569	LOC101060091	59810	-	NR_110174	114648569	114648569	5
chr2	114647510	114719129	ACTR3	71619	+	NM_005721	114647856	114715032	12
chr2	114735245	114737561	LOC100499194	2316	-	NR_034130	114737561	114737561	1
chr2	114737145	114764887	LINC01191	27742	+	NR_034128	114764887	114764887	2
chr2	115199898	116602326	DPP10	1402428	+	NM_020868	115200355	116599921	26
chr2	115585917	115591125	DPP10-AS3	5208	-	NR_132105	115591125	115591125	2
chr2	115901624	115918920	DPP10-AS1	17296	-	NR_036580	115918920	115918920	3
chr2	118572254	118589953	DDX18	17699	+	NM_006773	118572353	118588300	14
chr2	118673053	118771739	CCDC93	98686	-	NM_019044	118677918	118771571	24
chr2	118846049	118867597	INSIG2	21548	+	NM_016133	118854132	118865898	6
chr2	119357358	119360542	LOC101927709	3184	-	NR_110272	119360542	119360542	3
chr2	119599746	119605759	EN1	6013	-	NM_001426	119600513	119604743	2
chr2	119699744	119752236	MARCO	52492	+	NM_006770	119699876	119752096	17
chr2	119913818	119916471	C1QL2	2653	-	NM_182528	119914377	119915845	2
chr2	119981383	120023227	STEAP3	41844	+	NM_138637	120003072	120015221	6
chr2	120001997	120006647	STEAP3-AS1	4650	-	NR_046721	120006647	120006647	2
chr2	120060019	120124258	C2orf76	64239	-	NM_001017927	120060047	120097535	7
chr2	120124499	120130127	DBI	5628	+	NM_020548	120125160	120129894	5
chr2	120189445	120196096	TMEM37	6651	+	NM_183240	120189479	120195016	2
chr2	120197418	120282028	SCTR	84610	-	NM_002980	120197692	120281802	13
chr2	120302007	120414237	CFAP221	112230	+	NR_073132	120414237	120414237	25
chr2	120436742	120439694	TMEM177	2952	+	NM_030577	120438429	120439365	2
chr2	120517206	120742474	PTPN4	225268	+	NM_002830	120567429	120734646	27
chr2	120770603	120936697	EPB41L5	166094	+	NM_020909	120776660	120932483	25
chr2	120975046	120980984	TMEM185B	5938	-	NM_024121	120979499	120980552	1
chr2	121010413	121052286	RALB	41873	+	NM_002881	121036240	121050836	5
chr2	121103718	121109383	INHBB	5665	+	NM_002193	121103764	121107450	2
chr2	121221910	121223925	LINC01101	2015	-	NR_027181	121223925	121223925	1
chr2	121554866	121750229	GLI2	195363	+	NM_005270	121554896	121748251	13
chr2	121974163	122042778	TFCP2L1	68615	-	NM_014553	121981916	122042685	15
chr2	122095351	122407052	CLASP1	311701	-	NM_001142273	122098436	122363471	39
chr2	122288455	122288585	RNU4ATAC	130	+	NR_023343	122288585	122288585	1
chr2	122407229	122486136	NIFK-AS1	78907	+	NR_037857	122486136	122486136	4
chr2	122484520	122494503	NIFK	9983	-	NM_032390	122485299	122494426	7
chr2	122513120	122525428	TSN	12308	+	NM_004622	122513355	122522943	6
chr2	124782863	125672954	CNTNAP5	890091	+	NM_130773	124783227	125671865	24
chr2	127413510	127454251	GYPC	40741	+	NM_001256584	127447844	127453718	5
chr2	127805598	127864903	BIN1	59305	-	NM_139343	127806101	127864519	19
chr2	127941411	127963343	CYP27C1	21932	-	NM_001001665	127944846	127961125	8
chr2	128014865	128051752	ERCC3	36887	-	NM_000122	128015171	128051657	15
chr2	128056244	128100805	MAP3K2	44561	-	NM_006609	128065154	128100705	16
chr2	128175995	128186822	PROC	10827	+	NM_000312	128177518	128186522	9
chr2	128181112	128181194	MIR4783	82	-	NR_039944	128181194	128181194	1
chr2	128238382	128284087	IWS1	45705	-	NM_017969	128238619	128283784	14
chr2	128293377	128395303	MYO7B	101926	+	NM_001080527	128317297	128394992	47
chr2	128317619	128328537	LOC105373609	10918	-	NR_132317	128328537	128328537	3
chr2	128395995	128439360	LIMS2	43365	-	NM_001161404	128396855	128415132	10
chr2	128403438	128410213	GPR17	6775	+	NM_001161415	128407586	128409329	4
chr2	128458596	128461407	SFT2D3	2811	+	NM_032740	128459102	128459750	1
chr2	128461807	128568761	WDR33	106954	-	NM_018383	128463896	128528555	22
chr2	128603839	128615729	POLR2D	11890	-	NM_004805	128605680	128615674	4
chr2	128619206	128643514	AMMECR1L	24308	-	NM_001199140	128622667	128631808	8
chr2	128698790	128784869	SAP130	86079	-	NM_001145928	128699579	128784737	21
chr2	128848753	128953249	UGGT1	104496	+	NM_020120	128848931	128947316	41
chr2	129023053	129076171	HS6ST1	53118	-	NM_004807	129025735	129076137	2
chr2	129622173	129626301	LOC101927881	4128	+	NR_110278	129626301	129626301	3
chr2	129999745	130031464	LOC151121	31719	-	NR_122040	130031464	130031464	5
chr2	130680434	130691890	LOC389033	11456	-	NR_026740	130691890	130691890	3
chr2	130680749	130704276	LOC101927924	23527	+	NR_110285	130704276	130704276	4
chr2	130724164	130738045	RAB6C-AS1	13881	-	NR_036537	130738045	130738045	6
chr2	130737234	130740311	RAB6C	3077	+	NM_032144	130737688	130738453	1
chr2	130783571	130808704	FAR2P1	25133	-	NR_026758	130808704	130808704	12
chr2	130831107	130886795	POTEF	55688	-	NM_001099771	130831816	130878088	17
chr2	130887195	130896986	MED15P9	9791	+	NR_033903	130896986	130896986	6
chr2	130896855	130902707	CCDC74B	5852	-	NM_207310	130897127	130902569	8
chr2	130908964	130940323	SMPD4	31359	-	NR_033230	130940323	130940323	20
chr2	130939500	130948300	MZT2B	8800	+	NM_025029	130939855	130948199	3
chr2	130949317	130956034	TUBA3E	6717	-	NM_207312	130949403	130955933	5
chr2	131095505	131100254	CCDC115	4749	-	NR_104471	131100254	131100254	6
chr2	131100488	131104197	IMP4	3709	+	NM_033416	131100505	131104041	9
chr2	131113579	131132982	PTPN18	19403	+	NM_014369	131113680	131130797	15
chr2	131174325	131186119	FAR2P2	11794	-	NR_046258	131186119	131186119	6
chr2	131193234	131199254	CYP4F62P	6020	-	NR_103761	131199254	131199254	5
chr2	131220388	131266808	POTEI	46420	-	NM_001277406	131220388	131266808	15
chr2	131278666	131285565	CFC1B	6899	+	NM_001079530	131279057	131285468	6
chr2	131294142	131307471	TISP43	13329	-	NR_027313	131307471	131307471	3
chr2	131294142	131307488	LOC646743	13346	-	NR_033930	131307488	131307488	3
chr2	131349737	131357148	CFC1	7411	-	NM_032545	131350449	131356860	6
chr2	131369105	131415610	POTEJ	46505	+	NM_001277083	131369105	131415450	15
chr2	131437622	131443435	CYP4F30P	5813	+	NR_023391	131443435	131443435	5
chr2	131486642	131487909	GPR148	1267	+	NM_207364	131486724	131487768	1
chr2	131513076	131525707	AMER3	12631	+	NM_152698	131519645	131522231	2
chr2	131674223	131804826	ARHGEF4	130603	+	NM_015320	131688530	131803762	14
chr2	131805448	131851004	FAM168B	45556	-	NM_001009993	131810475	131840219	7
chr2	131862419	131907425	PLEKHB2	45006	+	NM_001309452	131883432	131904346	9
chr2	131975923	132022416	POTEE	46493	+	NM_001083538	131975975	132022256	15
chr2	132036862	132057392	LOC440910	20530	+	NR_030728	132057392	132057392	6
chr2	132118064	132121731	WTH3DI	3667	-	NM_001077637	132120528	132121293	1
chr2	132160473	132165801	LINC01120	5328	+	NR_036499	132165801	132165801	3
chr2	132199733	132202467	LOC401010	2734	-	NR_002826	132202467	132202467	1
chr2	132233579	132240507	TUBA3D	6928	+	NM_080386	132233772	132240421	5
chr2	132241532	132250064	MZT2A	8532	-	NM_001085365	132241633	132249949	3
chr2	132248732	132248809	MIR4784	77	-	NR_039945	132248809	132248809	1
chr2	132250385	132279149	LOC150776	28764	+	NR_026922	132279149	132279149	18
chr2	132285406	132291239	CCDC74A	5833	+	NM_001258306	132285543	132290971	8
chr2	132354346	132366974	POTEKP	12628	+	NR_033885	132366974	132366974	6
chr2	132394597	132407188	LINC01087	12591	+	NR_108087	132407188	132407188	2
chr2	132480063	132524977	C2orf27A	44914	+	NM_013310	132509130	132524775	4
chr2	132552533	132559234	C2orf27B	6701	-	NM_214461	132552735	132558510	3
chr2	132905163	133015542	ANKRD30BL	110379	-	NR_027020	133015542	133015542	5
chr2	133014538	133014653	MIR663B	115	-	NR_031608	133014653	133014653	1
chr2	133064716	133076320	ZNF806	11604	+	NM_001304449	133066881	133076309	4
chr2	133174146	133404169	GPR39	230023	+	NM_001508	133174615	133403179	2
chr2	133402336	133429070	LYPD1	26734	-	NM_001077427	133403617	133426006	3
chr2	133429371	134326031	NCKAP5	896660	-	NM_207363	133430861	134275097	20
chr2	133551020	134196212	MIR7853	645192	-	NR_107007	134196212	134196212	7
chr2	134023766	134042330	LOC101928161	18564	+	NR_110294	134042330	134042330	5
chr2	134884695	134884763	MIR3679	68	+	NR_037450	134884763	134884763	1
chr2	135011829	135212192	MGAT5	200363	+	NM_002410	135011974	135206418	16
chr2	135213329	135476571	TMEM163	263242	-	NM_030923	135214286	135476505	8
chr2	135596185	135659602	ACMSD	63417	+	NM_001307983	135616852	135659430	10
chr2	135615389	135615443	MIR5590	54	+	NR_049856	135615443	135615443	1
chr2	135624202	135676176	CCNT2-AS1	51974	-	NR_036549	135676176	135676176	5
chr2	135676391	135716915	CCNT2	40524	+	NR_037649	135716915	135716915	11
chr2	135722060	135782248	MAP3K19	60188	-	NM_025052	135722419	135782217	10
chr2	135809834	135928279	RAB3GAP1	118445	+	NM_001172435	135809877	135926351	25
chr2	135954538	136288806	ZRANB3	334268	-	NM_032143	135957911	136262059	21
chr2	136289024	136482840	R3HDM1	193816	+	NM_015361	136362415	136481862	26
chr2	136422966	136423048	MIR128-1	82	+	NR_029672	136423048	136423048	1
chr2	136499188	136542633	UBXN4	43445	+	NM_014607	136499499	136540457	13
chr2	136545414	136594750	LCT	49336	-	NM_002299	136545893	136594739	17
chr2	136577760	136580657	LOC100507600	2897	+	NR_045486	136580657	136580657	2
chr2	136597195	136634047	MCM6	36852	-	NM_005915	136598404	136633935	17
chr2	136663450	136743254	DARS	79804	-	NM_001349	136664885	136743038	16
chr2	136742745	136765112	DARS-AS1	22367	+	NR_110199	136765112	136765112	4
chr2	136871918	136875725	CXCR4	3807	-	NM_003467	136872438	136875630	2
chr2	137523131	138435282	THSD7B	912151	+	NM_001316349	137639748	138434175	28
chr2	138636323	138685502	LOC101928273	49179	-	NR_120402	138685502	138685502	3
chr2	138721807	138773934	HNMT	52127	+	NM_006895	138722061	138771700	6
chr2	139259349	139330805	SPOPL	71456	+	NM_001001664	139307786	139326650	11
chr2	139426726	139537811	NXPH2	111085	-	NM_007226	139428491	139537811	2
chr2	139654893	139656744	YY1P2	1851	+	NR_033658	139656744	139656744	1
chr2	140988995	142889270	LRP1B	1900275	-	NM_018557	140990754	142888298	91
chr2	141344194	141344254	MIR7157	60	-	NR_106979	141344254	141344254	1
chr2	143635194	143799885	KYNU	164691	+	NM_001199241	143642936	143799741	15
chr2	143886898	144525921	ARHGAP15	639023	+	NM_018460	143913059	144525741	14
chr2	144694633	144721722	LOC101928386	27089	+	NR_110237	144721722	144721722	3
chr2	144703580	145090101	GTDC1	386521	-	NM_001284238	144704618	144934784	14
chr2	145141941	145277958	ZEB2	136017	-	NM_014795	145147017	145274917	10
chr2	145277180	145278465	ZEB2-AS1	1285	+	NR_040248	145278465	145278465	4
chr2	145279434	145337001	LINC01412	57567	+	NR_110570	145337001	145337001	3
chr2	145425533	145834291	TEX41	408758	+	NR_033870	145834291	145834291	5
chr2	147344624	147348558	PABPC1P2	3934	+	NR_026904	147348558	147348558	1
chr2	148602085	148688396	ACVR2A	86311	+	NM_001278579	148602721	148684843	12
chr2	148687965	148779173	ORC4	91208	-	NM_181742	148693078	148733527	14
chr2	148778579	149271044	MBD5	492465	+	NM_018328	149216327	149270510	15
chr2	149402559	149545136	EPC2	142577	+	NM_015630	149402586	149543946	14
chr2	149632791	149883273	KIF5C	250482	+	NM_004522	149633186	149868190	26
chr2	149894980	150071772	LYPD6B	176792	+	NM_001317005	149987462	150071224	7
chr2	150186498	150330659	LYPD6	144161	+	NM_001195685	150294222	150327364	5
chr2	150426146	150444330	MMADHC	18184	-	NM_015702	150426487	150443611	8
chr2	150443871	150704748	LOC101929231	260877	+	NR_110240	150704748	150704748	3
chr2	151324706	151344209	RND3	19503	-	NM_001254738	151326500	151343931	5
chr2	151409045	151428735	LOC101929260	19690	-	NR_110241	151428735	151428735	6
chr2	151485410	151491871	LOC101929282	6461	+	NR_110244	151491871	151491871	5
chr2	152104727	152118389	RBM43	13662	-	NM_198557	152107419	152118241	4
chr2	152126981	152146430	NMI	19449	-	NM_004688	152127206	152139462	8
chr2	152194341	152235885	LOC101929319	41544	-	NR_110248	152235885	152235885	3
chr2	152214105	152236562	TNFAIP6	22457	+	NM_007115	152214180	152236047	6
chr2	152224847	152224925	MIR4773-1	78	+	NR_039931	152224925	152224925	1
chr2	152224847	152224925	MIR4773-2	78	-	NR_039932	152224925	152224925	1
chr2	152266396	152333860	RIF1	67464	+	NM_018151	152266937	152331585	36
chr2	152341852	152591001	NEB	249149	-	NM_001271208	152342273	152589670	183
chr2	152657479	152685009	ARL5A	27530	-	NM_012097	152659789	152684690	6
chr2	152689285	152955593	CACNB4	266308	-	NM_000726	152695632	152955525	14
chr2	152973314	153032506	STAM2	59192	-	NM_005843	152977087	153032156	14
chr2	153191750	153506348	FMNL2	314598	+	NM_052905	153192117	153504419	26
chr2	153508106	153573975	PRPF40A	65869	-	NM_017892	153512819	153573953	26
chr2	153574406	153617767	ARL6IP6	43361	+	NR_024526	153617767	153617767	4
chr2	154333851	154335322	RPRM	1471	-	NM_019845	154334749	154335079	1
chr2	154728410	155310489	GALNT13	582079	+	NM_052917	154801010	155307063	13
chr2	155292364	155313950	LOC100144595	21586	-	NM_001256368	155294102	155302368	5
chr2	155555092	155714864	KCNJ3	159772	+	NM_002239	155555287	155711825	3
chr2	156877046	157111443	LOC101929378	234397	-	NR_110250	157111443	157111443	4
chr2	157180943	157189287	NR4A2	8344	-	NM_006186	157182255	157186698	8
chr2	157291964	157442915	GPD2	150951	+	NM_001083112	157332617	157439430	17
chr2	158114339	158167913	GALNT5	53574	+	NM_014568	158114594	158167860	10
chr2	158175124	158184225	ERMN	9101	-	NM_001009959	158177782	158183991	4
chr2	158271130	158300604	CYTIP	29474	-	NM_004288	158272188	158300532	8
chr2	158383278	158485399	ACVR1C	102121	-	NM_145259	158390429	158485156	9
chr2	158592957	158732374	ACVR1	139417	-	NM_001111067	158594042	158656005	11
chr2	158851690	158992666	UPP2	140976	+	NM_001135098	158851710	158991402	9
chr2	159023161	159092681	CCDC148-AS1	69520	+	NR_038850	159092681	159092681	5
chr2	159027868	159313265	CCDC148	285397	-	NM_138803	159028624	159312951	14
chr2	159313391	159537940	PKP4	224549	+	NM_001304969	159389696	159537189	22
chr2	159651828	159672496	DAPL1	20668	+	NM_001017920	159651884	159672333	4
chr2	159825145	160089170	TANC1	264025	+	NM_001145909	159922422	160086129	27
chr2	160043345	160043412	MIR6888	67	+	NR_106948	160043412	160043412	1
chr2	160092303	160143310	WDSUB1	51007	-	NM_001128212	160092543	160139580	11
chr2	160175489	160473112	BAZ2B	297623	-	NM_013450	160176775	160335230	37
chr2	160471804	160474553	LOC643072	2749	+	NR_110588	160474553	160474553	2
chr2	160568967	160625094	MARCH7	56127	+	NM_001282805	160585533	160623853	12
chr2	160625138	160654766	CD302	29628	-	NM_014880	160628361	160654709	6
chr2	160625138	160761267	LY75-CD302	136129	-	NM_001198759	160628361	160761193	39
chr2	160659867	160761267	LY75	101400	-	NM_002349	160661554	160761193	35
chr2	160797259	160919126	PLA2R1	121867	-	NM_007366	160798288	160918914	30
chr2	160956176	161056824	ITGB6	100648	-	NM_001282353	160958246	161056574	16
chr2	161114229	161128406	LOC100505984	14177	-	NR_103775	161128406	161128406	2
chr2	161128661	161350318	RBMS1	221657	-	NM_002897	161132147	161349874	14
chr2	161264320	161264393	MIR4785	73	-	NR_039946	161264393	161264393	1
chr2	161993465	162092682	TANK	99217	+	NM_004180	162036173	162092029	8
chr2	162079768	162111154	LOC101929512	31386	-	NR_110593	162111154	162111154	4
chr2	162101249	162105561	LOC100996579	4312	+	NR_110163	162105561	162105561	3
chr2	162164785	162268228	PSMD14	103443	+	NM_005805	162175336	162267911	12
chr2	162272619	162281573	TBR1	8954	+	NM_006593	162272921	162280738	6
chr2	162355577	162364413	AHCTF1P1	8836	-	NR_077058	162364413	162364413	1
chr2	162480844	162841786	SLC4A10	360942	+	NM_001178016	162565258	162834244	27
chr2	162848754	162931052	DPP4	82298	-	NM_001935	162849792	162930491	26
chr2	162970950	163029243	LOC101929532	58293	+	NR_110255	163029243	163029243	4
chr2	162999378	163008914	GCG	9536	-	NM_002054	162999873	163005688	6
chr2	163027193	163100045	FAP	72852	-	NM_004460	163027488	163099837	26
chr2	163123588	163175218	IFIH1	51630	-	NM_022168	163123709	163174817	16
chr2	163200582	163219148	GCA	18566	+	NM_012198	163200758	163216753	8
chr2	163227916	163695257	KCNH7	467341	-	NM_033272	163228338	163695028	16
chr2	163625445	163654482	LOC101929570	29037	+	NR_110258	163654482	163654482	5
chr2	164464117	164592513	FIGN	128396	-	NM_018086	164466061	164591437	3
chr2	165349322	165478360	GRB14	129038	-	NM_004490	165349545	165477819	14
chr2	165536694	165698678	COBLL1	161984	-	NM_001278458	165542455	165698554	17
chr2	165544152	165544287	SNORA70F	135	-	NR_033309	165544287	165544287	1
chr2	165697258	165705906	LOC101929633	8648	+	NR_110574	165705906	165705906	2
chr2	165754708	165812035	SLC38A11	57327	-	NM_001199148	165754946	165809277	11
chr2	165944029	166060577	SCN3A	116548	-	NM_001081676	165946659	166032904	28
chr2	166095911	166248820	SCN2A	152909	+	NM_001040142	166152333	166246334	27
chr2	166326156	166545917	CSRNP3	219761	+	NM_001172173	166451575	166536263	7
chr2	166604312	166650803	GALNT3	46491	-	NM_004482	166605290	166627210	11
chr2	166713985	166728451	LOC100506124	14466	-	NR_045375	166728451	166728451	4
chr2	166729871	166810348	TTC21B	80477	-	NM_024753	166731264	166810215	29
chr2	166790366	166804831	TTC21B-AS1	14465	+	NR_038983	166804831	166804831	5
chr2	166813927	166892910	LOC102724058	78983	+	NR_110598	166892910	166892910	4
chr2	166845669	167005642	SCN1A	159973	-	NM_001202435	166847754	166930131	28
chr2	166938040	167158293	LOC101929680	220253	+	NR_110260	167158293	167158293	12
chr2	167051696	167232497	SCN9A	180801	-	NM_002977	167055181	167168266	27
chr2	167260082	167343481	SCN7A	83399	-	NR_045628	167343481	167343481	26
chr2	167744996	168116261	XIRP2	371265	+	NM_001199143	167759992	168115873	11
chr2	167979318	167997465	XIRP2-AS1	18147	-	NR_046665	167997465	167997465	2
chr2	168671283	168797654	LOC105616981	126371	-	NR_131227	168797654	168797654	5
chr2	168675181	168727366	B3GALT1	52185	+	NM_020981	168725549	168726530	2
chr2	168810529	169104105	STK39	293576	-	NM_013233	168812005	169103945	18
chr2	169312758	169631644	CERS6	318886	+	NM_001256126	169312958	169626172	11
chr2	169439452	169439528	MIR4774	76	+	NR_039933	169439528	169439528	1
chr2	169628460	169642939	CERS6-AS1	14479	-	NR_045786	169642939	169642939	4
chr2	169643048	169721849	NOSTRIN	78801	+	NM_001171631	169659156	169721480	21
chr2	169727400	169746944	SPC25	19544	-	NM_020675	169727940	169746029	7
chr2	169757749	169766510	G6PC2	8761	+	NM_021176	169757841	169764589	5
chr2	169779448	169887833	ABCB11	108385	-	NM_003742	169780131	169874635	28
chr2	169923544	169952677	DHRS9	29133	+	NM_199204	169938091	169952277	6
chr2	169983618	170219122	LRP2	235504	-	NM_004525	169985172	170218909	79
chr2	170336005	170363165	BBS5	27160	+	NM_152384	170336063	170361092	12
chr2	170366211	170382772	KLHL41	16561	+	NM_006063	170366288	170382206	6
chr2	170386261	170430431	FASTKD1	44170	-	NM_024622	170386334	170428539	15
chr2	170440849	170494254	PPIG	53405	+	NM_004792	170460551	170494033	14
chr2	170501934	170550931	CCDC173	48997	-	NM_001085447	170502350	170550837	9
chr2	170550963	170558218	PHOSPHO2	7255	+	NM_001199287	170557481	170558207	5
chr2	170550963	170608396	PHOSPHO2-KLHL23	57433	+	NM_001199290	170591524	170606242	6
chr2	170590355	170608396	KLHL23	18041	+	NM_144711	170591524	170606242	4
chr2	170655321	170668571	SSB	13250	+	NM_003142	170657470	170668266	12
chr2	170668266	170681441	METTL5	13175	-	NM_001293187	170668329	170681107	8
chr2	170684017	170940639	UBR3	256622	+	NM_172070	170684017	170938353	39
chr2	171034654	171511674	MYO3B	477020	+	NR_045683	171511674	171511674	36
chr2	171197026	171207453	LOC101929753	10427	-	NR_110576	171207453	171207453	4
chr2	171556877	171627276	LOC101926913	70399	-	NR_110185	171627276	171627276	6
chr2	171568948	171571077	LINC01124	2129	-	NR_027433	171571077	171571077	1
chr2	171571856	171574498	SP5	2642	+	NM_001003845	171572022	171573914	2
chr2	171627191	171655481	ERICH2	28290	+	NM_001290030	171627191	171655404	10
chr2	171673199	171717659	GAD1	44460	+	NM_000817	171675101	171716392	17
chr2	171784947	171823643	GORASP2	38696	+	NM_001201428	171806108	171822640	10
chr2	171847332	172087824	TLK1	240492	-	NM_001136554	171850289	171974362	21
chr2	172173912	172291312	METTL8	117400	-	NM_024770	172180681	172248695	10
chr2	172290760	172341562	DCAF17	50802	+	NM_025000	172291087	172337624	14
chr2	172378756	172414643	CYBRD1	35887	+	NM_001256909	172378782	172411337	4
chr2	172543918	172606668	DYNC1I2	62750	+	NM_001378	172546665	172604399	18
chr2	172639914	172750816	SLC25A12	110902	-	NM_003705	172641783	172750724	18
chr2	172778934	172848600	HAT1	69666	+	NM_003642	172779010	172848266	11
chr2	172864803	172945587	METAP1D	80784	+	NM_199227	172864876	172945134	10
chr2	172950207	172954401	DLX1	4194	+	NM_178120	172950405	172952985	3
chr2	172964165	172967478	DLX2	3313	-	NM_004405	172965270	172967266	3
chr2	172967733	172974710	DLX2-AS1	6977	+	NR_126376	172974710	172974710	5
chr2	173292081	173371183	ITGA6	79102	+	NM_001316306	173332243	173366607	26
chr2	173420100	173490351	PDK1	70251	+	NR_103731	173490351	173490351	14
chr2	173587917	173600934	RAPGEF4-AS1	13017	-	NR_026995	173600934	173600934	4
chr2	173600524	173917620	RAPGEF4	317096	+	NM_007023	173600711	173916495	31
chr2	173940564	174132737	ZAK	192173	+	NM_016653	173955759	174131478	20
chr2	174062440	174146764	MLK7-AS1	84324	-	NR_033882	174146764	174146764	8
chr2	174219560	174233718	CDCA7	14158	+	NM_031942	174219691	174232392	10
chr2	174771186	174830430	SP3	59244	-	NM_003111	174774668	174829899	7
chr2	174937174	175113365	OLA1	176191	-	NM_013341	174940153	175111543	11
chr2	175190754	175195370	LINC01305	4616	+	NR_038897	175195370	175195370	3
chr2	175199820	175202268	SP9	2448	+	NM_001145250	175199820	175202268	2
chr2	175212877	175260443	CIR1	47566	-	NM_004882	175213224	175260350	10
chr2	175260456	175294303	SCRN3	33847	+	NM_001193528	175260484	175292623	8
chr2	175296299	175351816	GPR155	55517	-	NM_001033045	175300843	175346684	17
chr2	175422693	175422800	RNU6-2	107	-	NR_125730	175422800	175422800	1
chr2	175424301	175547627	WIPF1	123326	-	NM_001077269	175427274	175450301	8
chr2	175612322	175629200	CHRNA1	16878	-	NM_001039523	175612851	175629122	10
chr2	175664041	175870107	CHN1	206066	-	NM_001025201	175664843	175869640	13
chr2	175936977	176032934	ATF2	95957	-	NR_045769	176032934	176032934	17
chr2	176032360	176032437	MIR933	77	-	NR_030630	176032437	176032437	1
chr2	176040985	176046490	ATP5G3	5505	-	NM_001689	176043015	176046121	5
chr2	176788619	176867567	KIAA1715	78948	-	NR_130941	176867567	176867567	15
chr2	176944834	176948690	EVX2	3856	-	NM_001080458	176944834	176948504	3
chr2	176957531	176960666	HOXD13	3135	+	NM_000523	176957618	176959458	2
chr2	176964529	176965488	HOXD12	959	+	NM_021193	176964529	176965488	2
chr2	176972083	176974316	HOXD11	2233	+	NM_021192	176972083	176973870	2
chr2	176981491	176984670	HOXD10	3179	+	NM_002148	176981561	176983959	2
chr2	176987412	176989645	HOXD9	2233	+	NM_014213	176987496	176988903	2
chr2	176994421	176997423	HOXD8	3002	+	NM_001199747	176995646	176996340	3
chr2	176999568	177001826	HOXD-AS2	2258	-	NR_038435	177001826	177001826	3
chr2	177015030	177015140	MIR10B	110	+	NR_029609	177015140	177015140	1
chr2	177016112	177017949	HOXD4	1837	+	NM_014621	177016361	177017670	2
chr2	177028804	177037826	HOXD3	9022	+	NM_006898	177033842	177037002	3
chr2	177037916	177053686	HAGLR	15770	-	NR_033979	177053686	177053686	3
chr2	177042893	177043737	HAGLROS	844	+	NR_110457	177043737	177043737	2
chr2	177053306	177055635	HOXD1	2329	+	NM_024501	177053529	177054870	2
chr2	177053570	177053629	MIR7704	59	+	NR_106991	177053629	177053629	1
chr2	177134122	177202753	MTX2	68631	+	NR_027850	177202753	177202753	11
chr2	177465707	177465780	MIR1246	73	-	NR_031648	177465780	177465780	1
chr2	177494308	177502302	LINC01116	7994	-	NR_040001	177502302	177502302	3
chr2	177502481	177520686	LINC01117	18205	+	NR_110599	177520686	177520686	4
chr2	178077421	178088685	HNRNPA3	11264	+	NM_194247	178077527	178084027	11
chr2	178077453	178077526	MIR4444-1	73	+	NR_039646	178077526	178077526	1
chr2	178077453	178077526	MIR4444-2	73	+	NR_049831	178077526	178077526	1
chr2	178095030	178129859	NFE2L2	34829	-	NM_006164	178095512	178129304	5
chr2	178120672	178120738	MIR3128	66	-	NR_036075	178120738	178120738	1
chr2	178148235	178257419	LOC100130691	109184	-	NR_026966	178257419	178257419	9
chr2	178178533	178178610	MIR6512	77	-	NR_106767	178178610	178178610	1
chr2	178257470	178408564	AGPS	151094	+	NM_003659	178257517	178402923	20
chr2	178414880	178417524	TTC30B	2644	-	NM_152517	178415493	178417491	1
chr2	178479025	178483694	TTC30A	4669	-	NM_152275	178481431	178483429	1
chr2	178487976	178973066	PDE11A	485090	-	NM_001077197	178494134	178969190	21
chr2	178977150	178994382	RBM45	17232	+	NM_152945	178977273	178990903	10
chr2	179059207	179264160	OSBPL6	204953	+	NM_001201480	179170911	179260286	26
chr2	179246804	179541009	MIR548N	294205	+	NR_031666	179541009	179541009	5
chr2	179278385	179304970	LOC101927027	26585	+	NR_110204	179304970	179304970	5
chr2	179296140	179315967	PRKRA	19827	-	NM_001316362	179296823	179309205	9
chr2	179316162	179326110	DFNB59	9948	+	NM_001042702	179318136	179326001	7
chr2	179328390	179343355	FKBP7	14965	-	NM_001135212	179330496	179343226	4
chr2	179345198	179369782	PLEKHA3	24584	+	NM_019091	179345596	179368614	8
chr2	179387917	179484944	TTN-AS1	97027	+	NR_038271	179484944	179484944	7
chr2	179390716	179672150	TTN	281434	-	NM_001267550	179391738	179669369	363
chr2	179641652	179644690	LOC101927055	3038	+	NR_120594	179644690	179644690	2
chr2	179694483	179914786	CCDC141	220303	-	NM_173648	179698899	179914668	24
chr2	179966418	180129350	SESTD1	162932	-	NM_178123	179974625	180056568	18
chr2	180306710	180726232	ZNF385B	419522	-	NM_152520	180307976	180634482	10
chr2	180725562	180725635	MIR1258	73	-	NR_031659	180725635	180725635	1
chr2	180809603	180871780	CWC22	62177	-	NM_020943	180809855	180858068	20
chr2	181556830	181781666	SCHLAP1	224836	+	NR_104322	181781666	181781666	7
chr2	181845111	181928154	UBE2E3	83043	+	NM_182678	181846769	181927615	7
chr2	181988563	182264280	LOC101927156	275717	+	NR_130784	182264280	182264280	5
chr2	182170319	182170379	MIR4437	60	-	NR_039637	182170379	182170379	1
chr2	182321618	182403655	ITGA4	82037	+	NM_000885	182322381	182400254	28
chr2	182401400	182521834	CERKL	120434	-	NM_001030311	182402910	182521733	14
chr2	182540832	182545392	NEUROD1	4560	-	NM_002500	182542516	182543587	2
chr2	182756442	182795464	SSFA2	39022	+	NM_001130445	182756793	182792992	18
chr2	182818967	182982483	PPP1R1C	163516	+	NR_048567	182982483	182982483	5
chr2	183004761	183387572	PDE1A	382811	-	NM_001258312	183011805	183387366	16
chr2	183580767	183644750	DNAJC10	63983	+	NR_073366	183644750	183644750	25
chr2	183698004	183731498	FRZB	33494	-	NM_001463	183699575	183731280	6
chr2	183789578	183903586	NCKAP1	114008	-	NM_205842	183790429	183902827	32
chr2	183943286	183964722	DUSP19	21436	+	NM_080876	183943661	183960386	4
chr2	183982217	184026412	NUP35	44195	+	NM_001287584	183993025	184025859	10
chr2	185243701	185243771	MIR548AE1	70	+	NR_039638	185243771	185243771	1
chr2	185463092	185804214	ZNF804A	341122	+	NM_194250	185463686	185803753	4
chr2	186584600	186605204	LOC101927196	20604	-	NR_110217	186605204	186605204	3
chr2	186603354	186698016	FSIP2	94662	+	NM_173651	186603354	186697953	23
chr2	186898260	186951044	LINC01473	52784	-	NR_110218	186951044	186951044	6
chr2	187350884	187374087	ZC3H15	23203	+	NM_018471	187351109	187373460	10
chr2	187454789	187545629	ITGAV	90840	+	NM_002210	187455065	187542019	30
chr2	187558788	187628512	FAM171B	69724	+	NM_177454	187558900	187627550	8
chr2	187692206	187713897	ZSWIM2	21691	-	NM_182521	187692710	187713857	9
chr2	188206689	188313021	CALCRL	106332	-	NM_005795	188210910	188250322	15
chr2	188328957	188419219	TFPI	90262	-	NM_006287	188331662	188368495	8
chr2	188900322	189152418	LINC01090	252096	-	NR_126396	189152418	189152418	3
chr2	189156395	189460652	GULP1	304257	+	NM_001252668	189342429	189458688	13
chr2	189162218	189162315	MIR561	97	+	NR_030287	189162315	189162315	1
chr2	189598464	189654831	DIRC1	56367	-	NM_052952	189599332	189599647	2
chr2	189839098	189877472	COL3A1	38374	+	NM_000090	189839215	189876500	51
chr2	189842817	189842886	MIR1245A	69	+	NR_031647	189842886	189842886	1
chr2	189842819	189842887	MIR1245B	68	-	NR_039947	189842887	189842887	1
chr2	189860355	189860418	MIR3606	63	+	NR_037401	189860418	189860418	1
chr2	189896640	190044605	COL5A2	147965	-	NM_000393	189898795	190044330	54
chr2	189997761	189997837	MIR3129	76	-	NR_036076	189997837	189997837	1
chr2	190306158	190340288	WDR75	34130	+	NM_001303096	190313536	190340143	22
chr2	190425315	190445537	SLC40A1	20222	-	NM_014585	190426603	190445186	8
chr2	190526124	190535557	ASNSD1	9433	+	NM_019048	190530858	190535452	6
chr2	190540710	190611376	ANKAR	70666	+	NM_144708	190541216	190611353	23
chr2	190611385	190627924	OSGEPL1	16539	-	NM_022353	190615303	190626366	9
chr2	190627505	190630282	OSGEPL1-AS1	2777	+	NR_102429	190630282	190630282	2
chr2	190634992	190649097	ORMDL1	14105	-	NM_016467	190636492	190647321	5
chr2	190648810	190742355	PMS1	93545	+	NM_000534	190656535	190742162	13
chr2	190920425	190927455	MSTN	7030	-	NM_005259	190921983	190927322	3
chr2	191002485	191068210	C2orf88	65725	+	NM_001042521	191064586	191064874	3
chr2	191069359	191184771	HIBCH	115412	-	NM_014362	191069842	191184476	14
chr2	191208195	191236391	INPP1	28196	+	NM_001128928	191224828	191236128	7
chr2	191273080	191367041	MFSD6	93961	+	NM_017694	191300755	191364944	8
chr2	191371618	191399468	NEMP2	27850	-	NM_001142645	191373914	191399381	9
chr2	191513847	191557492	NAB1	43645	+	NM_005966	191523902	191555059	10
chr2	191745546	191830270	GLS	84724	+	NM_014905	191745810	191827712	18
chr2	191833761	191878976	STAT1	45215	-	NM_007315	191835428	191874729	25
chr2	191894301	192016322	STAT4	122021	-	NM_001243835	191894565	192012929	24
chr2	192110106	192290115	MYO1B	180009	+	NM_001130158	192141621	192288686	31
chr2	192542797	192553248	NABP1	10451	+	NR_045622	192553248	192553248	7
chr2	192554906	192575195	LOC105747689	20289	+	NR_131917	192575195	192575195	3
chr2	192699031	192712006	SDPR	12975	-	NM_004657	192700648	192711651	2
chr2	192813771	193059659	TMEFF2	245888	-	NM_016192	192815036	193059250	10
chr2	193614570	193641625	PCGEM1	27055	+	NR_002769	193641625	193641625	3
chr2	195208992	195284355	LOC101927406	75363	+	NR_110222	195284355	195284355	6
chr2	195595318	195626159	LOC101927431	30841	+	NR_110223	195626159	195626159	4
chr2	196521531	196602426	SLC39A10	80895	+	NM_001127257	196544766	196599765	10
chr2	196602426	196933536	DNAH7	331110	-	NM_018897	196602644	196933435	65
chr2	196998306	197036336	STK17B	38030	-	NM_004226	197002170	197028107	8
chr2	197063974	197457335	HECW2	393361	-	NM_020760	197066000	197298147	29
chr2	197124747	197128928	LOC101927482	4181	+	NR_110226	197128928	197128928	3
chr2	197504355	197597530	CCDC150	93175	+	NM_001080539	197504490	197597286	28
chr2	197565358	197577736	LOC100130452	12378	-	NR_034036	197577736	197577736	4
chr2	197627755	197664492	GTF3C3	36737	-	NM_012086	197629286	197664335	18
chr2	197669138	197675000	C2orf66	5862	-	NM_213608	197672166	197674111	3
chr2	197697727	197791454	PGAP1	93727	-	NM_024989	197705957	197791340	27
chr2	197851385	198175521	ANKRD44	324136	-	NM_001195144	197854314	198175328	28
chr2	198115581	198167243	ANKRD44-IT1	51662	-	NR_046837	198167243	198167243	6
chr2	198256697	198299817	SF3B1	43120	-	NM_012433	198257026	198299723	25
chr2	198318230	198339851	COQ10B	21621	+	NM_025147	198318284	198338648	5
chr2	198351307	198364998	HSPD1	13691	-	NM_199440	198351769	198363572	12
chr2	198351511	198351627	SNORA105A	116	-	NR_132787	198351627	198351627	1
chr2	198351511	198351627	SNORA105B	116	-	NR_132788	198351627	198351627	1
chr2	198364720	198368187	HSPE1	3467	+	NM_002157	198365160	198367983	4
chr2	198364720	198418423	HSPE1-MOB4	53703	+	NM_001202485	198365160	198415370	9
chr2	198380294	198418423	MOB4	38129	+	NM_199482	198388383	198415370	8
chr2	198435526	198540584	RFTN2	105058	-	NM_144629	198436731	198540182	9
chr2	198570027	198573114	MARS2	3087	+	NM_138395	198570129	198571911	1
chr2	198591602	198651036	BOLL	59434	-	NM_001284358	198593278	198643723	9
chr2	198669425	199014608	PLCL1	345183	+	NM_006226	198669823	199011686	6
chr2	199164086	199239821	LOC101927619	75735	-	NR_110267	199239821	199239821	3
chr2	200134222	200335989	SATB2	201767	-	NM_015265	200136933	200320760	12
chr2	200332820	200337481	SATB2-AS1	4661	+	NR_026830	200337481	200337481	2
chr2	200472790	200523855	LOC101927641	51065	+	NR_110270	200523855	200523855	7
chr2	200625258	200715896	FTCDNL1	90638	-	NR_034096	200715896	200715896	4
chr2	200775978	200792996	C2orf69	17018	+	NM_153689	200776161	200790609	2
chr2	200793633	200820459	TYW5	26826	-	NM_001039693	200797789	200820193	8
chr2	200820039	200828847	C2orf47	8808	+	NM_024520	200820521	200828534	6
chr2	201170603	201346986	SPATS2L	176383	+	NM_001282735	201253967	201342754	13
chr2	201353683	201374792	KCTD18	21109	-	NM_152387	201354822	201371739	7
chr2	201390864	201448818	SGOL2	57954	+	NM_001160033	201397698	201448179	9
chr2	201450730	201536217	AOX1	85487	+	NM_001159	201450831	201535402	35
chr2	201560445	201658941	AOX2P	98496	+	NR_001557	201658941	201658941	31
chr2	201577027	201599900	LOC100507140	22873	-	NR_037886	201599900	201599900	3
chr2	201645217	201676893	LOC101927795	31676	-	NR_110275	201676893	201676893	4
chr2	201676268	201688569	BZW1	12301	+	NM_014670	201677940	201686901	12
chr2	201717731	201729467	CLK1	11736	-	NM_004071	201718028	201726585	13
chr2	201735678	201753849	PPIL3	18171	-	NM_032472	201736117	201752338	7
chr2	201754049	201768655	NIF3L1	14606	+	NM_001142355	201756747	201768401	7
chr2	201774893	201828424	ORC2	53531	-	NM_006190	201776023	201822846	18
chr2	201838440	201936392	FAM126B	97952	-	NM_173822	201845992	201888732	12
chr2	201936461	201950473	NDUFB3	14012	+	NM_001257102	201943605	201950338	4
chr2	201980876	202037411	CFLAR	56535	+	NM_003879	201994588	202028696	10
chr2	202005011	202022515	CFLAR-AS1	17504	-	NR_040030	202022515	202022515	7
chr2	202047620	202094129	CASP10	46509	+	NM_032974	202050500	202093806	10
chr2	202098165	202152434	CASP8	54269	+	NM_001228	202131209	202151317	10
chr2	202152993	202222121	ALS2CR12	69128	-	NM_001127391	202153377	202216127	15
chr2	202241929	202316319	TRAK2	74390	-	NM_015049	202245265	202285230	16
chr2	202316391	202345574	STRADB	29183	+	NM_018571	202319563	202344898	12
chr2	202352143	202483905	ALS2CR11	131762	-	NM_001168221	202352334	202483853	16
chr2	202484906	202508252	TMEM237	23346	-	NM_001044385	202488977	202508123	12
chr2	202509596	202563417	MPP4	53821	-	NM_033066	202509932	202558677	22
chr2	202564985	202645895	ALS2	80910	-	NM_020919	202566573	202633608	34
chr2	202671151	202760273	CDK15	89122	+	NM_139158	202672246	202755617	14
chr2	202899309	202903160	FZD7	3851	+	NM_003507	202899370	202901095	1
chr2	202937977	203061886	KIAA2012	123909	+	NM_001277372	202938350	203061773	22
chr2	203070902	203103322	SUMO1	32420	-	NM_001005781	203071975	203103174	6
chr2	203130438	203168384	NOP58	37946	+	NM_015934	203130664	203168159	15
chr2	203141153	203141241	SNORD70	88	+	NR_003058	203141241	203141241	1
chr2	203156039	203156151	SNORD11B	112	+	NR_003694	203156151	203156151	1
chr2	203157773	203157857	SNORD11	84	+	NR_003031	203157857	203157857	1
chr2	203241049	203432474	BMPR2	191425	+	NM_001204	203242197	203424669	13
chr2	203499900	203634480	FAM117B	134580	+	NM_173511	203499910	203630487	8
chr2	203637872	203736708	ICA1L	98836	-	NM_138468	203644255	203693732	14
chr2	203745322	203776949	WDR12	31627	-	NM_018256	203745582	203776199	13
chr2	203776940	203851208	CARF	74268	+	NM_024744	203806625	203848347	17
chr2	203879601	204082717	NBEAL1	203116	+	NM_001114132	203881107	204082077	55
chr2	204103163	204170563	CYP20A1	67400	+	NM_177538	204103785	204161631	13
chr2	204192961	204296896	ABI2	103935	+	NM_001282925	204193237	204292075	11
chr2	204298404	204400058	RAPH1	101654	-	NM_213589	204304159	204360076	14
chr2	204571197	204603636	CD28	32439	+	NM_001243077	204571419	204599635	4
chr2	204732510	204738683	CTLA4	6173	+	NM_005214	204732665	204737535	4
chr2	204801470	204826298	ICOS	24828	+	NM_012092	204801537	204824322	5
chr2	205410515	206484886	PARD3B	1074371	+	NM_001302769	205410722	206480537	23
chr2	206547223	206662857	NRP2	115634	+	NM_201266	206548014	206659782	17
chr2	206858444	206950906	INO80D	92462	-	NM_017759	206869091	206927740	11
chr2	206980296	206981296	GCSHP3	1000	-	NR_033248	206981296	206981296	1
chr2	206987802	207024243	NDUFS1	36441	-	NM_005006	206988908	207018402	19
chr2	207024317	207027653	EEF1B2	3336	+	NM_021121	207024703	207027607	7
chr2	207026604	207026674	SNORD51	70	+	NR_002589	207026674	207026674	1
chr2	207026951	207027083	SNORA41	132	+	NR_002590	207027083	207027083	1
chr2	207040041	207082771	GPR1	42730	-	NM_001261453	207040903	207041971	4
chr2	207068099	207130967	GPR1-AS	62868	+	NR_104359	207130967	207130967	6
chr2	207139364	207179150	ZDBF2	39786	+	NM_020923	207146573	207176317	5
chr2	207308367	207485854	ADAM23	177487	+	NM_003812	207308590	207482351	26
chr2	207507141	207514173	LOC200726	7032	+	NM_001102659	207508960	207513518	3
chr2	207516344	207583120	DYTN	66776	-	NM_001093730	207516541	207583003	12
chr2	207602488	207630273	MDH1B	27785	-	NM_001282940	207603206	207629995	12
chr2	207630111	207660911	FASTKD2	30800	+	NM_001136193	207631417	207656526	12
chr2	207647957	207648032	MIR3130-1	75	-	NR_036077	207648032	207648032	1
chr2	207647957	207648032	MIR3130-2	75	+	NR_036078	207648032	207648032	1
chr2	207804277	207834198	CPO	29921	+	NM_173077	207804323	207834160	9
chr2	207938861	208031970	KLF7	93109	-	NM_001270943	207945936	208031866	4
chr2	207974710	207974797	MIR2355	87	-	NR_036227	207974797	207974797	1
chr2	208031123	208031222	MIR7845	99	+	NR_106999	208031222	208031222	1
chr2	208051413	208119040	LOC101927865	67627	-	NR_110283	208119040	208119040	4
chr2	208133998	208134148	MIR1302-4	150	-	NR_031633	208134148	208134148	1
chr2	208394615	208470284	CREB1	75669	+	NM_134442	208420359	208461782	9
chr2	208445354	208490055	METTL21A	44701	-	NM_001308021	208446545	208489099	5
chr2	208576263	208620896	CCNYL1	44633	+	NM_152523	208576830	208618422	11
chr2	208619530	208619605	MIR4775	75	+	NR_039934	208619605	208619605	1
chr2	208627309	208634143	FZD5	6834	-	NM_003468	208631705	208633463	2
chr2	208686011	208890284	PLEKHM3	204273	-	NM_001080475	208693042	208866363	8
chr2	208983852	209021486	LOC100507443	37634	+	NR_038437	209021486	209021486	3
chr2	208986330	208989313	CRYGD	2983	-	NM_006891	208986396	208989197	3
chr2	208992860	208994554	CRYGC	1694	-	NM_020989	208992926	208994516	3
chr2	209007296	209010877	CRYGB	3581	-	NM_005210	209007361	209010844	3
chr2	209025463	209028297	CRYGA	2834	-	NM_014617	209025527	209028280	3
chr2	209030070	209054773	C2orf80	24703	-	NM_001099334	209030530	209051710	9
chr2	209100950	209119867	IDH1	18917	-	NM_005896	209101802	209116275	10
chr2	209119956	209120918	IDH1-AS1	962	+	NR_046452	209120918	209120918	2
chr2	209130990	209223475	PIKFYVE	92485	+	NM_015040	209136243	209220029	42
chr2	209224568	209359231	PTH2R	134663	+	NM_001309516	209302528	209358384	13
chr2	210288770	210598834	MAP2	310064	+	NM_001039538	210517894	210595121	15
chr2	210636716	210864024	UNC80	227308	+	NM_032504	210636796	210860319	64
chr2	210867288	210886984	RPE	19696	+	NM_001278283	210880698	210884515	8
chr2	210886144	211036094	KANSL1L	149950	-	NM_152519	210887672	211019306	15
chr2	210894645	210929080	LOC101928020	34435	+	NR_110291	210929080	210929080	5
chr2	211052715	211090215	ACADL	37500	-	NM_001608	211053684	211089987	11
chr2	211154867	211179895	MYL1	25028	-	NM_079420	211155769	211179766	7
chr2	211189435	211335057	LANCL1-AS1	145622	+	NR_110605	211335057	211335057	6
chr2	211295972	211341499	LANCL1	45527	-	NM_001136575	211299210	211341120	10
chr2	211342405	211543831	CPS1	201426	+	NM_001122633	211342487	211542709	39
chr2	211482294	211484599	CPS1-IT1	2305	+	NR_002763	211484599	211484599	1
chr2	212240441	213403352	ERBB4	1162911	-	NM_005235	212248339	213403254	28
chr2	213290986	213291084	MIR548F2	98	-	NR_031643	213291084	213291084	1
chr2	213660054	213683987	LOC102725079	23933	+	NR_131941	213683987	213683987	5
chr2	213790980	213791060	MIR4776-1	80	+	NR_039935	213791060	213791060	1
chr2	213790980	213791060	MIR4776-2	80	-	NR_039936	213791060	213791060	1
chr2	213864410	214016333	IKZF2	151923	-	NM_001079526	213872083	214013353	9
chr2	214141276	214148929	LOC100130451	7653	-	NM_001242575	214142440	214148802	3
chr2	214149102	215275225	SPAG16	1126123	+	NR_047659	215275225	215275225	18
chr2	214622790	214622883	MIR4438	93	+	NR_039640	214622883	214622883	1
chr2	215276460	215440653	VWC2L	164193	+	NM_001080500	215278917	215440544	4
chr2	215374905	215401613	VWC2L-IT1	26708	+	NR_047698	215401613	215401613	4
chr2	215590369	215674435	BARD1	84066	-	NM_000465	215593399	215674293	11
chr2	215674952	215828329	LOC101928103	153377	+	NR_110292	215828329	215828329	4
chr2	215796265	216003151	ABCA12	206886	-	NR_103740	216003151	216003151	55
chr2	216176678	216214496	ATIC	37818	+	NM_004044	216176865	216214378	16
chr2	216225162	216300793	FN1	75631	-	NM_001306129	216226277	216300525	47
chr2	216318429	216328591	LOC102724849	10162	+	NR_110607	216328591	216328591	4
chr2	216476285	216708259	LINC00607	231974	-	NR_037195	216708259	216708259	10
chr2	216582765	216585669	LINC01614	2904	+	NR_132383	216585669	216585669	2
chr2	216807313	216878346	MREG	71033	-	NM_018000	216809585	216878050	5
chr2	216903110	216946539	PECR	43429	-	NM_018441	216903997	216946464	8
chr2	216946588	216967506	TMEM169	20918	+	NM_001142310	216960686	216965265	4
chr2	216974019	217071016	XRCC5	96997	+	NM_021141	216974159	217069925	21
chr2	217081611	217084915	PKI55	3304	+	NR_037701	217084915	217084915	1
chr2	217122584	217236750	MARCH4	114166	-	NM_020814	217124034	217234983	4
chr2	217277136	217347774	SMARCAL1	70638	+	NM_014140	217279427	217347700	18
chr2	217363519	217366188	RPL37A	2669	+	NM_000998	217363597	217366127	4
chr2	217454715	217471661	LINC01280	16946	-	NR_110392	217471661	217471661	4
chr2	217497550	217529158	IGFBP2	31608	+	NM_001313992	217525335	217528827	4
chr2	217536827	217560272	IGFBP5	23445	-	NM_000599	217541473	217559498	4
chr2	217724181	217724782	TNP1	601	-	NM_003284	217724389	217724757	2
chr2	217735494	217736362	LOC101928327	868	+	NR_130782	217736362	217736362	2
chr2	218147455	218208927	DIRC3-AS1	61472	+	NR_133642	218208927	218208927	6
chr2	218148745	218621316	DIRC3	472571	-	NR_026597	218621316	218621316	13
chr2	218664511	218808796	TNS1	144285	-	NM_022648	218669181	218762688	33
chr2	218765235	218765351	MIR6809	116	-	NR_106867	218765351	218765351	1
chr2	218899656	218955304	RUFY4	55648	+	NR_034176	218955304	218955304	14
chr2	218923877	218926013	CXCR2P1	2136	-	NR_002712	218926013	218926013	1
chr2	218990012	219001976	CXCR2	11964	+	NM_001168298	218999524	219000607	4
chr2	219027567	219031716	CXCR1	4149	-	NM_000634	219028881	219029934	2
chr2	219081816	219119071	ARPC2	37255	+	NM_152862	219082193	219118638	11
chr2	219125737	219128582	GPBAR1	2845	+	NM_001077194	219127447	219128440	2
chr2	219128851	219134932	AAMP	6081	-	NM_001302545	219129255	219134809	11
chr2	219135114	219211516	PNKD	76402	+	NM_015488	219135258	219209704	10
chr2	219138916	219157280	TMBIM1	18364	-	NM_022152	219140197	219146864	12
chr2	219144847	219144911	MIR6513	64	-	NR_106768	219144911	219144911	1
chr2	219190963	219222689	CATIP-AS2	31726	-	NR_125777	219222689	219222689	4
chr2	219206633	219206703	MIR6810	70	+	NR_106868	219206703	219206703	1
chr2	219221578	219232817	CATIP	11239	+	NM_198559	219221607	219232687	10
chr2	219231387	219232625	CATIP-AS1	1238	-	NR_110573	219232625	219232625	3
chr2	219246751	219261617	SLC11A1	14866	+	NM_000578	219247091	219259758	15
chr2	219263060	219270664	CTDSP1	7604	+	NM_001206878	219263135	219269148	7
chr2	219267368	219267445	MIR26B	77	+	NR_029500	219267445	219267445	1
chr2	219283837	219314248	VIL1	30411	+	NM_007127	219288501	219314059	20
chr2	219314973	219433084	USP37	118111	-	NM_020935	219319652	219423376	26
chr2	219433302	219461158	RQCD1	27856	+	NM_001271634	219433677	219458999	9
chr2	219472487	219501909	PLCD4	29422	+	NM_032726	219480462	219501300	16
chr2	219502639	219524355	ZNF142	21716	-	NR_073599	219524355	219524355	11
chr2	219524378	219528166	BCS1L	3788	+	NM_001257343	219525710	219528109	9
chr2	219528586	219536781	RNF25	8195	-	NM_022453	219528679	219536693	10
chr2	219536748	219567440	STK36	30692	+	NM_015690	219537552	219566732	27
chr2	219575567	219620138	TTLL4	44571	+	NM_014640	219602399	219619112	20
chr2	219646471	219680016	CYP27A1	33545	+	NM_000784	219646905	219679753	9
chr2	219687105	219696512	PRKAG3	9407	-	NM_017431	219688484	219696493	14
chr2	219687812	219687877	MIR9500	65	+	NR_128707	219687877	219687877	1
chr2	219724545	219738954	WNT6	14409	+	NM_006522	219724760	219738567	4
chr2	219745254	219758651	WNT10A	13397	+	NM_025216	219745717	219757993	4
chr2	219765536	219795359	LINC01494	29823	-	NR_110238	219795359	219795359	5
chr2	219824349	219826877	CDK5R2	2528	+	NM_003936	219824542	219825646	1
chr2	219841005	219842644	LINC00608	1639	+	NR_015390	219842644	219842644	2
chr2	219845808	219850379	FEV	4571	-	NM_017521	219846388	219849797	3
chr2	219854911	219858127	CRYBA2	3216	-	NM_057094	219854973	219857898	5
chr2	219866366	219866430	MIR375	64	-	NR_029867	219866430	219866430	1
chr2	219866936	219880444	LOC100129175	13508	+	NR_046086	219880444	219880444	3
chr2	219867567	219906273	CFAP65	38706	-	NM_194302	219867658	219903770	35
chr2	219919141	219925238	IHH	6097	-	NM_002181	219919928	219925189	3
chr2	219923409	219923472	MIR3131	63	-	NR_036081	219923472	219923472	1
chr2	219940045	220025587	NHEJ1	85542	-	NM_024782	219941102	220023084	8
chr2	220026180	220034817	SLC23A3	8637	-	NM_001144889	220026630	220034706	12
chr2	220036618	220041702	CNPPD1	5084	-	NM_015680	220037307	220041550	8
chr2	220042938	220050197	FAM134A	7259	+	NM_024293	220043074	220047351	9
chr2	220071505	220074373	ZFAND2B	2868	+	NM_001270998	220071709	220074028	10
chr2	220074487	220083712	ABCB6	9225	-	NM_005689	220074659	220083395	19
chr2	220084101	220094410	ATG9A	10309	-	NM_001077198	220085168	220092746	16
chr2	220094478	220101391	ANKZF1	6913	+	NM_018089	220094979	220101167	14
chr2	220101319	220110151	GLB1L	8832	-	NM_024506	220101793	220108295	17
chr2	220110191	220115059	STK16	4868	+	NM_001008910	220110721	220113281	8
chr2	220114432	220119330	TUBA4A	4898	-	NM_001278552	220115073	220116910	4
chr2	220117964	220136910	TUBA4B	18946	+	NR_003063	220136910	220136910	4
chr2	220144039	220151622	DNAJB2	7583	+	NM_001039550	220144555	220150719	10
chr2	220154344	220174295	PTPRN	19951	-	NM_002846	220154947	220174054	23
chr2	220158832	220158922	MIR153-1	90	-	NR_029688	220158922	220158922	1
chr2	220192130	220197899	RESP18	5769	-	NM_001007089	220192238	220197899	7
chr2	220238179	220252662	DNPEP	14483	-	NM_012100	220239013	220252516	15
chr2	220283098	220291461	DES	8363	+	NM_001927	220283184	220290712	9
chr2	220299699	220358354	SPEG	58655	+	NM_005876	220299699	220357508	41
chr2	220361076	220363009	LOC100996693	1933	+	NM_001286811	220361076	220362911	4
chr2	220363586	220371718	GMPPA	8132	+	NM_013335	220364697	220371520	13
chr2	220378891	220403494	ASIC4	24603	+	NM_182847	220379065	220402768	9
chr2	220403668	220408487	CHPF	4819	-	NM_024536	220404104	220408260	4
chr2	220408384	220415317	TMEM198	6933	+	NM_001303098	220409449	220414576	6
chr2	220413794	220413869	MIR3132	75	-	NR_036082	220413869	220413869	1
chr2	220415449	220436268	OBSL1	20819	-	NM_015311	220415556	220435954	21
chr2	220436953	220440435	INHA	3482	+	NM_002191	220437096	220440248	2
chr2	220462572	220481173	STK11IP	18601	+	NM_052902	220462841	220480915	25
chr2	220492291	220506702	SLC4A3	14411	+	NM_201574	220492714	220506450	23
chr2	220771222	220771286	MIR4268	64	-	NR_036228	220771286	220771286	1
chr2	222282746	222438922	EPHA4	156176	-	NM_001304536	222290747	222436968	19
chr2	223064605	223163715	PAX3	99110	-	NM_181459	223065892	223163334	10
chr2	223162865	223169936	CCDC140	7071	+	NM_153038	223168621	223169113	2
chr2	223289321	223423617	SGPP2	134296	+	NM_152386	223289321	223423617	5
chr2	223436161	223521074	FARSB	84913	-	NR_130154	223521074	223521074	18
chr2	223536456	223574649	MOGAT1	38193	+	NM_058165	223536504	223574609	6
chr2	223725731	223808119	ACSL3	82388	+	NM_004457	223773490	223806372	17
chr2	223916647	223920357	KCNE4	3710	+	NM_080671	223916862	223918061	2
chr2	224461657	224467217	SCG2	5560	-	NM_003469	224462146	224464000	2
chr2	224620046	224702319	AP1S3	82273	-	NR_110905	224702319	224702319	6
chr2	224740059	224810104	WDFY1	70045	-	NM_020830	224743387	224810001	12
chr2	224822120	224832431	MRPL44	10311	+	NM_022915	224822189	224831751	4
chr2	224839764	224904036	SERPINE2	64272	-	NM_001136528	224840583	224866617	9
chr2	225243414	225266711	FAM124B	23297	-	NM_024785	225265135	225266485	3
chr2	225334866	225450114	CUL3	115248	-	NM_003590	225338961	225449726	16
chr2	225629806	225907330	DOCK10	277524	-	NM_014689	225630437	225907091	56
chr2	225875177	225875257	MIR4439	80	-	NR_039641	225875257	225875257	1
chr2	226265601	226518734	NYAP2	253133	+	NM_020864	226273596	226516281	6
chr2	227007509	227044778	LOC646736	37269	+	NR_046102	227044778	227044778	7
chr2	227523425	227523509	MIR5702	84	-	NR_049887	227523509	227523509	1
chr2	227596032	227663506	IRS1	67474	-	NM_005544	227659725	227663454	2
chr2	227700670	227863923	RHBDD1	163253	+	NM_001167608	227729409	227860238	9
chr2	227867426	228029275	COL4A4	161849	-	NM_000092	227872040	228012199	48
chr2	228029280	228179508	COL4A3	150228	+	NM_000091	228029442	228176586	52
chr2	228085767	228189880	LOC654841	104113	-	NR_102371	228189880	228189880	14
chr2	228189866	228222552	MFF	32686	+	NM_001277061	228194461	228221833	11
chr2	228226873	228244022	TM4SF20	17149	-	NM_024795	228228439	228243984	4
chr2	228336847	228336903	MIR5703	56	+	NR_049888	228336903	228336903	1
chr2	228336887	228425938	AGFG1	89051	+	NM_001135187	228337137	228419211	14
chr2	228474805	228498036	C2orf83	23231	-	NM_001162483	228476366	228497801	4
chr2	228549925	228582745	SLC19A3	32820	-	NM_025243	228552112	228567034	6
chr2	228678557	228682280	CCL20	3723	+	NM_001130046	228678627	228681799	4
chr2	228736326	228789026	DAW1	52700	+	NM_178821	228736405	228788684	13
chr2	228844669	229046361	SPHKAP	201692	-	NM_001142644	228846432	229046314	12
chr2	229888688	230136057	PID1	247369	-	NM_017933	229890347	230127521	4
chr2	230222344	230579286	DNER	356942	-	NM_139072	230223255	230579139	13
chr2	230628552	230786725	TRIP12	158173	-	NM_001284214	230632269	230744795	42
chr2	230787206	230877825	FBXO36	90619	+	NM_174899	230787229	230875600	4
chr2	230899689	230933715	SLC16A14	34026	-	NM_152527	230902095	230924068	5
chr2	231033644	231084827	SP110	51183	-	NM_080424	231033839	231081642	19
chr2	231090444	231177930	SP140	87486	+	NM_007237	231090559	231177399	27
chr2	231191893	231268445	SP140L	76552	+	NM_138402	231191984	231267611	19
chr2	231280870	231410317	SP100	129447	+	NM_001080391	231281011	231407661	29
chr2	231555635	231565244	LOC151475	9609	-	NR_040038	231565244	231565244	4
chr2	231577556	231685790	CAB39	108234	+	NM_016289	231624716	231683419	9
chr2	231729312	231743969	ITM2C	14657	+	NM_001287241	231729740	231742814	7
chr2	231751260	231769232	LOC151484	17972	+	NR_038238	231769232	231769232	4
chr2	231772042	231789941	GPR55	17899	-	NM_005683	231774717	231775677	2
chr2	231849082	231860747	SPATA3-AS1	11665	-	NR_033879	231860747	231860747	6
chr2	231860838	231871999	SPATA3	11161	+	NM_139073	231860948	231867504	5
chr2	231902280	231914427	C2orf72	12147	+	NM_001144994	231902280	231911736	3
chr2	231921577	232037540	PSMD1	115963	+	NM_002807	231921739	232035426	25
chr2	231972949	231989824	HTR2B	16875	-	NM_000867	231973230	231988478	4
chr2	232070912	232240590	ARMC9	169678	+	NM_001271466	232070951	232236246	24
chr2	232227418	232227504	MIR4777	86	+	NR_039937	232227504	232227504	1
chr2	232260334	232265875	B3GNT7	5541	+	NM_145236	232260514	232263636	2
chr2	232319458	232329205	NCL	9747	-	NM_005381	232319901	232329064	14
chr2	232320510	232320647	SNORA75	137	-	NR_002921	232320647	232320647	1
chr2	232321154	232321234	SNORD20	80	-	NR_002908	232321234	232321234	1
chr2	232325078	232325153	SNORD82	75	-	NR_004398	232325153	232325153	1
chr2	232373136	232379050	LINC00471	5914	-	NR_024079	232379050	232379050	3
chr2	232387870	232395182	NMUR1	7312	-	NM_006056	232389753	232395072	3
chr2	232457574	232458994	C2orf57	1420	+	NM_152614	232457662	232458850	1
chr2	232573234	232578250	PTMA	5016	+	NM_002823	232573416	232577561	5
chr2	232578023	232578105	MIR1244-1	82	+	NR_036052	232578105	232578105	1
chr2	232578023	232578105	MIR1244-2	82	+	NR_036262	232578105	232578105	1
chr2	232578023	232578105	MIR1244-3	82	+	NR_036263	232578105	232578105	1
chr2	232578023	232578105	MIR1244-4	82	+	NR_128710	232578105	232578105	1
chr2	232597134	232646037	PDE6D	48903	-	NM_002601	232597661	232645824	5
chr2	232646380	232673963	COPS7B	27583	+	NM_001282949	232646533	232672355	6
chr2	232756951	232757008	MIR1471	57	-	NR_031717	232757008	232757008	1
chr2	232786803	232791113	NPPC	4310	-	NM_024409	232790134	232790959	3
chr2	232826292	233208678	DIS3L2	382386	+	NM_001257281	232879637	233208285	14
chr2	233243243	233247599	ALPP	4356	+	NM_001632	233243512	233246505	11
chr2	233250459	233251754	ECEL1P2	1295	-	NR_028501	233251754	233251754	1
chr2	233271551	233275424	ALPPL2	3873	+	NM_031313	233271604	233274582	11
chr2	233320821	233325455	ALPI	4634	+	NM_001631	233320909	233323856	11
chr2	233344536	233352569	ECEL1	8033	-	NM_001290787	233344862	233351363	18
chr2	233385172	233390425	PRSS56	5253	+	NM_001195129	233385308	233390216	13
chr2	233390869	233401375	CHRND	10506	+	NM_000751	233390925	233400022	12
chr2	233404436	233411038	CHRNG	6602	+	NM_005199	233404457	233410426	12
chr2	233412679	233415300	TIGD1	2621	-	NM_145702	233412816	233414592	1
chr2	233415183	233415283	MIR5001	100	-	NR_049797	233415283	233415283	1
chr2	233415296	233448355	EIF4E2	33059	+	NM_001282958	233415434	233439018	8
chr2	233470766	233547491	EFHD1	76725	+	NM_001243252	233470869	233546429	4
chr2	233562014	233725289	GIGYF2	163275	+	NM_001103147	233599907	233721570	31
chr2	233630511	233641275	KCNJ13	10764	-	NM_002242	233632900	233636072	3
chr2	233734993	233741107	C2orf82	6114	+	NM_206895	233735051	233741066	3
chr2	233743395	233877951	NGEF	134556	-	NM_019850	233744198	233839600	15
chr2	233897381	233899767	NEU2	2386	+	NM_005383	233897381	233899767	2
chr2	233924676	234116549	INPP5D	191873	+	NM_001017915	233925188	234115354	26
chr2	234160216	234204320	ATG16L1	44104	+	NM_001190267	234172670	234202996	18
chr2	234184371	234184649	SCARNA5	278	+	NR_003008	234184649	234184649	1
chr2	234197321	234197587	SCARNA6	266	+	NR_003006	234197587	234197587	1
chr2	234216308	234255701	SAG	39393	+	NM_000541	234217835	234255558	16
chr2	234263152	234380743	DGKD	117591	+	NM_152879	234263164	234378106	30
chr2	234384164	234474236	USP40	90072	-	NM_018218	234386037	234474236	31
chr2	234526290	234681945	UGT1A8	155655	+	NM_019076	234526353	234681205	5
chr2	234545122	234681951	UGT1A10	136829	+	NM_019075	234545168	234681205	5
chr2	234580543	234681951	UGT1A9	101408	+	NM_021027	234580580	234681205	5
chr2	234590583	234681945	UGT1A7	91362	+	NM_019077	234590583	234681205	5
chr2	234600320	234681945	UGT1A6	81625	+	NM_205862	234602451	234681205	6
chr2	234621637	234681945	UGT1A5	60308	+	NM_019078	234621637	234681205	5
chr2	234627437	234681945	UGT1A4	54508	+	NM_007120	234627466	234681205	5
chr2	234637772	234681945	UGT1A3	44173	+	NM_019093	234637772	234681205	5
chr2	234651395	234652661	DNAJB3	1266	-	NM_001001394	234652124	234652562	1
chr2	234662961	234663991	LOC100286922	1030	-	NR_037696	234663991	234663991	2
chr2	234668918	234681945	UGT1A1	13027	+	NM_000463	234668933	234681205	5
chr2	234684324	234742069	MROH2A	57745	+	NM_001287395	234688004	234741905	42
chr2	234745346	234763212	HJURP	17866	-	NM_018410	234746222	234763146	9
chr2	234774089	234777055	MSL3P1	2966	-	NR_024322	234777055	234777055	2
chr2	234826042	234928166	TRPM8	102124	+	NM_024080	234835182	234923256	26
chr2	234959345	234985776	SPP2	26431	+	NM_006944	234959430	234978657	8
chr2	235401685	235405697	ARL4C	4012	-	NM_001282431	235404449	235405230	2
chr2	235591311	235626408	LINC01173	35097	+	NR_132376	235626408	235626408	3
chr2	235860627	235964358	SH3BP4	103731	+	NM_014521	235943646	235962460	6
chr2	236402732	237040444	AGAP1	637712	+	NM_001037131	236403330	237032766	18
chr2	236414394	236416210	AGAP1-IT1	1816	+	NR_131900	236416210	236416210	2
chr2	237073878	237076652	GBX2	2774	-	NM_001301687	237074971	237076614	3
chr2	237103514	237172988	ASB18	69474	-	NM_212556	237103514	237172988	6
chr2	237232789	237416178	IQCA1	183389	-	NR_073043	237416178	237416178	20
chr2	237478379	237490994	ACKR3	12615	+	NM_020311	237489108	237490197	2
chr2	237994083	238007489	COPS8	13406	+	NM_198189	237995838	238006385	9
chr2	238232654	238322850	COL6A3	90196	-	NM_004369	238233416	238305460	44
chr2	238395052	238463961	MLPH	68909	+	NM_001281474	238402069	238462235	14
chr2	238419573	238419631	MIR6811	58	+	NR_106869	238419631	238419631	1
chr2	238475216	238475818	PRLH	602	+	NM_015893	238475216	238475818	2
chr2	238482964	238499769	RAB17	16805	-	NM_022449	238483661	238494797	6
chr2	238536223	238690290	LRRFIP1	154067	+	NM_001137550	238536287	238688175	24
chr2	238707387	238751451	RBM44	44064	+	NM_001080504	238722249	238743044	16
chr2	238768186	238820759	RAMP1	52573	+	NM_001308353	238785879	238820425	4
chr2	238875586	238951423	UBE2F	75837	+	NR_103500	238951423	238951423	11
chr2	238875586	239008054	UBE2F-SCLY	132468	+	NR_037904	239008054	239008054	19
chr2	238969564	239008054	SCLY	38490	+	NM_016510	238969671	239006996	12
chr2	239008950	239041928	ESPNL	32978	+	NM_194312	239009060	239040373	9
chr2	239047362	239061547	KLHL30	14185	+	NM_198582	239049395	239059706	8
chr2	239067648	239077532	FAM132B	9884	+	NM_001291832	239067648	239075695	8
chr2	239079042	239112324	ILKAP	33282	-	NM_030768	239079176	239112194	12
chr2	239133753	239140318	LOC151174	6565	-	NR_026926	239140318	239140318	3
chr2	239140326	239142985	LOC643387	2659	+	NR_026923	239142985	239142985	1
chr2	239146907	239148765	HES6	1858	-	NM_018645	239147467	239148546	4
chr2	239152678	239197207	PER2	44529	-	NM_022817	239155015	239186577	23
chr2	239229184	239309541	TRAF3IP1	80357	+	NM_015650	239229303	239307560	17
chr2	239335625	239360891	ASB1	25266	+	NM_001040445	239335711	239355152	5
chr2	239419330	239464140	LINC01107	44810	-	NR_037809	239464140	239464140	3
chr2	239756672	239832244	TWIST2	75572	+	NM_001271893	239756856	239757339	2
chr2	239840997	239847965	FLJ43879	6968	-	NR_034162	239847965	239847965	10
chr2	239969863	240322643	HDAC4	352780	-	NM_006037	239974792	240274394	27
chr2	239990512	239990610	MIR4440	98	-	NR_039642	239990610	239990610	1
chr2	240007522	240007622	MIR4441	100	-	NR_039643	240007622	240007622	1
chr2	240115026	240117153	MGC16025	2127	-	NR_026664	240117153	240117153	1
chr2	240227156	240227240	MIR4269	84	+	NR_036229	240227240	240227240	1
chr2	240273418	240273499	MIR2467	81	-	NR_039948	240273499	240273499	1
chr2	240684553	240722356	LOC150935	37803	+	NR_037808	240722356	240722356	3
chr2	240882431	240882511	MIR4786	80	-	NR_039949	240882511	240882511	1
chr2	240896788	240964819	NDUFA10	68031	-	NM_004544	240900534	240964718	10
chr2	240968907	240969846	OR6B2	939	-	NM_001005853	240968907	240969846	1
chr2	240981229	240982399	PRR21	1170	-	NM_001080835	240981229	240982399	1
chr2	240984493	240985489	OR6B3	996	-	NM_173351	240984493	240985489	1
chr2	241065979	241075764	MYEOV2	9785	-	NM_138336	241065979	241075764	5
chr2	241078445	241080073	OTOS	1628	-	NM_148961	241078586	241079743	4
chr2	241375114	241407495	GPC1	32381	+	NM_002081	241375335	241405707	9
chr2	241388835	241396117	PP14571	7282	-	NR_024014	241396117	241396117	2
chr2	241395417	241395506	MIR149	89	+	NR_029702	241395506	241395506	1
chr2	241418838	241500527	ANKMY1	81689	-	NM_001308375	241419025	241500367	15
chr2	241499470	241503431	DUSP28	3961	+	NM_001033575	241500101	241500884	3
chr2	241508003	241518149	RNPEPL1	10146	+	NM_018226	241508003	241517309	11
chr2	241522166	241525733	CAPN10-AS1	3567	-	NR_103792	241525733	241525733	1
chr2	241526132	241538526	CAPN10	12394	+	NM_023083	241526328	241538097	12
chr2	241544824	241570676	GPR35	25852	+	NM_001195382	241558359	241570299	6
chr2	241615834	241622317	AQP12B	6483	-	NM_001102467	241615961	241622254	3
chr2	241631261	241637900	AQP12A	6639	+	NM_198998	241631330	241637773	4
chr2	241653180	241759725	KIF1A	106545	-	NM_001244008	241656780	241737169	49
chr2	241808161	241818536	AGXT	10375	+	NM_000030	241808282	241818238	11
chr2	241825464	241835573	C2orf54	10109	-	NM_001085437	241826486	241835414	5
chr2	241894035	241906868	LOC200772	12833	-	NR_033841	241906868	241906868	9
chr2	241938254	242033643	SNED1	95389	+	NM_001080437	241938254	242027816	32
chr2	242026508	242041747	MTERF4	15239	-	NR_028049	242041747	242041747	7
chr2	242045513	242089394	PASK	43881	-	NM_001252120	242045980	242082447	19
chr2	242088987	242123065	PPP1R7	34078	+	NM_001282412	242089119	242122238	10
chr2	242127923	242164791	ANO7	36868	+	NM_001001891	242128026	242163568	25
chr2	242166681	242255115	HDLBP	88434	-	NM_005336	242169015	242206284	28
chr2	242254601	242293441	SEPT2	38840	+	NM_001008491	242263647	242289589	14
chr2	242295663	242434257	FARP2	138594	+	NM_014808	242312522	242433540	27
chr2	242417319	242417397	MIR3133	78	+	NR_036083	242417397	242417397	1
chr2	242434121	242448987	STK25	14866	-	NM_001282305	242435076	242440190	11
chr2	242483800	242498558	BOK-AS1	14758	-	NR_033346	242498558	242498558	2
chr2	242498145	242513553	BOK	15408	+	NM_032515	242498898	242511837	5
chr2	242523819	242576725	THAP4	52906	-	NM_015963	242524020	242576432	6
chr2	242577026	242613271	ATG4B	36245	+	NM_013325	242577129	242611679	13
chr2	242615156	242626383	DTYMK	11227	-	NM_012145	242615541	242626198	5
chr2	242641455	242668896	ING5	27441	+	NM_032329	242641480	242664446	8
chr2	242673993	242708231	D2HGDH	34238	+	NM_152783	242674639	242707384	10
chr2	242716239	242743702	GAL3ST2	27463	+	NM_022134	242716370	242743581	4
chr2	242750159	242758739	NEU4	8580	+	NM_001167600	242755681	242758374	4
chr2	242792032	242801058	PDCD1	9026	-	NM_005018	242793209	242800990	5
chr2	242811885	242815482	RTP5	3597	+	NM_173821	242811908	242815426	2
chr2	242823513	243020873	LINC01237	197360	+	NR_110220	243020873	243020873	4
chr2	242912833	242919427	LOC102723927	6594	+	NR_110592	242919427	242919427	6
chr2	243030783	243102476	LOC728323	71693	+	NR_130699	243102476	243102476	8
chr3	65430	66175	LOC102723448	745	+	NR_110824	66175	66175	2
chr3	238278	451097	CHL1	212819	+	NM_006614	361459	447394	28
chr3	405055	427478	CHL1-AS1	22423	-	NR_110739	427478	427478	3
chr3	633787	887698	LINC01266	253911	+	NR_110118	887698	887698	4
chr3	1134341	1445292	CNTN6	310951	+	NM_001289080	1189692	1445102	23
chr3	2140549	3099645	CNTN4	959096	+	NM_175607	2613187	3097904	25
chr3	2152092	2185925	CNTN4-AS2	33833	-	NR_046555	2185925	2185925	3
chr3	3081344	3102829	CNTN4-AS1	21485	-	NR_046554	3102829	3102829	4
chr3	3108007	3152058	IL5RA	44051	-	NM_000564	3111908	3146668	13
chr3	3168599	3190706	TRNT1	22107	+	NM_182916	3170724	3189838	8
chr3	3191316	3221401	CRBN	30085	-	NM_001173482	3192548	3221371	11
chr3	3841120	3889387	LRRN1	48267	+	NM_020873	3886325	3888476	2
chr3	4344987	4358949	SETMAR	13962	+	NM_001243723	4345054	4358930	4
chr3	4402828	4508966	SUMF1	106138	-	NM_182760	4403827	4508929	9
chr3	4532000	4534847	ITPR1-AS1	2847	-	NR_108075	4534847	4534847	2
chr3	4535031	4889524	ITPR1	354493	+	NM_001168272	4558175	4887909	61
chr3	4790877	4793274	EGOT	2397	-	NR_004428	4793274	4793274	2
chr3	4938492	5021646	BHLHE40-AS1	83154	-	NR_125915	5021646	5021646	4
chr3	5021096	5026865	BHLHE40	5769	+	NM_003670	5021403	5025377	5
chr3	5163929	5222601	ARL8B	58672	+	NM_018184	5164150	5220398	7
chr3	5229358	5261650	EDEM1	32292	+	NM_014674	5229490	5257603	12
chr3	5291861	5291940	MIR4790	79	-	NR_039953	5291940	5291940	1
chr3	6674044	6847136	GRM7-AS3	173092	-	NR_110123	6847136	6847136	4
chr3	6902801	7783218	GRM7	880417	+	NM_181874	6903075	7728114	11
chr3	6934323	6935704	GRM7-AS2	1381	-	NR_131906	6935704	6935704	2
chr3	7561427	7576971	GRM7-AS1	15544	-	NR_046606	7576971	7576971	3
chr3	7994491	8057994	LOC101927394	63503	-	NR_110131	8057994	8057994	4
chr3	8262833	8543344	LMCD1-AS1	280511	-	NR_033378	8543344	8543344	4
chr3	8543492	8609811	LMCD1	66319	+	NM_014583	8543624	8609284	6
chr3	8613467	8616354	LINC00312	2887	+	NR_024065	8616354	8616354	1
chr3	8661085	8693764	SSUH2	32679	-	NM_001256749	8661553	8675471	12
chr3	8775485	8788451	CAV3	12966	+	NM_001234	8775562	8787553	3
chr3	8792094	8811300	OXTR	19206	-	NM_000916	8794662	8809873	4
chr3	8918879	9005159	RAD18	86280	-	NM_020165	8923040	9005069	13
chr3	9022275	9291369	SRGAP3	269094	-	NM_001033117	9027202	9290635	22
chr3	9234176	9236137	LOC101927416	1961	+	NR_121663	9236137	9236137	3
chr3	9258578	9261192	SRGAP3-AS3	2614	+	NR_103443	9261192	9261192	5
chr3	9404716	9428475	THUMPD3	23759	+	NM_001114092	9406752	9426372	10
chr3	9426947	9438307	THUMPD3-AS1	11360	-	NR_132781	9438307	9438307	4
chr3	9439383	9519838	SETD5	80455	+	NM_001292043	9476511	9517775	25
chr3	9540044	9595486	LHFPL4	55442	-	NM_198560	9543894	9594363	4
chr3	9691116	9744078	MTMR14	52962	+	NM_001077525	9691267	9743657	19
chr3	9745509	9771592	CPNE9	26083	+	NM_153635	9745680	9771376	20
chr3	9773433	9789699	BRPF1	16266	+	NM_004634	9775824	9789033	14
chr3	9791627	9808353	OGG1	16726	+	NM_016829	9791970	9800938	8
chr3	9799028	9811668	CAMK1	12640	-	NM_003656	9799222	9809433	12
chr3	9821647	9834695	TADA3	13048	-	NM_006354	9822040	9833150	9
chr3	9834178	9848789	ARPC4	14611	+	NM_001024960	9843380	9847899	6
chr3	9834231	9878040	ARPC4-TTLL3	43809	+	NM_001198793	9834805	9876505	12
chr3	9851643	9878040	TTLL3	26397	+	NM_001025930	9851690	9877173	13
chr3	9879532	9885702	RPUSD3	6170	-	NM_173659	9879699	9885698	9
chr3	9908393	9921938	CIDEC	13545	-	NM_001199551	9908817	9920170	7
chr3	9932270	9936031	JAGN1	3761	+	NM_032492	9932406	9935061	2
chr3	9944295	9958084	IL17RE	13789	+	NM_153483	9944299	9957491	17
chr3	9958757	9975305	IL17RC	16548	+	NM_153460	9958999	9975277	19
chr3	9975523	9987097	CRELD1	11574	+	NM_015513	9976122	9986263	10
chr3	9987225	9994078	PRRT3	6853	-	NM_207351	9987910	9991799	4
chr3	9989087	9996471	PRRT3-AS1	7384	+	NR_046734	9996471	9996471	4
chr3	10005635	10028522	EMC3	22887	-	NM_018447	10005752	10028345	8
chr3	10028576	10048687	EMC3-AS1	20111	+	NR_103821	10048687	10048687	3
chr3	10048101	10052779	LOC401052	4678	-	NM_001008737	10049027	10050164	4
chr3	10059236	10067820	CIDECP	8584	-	NR_002786	10067820	10067820	3
chr3	10068112	10143614	FANCD2	75502	+	NM_001018115	10070341	10142946	44
chr3	10123003	10149915	FANCD2OS	26912	-	NM_173472	10145924	10146458	3
chr3	10157332	10168874	BRK1	11542	+	NM_018462	10157385	10167979	3
chr3	10183318	10195354	VHL	12036	+	NM_000551	10183531	10191649	3
chr3	10206562	10285427	IRAK2	78865	+	NM_001570	10206638	10283912	13
chr3	10290176	10322906	TATDN2	32730	+	NM_014760	10290884	10320709	8
chr3	10322635	10335133	GHRLOS	12498	+	NR_073566	10335133	10335133	7
chr3	10326102	10327430	LINC00852	1328	+	NR_026829	10327430	10327430	1
chr3	10327433	10334631	GHRL	7198	-	NM_001302821	10327558	10331864	7
chr3	10342612	10362872	SEC13	20260	-	NM_030673	10342944	10360834	10
chr3	10365706	10547268	ATP2B2	181562	-	NM_001001331	10370497	10491227	23
chr3	10371912	10371969	MIR378B	57	+	NR_036084	10371969	10371969	1
chr3	10436172	10436246	MIR885	74	-	NR_030614	10436246	10436246	1
chr3	10667700	10668492	ATP2B2-IT2	792	-	NR_046766	10668492	10668492	2
chr3	10801168	10805877	LINC00606	4709	-	NR_027102	10805877	10805877	3
chr3	10857884	10982419	SLC6A11	124535	+	NM_014229	10857950	10980088	14
chr3	11034419	11080935	SLC6A1	46516	+	NM_003042	11058897	11078652	16
chr3	11047783	11060910	SLC6A1-AS1	13127	-	NR_046647	11060910	11060910	3
chr3	11178778	11304939	HRH1	126161	+	NM_001098213	11300723	11302187	2
chr3	11314009	11599139	ATG7	285130	+	NM_006395	11340169	11596317	19
chr3	11597540	11762242	VGLL4	164702	-	NM_001284390	11600029	11712814	7
chr3	11831915	11888393	TAMM41	56478	-	NR_104314	11888393	11888393	10
chr3	12045833	12233532	SYN2	187699	+	NM_133625	12046025	12232125	14
chr3	12194567	12200851	TIMP4	6284	-	NM_003256	12195014	12200340	5
chr3	12329348	12475855	PPARG	146507	+	NM_138712	12421204	12475644	8
chr3	12525930	12574820	TSEN2	48890	+	NM_001145394	12531299	12574220	13
chr3	12581279	12586963	MKRN2OS	5684	-	NM_001195279	12581691	12586963	4
chr3	12598512	12625210	MKRN2	26698	+	NM_014160	12598649	12623752	8
chr3	12625099	12705700	RAF1	80601	-	NM_002880	12626012	12660220	17
chr3	12775028	12810956	TMEM40	35928	-	NM_001284406	12776272	12810789	12
chr3	12838170	12876313	CAND2	38143	+	NM_001162499	12838219	12875481	15
chr3	12876443	12883081	RPL32	6638	-	NM_001007073	12877592	12881736	4
chr3	12881810	12881949	SNORA7A	139	-	NR_002582	12881949	12881949	1
chr3	12938541	13114617	IQSEC1	176076	-	NM_001134382	12942481	13114514	15
chr3	13357729	13461819	NUP210	104090	-	NM_024923	13359180	13461726	40
chr3	13518487	13521553	HDAC11-AS1	3066	-	NR_046690	13521553	13521553	2
chr3	13521714	13547924	HDAC11	26210	+	NM_024827	13521847	13546183	10
chr3	13590624	13679922	FBLN2	89298	+	NM_001004019	13611855	13679419	18
chr3	13659880	13660048	SNORA93	168	+	NR_132775	13660048	13660048	1
chr3	13692220	13788132	LINC00620	95912	+	NR_027103	13788132	13788132	6
chr3	13860081	13921618	WNT7A	61537	-	NM_004625	13860440	13921313	4
chr3	13974552	13978444	FGD5P1	3892	+	NR_036481	13978444	13978444	2
chr3	13978806	14107481	TPRXL	128675	+	NR_002223	14107481	14107481	3
chr3	14153576	14166371	CHCHD4	12795	-	NM_144636	14154386	14163477	4
chr3	14166439	14185180	TMEM43	18741	+	NM_024334	14166693	14183295	12
chr3	14186647	14220172	XPC	33525	-	NM_004628	14187440	14220068	16
chr3	14220227	14239869	LSM3	19642	+	NM_014463	14220360	14239616	4
chr3	14389950	14394068	LINC01267	4118	-	NR_110135	14394068	14394068	3
chr3	14444075	14530857	SLC6A6	86782	+	NM_001134367	14444093	14526515	23
chr3	14530618	14581850	GRIP2	51232	-	NM_001080423	14535172	14581815	24
chr3	14693252	14714166	CCDC174	20914	+	NM_016474	14693343	14712701	11
chr3	14716605	14814543	C3orf20	97938	+	NM_001184958	14724586	14814382	17
chr3	14860468	14976072	FGD5	115604	+	NM_152536	14860578	14974674	20
chr3	14984285	14989948	FGD5-AS1	5663	-	NR_046251	14989948	14989948	2
chr3	14989090	15090786	NR2C2	101696	+	NM_003298	15045421	15084515	15
chr3	15090018	15106816	MRPS25	16798	-	NM_022497	15093947	15106701	4
chr3	15111575	15140664	RBSN	29089	-	NM_022340	15115288	15137627	14
chr3	15206868	15247466	COL6A4P1	40598	-	NR_027927	15247466	15247466	5
chr3	15247732	15294423	CAPN7	46691	+	NM_014296	15248002	15292767	21
chr3	15295690	15306005	SH3BP5-AS1	10315	+	NR_046084	15306005	15306005	3
chr3	15295862	15382901	SH3BP5	87039	-	NM_001018009	15297592	15311243	9
chr3	15451266	15469054	METTL6	17788	-	NM_152396	15452762	15468018	6
chr3	15469063	15484120	EAF1	15057	+	NM_033083	15469286	15480662	6
chr3	15491639	15563258	COLQ	71619	-	NM_005677	15493150	15563132	17
chr3	15537745	15537815	MIR4270	70	-	NR_036232	15537815	15537815	1
chr3	15602210	15643359	HACL1	41149	-	NM_012260	15602371	15642970	17
chr3	15642858	15687328	BTD	44470	+	NM_001281723	15643227	15686995	4
chr3	15708743	15901053	ANKRD28	192310	-	NM_015199	15711776	15900910	28
chr3	15915277	15915356	MIR563	79	+	NR_030289	15915356	15915356	1
chr3	16216183	16271253	GALNT15	55070	+	NM_054110	16216658	16269007	10
chr3	16298567	16306496	DPH3	7929	-	NM_206831	16302270	16306383	3
chr3	16306666	16347594	OXNAD1	40928	+	NM_138381	16312459	16345069	9
chr3	16357351	16555222	RFTN1	197871	-	NM_015150	16358334	16535376	10
chr3	16577824	16582880	LINC00690	5056	+	NR_103843	16582880	16582880	3
chr3	16628300	16647006	DAZL	18706	-	NM_001351	16630166	16646712	11
chr3	16926451	17132098	PLCL2	205647	+	NM_001144382	16926534	17131404	8
chr3	16974687	16974752	MIR3714	65	+	NR_037465	16974752	16974752	1
chr3	17198653	17782399	TBC1D5	583746	-	NM_014744	17202454	17550062	22
chr3	18004063	18310410	LOC339862	306347	+	NM_001257177	18004177	18308535	5
chr3	18389132	18480265	SATB1	91133	-	NM_001131010	18390661	18462459	11
chr3	18486728	18571606	SATB1-AS1	84878	+	NR_125803	18571606	18571606	7
chr3	19190016	19577135	KCNH8	387119	+	NM_144633	19190211	19575591	16
chr3	19356339	19356423	MIR4791	84	-	NR_039954	19356423	19356423	1
chr3	19920965	19975706	EFHB	54741	-	NM_144715	19921122	19975510	13
chr3	19988571	20026667	RAB5A	38096	+	NM_001292048	19992390	20025315	6
chr3	20021452	20053765	PP2D1	32313	-	NR_027694	20053765	20053765	4
chr3	20081523	20195896	KAT2B	114373	+	NM_003884	20081969	20194017	18
chr3	20179056	20179133	MIR3135A	77	+	NR_036086	20179133	20179133	1
chr3	20202084	20227725	SGOL1	25641	-	NM_001012412	20202596	20225519	9
chr3	20215777	20227607	SGOL1-AS1	11830	+	NR_132785	20227607	20227607	4
chr3	20383959	20392420	LOC101927829	8461	+	NR_110814	20392420	20392420	5
chr3	21447217	21448177	VENTXP7	960	+	NR_002311	21448177	21448177	1
chr3	21462489	21792816	ZNF385D	330327	-	NM_024697	21462705	21792408	8
chr3	21584280	21621451	ZNF385D-AS1	37171	+	NR_046731	21621451	21621451	3
chr3	21998630	22021320	ZNF385D-AS2	22690	+	NR_046876	22021320	22021320	4
chr3	23244783	23632296	UBE2E2	387513	+	NM_152653	23250190	23631322	6
chr3	23375625	23648882	MIR548AC	273257	+	NR_039621	23648882	23648882	3
chr3	23845514	23848396	UBE2E1-AS1	2882	-	NR_046652	23848396	23848396	2
chr3	23847383	23933131	UBE2E1	85748	+	NM_003341	23848760	23932097	6
chr3	23933571	23958537	NKIRAS1	24966	-	NM_020345	23934585	23952395	5
chr3	23958294	23965187	RPL15	6893	+	NM_001253384	23959350	23963166	5
chr3	23986750	24022109	NR1D2	35359	+	NR_110524	24022109	24022109	9
chr3	24141464	24144738	LINC00691	3274	-	NR_026834	24144738	24144738	2
chr3	24158644	24536313	THRB	377669	-	NM_001252634	24164374	24270450	12
chr3	24192814	24231447	LOC101927854	38633	+	NR_121667	24231447	24231447	4
chr3	24535577	24541502	THRB-AS1	5925	+	NR_046244	24541502	24541502	2
chr3	24562852	24562926	MIR4792	74	-	NR_039955	24562926	24562926	1
chr3	25215822	25639422	RARB	423600	+	NM_001290216	25215888	25638107	8
chr3	25639395	25705863	TOP2B	66468	-	NM_001068	25639797	25705788	36
chr3	25706363	25706430	MIR4442	67	-	NR_039644	25706430	25706430	1
chr3	25760434	25831530	NGLY1	71096	-	NM_001145294	25760950	25831356	12
chr3	25831562	25836025	OXSM	4463	+	NM_001145391	25832511	25835985	4
chr3	25900022	25915186	LINC00692	15164	-	NR_034055	25915186	25915186	8
chr3	26664296	26752265	LRRC3B	87969	+	NM_052953	26751163	26751943	2
chr3	27152393	27410951	NEK10	258558	-	NM_152534	27152762	27394373	39
chr3	27414211	27525911	SLC4A7	111700	-	NM_001258379	27418254	27525617	25
chr3	27757439	27764206	EOMES	6767	-	NM_005442	27758560	27763785	6
chr3	27872376	27875627	LOC100996624	3251	-	NR_132438	27875627	27875627	2
chr3	28283123	28361263	CMC1	78140	+	NM_182523	28283284	28361120	4
chr3	28363843	28390618	AZI2	26775	-	NM_001271650	28365532	28379986	9
chr3	28390639	28566632	ZCWPW2	175993	+	NM_001040432	28454559	28566179	10
chr3	28616768	28799828	LINC00693	183060	+	NR_038840	28799828	28799828	5
chr3	29305684	29322430	RBMS3-AS3	16746	-	NR_109804	29322430	29322430	3
chr3	29322802	30051886	RBMS3	729084	+	NM_001003793	29323172	30045353	15
chr3	29968301	29975647	RBMS3-AS1	7346	-	NR_046556	29975647	29975647	3
chr3	30647993	30735633	TGFBR2	87640	+	NM_001024847	30648375	30733091	8
chr3	30767691	30936153	GADL1	168462	-	NM_207359	30769733	30936106	15
chr3	31203195	31203279	MIR466	84	-	NR_130459	31203279	31203279	1
chr3	31573992	31679114	STT3B	105122	+	NM_178862	31574490	31677556	16
chr3	31702316	32023342	OSBPL10	321026	-	NM_017784	31703563	32022671	12
chr3	31745704	31763078	OSBPL10-AS1	17374	+	NR_049771	31763078	31763078	5
chr3	32023265	32033228	ZNF860	9963	+	NM_001137674	32030571	32032470	2
chr3	32148002	32210207	GPD1L	62205	+	NM_015141	32148203	32207402	8
chr3	32280170	32411813	CMTM8	131643	+	NM_178868	32280464	32411459	4
chr3	32433162	32496333	CMTM7	63171	+	NM_138410	32433398	32495746	5
chr3	32522803	32544403	CMTM6	21600	-	NM_017801	32525451	32544237	4
chr3	32567462	32612366	DYNC1LI1	44904	-	NM_016141	32568290	32612262	13
chr3	32726636	32815367	CNOT10	88731	+	NM_015442	32726952	32815103	19
chr3	32859509	32933771	TRIM71	74262	+	NM_001039111	32859572	32933303	4
chr3	32993065	32996403	CCR4	3338	+	NM_005508	32994914	32995997	2
chr3	33038099	33138722	GLB1	100623	-	NM_001317040	33038536	33138577	17
chr3	33131907	33138293	TMPPE	6386	-	NM_001039770	33134325	33135687	2
chr3	33155449	33189265	CRTAP	33816	+	NM_006371	33155569	33183940	7
chr3	33191536	33260707	SUSD5	69171	-	NM_015551	33194233	33260289	5
chr3	33318933	33428757	FBXL2	109824	+	NM_012157	33319004	33427100	15
chr3	33429828	33481897	UBP1	52069	-	NM_001128161	33431822	33481340	17
chr3	33537738	33759705	CLASP2	221967	-	NM_015097	33540122	33759494	39
chr3	33840062	33911199	PDCD6IP	71137	+	NM_001162429	33840220	33908017	18
chr3	34917288	35435515	LOC101928135	518227	-	NR_110817	35435515	35435515	4
chr3	35682509	35835988	ARPP21	153479	+	NM_001267617	35723243	35835450	19
chr3	35785967	35786051	MIR128-2	84	+	NR_029824	35786051	35786051	1
chr3	36421978	36589498	STAC	167520	+	NM_003149	36422135	36587781	11
chr3	36753912	36781352	DCLK3	27440	-	NM_033403	36756818	36780150	5
chr3	36868307	36986548	TRANK1	118241	-	NM_014831	36869765	36986300	23
chr3	37027356	37034795	EPM2AIP1	7439	-	NM_014805	37032744	37034568	1
chr3	37034840	37092337	MLH1	57497	+	NM_000249	37035038	37092144	19
chr3	37094116	37217851	LRRFIP2	123735	-	NM_001134369	37095341	37190474	15
chr3	37284681	37408370	GOLGA4	123689	+	NM_002078	37285041	37402763	24
chr3	37440967	37476988	C3orf35	36021	+	NR_126512	37476988	37476988	7
chr3	37493812	37861281	ITGA9	367469	+	NM_002207	37493865	37860480	28
chr3	37795179	37903271	ITGA9-AS1	108092	-	NR_110531	37903271	37903271	4
chr3	37903668	38025960	CTDSPL	122292	+	NM_001008392	37903690	38022358	8
chr3	38010894	38010971	MIR26A1	77	+	NR_029499	38010971	38010971	1
chr3	38035077	38048676	VILL	13599	+	NM_015873	38035163	38048546	19
chr3	38048986	38071154	PLCD1	22168	-	NM_006225	38049263	38071030	15
chr3	38080695	38164228	DLEC1	83533	+	NM_007335	38080716	38163903	37
chr3	38164200	38178733	ACAA1	14533	-	NM_001607	38164537	38178526	12
chr3	38179968	38184512	MYD88	4544	+	NM_001172567	38180152	38182777	5
chr3	38207025	38296979	OXSR1	89954	+	NM_005109	38207367	38294382	18
chr3	38307297	38319806	SLC22A13	12509	+	NM_004256	38307351	38318956	10
chr3	38347444	38359859	SLC22A14	12415	+	NM_004803	38347517	38359740	10
chr3	38388250	38456467	XYLB	68217	+	NM_005108	38388359	38454504	19
chr3	38492517	38496311	ACVR2B-AS1	3794	-	NR_028389	38496311	38496311	2
chr3	38495789	38534633	ACVR2B	38844	+	NM_001106	38495813	38524823	11
chr3	38537762	38567796	EXOG	30034	+	NM_005107	38537858	38565853	6
chr3	38589552	38691164	SCN5A	101612	-	NM_001160160	38591811	38674798	28
chr3	38738836	38835501	SCN10A	96665	-	NM_006514	38738839	38835501	27
chr3	38887259	38995142	SCN11A	107883	-	NM_001287223	38888184	38991853	27
chr3	39093476	39138161	WDR48	44685	+	NM_001303403	39093516	39136234	19
chr3	39138089	39149854	GORASP1	11765	-	NM_031899	39139726	39149032	9
chr3	39149151	39180394	TTC21A	31243	+	NM_145755	39149328	39180279	29
chr3	39179696	39179757	MIR6822	61	+	NR_106880	39179757	39179757	1
chr3	39183341	39195102	CSRNP1	11761	-	NM_033027	39184545	39188173	5
chr3	39224705	39234087	XIRP1	9382	-	NM_001198621	39227143	39230936	3
chr3	39304984	39323226	CX3CR1	18242	-	NM_001171174	39306932	39323186	2
chr3	39371196	39375171	CCR8	3975	+	NM_005201	39373822	39374890	2
chr3	39424814	39438819	SLC25A38	14005	+	NM_017875	39425215	39438011	7
chr3	39448179	39454032	RPSA	5853	+	NM_002295	39449144	39453859	7
chr3	39449881	39450030	SNORA6	149	+	NR_002325	39450030	39450030	1
chr3	39452544	39452698	SNORA62	154	+	NR_002324	39452698	39452698	1
chr3	39509063	39570988	MOBP	61925	+	NR_103505	39570988	39570988	7
chr3	39850404	40301811	MYRIP	451407	+	NM_001284423	39942307	40299657	17
chr3	40214637	40351189	EIF1B-AS1	136552	-	NR_033965	40351189	40351189	3
chr3	40351172	40353915	EIF1B	2743	+	NM_005875	40351432	40353505	4
chr3	40428646	40470117	ENTPD3	41471	+	NM_001248	40429548	40468999	11
chr3	40432441	40494799	ENTPD3-AS1	62358	-	NR_040100	40494799	40494799	4
chr3	40498782	40503863	RPL14	5081	+	NM_003973	40498851	40503723	6
chr3	40518603	40531728	ZNF619	13125	+	NM_001145082	40519470	40529732	6
chr3	40547529	40559712	ZNF620	12183	+	NM_175888	40547843	40558354	5
chr3	40566368	40581285	ZNF621	14917	+	NM_001287245	40567331	40579814	6
chr3	41240941	41281939	CTNNB1	40998	+	NM_001098209	41265559	41280833	16
chr3	41288089	42003660	ULK4	715571	-	NM_017886	41288419	41996251	37
chr3	42132745	42267382	TRAK1	134637	+	NM_001042646	42132961	42265229	16
chr3	42299315	42307687	CCK	8372	-	NM_000729	42299589	42305122	5
chr3	42438569	42452094	LYZL4	13525	-	NM_001304386	42438756	42448743	5
chr3	42530790	42579065	VIPR1	48275	+	NM_001251882	42555285	42577773	14
chr3	42572387	42574098	VIPR1-AS1	1711	-	NR_046654	42574098	42574098	3
chr3	42589458	42642572	SEC22C	53114	-	NM_001201572	42590107	42610538	7
chr3	42632297	42636490	SS18L2	4193	+	NM_016305	42632389	42636001	3
chr3	42642146	42690233	NKTR	48087	+	NM_005385	42642498	42687467	17
chr3	42653801	42695880	LOC101928323	42079	-	NR_125400	42695880	42695880	3
chr3	42695175	42709072	ZBTB47	13897	+	NM_145166	42699847	42706090	6
chr3	42727010	42733938	KLHL40	6928	+	NM_152393	42727110	42733485	6
chr3	42734154	42744319	HHATL	10165	-	NM_020707	42734242	42742318	12
chr3	42749873	42814745	CCDC13	64872	-	NM_144719	42750471	42799837	16
chr3	42774066	42786650	CCDC13-AS1	12584	+	NR_046732	42786650	42786650	4
chr3	42812103	42815126	LOC729083	3023	+	NR_122070	42815126	42815126	2
chr3	42824399	42846027	HIGD1A	21628	-	NM_014056	42826762	42835745	4
chr3	42850963	42908775	ACKR2	57812	+	NM_001296	42905994	42907149	3
chr3	42913683	42917633	CYP8B1	3950	-	NM_004391	42915802	42917308	1
chr3	42947401	42960825	ZNF662	13424	+	NM_207404	42949606	42956846	5
chr3	42975735	42978277	KRBOX1-AS1	2542	-	NR_122033	42978277	42978277	2
chr3	42977833	42984283	KRBOX1	6450	+	NM_001205272	42980387	42984139	5
chr3	43020758	43099207	FAM198A	78449	+	NM_001129908	43021134	43097878	5
chr3	43120720	43147575	POMGNT2	26855	-	NM_032806	43121180	43122923	2
chr3	43328003	43392634	SNRK	64631	+	NM_017719	43344695	43390049	7
chr3	43388410	43393454	SNRK-AS1	5044	-	NR_046757	43393454	43393454	3
chr3	43407817	43663560	ANO10	255743	-	NM_001204831	43414252	43647344	13
chr3	43732374	43764217	ABHD5	31843	+	NM_016006	43732484	43760024	7
chr3	44155703	44155802	MIR138-1	99	+	NR_029700	44155802	44155802	1
chr3	44283377	44373590	TOPAZ1	90213	+	NM_001145030	44283545	44373503	20
chr3	44379610	44450940	TCAIM	71330	+	NM_001282913	44396274	44449174	11
chr3	44481261	44519162	ZNF445	37901	-	NM_181489	44488066	44497041	8
chr3	44540461	44552132	ZNF852	11671	-	NM_001287349	44540673	44544471	5
chr3	44596666	44624956	ZKSCAN7	28290	+	NM_001288592	44607005	44624483	6
chr3	44626455	44637557	ZNF660	11102	+	NM_173658	44635685	44636681	3
chr3	44658619	44666289	ZNF197-AS1	7670	-	NR_046658	44666289	44666289	2
chr3	44666510	44689963	ZNF197	23453	+	NM_001024855	44670646	44688017	6
chr3	44690232	44702283	ZNF35	12051	+	NM_003420	44692559	44701439	4
chr3	44754134	44765323	ZNF502	11189	+	NM_001282880	44761753	44763944	5
chr3	44771097	44778575	ZNF501	7478	+	NM_001258280	44775913	44776729	3
chr3	44790235	44803173	KIAA1143	12938	-	NM_020696	44794832	44803094	3
chr3	44803208	44894748	KIF15	91540	+	NM_020242	44803357	44894227	35
chr3	44903379	44903473	MIR564	94	+	NR_030290	44903473	44903473	1
chr3	44903400	44907159	TMEM42	3759	+	NM_144638	44903416	44906672	3
chr3	44916097	44956088	TGM4	39991	+	NM_003241	44916170	44955217	14
chr3	44956752	45017674	ZDHHC3	60922	-	NM_016598	44968180	45000928	8
chr3	45017740	45054158	EXOSC7	36418	+	NR_023353	45054158	45054158	7
chr3	45067758	45077563	CLEC3B	9805	+	NM_003278	45067854	45077416	3
chr3	45123765	45187914	CDCP1	64149	-	NM_022842	45127129	45187779	9
chr3	45265955	45267814	TMEM158	1859	-	NM_015444	45266616	45267519	1
chr3	45430074	45590328	LARS2	160254	+	NM_015340	45435945	45589022	22
chr3	45524186	45551037	LARS2-AS1	26851	-	NR_048543	45551037	45551037	4
chr3	45636322	45722755	LIMD1	86433	+	NM_014240	45636371	45718551	8
chr3	45719656	45730374	LIMD1-AS1	10718	-	NR_033947	45730374	45730374	3
chr3	45730753	45786900	SACM1L	56147	+	NM_014016	45730957	45785161	20
chr3	45796940	45838035	SLC6A20	41095	-	NM_020208	45800469	45837911	11
chr3	45864809	45957216	LZTFL1	92407	-	NM_001276378	45867805	45879495	12
chr3	45927995	45944667	CCR9	16672	+	NM_001256369	45942316	45943390	4
chr3	45959390	46037316	FYCO1	77926	-	NM_024513	45963256	46026402	18
chr3	45984972	45989845	CXCR6	4873	+	NM_006564	45987973	45989002	2
chr3	46062290	46068979	XCR1	6689	-	NM_005283	46062437	46063439	3
chr3	46243199	46249832	CCR1	6633	-	NM_001295	46244736	46245804	2
chr3	46283871	46308197	CCR3	24326	+	NM_001837	46306649	46307717	3
chr3	46395234	46402413	CCR2	7179	+	NM_001123041	46399018	46401351	3
chr3	46406150	46448550	LOC102724297	42400	-	NR_125406	46448550	46448550	4
chr3	46411632	46417697	CCR5	6065	+	NM_000579	46414393	46415452	3
chr3	46448720	46451014	CCRL2	2294	+	NM_003965	46449570	46450605	2
chr3	46477495	46506632	LTF	29137	-	NM_002343	46477685	46506357	17
chr3	46539484	46542439	RTP3	2955	+	NM_031440	46539552	46542389	2
chr3	46556877	46608040	LRRC2	51163	-	NM_024512	46560503	46593081	9
chr3	46598887	46601178	LRRC2-AS1	2291	+	NR_073385	46601178	46601178	3
chr3	46616044	46623952	TDGF1	7908	+	NM_001174136	46620597	46622740	6
chr3	46653924	46668033	LOC100132146	14109	+	NM_001195442	46654155	46666708	3
chr3	46710484	46735194	ALS2CL	24710	-	NM_147129	46712473	46730930	26
chr3	46742822	46752413	TMIE	9591	+	NM_147196	46742977	46751178	4
chr3	46753605	46759373	PRSS50	5768	-	NM_013270	46753735	46759314	6
chr3	46761072	46777921	PRSS46	16849	-	NM_001205271	46761488	46777878	4
chr3	46783580	46786245	PRSS45	2665	-	NM_199183	46783839	46786245	4
chr3	46871893	46875585	PRSS42	3692	-	NM_182702	46871893	46875585	5
chr3	46899356	46904973	MYL3	5617	-	NM_000258	46899733	46904880	7
chr3	46919235	46945289	PTH1R	26054	+	NM_000316	46925049	46945146	16
chr3	46963219	47023500	CCDC12	60281	-	NM_144716	46963546	47018261	8
chr3	47021172	47051194	NBEAL2	30022	+	NM_015175	47021351	47050810	54
chr3	47053031	47054957	NRADDP	1926	+	NR_024046	47054957	47054957	4
chr3	47057897	47205467	SETD2	147570	-	NM_014159	47058582	47205414	21
chr3	47205859	47285606	KIF9-AS1	79747	+	NR_033373	47285606	47285606	7
chr3	47269515	47324337	KIF9	54822	-	NM_001134878	47270141	47318864	22
chr3	47324329	47388306	KLHL18	63977	+	NM_025010	47324455	47385431	10
chr3	47422471	47454931	PTPN23	32460	+	NM_015466	47422586	47454675	25
chr3	47455183	47517445	SCAP	62262	-	NM_012235	47455343	47484483	23
chr3	47537129	47555199	ELP6	18070	-	NM_001031703	47537558	47555080	7
chr3	47603727	47621730	CSPG5	18003	-	NM_001206942	47604089	47619101	5
chr3	47627377	47823405	SMARCC1	196028	-	NM_003074	47629698	47823287	28
chr3	47844398	47891686	DHX30	47288	+	NM_014966	47860747	47891610	23
chr3	47891044	47891119	MIR1226	75	+	NR_031595	47891119	47891119	1
chr3	47892179	48130769	MAP4	238590	-	NM_002375	47894521	48040350	19
chr3	48198667	48229801	CDC25A	31134	-	NM_001789	48200434	48229437	15
chr3	48238053	48238106	MIR4443	53	+	NR_039645	48238106	48238106	1
chr3	48264836	48266981	CAMP	2145	+	NM_004345	48264992	48266914	4
chr3	48282595	48312479	ZNF589	29884	+	NM_016089	48282661	48310276	4
chr3	48333806	48343175	NME6	9369	-	NM_001308426	48336126	48340006	6
chr3	48348335	48369831	SPINK8	21496	-	NM_001080525	48348481	48369831	5
chr3	48357849	48357949	MIR2115	100	-	NR_031749	48357949	48357949	1
chr3	48413708	48436190	FBXW12	22482	+	NM_207102	48414257	48436124	11
chr3	48445260	48471460	PLXNB1	26200	-	NM_001130082	48445892	48466020	38
chr3	48473579	48481529	CCDC51	7950	-	NM_001256968	48473817	48475266	4
chr3	48481685	48485537	TMA7	3852	+	NM_015933	48481706	48485290	4
chr3	48488113	48507054	ATRIP	18941	+	NM_001271022	48493134	48506953	14
chr3	48506918	48509044	TREX1	2126	+	NM_007248	48508084	48508999	2
chr3	48509196	48542259	SHISA5	33063	-	NM_001272066	48510505	48538709	6
chr3	48555116	48598613	PFKFB4	43497	-	NM_001317136	48557179	48598548	14
chr3	48587393	48587454	MIR6823	61	-	NR_106881	48587454	48587454	1
chr3	48599150	48601201	UCN2	2051	-	NM_033199	48600218	48600557	2
chr3	48601505	48632593	COL7A1	31088	-	NM_000094	48601838	48632592	118
chr3	48616334	48616410	MIR711	76	-	NR_031756	48616410	48616410	1
chr3	48636431	48647098	UQCRC1	10667	-	NM_003365	48636560	48647053	13
chr3	48642352	48642583	SNORA94	231	-	NR_132776	48642583	48642583	1
chr3	48658274	48659189	TMEM89	915	-	NM_001008269	48658274	48659189	2
chr3	48663155	48672926	SLC26A6	9771	-	NM_134263	48663418	48672826	21
chr3	48671068	48671131	MIR6824	63	-	NR_106882	48671131	48671131	1
chr3	48673895	48700348	CELSR3	26453	-	NM_001407	48675637	48700067	35
chr3	48681626	48681713	MIR4793	87	-	NR_039956	48681713	48681713	1
chr3	48701200	48706603	CELSR3-AS1	5403	+	NR_111921	48706603	48706603	3
chr3	48711271	48723366	NCKIPSD	12095	-	NM_184231	48711976	48723240	13
chr3	48725435	48754711	IP6K2	29276	-	NM_016291	48725705	48732724	6
chr3	48788092	48885270	PRKAR2A	97178	-	NM_004157	48789017	48885029	11
chr3	48885369	48889415	PRKAR2A-AS1	4046	+	NR_109997	48889415	48889415	3
chr3	48894355	48936426	SLC25A20	42071	-	NM_000387	48895142	48936227	9
chr3	48955220	48956818	ARIH2OS	1598	-	NM_001123040	48955709	48956582	1
chr3	48956252	49022971	ARIH2	66719	+	NM_001317333	48964991	49020703	17
chr3	49027340	49044581	P4HTM	17241	+	NM_177939	49027689	49044340	9
chr3	49044636	49053386	WDR6	8750	+	NM_018031	49044774	49052721	6
chr3	49052920	49058504	DALRD3	5584	-	NM_018114	49053020	49055262	12
chr3	49057580	49057667	MIR425	87	-	NR_029948	49057667	49057667	1
chr3	49057907	49060926	NDUFAF3	3019	+	NM_199074	49059872	49060605	5
chr3	49058050	49058142	MIR191	92	-	NR_029690	49058142	49058142	1
chr3	49061761	49066875	IMPDH2	5114	-	NM_000884	49061815	49066783	14
chr3	49067141	49131504	QRICH1	64363	-	NM_017730	49067884	49114450	11
chr3	49133364	49142562	QARS	9198	-	NM_001272073	49133461	49142166	24
chr3	49137286	49137347	MIR6890	61	-	NR_106950	49137347	49137347	1
chr3	49145478	49158371	USP19	12893	-	NM_001199162	49145844	49156578	27
chr3	49158546	49170599	LAMB2	12053	-	NM_002292	49158658	49170300	32
chr3	49190291	49191834	LAMB2P1	1543	-	NR_004405	49191834	49191834	1
chr3	49199967	49203785	CCDC71	3818	-	NM_022903	49200237	49201641	2
chr3	49209017	49213919	KLHDC8B	4902	+	NM_173546	49210202	49213234	6
chr3	49215068	49229291	C3orf84	14223	-	NM_001080528	49215068	49229204	4
chr3	49235860	49295537	CCDC36	59677	+	NM_178173	49249213	49294715	10
chr3	49306029	49314508	C3orf62	8479	-	NM_198562	49308612	49314305	3
chr3	49311552	49311619	MIR4271	67	+	NR_036233	49311619	49311619	1
chr3	49314576	49377536	USP4	62960	-	NM_003363	49315725	49377457	22
chr3	49394608	49395791	GPX1	1183	-	NM_000581	49394820	49395711	2
chr3	49396568	49449530	RHOA	52962	-	NM_001313941	49397641	49413022	6
chr3	49449638	49453909	TCTA	4271	+	NM_022171	49449859	49452295	3
chr3	49454210	49460111	AMT	5901	-	NM_001164712	49454776	49459883	10
chr3	49459765	49466757	NICN1	6992	-	NM_032316	49462265	49466672	6
chr3	49506135	49573051	DAG1	66916	+	NM_001177643	49547967	49570632	3
chr3	49586738	49591799	BSN-AS2	5061	-	NR_038866	49591799	49591799	3
chr3	49591921	49708982	BSN	117061	+	NM_003458	49592035	49702272	12
chr3	49711434	49720934	APEH	9500	+	NM_001640	49711834	49720775	22
chr3	49721379	49726196	MST1	4817	-	NM_020998	49721460	49726124	18
chr3	49726949	49758962	RNF123	32013	+	NM_022064	49728598	49758738	39
chr3	49754266	49757238	AMIGO3	2972	-	NM_198722	49755383	49756898	1
chr3	49758908	49761407	GMPPB	2499	-	NM_021971	49759184	49761159	9
chr3	49761727	49823973	IP6K1	62246	-	NM_153273	49764554	49785473	6
chr3	49828166	49837268	CDHR4	9102	-	NM_001007540	49828264	49837245	19
chr3	49840686	49842463	FAM212A	1777	+	NM_203370	49840819	49842420	2
chr3	49842637	49851391	UBA7	8754	-	NM_003335	49842740	49851220	24
chr3	49843569	49843678	MIR5193	109	-	NR_049825	49843678	49843678	1
chr3	49866027	49893992	TRAIP	27965	-	NM_005879	49866535	49893886	15
chr3	49895421	49907369	CAMKV	11948	-	NM_024046	49896750	49899821	11
chr3	49924435	49941306	MST1R	16871	-	NM_002447	49924739	49941042	20
chr3	49946301	49967445	MON1A	21144	-	NM_032355	49946446	49967319	6
chr3	49977476	50114685	RBM6	137209	+	NM_005777	50000074	50114566	21
chr3	50126340	50156397	RBM5	30057	+	NM_005778	50127867	50155889	25
chr3	50137035	50138421	RBM5-AS1	1386	-	NR_045388	50138421	50138421	1
chr3	50192847	50226508	SEMA3F	33661	+	NM_004186	50197055	50225548	19
chr3	50210758	50210852	MIR566	94	+	NR_030291	50210852	50210852	1
chr3	50229042	50235129	GNAT1	6087	+	NM_144499	50229158	50232388	9
chr3	50242678	50258411	SLC38A3	15733	+	NM_006841	50251632	50257609	16
chr3	50264119	50296786	GNAI2	32667	+	NM_001282619	50289105	50295122	10
chr3	50264867	50264922	MIR5787	55	+	NR_106714	50264922	50264922	1
chr3	50304072	50304803	SEMA3B-AS1	731	-	NR_110702	50304803	50304803	2
chr3	50304989	50314602	SEMA3B	9613	+	NM_004636	50306672	50314137	18
chr3	50310666	50310728	MIR6872	62	+	NR_106932	50310728	50310728	1
chr3	50316457	50325545	LSMEM2	9088	+	NM_153215	50316544	50324633	4
chr3	50325162	50330026	IFRD2	4864	-	NM_006764	50325621	50329897	12
chr3	50330258	50336899	HYAL3	6641	-	NM_003549	50330676	50333033	4
chr3	50333832	50336852	NAT6	3020	-	NM_012191	50334033	50336645	2
chr3	50337319	50349812	HYAL1	12493	-	NM_153281	50337913	50340387	6
chr3	50355220	50360281	HYAL2	5061	-	NM_033158	50355559	50357920	5
chr3	50362339	50365669	TUSC2	3330	-	NM_007275	50363551	50365530	3
chr3	50367216	50378367	RASSF1	11151	-	NM_007182	50368011	50378236	6
chr3	50374941	50375727	RASSF1-AS1	786	+	NR_109831	50375727	50375727	1
chr3	50378536	50383177	ZMYND10	4641	-	NM_015896	50378840	50383010	12
chr3	50384918	50388486	NPRL2	3568	-	NM_006545	50385036	50388083	11
chr3	50388125	50405628	CYB561D2	17503	+	NR_111912	50405628	50405628	4
chr3	50392179	50396939	TMEM115	4760	-	NM_007024	50392773	50396494	2
chr3	50400043	50541675	CACNA2D2	141632	-	NM_001291101	50402096	50513629	38
chr3	50595455	50608458	C3orf18	13003	-	NM_001171741	50597087	50603130	5
chr3	50606582	50622421	HEMK1	15839	+	NM_001317851	50608535	50617848	11
chr3	50643884	50649262	CISH	5378	-	NM_013324	50645037	50647874	4
chr3	50649292	50686728	MAPKAPK3	37436	+	NM_001243926	50654996	50685477	13
chr3	50712510	50712594	MIR4787	84	+	NR_039950	50712594	50712594	1
chr3	50712671	51421629	DOCK3	708958	+	NM_004947	50712694	51418990	53
chr3	51422667	51426828	MANF	4161	+	NM_006010	51422764	51426520	4
chr3	51428698	51435336	RBM15B	6638	+	NM_013286	51428830	51431503	1
chr3	51433297	51534018	VPRBP	100721	-	NM_014703	51436199	51517844	25
chr3	51575595	51697612	RAD54L2	122017	+	NM_015106	51624436	51697436	22
chr3	51705190	51738339	TEX264	33149	+	NM_001278195	51708320	51738032	6
chr3	51741080	51752625	GRM2	11545	+	NM_000839	51742999	51752128	6
chr3	51812576	51813203	IQCF6	627	-	NM_001143833	51812638	51812962	2
chr3	51851618	51853651	IQCF4	2033	+	NR_038213	51853651	51853651	4
chr3	51860898	51864874	IQCF3	3976	+	NM_001207023	51863491	51864817	7
chr3	51895644	51897440	IQCF2	1796	+	NM_203424	51895682	51897386	3
chr3	51907611	51909783	IQCF5-AS1	2172	+	NR_109984	51909783	51909783	3
chr3	51907736	51909600	IQCF5	1864	-	NM_001145059	51907748	51909547	2
chr3	51928891	51937386	IQCF1	8495	-	NM_152397	51928905	51937288	4
chr3	51967441	51975957	RRP9	8516	-	NM_004704	51967521	51975883	15
chr3	51976320	51982883	PARP3	6563	+	NM_005485	51977371	51982496	11
chr3	51989329	51991520	GPR62	2191	+	NM_080865	51989668	51990775	1
chr3	51991469	52001482	PCBP4	10013	-	NM_001174100	51992076	51995256	14
chr3	52002525	52008646	ABHD14B	6121	-	NM_001146314	52003441	52005686	4
chr3	52009041	52015216	ABHD14A	6175	+	NM_015407	52009151	52015034	5
chr3	52009041	52023218	ABHD14A-ACY1	14177	+	NM_001316331	52011962	52023091	17
chr3	52017299	52023218	ACY1	5919	+	NM_000666	52018080	52023091	15
chr3	52027643	52029958	RPL29	2315	-	NM_000992	52027764	52029477	4
chr3	52082936	52090461	DUSP7	7525	-	NM_001947	52084830	52090382	3
chr3	52096109	52099128	LINC00696	3019	-	NR_027331	52099128	52099128	1
chr3	52109248	52188706	POC1A	79458	-	NM_015426	52109902	52188388	11
chr3	52232098	52248343	ALAS1	16245	+	NM_000688	52233257	52248196	12
chr3	52255095	52260179	TLR9	5084	-	NM_017442	52255232	52259545	2
chr3	52262625	52273183	TWF2	10558	-	NM_007284	52263049	52273032	9
chr3	52279808	52284615	PPM1M	4807	+	NM_144641	52279840	52283830	10
chr3	52288437	52312659	WDR82	24222	-	NM_025222	52291505	52312377	9
chr3	52302293	52302377	MIRLET7G	84	-	NR_029660	52302377	52302377	1
chr3	52321835	52329272	GLYCTK	7437	+	NR_026701	52329272	52329272	6
chr3	52322595	52323749	GLYCTK-AS1	1154	-	NR_046719	52323749	52323749	1
chr3	52328234	52328324	MIR135A1	90	-	NR_029677	52328324	52328324	1
chr3	52350334	52434513	DNAH1	84179	+	NM_015512	52356458	52434462	78
chr3	52435019	52444121	BAP1	9102	-	NM_004656	52436303	52443894	17
chr3	52444576	52457657	PHF7	13081	+	NM_016483	52446895	52457333	11
chr3	52467267	52479043	SEMA3G	11776	-	NM_020163	52469618	52479043	16
chr3	52485106	52488057	TNNC1	2951	-	NM_003280	52485290	52488031	6
chr3	52489523	52527088	NISCH	37565	+	NM_007184	52489657	52526498	21
chr3	52529355	52558511	STAB1	29156	+	NM_015136	52529429	52558372	69
chr3	52558384	52569093	NT5DC2	10709	-	NM_022908	52558485	52568669	14
chr3	52570620	52574586	SMIM4	3966	+	NM_001124767	52570771	52574501	2
chr3	52579367	52719866	PBRM1	140499	-	NM_018313	52582078	52713727	30
chr3	52719935	52728510	GNL3	8575	+	NM_014366	52720108	52728291	15
chr3	52722902	52723049	SNORD136	147	+	NR_132757	52723049	52723049	1
chr3	52723255	52723331	SNORD19	76	+	NR_003047	52723331	52723331	1
chr3	52724753	52724846	SNORD19B	93	+	NR_003687	52724846	52724846	1
chr3	52726751	52726828	SNORD69	77	+	NR_003057	52726828	52726828	1
chr3	52728499	52740099	GLT8D1	11600	-	NM_001278281	52728860	52734476	11
chr3	52739856	52742197	SPCS1	2341	+	NM_014041	52740061	52741828	4
chr3	52744795	52804965	NEK4	60170	-	NM_003157	52745792	52804762	16
chr3	52811601	52826084	ITIH1	14483	+	NM_002215	52811631	52825927	22
chr3	52828783	52843025	ITIH3	14242	+	NM_002217	52828819	52842697	22
chr3	52847005	52864717	ITIH4	17712	-	NM_002218	52847436	52864658	24
chr3	52857950	52859330	ITIH4-AS1	1380	+	NR_046615	52859330	52859330	3
chr3	52867130	52869235	MUSTN1	2105	-	NM_205853	52867339	52868964	3
chr3	52867130	52931597	TMEM110-MUSTN1	64467	-	NM_001198974	52867339	52931466	10
chr3	52870771	52931597	TMEM110	60826	-	NM_198563	52874509	52931466	9
chr3	52880478	52880568	MIR8064	90	-	NR_107031	52880568	52880568	1
chr3	52937582	53080089	SFMBT1	142507	-	NM_016329	52939151	53003144	21
chr3	53122500	53164470	RFT1	41970	-	NM_052859	53125918	53164416	13
chr3	53195222	53226733	PRKCD	31511	+	NM_006254	53212438	53226282	19
chr3	53258722	53290130	TKT	31408	-	NM_001135055	53259771	53289958	15
chr3	53317444	53381654	DCP1A	64210	-	NM_001290205	53321597	53376203	11
chr3	53529075	53846492	CACNA1D	317417	+	NM_000720	53529193	53845433	49
chr3	53850323	53880420	CHDH	30097	-	NM_018397	53851803	53858035	9
chr3	53880576	53899827	IL17RB	19251	+	NM_018725	53880615	53899335	11
chr3	53901093	53916229	ACTR8	15136	-	NM_022899	53902745	53916128	13
chr3	53919225	53925989	SELK	6764	-	NM_021237	53919584	53925815	5
chr3	54156692	55108584	CACNA2D3	951892	+	NM_018398	54156740	55108233	38
chr3	54666150	54673884	ESRG	7734	-	NR_027122	54673884	54673884	4
chr3	54908631	54935282	CACNA2D3-AS1	26651	-	NR_046666	54935282	54935282	7
chr3	54952380	55001115	LRTM1	48735	-	NM_001304389	54952485	54959021	3
chr3	55499742	55521670	WNT5A	21928	-	NM_003392	55504119	55521013	5
chr3	55542338	56502391	ERC2	960053	-	NR_132749	56502391	56502391	18
chr3	55691242	55693497	ERC2-IT1	2255	-	NR_024615	55693497	55693497	1
chr3	55886519	55886622	MIR3938	103	-	NR_037502	55886622	55886622	1
chr3	56591183	56655848	CCDC66	64665	+	NM_001012506	56597711	56655646	18
chr3	56654159	56717135	FAM208A	62976	-	NM_001112736	56657815	56717034	24
chr3	56761445	57113336	ARHGEF3	351891	-	NM_001128615	56763297	57069177	13
chr3	56974067	56994880	ARHGEF3-AS1	20813	+	NR_046572	56994880	56994880	3
chr3	57094468	57109460	SPATA12	14992	+	NM_181727	57107722	57108295	2
chr3	57124009	57199403	IL17RD	75394	-	NM_017563	57130420	57199314	13
chr3	57231943	57234280	HESX1	2337	-	NM_003865	57232224	57233946	4
chr3	57261764	57307498	APPL1	45734	+	NM_012096	57261911	57303715	22
chr3	57302378	57326710	ASB14	24332	-	NM_001142733	57310577	57326061	11
chr3	57327726	57530071	DNAH12	202345	-	NM_001291661	57327808	57528597	58
chr3	57541980	57547768	PDE12	5788	+	NM_177966	57542106	57545731	3
chr3	57557089	57583215	ARF4	26126	-	NM_001660	57557938	57582867	6
chr3	57583515	57586642	ARF4-AS1	3127	+	NR_132369	57586642	57586642	3
chr3	57611180	57678816	DENND6A	67636	-	NM_152678	57613940	57678745	20
chr3	57742982	57915741	SLMAP	172759	+	NM_001304420	57743378	57913115	22
chr3	57994126	58157982	FLNB	163856	+	NM_001164317	57994291	58156489	47
chr3	58178352	58196730	DNASE1L3	18378	-	NM_004944	58178413	58196633	8
chr3	58223258	58280461	ABHD6	57203	+	NM_020676	58242313	58279492	9
chr3	58291971	58305920	RPP14	13949	+	NM_001098783	58296056	58303223	6
chr3	58318616	58411854	PXK	93238	+	NM_001289098	58318715	58406282	19
chr3	58413356	58419579	PDHB	6223	-	NM_001173468	58413760	58419536	11
chr3	58477822	58488087	KCTD6	10265	+	NM_001128214	58484482	58487359	3
chr3	58490862	58522929	ACOX2	32067	-	NM_003500	58490950	58520833	15
chr3	58549838	58613337	FAM107A	63499	-	NM_001282714	58552314	58612721	5
chr3	58619669	58652561	FAM3D	32892	-	NM_138805	58620005	58641290	10
chr3	58727736	59035715	C3orf67	307979	-	NM_198463	58728186	58923391	16
chr3	58810196	59004819	C3orf67-AS1	194623	+	NR_110820	59004819	59004819	3
chr3	59735035	61237133	FHIT	1502098	-	NM_002012	59737951	60522695	10
chr3	60603537	60603603	MIR548BB	66	-	NR_128708	60603603	60603603	1
chr3	61547242	62280573	PTPRG	733331	+	NM_002841	61547961	62278982	30
chr3	62247493	62304622	PTPRG-AS1	57129	-	NR_038282	62304622	62304622	5
chr3	62304647	62321888	C3orf14	17241	+	NM_001291941	62306146	62319064	6
chr3	62355346	62359190	FEZF2	3844	-	NM_018008	62355757	62358543	5
chr3	62384020	62861064	CADPS	477044	-	NM_003716	62385080	62860704	30
chr3	63088363	63110737	LINC00698	22374	+	NR_027104	63110737	63110737	7
chr3	63263913	63602597	SYNPR	338684	+	NM_001130003	63264209	63601157	6
chr3	63409271	63535727	SYNPR-AS1	126456	-	NR_046677	63535727	63535727	5
chr3	63638343	63650891	SNTN	12548	+	NM_001080537	63638363	63649771	4
chr3	63805040	63834312	C3orf49	29272	+	NR_026866	63834312	63834312	7
chr3	63819545	63849599	THOC7	30054	-	NM_025075	63819807	63849466	8
chr3	63846320	63847495	THOC7-AS1	1175	+	NR_104326	63847495	63847495	2
chr3	63850232	63989136	ATXN7	138904	+	NM_000333	63898274	63985143	13
chr3	63989697	63997917	PSMD6-AS2	8220	+	NR_038286	63997917	63997917	3
chr3	63996224	64009686	PSMD6	13462	-	NM_001271780	63996343	64009511	8
chr3	64053639	64088807	PRICKLE2-AS1	35168	+	NR_045697	64088807	64088807	3
chr3	64064036	64073039	LINC00994	9003	-	NR_033978	64073039	64073039	4
chr3	64079525	64211131	PRICKLE2	131606	-	NM_198859	64084726	64184603	8
chr3	64089145	64092034	PRICKLE2-AS2	2889	+	NR_046701	64092034	64092034	4
chr3	64173219	64187236	PRICKLE2-AS3	14017	+	NR_046702	64187236	64187236	4
chr3	64501330	64673365	ADAMTS9	172035	-	NM_182920	64507846	64673333	40
chr3	64547021	64575760	ADAMTS9-AS1	28739	+	NR_110150	64575760	64575760	3
chr3	64670545	64997143	ADAMTS9-AS2	326598	+	NR_038264	64997143	64997143	6
chr3	64705682	64941858	MIR548A2	236176	+	NR_030317	64941858	64941858	4
chr3	65339905	66024509	MAGI1	684604	-	NM_015520	65342750	66023983	25
chr3	65879490	65910972	MAGI1-AS1	31482	+	NR_046575	65910972	65910972	3
chr3	66119284	66429351	SLC25A26	310067	+	NM_173471	66271520	66428231	11
chr3	66429220	66550845	LRIG1	121625	-	NM_015541	66430686	66550831	19
chr3	67048726	67061632	KBTBD8	12906	+	NM_032505	67048779	67058809	4
chr3	67275887	67275951	MIR4272	64	+	NR_036234	67275951	67275951	1
chr3	67410883	67705038	SUCLG2	294155	-	NM_001177599	67411052	67705010	11
chr3	67705120	67998136	SUCLG2-AS1	293016	+	NR_109992	67998136	67998136	7
chr3	68040733	68594771	FAM19A1	554038	+	NM_001252216	68055769	68593654	5
chr3	68780914	68981761	FAM19A4	200847	-	NM_182522	68782292	68934339	6
chr3	69024362	69063045	EOGT	38683	-	NM_001278689	69026768	69058997	18
chr3	69068977	69101484	TMF1	32507	-	NM_007114	69072327	69101237	17
chr3	69098108	69098186	MIR3136	78	-	NR_036087	69098186	69098186	1
chr3	69103880	69129524	UBA3	25644	-	NM_003968	69104587	69129504	18
chr3	69134089	69155239	ARL6IP5	21150	+	NM_006407	69134198	69153787	3
chr3	69157822	69171746	LMOD3	13924	-	NM_001304418	69158245	69171537	4
chr3	69217933	69435455	FRMD4B	217522	-	NM_015123	69221011	69435140	23
chr3	69788585	70017488	MITF	228903	+	NM_198159	69788748	70014399	10
chr3	70048894	70064451	LINC01212	15557	+	NR_110000	70064451	70064451	4
chr3	71003864	71633140	FOXP1	629276	-	NM_032682	71008397	71247532	21
chr3	71338908	71355005	FOXP1-AS1	16097	+	NR_126463	71355005	71355005	5
chr3	71591120	71591240	MIR1284	120	-	NR_031697	71591240	71591240	1
chr3	71728439	71803924	EIF4E3	75485	-	NM_173359	71733832	71748790	8
chr3	71803200	71804328	GPR27	1128	+	NM_018971	71803200	71804328	1
chr3	71820805	71834357	PROK2	13552	-	NM_001126128	71821874	71834203	4
chr3	72084669	72149606	LINC00877	64937	-	NR_104116	72149606	72149606	7
chr3	72200407	72223490	LINC00870	23083	+	NR_038221	72223490	72223490	3
chr3	72423743	72495774	RYBP	72031	-	NM_012234	72427535	72495774	4
chr3	72798427	72897598	SHQ1	99171	-	NM_018130	72799434	72897491	11
chr3	72937384	73024522	GXYLT2	87138	+	NM_001080393	72937384	73024310	7
chr3	73045893	73118352	PPP4R2	72459	+	NM_001318026	73047307	73114873	9
chr3	73110809	73112471	EBLN2	1662	+	NM_018029	73111232	73112051	1
chr3	73431580	73674072	PDZRN3	242492	-	NM_015009	73432515	73673976	10
chr3	73570472	73618925	LOC101927296	48453	+	NR_121660	73618925	73618925	2
chr3	73672718	73677050	PDZRN3-AS1	4332	+	NR_046681	73677050	73677050	2
chr3	74311719	74570291	CNTN3	258572	-	NM_020872	74313551	74570263	22
chr3	75470702	75484266	FAM86DP	13564	-	NR_024241	75484266	75484266	8
chr3	75679913	75680009	MIR1324	96	+	NR_031714	75680009	75680009	1
chr3	75713480	75716368	FRG2EP	2888	+	NR_037925	75716368	75716368	4
chr3	75713486	75716368	FRG2C	2882	+	NM_001124759	75713530	75715192	4
chr3	75721431	75728454	LINC00960	7023	+	NR_040005	75728454	75728454	5
chr3	75779111	75834734	ZNF717	55623	-	NM_001290210	75779763	75832513	6
chr3	75787430	75787514	MIR4273	84	+	NR_036235	75787514	75787514	1
chr3	77089293	77699114	ROBO2	609821	+	NM_001290040	77089936	77695206	28
chr3	78646387	79817059	ROBO1	1170672	-	NM_002941	78648062	79639061	31
chr3	79460876	79484377	LOC101927374	23501	+	NR_110133	79484377	79484377	3
chr3	79557036	79557119	MIR3923	83	+	NR_037488	79557119	79557119	1
chr3	81043018	81144798	LOC728290	101780	+	NR_132411	81144798	81144798	2
chr3	81538849	81810950	GBE1	272101	-	NM_000158	81539557	81810668	16
chr3	84687555	84918726	LINC00971	231171	-	NR_033860	84918726	84918726	21
chr3	85008132	86123579	CADM2	1115447	+	NM_001167675	85008758	86115933	10
chr3	85111303	85111415	SNORA95	112	-	NR_132777	85111415	85111415	1
chr3	85434859	85434942	MIR5688	83	+	NR_049870	85434942	85434942	1
chr3	85849136	85877200	CADM2-AS2	28064	-	NR_046752	85877200	85877200	4
chr3	86987122	87040257	VGLL3	53135	-	NM_016206	86996173	87039893	4
chr3	87138429	87206219	LINC00506	67790	+	NR_104153	87206219	87206219	3
chr3	87275338	87275427	MIR4795	89	-	NR_039958	87275427	87275427	1
chr3	87276412	87304698	CHMP2B	28286	+	NM_014043	87276672	87302972	6
chr3	87308782	87325737	POU1F1	16955	-	NM_000306	87309043	87325612	6
chr3	88031725	88042919	HTR1F	11194	+	NM_000866	88039899	88041000	2
chr3	88101099	88199016	CGGBP1	97917	-	NM_001195308	88104622	88105126	4
chr3	88188261	88193814	ZNF654	5553	+	NM_018293	88188460	88190802	2
chr3	88198892	88207115	C3orf38	8223	+	NM_173824	88199202	88205785	3
chr3	89156673	89531284	EPHA3	374611	+	NM_005233	89156898	89528652	17
chr3	93591880	93692934	PROS1	101054	-	NM_000313	93593088	93692593	15
chr3	93698982	93774522	ARL13B	75540	+	NM_182896	93699267	93772107	11
chr3	93733214	93747454	STX19	14240	-	NM_001001850	93733228	93734113	2
chr3	93776765	93782067	DHFRL1	5302	-	NM_001195643	93779791	93780355	2
chr3	93781854	93845630	NSUN3	63776	+	NM_022072	93781970	93845334	6
chr3	94657106	94710169	LINC00879	53063	+	NR_015400	94710169	94710169	8
chr3	95373266	95402037	MTHFD2P1	28771	-	NR_077228	95402037	95402037	5
chr3	96078807	96078883	MIR8060	76	+	NR_107027	96078883	96078883	1
chr3	96533424	97467786	EPHA6	934362	+	NM_001080448	96533467	97467545	18
chr3	97483364	97520086	ARL6	36722	+	NR_103511	97520086	97520086	10
chr3	97540883	97663830	CRYBG3	122947	+	NM_153605	97541050	97662158	22
chr3	97660660	97691295	MINA	30635	-	NM_153182	97664027	97686437	10
chr3	97705526	97754148	GABRR3	48622	-	NM_001105580	97705526	97753831	10
chr3	97806016	97806946	OR5AC2	930	+	NM_054106	97806016	97806946	1
chr3	97851541	97852483	OR5H1	942	+	NM_001005338	97851541	97852483	1
chr3	97868229	97869162	OR5H14	933	+	NM_001005514	97868229	97869162	1
chr3	97887543	97888485	OR5H15	942	+	NM_001005515	97887543	97888485	1
chr3	97983128	97984106	OR5H6	978	+	NM_001005479	97983128	97984106	1
chr3	98001731	98002676	OR5H2	945	+	NM_001005482	98001731	98002676	1
chr3	98072697	98073663	OR5K4	966	+	NM_001005517	98072697	98073663	1
chr3	98109509	98110475	OR5K3	966	+	NM_001005516	98109509	98110475	1
chr3	98188323	98189420	OR5K1	1097	+	NM_001004736	98188420	98189347	1
chr3	98216524	98217475	OR5K2	951	+	NM_001004737	98216524	98217475	1
chr3	98234316	98241910	CLDND1	7594	-	NM_019895	98235502	98240268	6
chr3	98250742	98251994	GPR15	1252	+	NM_005290	98250877	98251960	1
chr3	98298289	98312455	CPOX	14166	-	NM_000097	98299526	98312348	7
chr3	98433176	98451495	ST3GAL6-AS1	18319	-	NR_046683	98451495	98451495	5
chr3	98451079	98514689	ST3GAL6	63610	+	NM_001271142	98491747	98512605	11
chr3	98514813	98620533	DCBLD2	105720	-	NM_080927	98518215	98620170	16
chr3	99273152	99717059	MIR548G	443907	-	NR_031662	99717059	99717059	5
chr3	99357439	99515577	COL8A1	158138	+	NM_001850	99509526	99514980	5
chr3	99535475	99542709	HP09053	7234	-	NR_110821	99542709	99542709	3
chr3	99536677	99897476	CMSS1	360799	+	NM_032359	99536823	99897232	10
chr3	99551987	99833357	FILIP1L	281370	-	NM_182909	99552078	99649864	6
chr3	99683157	99683242	MIR3921	85	-	NR_037486	99683242	99683242	1
chr3	99904667	99913030	TMEM30C	8363	+	NR_028357	99913030	99913030	3
chr3	99979660	100044096	TBC1D23	64436	+	NM_001199198	99979862	100042512	19
chr3	100053561	100074478	NIT2	20917	+	NM_020202	100053635	100074112	10
chr3	100082302	100120242	TOMM70A	37940	-	NM_014820	100084407	100119793	12
chr3	100120036	100175170	LNP1	55134	+	NM_001085451	100148573	100174770	4
chr3	100211462	100296296	TMEM45A	84834	+	NM_018004	100274055	100295862	6
chr3	100328432	100414323	ADGRG7	85891	+	NM_032787	100328700	100413845	16
chr3	100428133	100467811	TFG	39678	+	NM_001007565	100432529	100467375	8
chr3	100468178	100712334	ABI3BP	244156	-	NM_015429	100469338	100712249	35
chr3	100941389	101039419	IMPG2	98030	-	NM_016247	100945812	101039216	19
chr3	101043032	101232085	SENP7	189053	-	NM_020654	101044786	101231974	24
chr3	101237710	101242731	FAM172BP	5021	+	NR_036433	101242731	101242731	2
chr3	101280679	101285290	TRMT10C	4611	+	NM_017819	101283625	101284837	2
chr3	101293041	101313281	PCNP	20240	+	NM_020357	101293059	101311597	5
chr3	101368282	101395988	ZBTB11	27706	-	NM_014415	101370009	101395758	11
chr3	101395273	101398057	ZBTB11-AS1	2784	+	NR_024407	101398057	101398057	1
chr3	101399933	101405563	RPL24	5630	-	NM_000986	101399978	101405520	6
chr3	101431277	101432260	PDCL3P4	983	+	NR_002941	101432260	101432260	1
chr3	101443436	101489406	CEP97	45970	+	NM_001303401	101443520	101484395	11
chr3	101498028	101547075	NXPE3	49047	+	NM_145037	101504440	101540798	8
chr3	101546833	101579869	NFKBIZ	33036	+	NM_001005474	101570939	101578215	13
chr3	101659702	101716770	LOC152225	57068	+	NR_026934	101716770	101716770	4
chr3	102153858	102198685	ZPLD1	44827	+	NM_175056	102153958	102196462	11
chr3	103242876	103242960	MIR548AB	84	-	NR_039611	103242960	103242960	1
chr3	103903475	103946105	MIR548A3	42630	-	NR_030330	103946105	103946105	3
chr3	105085556	105295757	ALCAM	210201	+	NM_001627	105086252	105290783	16
chr3	105377108	105587887	CBLB	210779	-	NM_170662	105377813	105586421	19
chr3	106828636	106959485	LINC00882	130849	-	NR_028303	106959485	106959485	4
chr3	106959538	107045811	DUBR	86273	+	NR_028302	107045811	107045811	4
chr3	107096187	107097481	CCDC54	1294	+	NM_032600	107096434	107097421	1
chr3	107099322	107101006	LOC101929579	1684	-	NR_126332	107101006	107101006	2
chr3	107149776	107182759	LOC101929607	32983	+	NR_110039	107182759	107182759	3
chr3	107241782	107530176	BBX	288394	+	NM_001142568	107429307	107524304	18
chr3	107560508	107596915	LINC00635	36407	-	NR_015414	107596915	107596915	11
chr3	107602051	107647753	LINC00636	45702	+	NR_015394	107647753	107647753	3
chr3	107761940	107809935	CD47	47995	-	NM_001777	107766134	107809755	11
chr3	107843910	107857457	LINC01215	13547	+	NR_110030	107857457	107857457	2
chr3	107879658	107941417	IFT57	61759	-	NM_018010	107881323	107941169	11
chr3	108015336	108097131	HHLA2	81795	+	NM_001282559	108047150	108096125	11
chr3	108099215	108248169	MYH15	148954	-	NM_014981	108100391	108248112	42
chr3	108268717	108308491	KIAA1524	39774	-	NM_020890	108269995	108308222	21
chr3	108308336	108413693	DZIP3	105357	+	NM_014648	108324253	108409744	33
chr3	108474485	108476130	RETNLB	1645	-	NM_032579	108474624	108476032	3
chr3	108541544	108573852	TRAT1	32308	+	NM_016388	108541774	108572724	6
chr3	108626641	108672677	GUCA1C	46036	-	NM_005459	108626868	108672609	4
chr3	108677086	108836993	MORC1	159907	-	NM_014429	108677811	108836906	28
chr3	108855560	108868951	FLJ22763	13391	+	NR_033977	108868951	108868951	3
chr3	108897011	108904108	LINC00488	7097	+	NR_026767	108904108	108904108	3
chr3	109012634	109035364	DPPA2	22730	-	NM_138815	109019239	109033389	9
chr3	109044987	109056419	DPPA4	11432	-	NM_018189	109046834	109056364	7
chr3	109128836	109214014	LINC01205	85178	+	NR_109841	109214014	109214014	5
chr3	109321674	109321744	MIR4445	70	+	NR_039647	109321744	109321744	1
chr3	110764162	110788806	PVRL3-AS1	24644	-	NR_045114	110788806	110788806	4
chr3	110791014	110913016	PVRL3	122002	+	NM_001243288	110791266	110912226	9
chr3	111260925	111371206	CD96	110281	+	NM_198196	111261095	111368653	15
chr3	111311746	111314182	ZBED2	2436	-	NM_024508	111312391	111313048	2
chr3	111393522	111565294	PLCXD2	171772	+	NM_001185106	111394092	111451517	5
chr3	111395112	111396280	PLCXD2-AS1	1168	-	NR_046733	111396280	111396280	2
chr3	111451326	111695364	PHLDB2	244038	+	NM_001134437	111564715	111693410	18
chr3	111697722	111712215	ABHD10	14493	+	NM_001272069	111697908	111709588	6
chr3	111717585	111732735	TAGLN3	15150	+	NM_013259	111718269	111732398	5
chr3	111758464	111800116	TMPRSS7	41652	+	NR_026734	111800116	111800116	17
chr3	111805181	111837073	C3orf52	31892	+	NM_001171747	111805254	111835845	4
chr3	111831647	111831745	MIR567	98	+	NR_030292	111831745	111831745	1
chr3	111839687	111852152	GCSAM	12465	-	NM_001190259	111842301	111851967	6
chr3	111859751	112013074	SLC9C1	153323	-	NM_183061	111860118	112005638	29
chr3	112051915	112081658	CD200	29743	+	NM_001004196	112052059	112080397	7
chr3	112182812	112218408	BTLA	35596	-	NM_181780	112184954	112218205	5
chr3	112251353	112280810	ATG3	29457	-	NM_022488	112251545	112280375	12
chr3	112280856	112303284	SLC35A5	22428	+	NM_017945	112282250	112301583	7
chr3	112315640	112320816	LINC01279	5176	-	NR_109779	112320816	112320816	1
chr3	112323232	112359990	CCDC80	36758	-	NM_199512	112324263	112358752	8
chr3	112455295	112468166	LOC101929694	12871	-	NR_110017	112468166	112468166	5
chr3	112534555	112564797	CD200R1L	30242	-	NM_001199215	112534809	112548214	7
chr3	112641531	112693937	CD200R1	52406	-	NM_138806	112642523	112693704	8
chr3	112709799	112720221	GTPBP8	10422	+	NM_014170	112709846	112719766	6
chr3	112721291	112738555	C3orf17	17264	-	NM_015412	112724382	112738494	9
chr3	112861196	112886578	LOC101929717	25382	-	NR_110823	112886578	112886578	4
chr3	112930311	113006310	BOC	75999	+	NM_033254	112968649	113005709	20
chr3	113005776	113160361	CFAP44	154585	-	NM_001164496	113010403	113152511	35
chr3	113122844	113152839	CFAP44-AS1	29995	+	NR_046728	113152839	113152839	6
chr3	113150964	113151047	MIR8076	83	-	NR_107043	113151047	113151047	1
chr3	113161564	113234034	SPICE1	72470	-	NM_144718	113164153	113225452	18
chr3	113251217	113348422	SIDT1	97205	+	NM_001308350	113251868	113346555	26
chr3	113313722	113313789	MIR4446	67	+	NR_039648	113313789	113313789	1
chr3	113367232	113415493	USF3	48261	-	NR_111981	113415493	113415493	7
chr3	113435306	113465146	NAA50	29840	-	NM_025146	113440606	113464796	5
chr3	113465865	113530905	ATP6V1A	65040	+	NM_001690	113497600	113528274	15
chr3	113557680	113666021	GRAMD1C	108341	+	NM_017577	113557756	113664325	18
chr3	113666747	113681827	ZDHHC23	15080	+	NM_173570	113667649	113679580	6
chr3	113682983	113775460	CCDC191	92477	-	NM_020817	113684001	113775313	17
chr3	113775581	113807268	QTRTD1	31687	+	NM_024638	113784104	113804751	10
chr3	113847498	113918254	DRD3	70756	-	NM_001282563	113847562	113890839	8
chr3	113953479	113956425	ZNF80	2946	-	NM_007136	113955099	113955921	1
chr3	114012832	114029135	TIGIT	16303	+	NM_173799	114012908	114026978	4
chr3	114033346	114866127	ZBTB20	832781	-	NM_015642	114057851	114070705	10
chr3	114035321	114035416	MIR568	95	-	NR_030293	114035416	114035416	1
chr3	114070657	114107825	ZBTB20-AS1	37168	+	NR_038993	114107825	114107825	9
chr3	114172439	114238979	LOC101929754	66540	+	NR_121661	114238979	114238979	3
chr3	114462291	114462372	MIR4796	81	-	NR_039959	114462372	114462372	1
chr3	114591879	114595361	ZBTB20-AS3	3482	+	NR_126422	114595361	114595361	3
chr3	114819269	114821908	ZBTB20-AS4	2639	+	NR_046877	114821908	114821908	2
chr3	115342150	115440334	GAP43	98184	+	NM_001130064	115382625	115439729	4
chr3	115521209	116164385	LSAMP	643176	-	NM_002338	115529163	116163878	7
chr3	116078870	116088932	LSAMP-AS1	10062	+	NR_109998	116088932	116088932	4
chr3	116428634	116435887	TUSC7	7253	+	NR_015391	116435887	116435887	4
chr3	116569123	116569214	MIR4447	91	-	NR_039649	116569214	116569214	1
chr3	116640277	116651085	LINC00901	10808	+	NR_121607	116651085	116651085	2
chr3	118619478	118864898	IGSF11	245420	-	NM_152538	118621366	118824039	9
chr3	118661922	118667088	IGSF11-AS1	5166	+	NR_046230	118667088	118667088	4
chr3	118864996	118870302	C3orf30	5306	+	NM_152539	118865036	118870139	3
chr3	118892424	118924000	UPK1B	31576	+	NM_006952	118905588	118922814	8
chr3	118930588	118959752	B4GALT4	29164	-	NM_212543	118931395	118948946	9
chr3	118945332	119009513	B4GALT4-AS1	64181	+	NR_046574	119009513	119009513	4
chr3	119013219	119138323	ARHGAP31	125104	+	NM_020754	119013751	119135111	12
chr3	119033139	119041607	ARHGAP31-AS1	8468	-	NR_046748	119041607	119041607	2
chr3	119147806	119182529	TMEM39A	34723	-	NR_073506	119182529	119182529	10
chr3	119187784	119213554	POGLUT1	25770	+	NM_152305	119187868	119211285	11
chr3	119217367	119243125	TIMMDC1	25758	+	NM_016589	119217580	119242603	7
chr3	119243139	119278481	CD80	35342	-	NM_005191	119246617	119276575	7
chr3	119298279	119308792	ADPRH	10513	+	NM_001125	119301016	119306725	5
chr3	119316694	119348658	PLA1A	31964	+	NR_120610	119348658	119348658	11
chr3	119360898	119379437	POPDC2	18539	-	NM_001308333	119362222	119379270	5
chr3	119388371	119396243	COX17	7872	-	NM_005694	119393995	119396157	3
chr3	119421868	119485949	MAATS1	64081	+	NM_033364	119421945	119469944	18
chr3	119499330	119537332	NR1I2	38002	+	NM_033013	119526097	119536059	9
chr3	119540801	119813264	GSK3B	272463	-	NM_002093	119545634	119812281	12
chr3	119884327	119963142	GPR156	78815	-	NM_001168271	119885878	119962945	9
chr3	120043575	120068186	LRRC58	24611	-	NM_001099678	120050046	120068090	4
chr3	120113060	120169918	FSTL1	56858	-	NM_007085	120115798	120169593	11
chr3	120114514	120114576	MIR198	62	-	NR_029584	120114576	120114576	1
chr3	120315127	120321258	NDUFB4	6131	+	NM_004547	120315206	120321117	3
chr3	120347014	120401418	HGD	54404	-	NM_000187	120347226	120400958	14
chr3	120405527	120461384	RABL3	55857	-	NM_173825	120408669	120461354	8
chr3	120461557	120501916	GTF2E1	40359	+	NM_005513	120469399	120500317	5
chr3	120627049	121143608	STXBP5L	516559	+	NM_014980	120628425	121137944	28
chr3	120768486	120768562	MIR5682	76	+	NR_049861	120768562	120768562	1
chr3	121150272	121264853	POLQ	114581	-	NM_199420	121151150	121264724	30
chr3	121286777	121309469	ARGFX	22692	+	NM_001012659	121289560	121305447	5
chr3	121312169	121349139	FBXO40	36970	+	NM_016298	121339422	121345757	4
chr3	121350244	121379795	HCLS1	29551	-	NM_005335	121350692	121377194	14
chr3	121382045	121468614	GOLGB1	86569	-	NM_001256487	121383326	121448843	22
chr3	121488609	121553926	IQCB1	65317	-	NM_001023570	121489191	121547807	15
chr3	121554033	121605373	EAF2	51340	+	NM_018456	121554132	121605235	6
chr3	121613170	121663034	SLC15A2	49864	+	NM_021082	121613323	121659854	22
chr3	121706169	121741127	ILDR1	34958	-	NM_001199799	121707213	121740924	8
chr3	121774208	121839988	CD86	65780	+	NM_175862	121774336	121838381	7
chr3	121902529	122005344	CASR	102815	+	NM_000388	121973036	122004038	7
chr3	122044010	122060815	CSTA	16805	+	NM_005213	122044139	122060414	3
chr3	122078437	122102078	CCDC58	23641	-	NM_001017928	122078715	122102071	5
chr3	122103022	122128961	FAM162A	25939	+	NM_014367	122103112	122128678	5
chr3	122130699	122134882	WDR5B	4183	-	NM_019069	122133382	122134375	1
chr3	122135052	122162094	LOC102723582	27042	+	NR_125405	122162094	122162094	3
chr3	122140747	122233786	KPNA1	93039	-	NR_026698	122233786	122233786	15
chr3	122246759	122283523	PARP9	36764	-	NM_031458	122247210	122278467	11
chr3	122283184	122294049	DTX3L	10865	+	NM_138287	122283273	122290594	5
chr3	122296448	122357894	PARP15	61446	+	NM_001113523	122296514	122354947	12
chr3	122399671	122449687	PARP14	50016	+	NM_017554	122399730	122447444	17
chr3	122458843	122512666	HSPBAP1	53823	-	NM_024610	122459191	122512527	8
chr3	122513900	122599986	DIRC2	86086	+	NM_032839	122514039	122598225	9
chr3	122605359	122611263	LOC100129550	5904	+	NR_024618	122611263	122611263	1
chr3	122628039	122747452	SEMA5B	119413	-	NR_046079	122747452	122747452	23
chr3	122785855	122880953	PDIA5	95098	+	NM_006810	122786011	122880807	17
chr3	122880640	122880726	MIR7110	86	+	NR_106960	122880726	122880726	1
chr3	122920773	122992982	SEC22A	72209	+	NM_012430	122928064	122990569	7
chr3	123001142	123167392	ADCY5	166250	-	NM_183357	123003454	123167392	21
chr3	123213362	123303924	HACD2	90562	-	NM_198402	123213734	123303874	7
chr3	123304359	123349666	MYLK-AS1	45307	+	NR_121654	123349666	123349666	4
chr3	123331142	123603149	MYLK	272007	-	NM_053025	123332951	123512688	34
chr3	123408490	123411254	MYLK-AS2	2764	+	NR_046629	123411254	123411254	3
chr3	123632273	123680255	CCDC14	47982	-	NM_022757	123633625	123680164	12
chr3	123687862	123711017	ROPN1	23155	-	NM_001317774	123688001	123699328	6
chr3	123813557	124440036	KALRN	626479	+	NM_001024660	123813684	124438317	60
chr3	123851775	123851872	MIR5002	97	+	NR_049798	123851872	123851872	1
chr3	124093178	124093284	MIR6083	106	+	NR_106731	124093284	124093284	1
chr3	124449212	124468119	UMPS	18907	+	NR_033437	124468119	124468119	7
chr3	124451285	124451363	MIR544B	78	+	NR_036088	124451363	124451363	1
chr3	124480794	124606152	ITGB5	125358	-	NM_002213	124482469	124605847	15
chr3	124624288	124653595	MUC13	29307	-	NM_033049	124626993	124653556	12
chr3	124684553	124774802	HEG1	90249	-	NM_020733	124689495	124774734	17
chr3	124801479	124931609	SLC12A8	130130	-	NM_024628	124802733	124930193	14
chr3	124870308	124870396	MIR5092	88	-	NR_049815	124870396	124870396	1
chr3	124944512	125094198	ZNF148	149686	-	NM_021964	124951184	125032484	9
chr3	125165487	125239058	SNX4	73571	-	NM_003794	125166622	125239016	14
chr3	125247701	125314381	OSBPL11	66680	-	NM_022776	125249358	125313644	13
chr3	125509246	125509395	MIR548I1	149	-	NR_031687	125509395	125509395	1
chr3	125546079	125604920	LOC101927056	58841	-	NR_125395	125604920	125604920	5
chr3	125635443	125648867	FAM86JP	13424	+	NR_024251	125648867	125648867	5
chr3	125648117	125655887	ALG1L	7770	-	NM_001195223	125648194	125653316	7
chr3	125687986	125702296	ROPN1B	14310	+	NM_001308313	125690897	125702163	7
chr3	125725199	125820391	SLC41A3	95192	-	NM_001164475	125725858	125769815	10
chr3	125822403	125900029	ALDH1L1	77626	-	NM_001270364	125822633	125899811	23
chr3	125822482	125826912	ALDH1L1-AS1	4430	+	NR_046602	125826912	125826912	4
chr3	125898907	125929011	ALDH1L1-AS2	30104	+	NR_046383	125929011	125929011	2
chr3	126061477	126076236	KLF15	14759	-	NM_014079	126062569	126071765	3
chr3	126111874	126113641	CCDC37-AS1	1767	-	NR_103788	126113641	126113641	3
chr3	126113781	126155398	CFAP100	41617	+	NM_182628	126114843	126155247	17
chr3	126156443	126194762	ZXDC	38319	-	NM_025112	126157217	126194708	10
chr3	126200007	126236616	UROC1	36609	-	NM_001165974	126201187	126236562	21
chr3	126243130	126262134	CHST13	19004	+	NM_152889	126243175	126261421	3
chr3	126245841	126277808	C3orf22	31967	-	NR_130715	126277808	126277808	6
chr3	126290621	126327398	TXNRD3NB	36777	-	NM_001039783	126290874	126291386	4
chr3	126325894	126373967	TXNRD3	48073	-	NM_052883	126326747	126373833	16
chr3	126380923	126390782	NUP210P1	9859	+	NR_034158	126390782	126390782	5
chr3	126423062	126679263	CHCHD6	256201	+	NM_032343	126423155	126679044	8
chr3	126707436	126756235	PLXNA1	48799	+	NM_032242	126707436	126752860	31
chr3	126911973	126917027	C3orf56	5054	+	NM_001007534	126915528	126916257	2
chr3	127041149	127109513	LOC101927123	68364	-	NR_110147	127109513	127109513	5
chr3	127216443	127256623	LINC01471	40180	-	NR_125397	127256623	127256623	7
chr3	127291906	127309602	TPRA1	17696	-	NM_001136053	127292363	127298989	11
chr3	127294108	127294174	MIR6825	66	-	NR_106883	127294174	127294174	1
chr3	127305953	127306019	MIR7976	66	-	NR_107016	127306019	127306019	1
chr3	127317199	127341278	MCM2	24079	+	NM_004526	127317309	127340616	16
chr3	127348001	127391653	PODXL2	43652	+	NM_015720	127348062	127391323	8
chr3	127391780	127399769	ABTB1	7989	+	NR_033429	127399769	127399769	12
chr3	127407904	127542093	MGLL	134189	-	NM_001003794	127411040	127540661	8
chr3	127641901	127706514	KBTBD12	64613	+	NM_207335	127641904	127703121	5
chr3	127771211	127790526	SEC61A1	19315	+	NM_013336	127771395	127788505	12
chr3	127794652	127797899	RUVBL1-AS1	3247	+	NR_046645	127797899	127797899	2
chr3	127799799	127842671	RUVBL1	42872	-	NM_003707	127800092	127842567	11
chr3	127872299	128127489	EEFSEC	255190	+	NM_021937	127872350	128127102	7
chr3	128181274	128186091	DNAJB8	4817	-	NM_153330	128181389	128182088	3
chr3	128182436	128191160	DNAJB8-AS1	8724	+	NR_037890	128191160	128191160	3
chr3	128198264	128212030	GATA2	13766	-	NM_032638	128199861	128205874	6
chr3	128208045	128222050	GATA2-AS1	14005	+	NR_125398	128222050	128222050	3
chr3	128226677	128229429	LOC90246	2752	+	NR_026954	128229429	128229429	1
chr3	128290842	128294929	LINC01565	4087	-	NR_125802	128294929	128294929	3
chr3	128338812	128369719	RPN1	30907	-	NM_002950	128339253	128369643	10
chr3	128444978	128533641	RAB7A	88663	+	NM_004637	128514210	128532265	6
chr3	128580350	128590384	LOC653712	10034	-	NR_034179	128590384	128590384	5
chr3	128598332	128631957	ACAD9	33625	+	NR_033426	128631957	128631957	18
chr3	128689781	128712986	KIAA1257	23205	-	NM_020741	128690067	128712147	8
chr3	128720471	128759585	EFCC1	39114	+	NM_024768	128720471	128758691	8
chr3	128779609	128781254	GP9	1645	+	NM_000174	128780582	128781116	3
chr3	128806411	128840993	RAB43	34582	-	NM_001204883	128809938	128840332	4
chr3	128806411	128880073	ISY1-RAB43	73662	-	NM_001204890	128813867	128879818	13
chr3	128846258	128880073	ISY1	33815	-	NM_001199469	128848923	128879818	12
chr3	128886657	128902810	CNBP	16153	-	NM_001127192	128889295	128890600	5
chr3	128968452	128996616	COPG1	28164	+	NM_016128	128968552	128996267	24
chr3	128990988	128991086	MIR6826	98	+	NR_106884	128991086	128991086	1
chr3	128997683	129024135	HMCES	26452	+	NM_020187	128998575	129023668	7
chr3	129033613	129035120	H1FX	1507	-	NM_006026	129034103	129034745	1
chr3	129035113	129043412	H1FX-AS1	8299	+	NR_026991	129043412	129043412	5
chr3	129101676	129118282	RPL32P3	16606	-	NR_003111	129118282	129118282	4
chr3	129116052	129116191	SNORA7B	139	-	NR_002992	129116191	129116191	1
chr3	129120163	129147494	EFCAB12	27331	-	NM_207307	129120435	129147331	9
chr3	129149786	129159022	MBD4	9236	-	NM_003925	129150343	129158676	8
chr3	129158878	129239350	IFT122	80472	+	NM_052985	129159173	129239108	31
chr3	129247481	129254187	RHO	6706	+	NM_000539	129247576	129252561	5
chr3	129262056	129270310	H1FOO	8254	+	NM_153833	129262061	129270183	5
chr3	129274055	129325582	PLXND1	51527	-	NM_015103	129275154	129325482	36
chr3	129366634	129612419	TMCC1	245785	-	NM_001128224	129370323	129546879	6
chr3	129612713	129627755	TMCC1-AS1	15042	+	NR_037893	129627755	129627755	3
chr3	129693235	129696781	TRH	3546	+	NM_007117	129694659	129696059	3
chr3	129800673	129817233	ALG1L2	16560	+	NM_001136152	129800859	129817098	8
chr3	129816624	129830276	FAM86HP	13652	-	NR_024252	129830276	129830276	5
chr3	129931662	129992649	COL6A4P2	60987	+	NR_027898	129992649	129992649	23
chr3	130064358	130203690	COL6A5	139332	+	NR_022012	130203690	130203690	42
chr3	130279177	130395888	COL6A6	116711	+	NM_001102608	130279208	130394241	36
chr3	130397777	130465696	PIK3R4	67919	-	NM_014602	130398158	130464062	20
chr3	130569368	130735555	ATP2C1	166187	+	NM_001199180	130569664	130735091	28
chr3	130732716	130745698	ASTE1	12982	-	NM_001288950	130732900	130744150	7
chr3	130745693	131069309	NEK11	323616	+	NM_024800	130748552	131068620	18
chr3	131043935	131100319	LOC339874	56384	-	NR_038976	131100319	131100319	4
chr3	131080688	131083966	NUDT16P1	3278	+	NR_002949	131083966	131083966	3
chr3	131100514	131107674	NUDT16	7160	+	NM_001171905	131100889	131102286	4
chr3	131181044	131221860	MRPL3	40816	-	NM_007208	131181566	131221665	10
chr3	131197841	131198077	SNORA58	236	-	NR_002985	131198077	131198077	1
chr3	131252403	131758450	CPNE4	506047	-	NM_153429	131254038	131756453	17
chr3	131704698	131704775	MIR5704	77	-	NR_049890	131704775	131704775	1
chr3	132036210	132087146	ACPP	50936	+	NM_001134194	132036300	132086666	11
chr3	132136552	132257876	DNAJC13	121324	+	NM_015268	132153394	132257126	56
chr3	132276981	132378975	ACAD11	101994	-	NM_032169	132277814	132378595	20
chr3	132276981	132441303	NPHP3-ACAD11	164322	-	NR_037804	132441303	132441303	45
chr3	132316080	132321485	ACKR4	5405	+	NM_016557	132319241	132320294	2
chr3	132373289	132396944	UBA5	23655	+	NM_198329	132384673	132395370	12
chr3	132399452	132441303	NPHP3	41851	-	NM_153240	132400753	132441199	27
chr3	132441185	132593050	NPHP3-AS1	151865	+	NR_002811	132593050	132593050	11
chr3	132757131	133116619	TMEM108	359488	+	NM_001136469	132948155	133114830	6
chr3	132965291	132975965	TMEM108-AS1	10674	-	NR_110812	132975965	132975965	3
chr3	133118838	133194056	BFSP2	75218	+	NM_003571	133118927	133193816	7
chr3	133292433	133309118	CDV3	16685	+	NM_001282762	133293948	133306890	5
chr3	133319448	133380737	TOPBP1	61289	-	NM_007027	133320093	133379971	28
chr3	133464976	133497850	TF	32874	+	NM_001063	133465284	133497464	17
chr3	133502876	133540336	SRPRB	37460	+	NM_021203	133524692	133538610	8
chr3	133543079	133614691	RAB6B	71612	-	NM_016577	133547631	133614310	8
chr3	133646989	133648656	C3orf36	1667	-	NM_025041	133647149	133647647	1
chr3	133651539	133748920	SLCO2A1	97381	-	NM_005630	133653556	133748646	14
chr3	133875977	133969586	RYK	93609	-	NM_002958	133876996	133969496	15
chr3	134074186	134094259	AMOTL2	20073	-	NM_001278683	134076546	134094142	10
chr3	134086645	134086704	MIR6827	59	-	NR_106885	134086704	134086704	1
chr3	134156668	134156748	MIR4788	80	+	NR_039951	134156748	134156748	1
chr3	134196545	134204865	ANAPC13	8320	-	NM_001242374	134197431	134201746	3
chr3	134204574	134293855	CEP63	89281	+	NM_001042384	134214162	134293733	12
chr3	134318764	134369864	KY	51100	-	NM_178554	134322420	134369802	11
chr3	134514098	134979307	EPHB1	465209	+	NM_004441	134514473	134977962	16
chr3	135684514	135866752	PPP2R3A	182238	+	NM_002718	135720340	135864008	14
chr3	135867759	135914688	MSL2	46929	-	NM_018133	135869988	135913955	2
chr3	135969166	136049013	PCCB	79847	+	NM_001178014	135969217	136048868	16
chr3	136055998	136471245	STAG1	415247	-	NM_005862	136057095	136349740	34
chr3	136537860	136574734	SLC35G2	36874	+	NM_001097600	136573302	136574541	2
chr3	136560817	136580905	NCK1-AS1	20088	-	NR_110175	136580905	136580905	4
chr3	136581049	136670452	NCK1	89403	+	NM_006153	136646843	136667295	4
chr3	136676706	136729926	IL20RB	53220	+	NM_144717	136676955	136729065	7
chr3	137483133	137485172	SOX14	2039	+	NM_004189	137483626	137484349	1
chr3	137490752	137499719	LINC01210	8967	+	NR_109987	137499719	137499719	5
chr3	137717657	137752494	CLDN18	34837	+	NM_001002026	137717710	137749983	5
chr3	137780826	137834451	DZIP1L	53625	-	NM_173543	137781657	137822813	16
chr3	137842559	137851229	A4GNT	8670	-	NM_016161	137843105	137850098	3
chr3	137879829	137893791	DBR1	13962	-	NM_016216	137880730	137893637	8
chr3	137906089	138017228	ARMC8	111139	+	NM_015396	137907369	138014734	23
chr3	137980278	138048728	NME9	68450	-	NM_178130	137981381	138043739	12
chr3	138066489	138124377	MRAS	57888	+	NM_012219	138091725	138121111	6
chr3	138153414	138197256	ESYT3	43842	+	NM_031913	138153640	138195696	23
chr3	138213180	138313225	CEP70	100045	-	NM_024491	138213856	138291769	18
chr3	138327541	138352213	FAIM	24672	+	NM_001033031	138338568	138351921	6
chr3	138371539	138478201	PIK3CB	106662	-	NM_006219	138374230	138478185	22
chr3	138654030	138662862	LINC01391	8832	-	NR_121649	138662862	138662862	3
chr3	138663065	138665982	FOXL2	2917	-	NM_023067	138664433	138665564	1
chr3	138666075	138672830	FOXL2NB	6755	+	NM_001040061	138666206	138669414	3
chr3	138722803	138725110	PRR23A	2307	-	NM_001134659	138724309	138725110	1
chr3	138737872	138739768	PRR23B	1896	-	NM_001013650	138738705	138739503	1
chr3	138760943	138763734	PRR23C	2791	-	NM_001134657	138762673	138763462	1
chr3	138823026	138844005	BPESC1	20979	+	NR_026783	138844005	138844005	3
chr3	138951833	138952364	PISRT1	531	-	NR_027070	138952364	138952364	1
chr3	139062860	139075887	MRPS22	13027	+	NM_020191	139062868	139075856	8
chr3	139076432	139108522	COPB2	32090	-	NM_004766	139076704	139108392	22
chr3	139108644	139302161	LOC100507291	193517	+	NR_121609	139302161	139302161	5
chr3	139171725	139195352	RBP2	23627	-	NM_004164	139171957	139195301	4
chr3	139236275	139258671	RBP1	22396	-	NM_002899	139236468	139258560	4
chr3	139279022	139396885	NMNAT3	117863	-	NM_178177	139279851	139297895	5
chr3	139654026	140286919	CLSTN2	632893	+	NM_022131	139654216	140285095	17
chr3	140224459	140227631	CLSTN2-AS1	3172	-	NR_108084	140227631	140227631	2
chr3	140396865	140419992	TRIM42	23127	+	NM_152616	140397071	140419816	5
chr3	140660661	140698785	SLC25A36	38124	+	NM_001104647	140660896	140695295	7
chr3	140770243	140867453	SPSB4	97210	+	NM_080862	140784946	140866111	3
chr3	140950666	141013745	PXYLP1	63079	+	NM_152282	140979017	141012047	8
chr3	141043054	141168632	ZBTB38	125578	+	NM_001080412	141161230	141164818	8
chr3	141205888	141334205	RASA2	128317	+	NM_001303246	141205925	141331155	25
chr3	141457050	141465645	RNF7	8595	+	NR_037703	141465645	141465645	4
chr3	141497042	141535892	GRK7	38850	+	NM_139209	141497126	141535892	4
chr3	141595469	141645382	ATP1B3	49913	+	NM_001679	141595643	141644543	7
chr3	141663269	141868386	TFDP2	205117	-	NM_001178138	141671354	141724285	14
chr3	141876368	141944449	GK5	68081	-	NR_033289	141944449	141944449	17
chr3	142025448	142166904	XRN1	141456	-	NM_019001	142030352	142166786	42
chr3	142168076	142297668	ATR	129592	-	NM_001184	142168270	142297546	47
chr3	142315228	142432505	PLS1	117277	+	NM_001145319	142383079	142430849	16
chr3	142443265	142526729	TRPC1	83464	+	NM_001251845	142443401	142525077	13
chr3	142536701	142608045	PCOLCE2	71344	-	NM_013363	142537176	142607738	9
chr3	142645516	142661378	LOC100507389	15862	+	NR_038455	142661378	142661378	5
chr3	142680073	142682178	PAQR9	2105	-	NM_198504	142681044	142682178	1
chr3	142682899	142719932	PAQR9-AS1	37033	+	NR_125393	142719932	142719932	5
chr3	142719686	142720309	LOC100289361	623	-	NR_034032	142720309	142720309	1
chr3	142720371	142779567	U2SURP	59196	+	NM_001080415	142720470	142775292	28
chr3	142838617	142842856	CHST2	4239	+	NM_004267	142839658	142841251	2
chr3	142984063	143567373	SLC9A9	583310	-	NM_173653	142985543	143567164	16
chr3	143061087	143065913	SLC9A9-AS1	4826	+	NR_048544	143065913	143065913	4
chr3	143690639	143711210	C3orf58	20571	+	NM_173552	143691174	143708683	3
chr3	145787227	145879282	PLOD2	92055	-	NM_182943	145788503	145878776	20
chr3	145910123	145968966	PLSCR4	58843	-	NM_001128304	145912197	145939858	11
chr3	146151074	146213778	PLSCR2	62704	-	NM_020359	146159578	146177691	9
chr3	146232966	146262628	PLSCR1	29662	-	NM_021105	146233831	146254339	9
chr3	146303624	146324003	PLSCR5	20379	-	NM_001085420	146303860	146322999	8
chr3	147103834	147124596	ZIC4	20762	-	NM_032153	147106645	147120584	5
chr3	147127180	147134506	ZIC1	7326	+	NM_003412	147127899	147131338	3
chr3	147139113	147227697	LOC440982	88584	+	NR_121655	147227697	147227697	3
chr3	148415657	148460790	AGTR1	45133	+	NM_031850	148447966	148459902	4
chr3	148545587	148577972	CPB1	32385	+	NM_001871	148545610	148577789	11
chr3	148583042	148614878	CPA3	31836	+	NM_001870	148583094	148614494	11
chr3	148709194	148745456	GYG1	36262	+	NM_004130	148709427	148744720	8
chr3	148747903	148804341	HLTF	56438	-	NM_139048	148750006	148804123	26
chr3	148804118	148820610	HLTF-AS1	16492	+	NR_046648	148820610	148820610	3
chr3	148847370	148890983	HPS3	43613	+	NM_032383	148847510	148890009	17
chr3	148880196	148939832	CP	59636	-	NR_046371	148939832	148939832	18
chr3	149036284	149051548	TM4SF18	15264	-	NM_138786	149039264	149051169	6
chr3	149086804	149095568	TM4SF1	8764	-	NM_014220	149087652	149095334	5
chr3	149095564	149104370	TM4SF1-AS1	8806	+	NR_109809	149104370	149104370	3
chr3	149192367	149221181	TM4SF4	28814	+	NM_004617	149192664	149220480	5
chr3	149235021	149421060	WWTR1	186039	-	NM_001168278	149238591	149375093	8
chr3	149375996	149379149	WWTR1-AS1	3153	+	NR_040250	149379149	149379149	3
chr3	149456256	149470286	COMMD2	14030	-	NM_016094	149459307	149470231	5
chr3	149479225	149510610	ANKUB1	31385	-	NM_001144960	149479270	149510153	6
chr3	149530474	149679925	RNF13	149451	+	NM_007282	149563813	149678891	11
chr3	149682690	149688741	PFN2	6051	-	NM_053024	149684275	149688643	3
chr3	149689065	149691029	LOC646903	1964	+	NR_036538	149691029	149691029	1
chr3	149956305	149957992	LINC01213	1687	+	NR_110168	149957992	149957992	3
chr3	149983193	150041534	LINC01214	58341	-	NR_110186	150041534	150041534	4
chr3	150126121	150177905	TSC22D2	51784	+	NR_130136	150177905	150177905	5
chr3	150259779	150264428	SERP1	4649	-	NM_014445	150262244	150263922	3
chr3	150264573	150303803	EIF2A	39230	+	NM_032025	150264589	150301698	14
chr3	150321065	150348234	SELT	27169	+	NM_016275	150321149	150344921	6
chr3	150377671	150421758	ERICH6	44087	-	NM_152394	150377678	150421685	14
chr3	150421350	150437933	ERICH6-AS1	16583	+	NR_121675	150437933	150437933	3
chr3	150452257	150456772	LOC101928105	4515	-	NR_121657	150456772	150456772	3
chr3	150458909	150481263	SIAH2	22354	-	NM_005067	150459927	150480636	2
chr3	150644353	150690786	CLRN1	46433	-	NR_046380	150690786	150690786	5
chr3	150690464	150797617	CLRN1-AS1	107153	+	NR_024066	150797617	150797617	6
chr3	150804584	151154465	MED12L	349881	+	NM_053002	150804713	151150592	43
chr3	150915618	150920988	GPR171	5370	-	NM_013308	150916213	150917173	3
chr3	150929904	150996230	P2RY14	66326	-	NM_014879	150931087	150932104	3
chr3	151011875	151034636	GPR87	22761	-	NM_023915	151011956	151017888	3
chr3	151044095	151047337	P2RY13	3242	-	NM_176894	151045778	151047316	2
chr3	151054630	151102600	P2RY12	47970	-	NM_022788	151055604	151056633	3
chr3	151153777	151176497	IGSF10	22720	-	NM_178822	151154476	151176497	6
chr3	151283663	151283783	MIR5186	120	-	NR_049818	151283783	151283783	1
chr3	151347319	151542394	MIR548H2	195075	+	NR_031678	151542394	151542394	5
chr3	151451703	151475556	AADACL2	23853	+	NM_207365	151451823	151475382	5
chr3	151468966	151645963	AADACL2-AS1	176997	-	NR_110202	151645963	151645963	4
chr3	151488243	151502682	AADACP1	14439	+	NR_026915	151502682	151502682	3
chr3	151531860	151546276	AADAC	14416	+	NM_001086	151531950	151545960	5
chr3	151591430	151599876	SUCNR1	8446	+	NM_033050	151597680	151599336	3
chr3	151980404	151987415	MBNL1-AS1	7011	-	NR_027038	151987415	151987415	2
chr3	151986256	152183569	MBNL1	197313	+	NM_001314057	152114010	152177116	12
chr3	152057486	152058779	TMEM14EP	1293	-	NR_132656	152058779	152058779	1
chr3	152552481	152559228	P2RY1	6747	+	NM_002563	152553571	152554693	1
chr3	152880000	152888413	RAP2B	8413	+	NM_002886	152880482	152881034	1
chr3	153202283	153220486	C3orf79	18203	+	NM_001101337	153202345	153220271	3
chr3	153742189	153838999	ARHGEF26-AS1	96810	-	NR_037901	153838999	153838999	4
chr3	153838791	153975616	ARHGEF26	136825	+	NM_001251962	153839781	153973262	15
chr3	153993456	154042286	DHX36	48830	-	NM_020865	153993959	154042205	25
chr3	154055460	154147504	GPR149	92044	-	NM_001038705	154055487	154147404	4
chr3	154797435	154901518	MME	104083	+	NM_000902	154801956	154898248	23
chr3	154958733	154960912	LINC01487	2179	+	NR_125399	154960912	154960912	3
chr3	155008020	155011489	LOC100507537	3469	-	NR_037902	155011489	155011489	3
chr3	155197670	155421997	PLCH1	224327	-	NM_014996	155198756	155314156	22
chr3	155480400	155524076	C3orf33	43676	-	NM_173657	155481305	155520365	6
chr3	155544300	155572248	SLC33A1	27948	-	NM_001190992	155545998	155571786	7
chr3	155588324	155655520	GMPS	67196	+	NM_003875	155588659	155655481	16
chr3	155838336	156256927	KCNAB1	418591	+	NM_172160	155838400	156254536	14
chr3	155933348	155945672	KCNAB1-AS2	12324	-	NR_046617	155945672	155945672	4
chr3	156158945	156164725	KCNAB1-AS1	5780	-	NR_046618	156164725	156164725	3
chr3	156257341	156272989	SSR3	15648	-	NM_007107	156260991	156272878	5
chr3	156390959	156393502	TIPARP-AS1	2543	-	NR_027954	156393502	156393502	1
chr3	156392204	156424557	TIPARP	32353	+	NM_015508	156395486	156422920	6
chr3	156465131	156534851	LINC00886	69720	-	NR_038387	156534851	156534851	3
chr3	156527059	156529810	PA2G4P4	2751	-	NR_003284	156529810	156529810	1
chr3	156544095	156763918	LEKR1	219823	+	NM_001004316	156547118	156763539	13
chr3	156799455	156840791	LINC00880	41336	-	NR_034007	156840791	156840791	4
chr3	156807669	156818924	LINC00881	11255	+	NR_034008	156818924	156818924	3
chr3	156864290	156878549	CCNL1	14259	-	NM_001308185	156864341	156877883	11
chr3	156977531	157221136	VEPH1	243605	-	NM_001167912	156978922	157213138	14
chr3	157154579	157161417	PTX3	6838	+	NM_002852	157154722	157160768	3
chr3	157261132	157319021	PQLC2L	57889	+	NM_001130002	157271046	157318087	5
chr3	157813799	157823952	SHOX2	10153	-	NM_003030	157815815	157823813	6
chr3	157827840	158262624	RSRC1	434784	+	NM_001271838	157839893	158262064	10
chr3	158263008	158288855	LOC100996447	25847	-	NR_104147	158288855	158288855	5
chr3	158288952	158324249	MLF1	35297	+	NM_001195434	158310250	158322991	9
chr3	158362316	158410360	GFM1	48044	+	NM_001308164	158362423	158409256	19
chr3	158384202	158390482	LXN	6280	-	NM_020169	158384434	158390267	6
chr3	158414896	158450275	RARRES1	35379	-	NM_206963	158415466	158450204	6
chr3	158519714	158547508	MFSD1	27794	+	NM_022736	158519794	158546771	16
chr3	158787040	158984096	IQCJ	197056	+	NM_001042705	158787221	158983192	5
chr3	158787040	159615155	IQCJ-SCHIP1	828115	+	NM_001197113	158787221	159614563	11
chr3	158991035	159615155	SCHIP1	624120	+	NM_014575	158991609	159614563	8
chr3	159000434	159000523	MIR3919	89	+	NR_037483	159000523	159000523	1
chr3	159483170	159486401	IQCJ-SCHIP1-AS1	3231	-	NR_121669	159486401	159486401	3
chr3	159631189	159924879	IL12A-AS1	293690	-	NR_108088	159924879	159924879	10
chr3	159706622	159713806	IL12A	7184	+	NM_000882	159706843	159713346	7
chr3	159738435	159749210	LINC01100	10775	+	NR_104132	159749210	159749210	3
chr3	159943422	159946000	C3orf80	2578	+	NM_001168214	159943422	159944166	1
chr3	159974773	160117320	IFT80	142547	-	NM_001190241	159976312	160093627	21
chr3	160117091	160152749	SMC4	35658	+	NM_001288753	160118614	160151597	24
chr3	160122375	160122473	MIR15B	98	+	NR_029663	160122473	160122473	1
chr3	160122532	160122613	MIR16-2	81	+	NR_029525	160122613	160122613	1
chr3	160153290	160167626	TRIM59	14336	-	NM_173084	160155759	160156971	3
chr3	160212782	160283376	KPNA4	70594	-	NM_002268	160219891	160283070	17
chr3	160232694	160233024	SCARNA7	330	-	NR_003001	160233024	160233024	1
chr3	160394947	160396235	ARL14	1288	+	NM_025047	160395134	160395713	1
chr3	160473991	160796695	PPM1L	322704	+	NM_139245	160474096	160786945	4
chr3	160801670	160823160	B3GALNT1	21490	-	NM_001038628	160803546	160804542	8
chr3	160939098	160969795	NMD3	30697	+	NM_015938	160939801	160968698	16
chr3	161062579	161089871	SPTSSB	27292	-	NM_001040100	161063880	161064111	3
chr3	161144214	161166030	LOC101243545	21816	+	NR_102265	161166030	161166030	4
chr3	161214595	161221730	OTOL1	7135	+	NM_001080440	161214595	161221730	4
chr3	162895030	163021089	LINC01192	126059	-	NR_033945	163021089	163021089	7
chr3	163889258	163889344	MIR1263	86	-	NR_031665	163889344	163889344	1
chr3	164431882	164549268	LINC01324	117386	-	NR_126405	164549268	164549268	4
chr3	164696685	164796283	SI	99598	-	NM_001041	164697149	164793800	48
chr3	164904507	164914469	SLITRK3	9962	-	NM_014926	164905684	164908618	2
chr3	164924747	165231516	LINC01322	306769	+	NR_125764	165231516	165231516	6
chr3	165490691	165555253	BCHE	64562	-	NM_000055	165491169	165548821	4
chr3	166958076	167098085	ZBBX	140009	-	NM_001199201	166958580	167090689	22
chr3	167110583	167126307	LINC01327	15724	+	NR_126353	167126307	167126307	4
chr3	167159576	167191920	SERPINI2	32344	-	NM_001012303	167159896	167191544	10
chr3	167196472	167371289	WDR49	174817	-	NM_178824	167196665	167322191	15
chr3	167401694	167452651	PDCD10	50957	-	NM_145859	167402095	167437945	9
chr3	167453431	167543357	SERPINI1	89926	+	NM_001122752	167506916	167543111	9
chr3	167613735	167641797	LINC01330	28062	+	NR_033843	167641797	167641797	8
chr3	167726460	167813713	GOLIM4	87253	-	NM_014498	167728056	167813073	16
chr3	167967309	168548374	EGFEM1P	581065	+	NR_021485	168548374	168548374	16
chr3	168269641	168269737	MIR551B	96	+	NR_030294	168269737	168269737	1
chr3	168619732	168639781	LOC100507661	20049	+	NR_109989	168639781	168639781	5
chr3	168801286	169381563	MECOM	580277	-	NM_004991	168802696	169381160	17
chr3	169482397	169482848	TERC	451	-	NR_001566	169482848	169482848	1
chr3	169484710	169487683	ACTRT3	2973	-	NM_032487	169485219	169487308	2
chr3	169490852	169507504	MYNN	16652	+	NM_001185118	169492083	169504466	9
chr3	169511215	169530574	LRRC34	19359	-	NM_001172779	169511422	169530336	11
chr3	169539709	169555560	LRRIQ4	15851	+	NM_001080460	169539709	169555419	5
chr3	169557028	169587723	LRRC31	30695	-	NM_024727	169557769	169587595	9
chr3	169629359	169656956	SAMD7	27597	+	NR_130713	169656956	169656956	10
chr3	169661771	169684522	LOC100128164	22751	-	NR_027622	169684522	169684522	2
chr3	169684579	169716161	SEC62	31582	+	NM_003262	169684610	169710851	8
chr3	169755734	169803183	GPR160	47449	+	NM_014373	169801760	169802777	4
chr3	169805367	169899537	PHC3	94170	-	NM_001308116	169815017	169896704	15
chr3	169940219	170023770	PRKCI	83551	+	NM_002740	169940457	170020915	18
chr3	170075472	170114637	SKIL	39165	+	NM_001145098	170078179	170110205	8
chr3	170136652	170152479	CLDN11	15827	+	NM_005602	170136854	170150544	3
chr3	170140890	170140950	MIR6828	60	+	NR_106886	170140950	170140950	1
chr3	170177341	170303863	SLC7A14	126522	-	NM_020949	170184842	170244725	8
chr3	170582664	170588045	RPL22L1	5381	-	NM_001099645	170584168	170587956	4
chr3	170606203	170626426	EIF5A2	20223	-	NM_020390	170611148	170625595	5
chr3	170714136	170744768	SLC2A2	30632	-	NM_000340	170715691	170744459	11
chr3	170780291	171178197	TNIK	397906	-	NM_015028	170781669	171177852	33
chr3	170824452	170824548	MIR569	96	-	NR_030295	170824548	170824548	1
chr3	171318194	171528284	PLD1	210090	-	NM_002662	171320867	171455841	27
chr3	171561138	171577108	TMEM212	15970	+	NM_001164436	171561173	171574494	5
chr3	171594141	171618530	TMEM212-AS1	24389	-	NR_046852	171618530	171618530	3
chr3	171757417	172118492	FNDC3B	361075	+	NM_022763	171830269	172115265	26
chr3	172161080	172166246	GHSR	5166	-	NM_198407	172162950	172166203	2
chr3	172223297	172241297	TNFSF10	18000	-	NM_003810	172224281	172241174	5
chr3	172348434	172429008	NCEH1	80574	-	NM_020792	172351264	172428870	5
chr3	172468474	172539264	ECT2	70790	+	NM_001258315	172472320	172538027	25
chr3	172607146	172859058	SPATA16	251912	-	NM_031955	172607359	172835521	11
chr3	173116237	174001139	NLGN1	884902	+	NM_014932	173322388	173999093	7
chr3	173628288	173638586	NLGN1-AS1	10298	-	NR_046664	173638586	173638586	4
chr3	174577110	175523428	NAALADL2	946318	+	NM_207015	174577197	175520991	14
chr3	174797101	174833032	NAALADL2-AS3	35931	-	NR_046390	174833032	174833032	4
chr3	174952881	174988885	NAALADL2-AS2	36004	-	NR_046713	174988885	174988885	3
chr3	175087328	175087410	MIR4789	82	+	NR_039952	175087410	175087410	1
chr3	175132985	175153256	MIR548AY	20271	+	NR_106753	175153256	175153256	3
chr3	175491365	175494121	NAALADL2-AS1	2756	-	NR_046714	175494121	175494121	3
chr3	176232890	176232939	MIR7977	49	+	NR_107017	176232939	176232939	1
chr3	176321935	176353320	LINC01208	31385	-	NR_109968	176353320	176353320	3
chr3	176531943	176534789	LINC01209	2846	-	NR_110819	176534789	176534789	2
chr3	176738541	176915048	TBL1XR1	176507	-	NM_024665	176743285	176782765	16
chr3	177012229	177041223	LINC00501	28994	+	NR_047465	177041223	177041223	2
chr3	177159708	177470492	LINC00578	310784	+	NR_047568	177470492	177470492	4
chr3	177534652	177617012	KCCAT211	82360	+	NR_110826	177617012	177617012	3
chr3	178136988	178175093	LINC01014	38105	+	NR_046786	178175093	178175093	3
chr3	178243254	178578193	KCNMB2-AS1	334939	-	NR_126560	178578193	178578193	8
chr3	178254085	178562217	KCNMB2	308132	+	NM_181361	178525197	178560725	5
chr3	178735010	178789656	ZMAT3	54646	-	NM_152240	178742804	178785540	7
chr3	178819158	178865761	LOC101928739	46603	-	NR_125401	178865761	178865761	3
chr3	178866310	178952497	PIK3CA	86187	+	NM_006218	178916613	178952152	21
chr3	178957536	178984838	KCNMB3	27302	-	NM_001163677	178957783	178984498	4
chr3	179040778	179053323	ZNF639	12545	+	NM_001303425	179046081	179052210	7
chr3	179065479	179111008	MFN1	45529	+	NM_033540	179066639	179109847	18
chr3	179113875	179169371	GNB4	55496	-	NM_021629	179119000	179143988	10
chr3	179280667	179306193	ACTL6A	25526	+	NM_004301	179280880	179305798	14
chr3	179306254	179322434	MRPL47	16180	-	NM_020409	179306659	179322412	7
chr3	179322574	179342288	NDUFB5	19714	+	NM_002492	179322603	179341828	6
chr3	179370932	179507189	USP13	136257	+	NM_003940	179371013	179501929	21
chr3	179512746	179754841	PEX5L	242095	-	NM_001256750	179519615	179754387	15
chr3	179615981	179639687	PEX5L-AS2	23706	+	NR_110059	179639687	179639687	3
chr3	180131960	180140289	LOC100505609	8329	+	NR_132416	180140289	180140289	2
chr3	180319917	180336135	TTC14	16218	+	NM_001288582	180320049	180335355	13
chr3	180331795	180397283	CCDC39	65488	-	NM_181426	180332708	180397168	20
chr3	180425377	180587966	LOC101928882	162589	-	NR_109986	180587966	180587966	14
chr3	180630233	180700539	FXR1	70306	+	NM_001013439	180665709	180694080	18
chr3	180701497	180707562	DNAJC19	6065	-	NR_033723	180707562	180707562	6
chr3	180774467	181460013	SOX2-OT	685546	+	NR_075091	181460013	181460013	8
chr3	181138950	181160274	LOC102724604	21324	-	NR_125407	181160274	181160274	5
chr3	181429711	181432223	SOX2	2512	+	NM_003106	181430148	181431102	1
chr3	181670151	181728464	LINC01206	58313	+	NR_104146	181728464	181728464	8
chr3	182164757	182204150	FLJ46066	39393	-	NR_040105	182204150	182204150	4
chr3	182511290	182639421	ATP11B	128131	+	NM_014616	182511547	182635892	30
chr3	182655945	182703741	DCUN1D1	47796	-	NM_001308101	182662881	182683499	7
chr3	182733005	182817375	MCCC1	84370	-	NM_020166	182733225	182817228	19
chr3	182840002	182880667	LAMP3	40665	-	NM_014398	182841868	182880443	6
chr3	182895791	183146057	MCF2L2	250266	-	NM_015078	182897167	183145765	30
chr3	182971031	182991179	B3GNT5	20148	+	NM_032047	182987586	182988723	2
chr3	183165395	183173800	LINC00888	8405	+	NR_038302	183173800	183173800	4
chr3	183205318	183273499	KLHL6	68181	-	NM_130446	183209714	183273441	7
chr3	183266522	183270114	KLHL6-AS1	3592	+	NR_046687	183270114	183270114	2
chr3	183353410	183402304	KLHL24	48894	+	NM_017644	183368144	183397074	8
chr3	183415605	183530413	YEATS2	114808	+	NM_018023	183432950	183528371	31
chr3	183533663	183543393	MAP6D1	9730	-	NM_024871	183535143	183543335	3
chr3	183547172	183602693	PARL	55521	-	NM_018622	183547385	183602634	10
chr3	183637723	183735727	ABCC5	98004	-	NM_005688	183639087	183732180	30
chr3	183724125	183729207	ABCC5-AS1	5082	+	NR_046570	183729207	183729207	3
chr3	183749331	183757157	HTR3D	7826	+	NM_182537	183754187	183756763	6
chr3	183770834	183778461	HTR3C	7627	+	NM_130770	183770868	183778140	9
chr3	183812905	183822966	HTR3E-AS1	10061	-	NR_133658	183822966	183822966	3
chr3	183814851	183824783	HTR3E	9932	+	NM_001256613	183815317	183824481	9
chr3	183852809	183863099	EIF2B5	10290	+	NM_003907	183853173	183862731	16
chr3	183873283	183891314	DVL3	18031	+	NM_004423	183873423	183888543	15
chr3	183892633	183901879	AP2M1	9246	+	NM_001311198	183894781	183901404	13
chr3	183903862	183911795	ABCF3	7933	+	NM_018358	183903995	183911486	21
chr3	183948316	183960117	VWA5B2	11801	+	NM_138345	183948316	183959826	19
chr3	183959192	183959277	MIR1224	85	+	NR_030410	183959277	183959277	1
chr3	183960116	183967313	ALG3	7197	-	NM_001006941	183960301	183967065	9
chr3	183967444	184010819	ECE2	43375	+	NM_014693	183967482	184010026	19
chr3	183977002	183979251	CAMK2N2	2249	-	NM_033259	183977944	183979073	2
chr3	184016885	184026842	PSMD2	9957	+	NM_002808	184017054	184026678	21
chr3	184032282	184053146	EIF4G1	20864	+	NM_001194946	184033584	184052696	34
chr3	184043483	184043559	SNORD66	76	+	NR_003055	184043559	184043559	1
chr3	184053716	184064063	FAM131A	10347	+	NM_001171093	184059535	184062758	6
chr3	184063972	184079439	CLCN2	15467	-	NM_004366	184064393	184079267	24
chr3	184079501	184086383	POLR2H	6882	+	NM_001278700	184082788	184086082	5
chr3	184089722	184097476	THPO	7754	-	NM_001290027	184090385	184094047	8
chr3	184097860	184107623	CHRD	9763	+	NM_001304473	184100848	184107210	24
chr3	184264501	184274706	EIF2B5-AS1	10205	-	NR_046593	184274706	184274706	2
chr3	184279586	184300196	EPHB3	20610	+	NM_004443	184280023	184299410	16
chr3	184428154	184429836	MAGEF1	1682	-	NM_022149	184428685	184429609	1
chr3	184474176	184490943	LOC101928992	16767	-	NR_110043	184490943	184490943	3
chr3	184529930	184770402	VPS8	240472	+	NM_015303	184542420	184769813	47
chr3	184795837	184870802	C3orf70	74965	-	NM_001025266	184800794	184870611	2
chr3	184880688	184909743	EHHADH-AS1	29055	+	NR_038990	184909743	184909743	7
chr3	184908411	184971886	EHHADH	63475	-	NM_001166415	184910013	184953140	7
chr3	184970997	184971060	MIR5588	63	-	NR_106712	184971060	184971060	1
chr3	185000728	185206882	MAP3K13	206154	+	NM_001242314	185146369	185200244	15
chr3	185207388	185216845	TMEM41A	9457	-	NM_080652	185209324	185216749	5
chr3	185225569	185270369	LIPH	44800	-	NM_139248	185226577	185270259	10
chr3	185304030	185348885	SENP2	44855	+	NM_021627	185304201	185347632	17
chr3	185361526	185542827	IGF2BP2	181301	-	NM_006548	185363318	185542748	16
chr3	185431039	185447575	IGF2BP2-AS1	16536	+	NR_126326	185447575	185447575	8
chr3	185632357	185655924	TRA2B	23567	-	NM_004593	185635502	185655648	9
chr3	185677757	185698665	LOC344887	20908	+	NR_033752	185698665	185698665	6
chr3	185764105	185826901	ETV5	62796	-	NM_004454	185766427	185823657	13
chr3	185864989	186080023	DGKG	215034	-	NM_001346	185867878	186038248	25
chr3	186172769	186211450	LOC253573	38681	-	NR_033844	186211450	186211450	8
chr3	186256231	186262167	CRYGS	5936	-	NM_017541	186256484	186262115	3
chr3	186263855	186288332	TBCCD1	24477	-	NM_001134415	186268938	186282118	8
chr3	186288464	186303589	DNAJB11	15125	+	NM_016306	186288686	186303197	10
chr3	186330849	186339107	AHSG	8258	+	NM_001622	186330930	186338719	7
chr3	186358148	186370797	FETUB	12649	+	NM_014375	186358249	186370420	7
chr3	186383740	186396029	HRG	12289	+	NM_000412	186383820	186395672	7
chr3	186435097	186462199	KNG1	27102	+	NM_000893	186435331	186461574	11
chr3	186501360	186507685	EIF4A2	6325	+	NM_001967	186501399	186507058	11
chr3	186502584	186502654	SNORD2	70	+	NR_002587	186502654	186502654	1
chr3	186504460	186504566	MIR1248	106	+	NR_031650	186504566	186504566	1
chr3	186504463	186504641	SNORA81	178	+	NR_002989	186504641	186504641	1
chr3	186505087	186505222	SNORA63	135	+	NR_002586	186505222	186505222	1
chr3	186505401	186505538	SNORA4	137	+	NR_002588	186505538	186505538	1
chr3	186507681	186524484	RFC4	16803	-	NM_181573	186507757	186522502	11
chr3	186528668	186543310	LOC102724699	14642	-	NR_125409	186543310	186543310	4
chr3	186560462	186576252	ADIPOQ	15790	+	NM_001177800	186570847	186572493	4
chr3	186569675	186573912	ADIPOQ-AS1	4237	-	NR_046662	186573912	186573912	3
chr3	186648314	186796341	ST6GAL1	148027	+	NM_173216	186760491	186793591	8
chr3	186838740	186857263	RPL39L	18523	-	NM_052969	186838932	186839088	3
chr3	186914877	186925417	LOC101929106	10540	-	NR_110052	186925417	186925417	5
chr3	186915273	186919253	RTP1	3980	+	NM_153708	186915303	186917858	2
chr3	186933872	187009810	MASP1	75938	-	NM_001879	186937858	187009420	16
chr3	187086167	187089369	RTP4	3202	+	NM_022147	187086229	187089161	2
chr3	187386693	187388201	SST	1508	-	NM_001048	187386852	187388079	2
chr3	187416046	187420345	RTP2	4299	-	NM_001004312	187416285	187419916	2
chr3	187420153	187450203	LOC100131635	30050	+	NR_034062	187450203	187450203	3
chr3	187439164	187463513	BCL6	24349	-	NM_001706	187440245	187451481	10
chr3	187868993	187871876	LPP-AS2	2883	-	NR_036497	187871876	187871876	1
chr3	187871660	188608460	LPP	736800	+	NM_001167672	188123908	188592267	10
chr3	187896330	187898596	FLJ42393	2266	+	NR_024413	187898596	187898596	1
chr3	188280024	188286454	LPP-AS1	6430	-	NR_046623	188286454	188286454	2
chr3	188406568	188406654	MIR28	86	+	NR_029502	188406654	188406654	1
chr3	188659503	188665428	TPRG1-AS1	5925	-	NR_046873	188665428	188665428	2
chr3	188889762	189041271	TPRG1	151509	+	NM_198485	188925173	189038609	6
chr3	188956474	188958383	TPRG1-AS2	1909	-	NR_046722	188958383	188958383	3
chr3	189349215	189615068	TP63	265853	+	NM_003722	189349304	189612291	14
chr3	189547710	189547798	MIR944	88	+	NR_030642	189547798	189547798	1
chr3	189674516	189840226	P3H2	165710	-	NM_001134418	189675700	189713168	15
chr3	189838752	189862635	P3H2-AS1	23883	+	NR_126419	189862635	189862635	4
chr3	190023489	190040235	CLDN1	16746	-	NM_021101	190026065	190039995	4
chr3	190105660	190129932	CLDN16	24272	+	NM_006580	190105908	190127825	5
chr3	190146444	190167665	TMEM207	21221	-	NM_207316	190147383	190167598	5
chr3	190231839	190374986	IL1RAP	143147	+	NM_001167931	190282078	190374396	12
chr3	190570525	190580465	GMNC	9940	-	NM_001146686	190573083	190580404	5
chr3	190595718	190595839	SNAR-I	121	+	NR_024343	190595839	190595839	1
chr3	190930321	190967910	OSTN	37589	+	NM_198184	190930321	190967910	3
chr3	190931083	190952394	OSTN-AS1	21311	-	NR_133663	190952394	190952394	6
chr3	190984943	191048325	UTS2B	63382	-	NM_198152	190986204	190999978	9
chr3	191046873	191116459	CCDC50	69586	+	NM_178335	191047463	191109549	12
chr3	191143312	191308145	LINCR-0002	164833	+	NR_120606	191308145	191308145	7
chr3	191178951	191179245	PYDC2	294	+	NM_001083308	191178951	191179245	1
chr3	191857181	192445388	FGF12	588207	-	NM_004113	191861797	192444982	6
chr3	191956418	192000884	FGF12-AS1	44466	+	NR_046596	192000884	192000884	5
chr3	192514604	192635950	MB21D2	121346	-	NM_178496	192516174	192635629	2
chr3	192958916	192988644	HRASLS	29728	+	NM_020386	192959007	192988494	4
chr3	192959567	192961761	MGC2889	2194	+	NR_026877	192961761	192961761	1
chr3	192992830	193096514	ATP13A5	103684	-	NM_198505	192992830	193096514	30
chr3	193025032	193032310	ATP13A5-AS1	7278	+	NR_046758	193032310	193032310	2
chr3	193116755	193272911	ATP13A4	156156	-	NM_032279	193120440	193272588	30
chr3	193271001	193273373	ATP13A4-AS1	2372	+	NR_121666	193273373	193273373	2
chr3	193310932	193415600	OPA1	104668	+	NM_130837	193311166	193409916	31
chr3	193336387	193345121	OPA1-AS1	8734	-	NR_046634	193345121	193345121	3
chr3	193675160	193721448	LOC647323	46288	-	NR_033944	193721448	193721448	3
chr3	193710882	193712027	DPPA2P3	1145	-	NR_027764	193712027	193712027	1
chr3	193853930	193856401	HES1	2471	+	NM_005524	193854169	193856022	4
chr3	193920804	193967942	LOC100505920	47138	-	NR_125403	193967942	193967942	3
chr3	193965436	193975561	LOC101929337	10125	+	NR_125402	193975561	193975561	4
chr3	194018988	194030593	LINC00887	11605	-	NR_024480	194030593	194030593	3
chr3	194060493	194072057	CPN2	11564	-	NM_001080513	194061793	194063431	2
chr3	194075975	194090472	LRRC15	14497	-	NM_001135057	194080026	194084099	3
chr3	194115549	194119995	GP5	4446	-	NM_004488	194117328	194119011	2
chr3	194123402	194188968	ATP13A3	65566	-	NM_024524	194126647	194182919	32
chr3	194207868	194209274	LINC00884	1406	+	NR_033929	194209274	194209274	2
chr3	194304996	194311561	TMEM44-AS1	6565	+	NR_047573	194311561	194311561	4
chr3	194308401	194354150	TMEM44	45749	-	NM_001166305	194309257	194353944	11
chr3	194361516	194393206	LSG1	31690	-	NM_018385	194362796	194392891	14
chr3	194406621	194409766	FAM43A	3145	+	NM_153690	194407555	194408827	1
chr3	194429149	194502897	LOC100507391	73748	+	NR_037891	194502897	194502897	4
chr3	194789012	194991895	XXYLT1	202883	-	NM_152531	194790443	194991787	4
chr3	194815316	194816786	XXYLT1-AS1	1470	+	NR_104188	194816786	194816786	4
chr3	194855234	194855309	MIR3137	75	-	NR_036089	194855309	194855309	1
chr3	194868599	194873585	XXYLT1-AS2	4986	+	NR_102710	194873585	194873585	2
chr3	194995464	195163817	ACAP2	168353	-	NM_012287	195000056	195163576	23
chr3	195208644	195208667	MIR5692C1	23	-	NR_049867	195208667	195208667	1
chr3	195241217	195270224	PPP1R2	29007	-	NM_001316325	195243693	195256619	7
chr3	195295572	195311076	APOD	15504	-	NM_001647	195295770	195306332	5
chr3	195384909	195415735	SDHAP2	30826	+	NR_003265	195415735	195415735	15
chr3	195415368	195438746	LINC00969	23378	+	NR_122105	195438746	195438746	5
chr3	195426271	195426368	MIR570	97	+	NR_030296	195426368	195426368	1
chr3	195447752	195460424	MUC20	12672	+	NM_020790	195447878	195460089	6
chr3	195473637	195538844	MUC4	65207	-	NM_018406	195474046	195538688	25
chr3	195590235	195635880	TNK2	45645	-	NM_005781	195591051	195615459	15
chr3	195609199	195609266	MIR6829	67	-	NR_106887	195609266	195609266	1
chr3	195686791	195717150	SDHAP1	30359	-	NR_003264	195717150	195717150	17
chr3	195776154	195809032	TFRC	32878	-	NM_001128148	195778812	195803970	19
chr3	195869506	195887761	LINC00885	18255	+	NR_034088	195887761	195887761	3
chr3	195924322	195938300	ZDHHC19	13978	-	NM_001039617	195925165	195938186	8
chr3	195943382	195960301	SLC51A	16919	+	NM_152672	195943583	195960070	9
chr3	195964615	196014623	PCYT1A	50008	-	NM_005017	195965558	195997402	10
chr3	196018089	196045165	TCTEX1D2	27076	-	NM_152773	196018197	196045023	5
chr3	196042955	196065291	TM4SF19-TCTEX1D2	22336	-	NR_037950	196065291	196065291	6
chr3	196045202	196052441	TM4SF19-AS1	7239	+	NR_046724	196052441	196052441	2
chr3	196050416	196065291	TM4SF19	14875	-	NM_001204897	196050584	196054461	5
chr3	196080368	196159345	UBXN7	78977	-	NM_015562	196083555	196159270	11
chr3	196195656	196230639	RNF168	34983	-	NM_152617	196198689	196230044	6
chr3	196233749	196242237	SMCO1	8488	-	NM_001077657	196234757	196242080	3
chr3	196281058	196295413	WDR53	14355	-	NM_182627	196281081	196288346	4
chr3	196295724	196315930	FBXO45	20206	+	NM_001105573	196295855	196311189	3
chr3	196358374	196359458	LINC01063	1084	-	NR_132101	196359458	196359458	2
chr3	196366566	196388874	NRROS	22308	+	NM_198565	196381410	196388593	3
chr3	196433147	196439165	CEP19	6018	-	NM_032898	196434421	196435540	3
chr3	196439244	196462876	PIGX	23632	+	NM_001166304	196439403	196460773	7
chr3	196466727	196559518	PAK2	92791	+	NM_002577	196509517	196555276	15
chr3	196594726	196661584	SENP5	66858	+	NM_152699	196612052	196657794	10
chr3	196662272	196669464	NCBP2	7192	-	NM_007362	196663881	196669374	4
chr3	196669493	196670884	NCBP2-AS2	1391	+	NR_024388	196670884	196670884	1
chr3	196673213	196695742	PIGZ	22529	-	NM_025163	196674027	196678902	3
chr3	196728611	196756687	MFI2	28076	-	NM_005929	196730242	196756573	16
chr3	196729776	196731615	MFI2-AS1	1839	+	NR_038285	196731615	196731615	4
chr3	196769430	197026143	DLG1	256713	-	NM_001290983	196771493	197024075	26
chr3	197020748	197020819	MIR4797	71	-	NR_039960	197020819	197020819	1
chr3	197025117	197030621	DLG1-AS1	5504	+	NR_038289	197030621	197030621	3
chr3	197236653	197300194	BDH1	63541	-	NM_203315	197238765	197273314	7
chr3	197340897	197354752	LOC220729	13855	-	NR_003266	197354752	197354752	8
chr3	197398264	197476570	RUBCN	78306	-	NM_001145642	197401888	197444886	21
chr3	197401366	197401447	MIR922	81	-	NR_030627	197401447	197401447	1
chr3	197476423	197511317	FYTTD1	34894	+	NM_001011537	197482680	197508780	10
chr3	197518096	197598456	LRCH3	80360	+	NM_032773	197518149	197598342	19
chr3	197615945	197686886	IQCG	70941	-	NM_032263	197616450	197672498	12
chr3	197677051	197682721	RPL35A	5670	+	NM_000996	197677838	197682644	5
chr3	197687070	197770591	LMLN	83521	+	NM_001136049	197687092	197765538	17
chr3	197765194	197766338	LMLN-AS1	1144	-	NR_046669	197766338	197766338	4
chr3	197784403	197807542	ANKRD18DP	23139	-	NR_003291	197807542	197807542	10
chr3	197879236	197907728	FAM157A	28492	+	NM_001145248	197879236	197896723	7
chr4	53178	88099	ZNF595	34921	+	NM_001286054	85944	87340	7
chr4	53192	196095	ZNF718	142903	+	NR_110527	196095	196095	5
chr4	206388	249773	ZNF876P	43385	+	NR_027481	249773	249773	2
chr4	264463	289944	ZNF732	25481	-	NM_001137608	264887	289944	3
chr4	331595	367691	ZNF141	36096	+	NM_003441	331772	367651	4
chr4	343945	344041	MIR571	96	+	NR_030297	344041	344041	1
chr4	419223	467998	ABCA11P	48775	-	NR_002451	467998	467998	3
chr4	433772	492960	ZNF721	59188	-	NM_133474	435483	466397	3
chr4	492988	533710	PIGG	40722	+	NM_017733	493124	533158	13
chr4	619362	664681	PDE6B	45319	+	NM_000283	619415	663896	22
chr4	666224	668127	ATP5I	1903	-	NM_007100	666288	668036	4
chr4	671710	675817	MYL5	4107	+	NM_002477	671815	675783	7
chr4	675612	683230	MFSD7	7618	-	NM_032219	675746	682916	10
chr4	699529	764768	PCGF3	65239	+	NM_001317836	727469	759867	12
chr4	773936	775636	LOC100129917	1700	-	NR_036512	775636	775636	2
chr4	778744	819945	CPLX1	41201	-	NM_006651	780288	818310	4
chr4	843065	926178	GAK	83113	-	NM_001286833	843460	925975	25
chr4	926174	952443	TMEM175	26269	+	NM_001297426	945475	952284	12
chr4	952671	967348	DGKQ	14677	-	NM_001347	954407	967270	23
chr4	972860	987228	SLC26A1	14368	-	NM_134425	973193	985491	3
chr4	980784	998345	IDUA	17561	+	NM_000203	980872	998181	14
chr4	1005609	1020686	FGFRL1	15077	+	NM_001004356	1006273	1019135	7
chr4	1065265	1107352	RNF212	42087	-	NM_194439	1066803	1107252	10
chr4	1108984	1116952	TMED11P	7968	-	NR_033768	1116952	1116952	4
chr4	1160720	1202750	SPON2	42030	-	NM_001199021	1161259	1165859	8
chr4	1189570	1202750	LOC100130872	13180	-	NR_024569	1202750	1202750	4
chr4	1203907	1212379	CTBP1-AS	8472	+	NR_104331	1212379	1212379	6
chr4	1205227	1242908	CTBP1	37681	-	NM_001012614	1206027	1235119	10
chr4	1243227	1246795	CTBP1-AS2	3568	+	NR_033339	1246795	1246795	2
chr4	1283638	1333936	MAEA	50298	+	NM_001017405	1283701	1332957	9
chr4	1341053	1381837	UVSSA	40784	+	NM_001317934	1341879	1379749	14
chr4	1385339	1389782	CRIPAK	4443	+	NM_175918	1388299	1389640	1
chr4	1396719	1400230	NKX1-1	3511	-	NM_001290079	1396719	1400230	2
chr4	1641607	1686040	FAM53A	44433	-	NM_001174070	1643019	1670468	5
chr4	1694457	1714468	SLBP	20011	-	NM_006527	1695323	1713915	8
chr4	1717678	1723084	TMEM129	5406	-	NM_001127266	1718906	1722564	4
chr4	1723216	1746905	TACC3	23689	+	NM_006342	1725148	1746740	16
chr4	1795038	1810599	FGFR3	15561	+	NM_001163213	1795661	1808989	18
chr4	1813205	1857974	LETM1	44769	-	NM_012318	1816150	1857677	14
chr4	1873122	1983934	WHSC1	110812	+	NM_001042424	1902381	1980636	22
chr4	1976362	1976487	SCARNA22	125	+	NR_003004	1976487	1976487	1
chr4	1984440	2010962	NELFA	26522	-	NM_005663	1985045	2010719	11
chr4	1988110	1988204	MIR943	94	-	NR_030641	1988204	1988204	1
chr4	2043719	2045697	C4orf48	1978	+	NM_001168243	2043721	2045653	4
chr4	2061238	2070816	NAT8L	9578	+	NM_178557	2061238	2065854	3
chr4	2073684	2243891	POLN	170207	-	NM_181808	2073840	2230958	26
chr4	2233562	2243891	HAUS3	10329	-	NM_001303143	2233653	2242673	6
chr4	2249159	2263739	MXD4	14580	-	NM_006454	2252270	2263707	6
chr4	2251803	2251883	MIR4800	80	-	NR_039964	2251883	2251883	1
chr4	2271323	2420370	ZFYVE28	149047	-	NM_020972	2272451	2420050	13
chr4	2420671	2464690	CFAP99	44019	+	NM_001193282	2428202	2464653	16
chr4	2470794	2517586	RNF4	46792	+	NM_002938	2492220	2515546	8
chr4	2627158	2734302	FAM193A	107144	+	NM_001256668	2632731	2721761	20
chr4	2743386	2758103	TNIP2	14717	-	NM_024309	2743983	2758016	6
chr4	2794749	2842823	SH3BP2	48074	+	NM_001122681	2822344	2835561	13
chr4	2845583	2931802	ADD1	86219	+	NM_014190	2877642	2929898	16
chr4	2932287	2936586	MFSD10	4299	-	NM_001146069	2932564	2935650	13
chr4	2937272	2952800	NOP14-AS1	15528	+	NR_015453	2952800	2952800	4
chr4	2939663	2965233	NOP14	25570	-	NM_003703	2940557	2965046	19
chr4	2965342	3042474	GRK4	77132	+	NM_182982	2965797	3042352	16
chr4	3064972	3076241	HTT-AS	11269	-	NR_045414	3076241	3076241	3
chr4	3076236	3245687	HTT	169451	+	NM_002111	3076552	3241786	67
chr4	3250766	3258342	MSANTD1	7576	+	NM_001042690	3250949	3257692	3
chr4	3315873	3441640	RGS12	125767	+	NM_198229	3317897	3441411	18
chr4	3443659	3451222	HGFAC	7563	+	NM_001297439	3443728	3451146	15
chr4	3465032	3503200	DOK7	38168	+	NM_001301071	3465102	3502552	10
chr4	3505323	3534224	LRPAP1	28901	-	NM_002337	3514700	3534139	8
chr4	3578595	3592712	LINC00955	14117	+	NR_040045	3592712	3592712	3
chr4	3675319	3679582	LOC100133461	4263	-	NR_034136	3679582	3679582	3
chr4	3768295	3770253	ADRA2C	1958	+	NM_000683	3768333	3769722	1
chr4	3943486	3957155	FAM86EP	13669	-	NR_130740	3957155	3957155	4
chr4	4190529	4228621	OTOP1	38092	-	NM_177998	4190529	4228591	6
chr4	4237268	4249969	TMEM128	12701	-	NM_001297551	4239562	4249929	5
chr4	4269428	4291896	LYAR	22468	-	NM_017816	4269615	4285469	10
chr4	4291923	4323513	ZBTB49	31590	+	NM_145291	4301672	4323043	8
chr4	4387982	4420785	NSG1	32803	+	NM_001287763	4389356	4419162	6
chr4	4420695	4543775	STX18	123080	-	NM_016930	4421760	4543691	11
chr4	4477847	4483427	STX18-IT1	5580	-	NR_126434	4483427	4483427	4
chr4	4543857	4712664	STX18-AS1	168807	+	NR_037888	4712664	4712664	6
chr4	4763486	4789101	LOC101928279	25615	+	NR_125892	4789101	4789101	3
chr4	4846163	4852554	LINC01396	6391	+	NR_125765	4852554	4852554	4
chr4	4861391	4865660	MSX1	4269	+	NM_002448	4861626	4864870	2
chr4	4922534	4990398	LOC101928306	67864	+	NR_125893	4990398	4990398	3
chr4	5016313	5021197	CYTL1	4884	-	NM_018659	5016877	5021172	4
chr4	5053243	5502728	STK32B	449485	+	NM_001306082	5170058	5500810	13
chr4	5526295	5529527	LINC01587	3232	+	NR_126519	5529527	5529527	4
chr4	5564145	5711275	EVC2	147130	-	NM_001166136	5564574	5699362	22
chr4	5712923	5816031	EVC	103108	+	NM_001306090	5713107	5812764	21
chr4	5822490	5894810	CRMP1	72320	-	NM_001014809	5823486	5894696	14
chr4	5925001	5925055	MIR378D1	54	-	NR_039608	5925055	5925055	1
chr4	6027925	6202318	JAKMIP1	174393	-	NM_001099433	6027954	6114577	21
chr4	6202459	6235663	LOC285484	33204	+	NR_037863	6235663	6235663	4
chr4	6271576	6304992	WFS1	33416	+	NM_001145853	6279182	6304195	8
chr4	6322304	6565327	PPP2R2C	243023	-	NM_001206994	6325028	6537046	10
chr4	6576900	6624131	MAN2B2	47231	+	NM_015274	6576937	6623012	19
chr4	6641817	6644470	MRFAP1	2653	+	NM_001272053	6642589	6642973	3
chr4	6675820	6677774	LOC93622	1954	+	NR_015433	6677774	6677774	2
chr4	6695565	6698897	S100P	3332	+	NM_005980	6695659	6698769	2
chr4	6709428	6711606	MRFAP1L1	2178	-	NM_203462	6710972	6711356	2
chr4	6717841	6719387	BLOC1S4	1546	+	NM_018366	6717936	6718590	1
chr4	6784458	6885899	KIAA0232	101441	+	NM_014743	6826180	6882693	10
chr4	6911170	7034845	TBC1D14	123675	+	NM_001113361	6925116	7032119	14
chr4	7032280	7047958	LOC100129931	15678	-	NR_033828	7047958	7047958	4
chr4	7042575	7044728	CCDC96	2153	-	NM_153376	7042997	7044665	1
chr4	7045155	7059677	TADA2B	14522	+	NM_152293	7045306	7056781	2
chr4	7061779	7069800	GRPEL1	8021	-	NM_025196	7062588	7069759	4
chr4	7099150	7105103	FLJ36777	5953	-	NR_027441	7105103	7105103	2
chr4	7194373	7744564	SORCS2	550191	+	NM_020777	7194373	7741991	27
chr4	7312176	7312251	MIR4798	75	+	NR_039961	7312251	7312251	1
chr4	7432020	7436700	PSAPL1	4680	-	NM_001085382	7435040	7436606	1
chr4	7461754	7461845	MIR4274	91	+	NR_036238	7461845	7461845	1
chr4	7755816	7780654	AFAP1-AS1	24838	+	NR_026892	7780654	7780654	2
chr4	7760439	7941653	AFAP1	181214	-	NM_001134647	7765491	7873805	18
chr4	7940727	7942023	LOC389199	1296	+	NM_203423	7940892	7941708	1
chr4	7967036	8160559	ABLIM2	193523	-	NM_001130083	7968716	8160416	21
chr4	8007027	8007108	MIR95	81	-	NR_029511	8007108	8007108	1
chr4	8201059	8242830	SH3TC1	41771	+	NM_018986	8206921	8242682	18
chr4	8271491	8308838	HTRA3	37347	+	NM_053044	8271695	8307863	9
chr4	8368008	8442452	ACOX3	74444	-	NM_003501	8368687	8418248	18
chr4	8442531	8478282	TRMT44	35751	+	NM_152544	8442549	8477728	11
chr4	8581963	8591750	GPR78	9787	+	NR_045511	8591750	8591750	3
chr4	8594386	8621488	CPZ	27102	+	NM_001014447	8594560	8621344	11
chr4	8847801	8873543	HMX1	25742	-	NM_001306142	8847871	8873340	2
chr4	8951476	8952127	LOC650293	651	+	NM_001040071	8951476	8952127	1
chr4	9212382	9213975	USP17L10	1593	+	NM_001256852	9212382	9213975	1
chr4	9217130	9218723	USP17L11	1593	+	NM_001256854	9217130	9218723	1
chr4	9217130	9218723	USP17L18	1593	+	NM_001256859	9217130	9218723	1
chr4	9221877	9223470	USP17L12	1593	+	NM_001256853	9221877	9223470	1
chr4	9221877	9223470	USP17L21	1593	+	NM_001256862	9221877	9223470	1
chr4	9226621	9228214	USP17L13	1593	+	NM_001256855	9226621	9228214	1
chr4	9236110	9238060	USP17L15	1950	+	NM_001256894	9236110	9238060	2
chr4	9245604	9247197	USP17L17	1593	+	NM_001256857	9245604	9247197	1
chr4	9255103	9256696	USP17L19	1593	+	NM_001256860	9255103	9256696	1
chr4	9259849	9261442	USP17L22	1593	+	NM_001256863	9259849	9261442	1
chr4	9269344	9270937	USP17L20	1593	+	NM_001256861	9269344	9270937	1
chr4	9326890	9328483	USP17L5	1593	+	NM_001242329	9326890	9328483	1
chr4	9326890	9328483	USP17L26	1593	+	NM_001242328	9326890	9328483	1
chr4	9326890	9328483	USP17L27	1593	+	NM_001242330	9326890	9328483	1
chr4	9341128	9342721	USP17L30	1593	+	NM_001256867	9341128	9342721	1
chr4	9345873	9347466	USP17L25	1593	+	NM_001242326	9345873	9347466	1
chr4	9350618	9352211	USP17L24	1593	+	NM_001242327	9350618	9352211	1
chr4	9350618	9352211	USP17L28	1593	+	NM_001242331	9350618	9352211	1
chr4	9350618	9352211	USP17L29	1593	+	NM_001242332	9350618	9352211	1
chr4	9360107	9361700	USP17L9P	1593	+	NR_046416	9361700	9361700	1
chr4	9369599	9370796	USP17L6P	1197	+	NR_027279	9370796	9370796	1
chr4	9446259	9452240	DEFB131	5981	+	NM_001040448	9446259	9452240	2
chr4	9557788	9557937	MIR548I2	149	-	NR_031688	9557937	9557937	1
chr4	9783257	9785633	DRD5	2376	+	NM_000798	9783653	9785087	1
chr4	9827847	10041872	SLC2A9	214025	-	NM_001001290	9828020	10027590	13
chr4	10075962	10118573	WDR1	42611	-	NM_017491	10077001	10118290	15
chr4	10080234	10080316	MIR3138	82	-	NR_036090	10080316	10080316	1
chr4	10441503	10459032	ZNF518B	17529	-	NM_053042	10444727	10447952	3
chr4	10491837	10686386	CLNK	194549	-	NM_052964	10492090	10669493	19
chr4	11370450	11370545	MIR572	95	+	NR_030298	11370545	11370545	1
chr4	11399987	11430537	HS3ST1	30550	-	NM_005114	11400705	11401629	2
chr4	12225074	12252909	LOC101929019	27835	+	NR_125910	12252909	12252909	4
chr4	13369346	13485989	RAB28	116643	-	NM_001159601	13373449	13485774	8
chr4	13527942	13533041	LINC01097	5099	-	NR_034054	13533041	13533041	4
chr4	13542453	13546114	NKX3-2	3661	-	NM_001189	13543616	13546038	2
chr4	13547699	13549448	LINC01096	1749	-	NR_015450	13549448	13549448	1
chr4	13570365	13629328	BOD1L1	58963	-	NM_148894	13571634	13629211	26
chr4	13629488	13629581	MIR5091	93	+	NR_049814	13629581	13629581	1
chr4	13656802	13932852	LINC01182	276050	+	NR_121681	13932852	13932852	4
chr4	14113591	14141676	LINC01085	28085	+	NR_033931	14141676	14141676	3
chr4	14472089	14889793	LINC00504	417704	-	NR_126435	14889793	14889793	7
chr4	14911584	15003669	CPEB2-AS1	92085	-	NR_038857	15003669	15003669	8
chr4	15004297	15071777	CPEB2	67480	+	NM_001177382	15004297	15068004	12
chr4	15006565	15429538	LOC101929095	422973	-	NR_125911	15429538	15429538	6
chr4	15341559	15447791	C1QTNF7	106232	+	NM_001135170	15341818	15444423	3
chr4	15471488	15603180	CC2D2A	131692	+	NM_001080522	15477556	15603048	38
chr4	15606006	15657035	FBXL5	51029	-	NR_036464	15657035	15657035	12
chr4	15683351	15692070	FAM200B	8719	+	NM_001145191	15688600	15690574	2
chr4	15704572	15733796	BST1	29224	+	NM_004334	15704767	15733468	9
chr4	15779887	15854866	CD38	74979	+	NM_001775	15780037	15850225	8
chr4	15937192	15940363	FGFBP1	3171	-	NM_005130	15937550	15938255	3
chr4	15961862	15964859	FGFBP2	2997	-	NM_031950	15964080	15964752	2
chr4	15969848	16085623	PROM1	115775	-	NM_001145848	15972689	16077529	27
chr4	16162127	16228161	TAPT1	66034	-	NM_153365	16164930	16228080	14
chr4	16228285	16259810	TAPT1-AS1	31525	+	NR_027697	16259810	16259810	3
chr4	16503156	16900432	LDB2	397276	-	NM_001130834	16507500	16900108	9
chr4	16595985	16623654	MIR548AX	27669	-	NR_049865	16623654	16623654	2
chr4	17173379	17187680	LOC101929123	14301	-	NR_125919	17187680	17187680	6
chr4	17488015	17513857	QDPR	25842	-	NM_000320	17488753	17513677	7
chr4	17516787	17528727	CLRN2	11940	+	NM_001079827	17516889	17528705	3
chr4	17578926	17609590	LAP3	30664	+	NM_015907	17579088	17609212	13
chr4	17616250	17627251	MED28	11001	+	NM_025205	17616277	17625421	4
chr4	17633708	17783135	FAM184B	149427	-	NM_015688	17634154	17782922	18
chr4	17802277	17812381	DCAF16	10104	-	NM_017741	17805113	17805764	3
chr4	17812435	17846487	NCAPG	34052	+	NM_022346	17812700	17845048	21
chr4	17844838	18023483	LCORL	178645	-	NM_153686	17847343	18023374	7
chr4	20253527	20622184	SLIT2	368657	+	NM_004787	20255438	20620632	37
chr4	20393811	20396479	SLIT2-IT1	2668	+	NR_037876	20396479	20396479	4
chr4	20529897	20530007	MIR218-1	110	+	NR_029631	20530007	20530007	1
chr4	20697904	20754523	PACRGL	56619	+	NR_133933	20754523	20754523	10
chr4	20730238	21950374	KCNIP4	1220136	-	NM_147182	20731704	20852267	9
chr4	21466322	21466381	MIR7978	59	-	NR_107018	21466381	21466381	1
chr4	21583718	21615345	LOC105374516	31627	+	NR_134233	21615345	21615345	4
chr4	21844963	21854811	KCNIP4-IT1	9848	-	NR_002813	21854811	21854811	1
chr4	22328989	22341289	LOC100505912	12300	-	NR_037877	22341289	22341289	4
chr4	22388996	22517677	ADGRA3	128681	-	NM_145290	22389327	22517407	19
chr4	22694536	22821195	GBA3	126659	+	NM_020973	22694638	22820546	5
chr4	23199716	23464726	MIR548AJ2	265010	-	NR_039674	23464726	23464726	3
chr4	23793643	23891700	PPARGC1A	98057	-	NM_013261	23797444	23891580	13
chr4	24521814	24521913	MIR573	99	-	NR_030299	24521913	24521913	1
chr4	24529087	24586184	DHX15	57097	-	NM_001358	24529546	24586016	14
chr4	24797084	24802467	SOD3	5383	+	NM_003102	24801143	24801866	2
chr4	24807738	24981826	CCDC149	174088	-	NM_173463	24810010	24896676	13
chr4	25000470	25032414	LGI2	31944	-	NM_018176	25005072	25032315	8
chr4	25121626	25162204	SEPSECS	40578	-	NM_016955	25125552	25161991	11
chr4	25162293	25200127	SEPSECS-AS1	37834	+	NR_037934	25200127	25200127	2
chr4	25235652	25280831	PI4K2B	45179	+	NM_018323	25235785	25278809	10
chr4	25314395	25372005	ZCCHC4	57610	+	NM_024936	25314431	25370786	13
chr4	25378847	25420120	ANAPC4	41273	+	NM_001286756	25379049	25420004	29
chr4	25657434	25680368	SLC34A2	22934	+	NM_006424	25664122	25678371	13
chr4	25749048	25865217	SEL1L3	116169	-	NM_001297594	25750046	25849189	24
chr4	25915813	25931501	SMIM20	15688	+	NM_001145432	25915935	25930813	3
chr4	26321331	26436752	RBPJ	115421	+	NM_005349	26322378	26432629	12
chr4	26483017	26492042	CCKAR	9025	-	NM_000730	26483259	26491889	5
chr4	26585545	26757835	TBC1D19	172290	+	NM_018317	26585815	26756569	21
chr4	26862312	27027003	STIM2	164691	+	NM_001169118	26862840	27024618	13
chr4	27219100	27283847	LOC101929199	64747	+	NR_125921	27283847	27283847	6
chr4	28821203	28821290	MIR4275	87	+	NR_036237	28821290	28821290	1
chr4	30722036	31148423	PCDH7	426387	+	NM_001173523	30723044	31144471	3
chr4	31172765	31213296	LOC102723778	40531	+	NR_125935	31213296	31213296	5
chr4	31999000	32157028	LOC102723828	158028	+	NR_125936	32157028	32157028	3
chr4	33897960	34041515	LOC101928622	143555	-	NR_125902	34041515	34041515	5
chr4	36067619	36245979	ARAP2	178360	-	NM_015230	36069528	36231108	33
chr4	36245737	36275837	LOC439933	30100	+	NR_122079	36275837	36275837	5
chr4	36283236	36346407	DTHD1	63171	+	NM_001136536	36283634	36345446	9
chr4	36427987	36428050	MIR1255B1	63	-	NR_031701	36428050	36428050	1
chr4	37243531	37243613	MIR4801	82	-	NR_039965	37243613	37243613	1
chr4	37246689	37451087	NWD2	204398	+	NM_001144990	37246689	37448839	7
chr4	37455551	37595132	C4orf19	139581	+	NM_001104629	37590489	37592622	4
chr4	37592421	37687999	RELL1	95578	-	NM_001085399	37633009	37687909	7
chr4	37828281	37864559	PGM2	36278	+	NM_018290	37828354	37863233	14
chr4	37892704	38140796	TBC1D1	248092	+	NM_001253912	37903716	38138956	21
chr4	37962055	37962631	PTTG2	576	+	NM_006607	37962055	37962631	1
chr4	38422282	38524801	LINC01258	102519	-	NR_110951	38524801	38524801	8
chr4	38614321	38666249	KLF3-AS1	51928	-	NR_026804	38666249	38666249	8
chr4	38665789	38703129	KLF3	37340	+	NM_016531	38682246	38698884	6
chr4	38773859	38784611	TLR10	10752	-	NM_030956	38774775	38777211	4
chr4	38797875	38806412	TLR1	8537	-	NM_003263	38798091	38800452	4
chr4	38825328	38858438	TLR6	33110	-	NM_006068	38828703	38831094	2
chr4	38869353	38947365	FAM114A1	78012	+	NM_138389	38879699	38945178	15
chr4	38869652	38869748	MIR574	96	+	NR_030300	38869748	38869748	1
chr4	38968365	39034041	TMEM156	65676	-	NM_001303228	38972689	39033933	7
chr4	39046450	39127853	KLHL5	81403	+	NM_001007075	39064272	39122686	12
chr4	39105519	39584819	MIR1273H	479300	+	NR_106996	39584819	39584819	4
chr4	39184023	39287430	WDR19	103407	+	NM_025132	39184177	39280270	37
chr4	39289068	39368001	RFC1	78933	-	NM_001204747	39290380	39367861	25
chr4	39408472	39453153	KLB	44681	+	NM_175737	39408569	39450306	5
chr4	39413529	39413594	MIR5591	65	+	NR_049857	39413594	39413594	1
chr4	39455744	39460568	RPL9	4824	-	NM_000661	39456162	39460059	8
chr4	39460643	39479271	LIAS	18628	+	NM_006859	39460737	39478735	11
chr4	39481874	39483523	LOC401127	1649	+	NR_026854	39483523	39483523	1
chr4	39500374	39529218	UGDH	28844	-	NM_001184700	39501762	39523132	11
chr4	39529458	39596327	UGDH-AS1	66869	+	NR_047679	39596327	39596327	5
chr4	39548916	39640618	SMIM14	91702	-	NM_001317896	39553745	39606765	6
chr4	39699663	39784410	UBE2K	84747	+	NM_005339	39699947	39780054	7
chr4	39824482	39979576	PDS5A	155094	-	NM_001100399	39827104	39978197	33
chr4	40044536	40058819	LOC344967	14283	-	NR_027277	40058819	40058819	3
chr4	40058523	40159872	N4BP2	101349	+	NM_018177	40098960	40155857	18
chr4	40192630	40246384	RHOH	53754	+	NM_001278368	40245006	40245582	3
chr4	40309201	40332436	LOC101060498	23235	+	NR_121641	40332436	40332436	4
chr4	40337345	40357234	CHRNA9	19889	+	NM_017581	40337484	40356537	5
chr4	40425271	40631883	RBM47	206612	-	NM_001098634	40427920	40440910	7
chr4	40504056	40504136	MIR4802	80	-	NR_039966	40504136	40504136	1
chr4	40751913	40812002	NSUN7	60089	+	NM_024677	40752710	40810956	12
chr4	40812043	41216635	APBB2	404592	-	NM_001166050	40818108	41035271	18
chr4	41222090	41258744	UCHL1-AS1	36654	-	NR_102709	41258744	41258744	3
chr4	41258897	41270446	UCHL1	11549	+	NM_004181	41258993	41270090	9
chr4	41361623	41702061	LIMCH1	340438	+	NM_001289124	41608012	41699202	26
chr4	41746098	41750987	PHOX2B	4889	-	NM_003924	41747823	41750627	3
chr4	41881538	41884628	LINC00682	3090	-	NR_104143	41884628	41884628	2
chr4	41937136	41962824	TMEM33	25688	+	NM_018126	41937501	41956216	7
chr4	41983712	41988484	DCAF4L1	4772	+	NM_001029955	41983809	41985000	1
chr4	41992522	42089551	SLC30A9	97029	+	NM_006345	41992668	42088143	18
chr4	42112869	42154895	BEND4	42026	-	NM_001159547	42119742	42154160	6
chr4	42399855	42404504	SHISA3	4649	+	NM_001080505	42400073	42403468	2
chr4	42410391	42659122	ATP8A1	248731	-	NM_006095	42414932	42658890	37
chr4	42895282	43032675	GRXCR1	137393	+	NM_001080476	42895283	43032557	4
chr4	44018877	44024078	LVCAT1	5201	+	NR_131959	44024078	44024078	2
chr4	44175919	44450824	KCTD8	274905	-	NM_198353	44176806	44450540	2
chr4	44624353	44653658	YIPF7	29305	-	NM_182592	44624430	44653641	6
chr4	44680432	44702697	GUF1	22265	+	NM_021927	44680639	44700698	17
chr4	44703811	44728651	GNPDA2	24840	-	NM_138335	44705097	44724224	7
chr4	46037786	46126082	GABRG1	88296	-	NM_173536	46043004	46125930	9
chr4	46251580	46392056	GABRA2	140476	-	NM_000807	46252324	46390723	10
chr4	46736846	46911252	COX7B2	174406	-	NM_130902	46736963	46737209	3
chr4	46920916	46996424	GABRA4	75508	-	NM_000809	46930241	46995441	9
chr4	47033294	47428447	GABRB1	395153	+	NM_000812	47033668	47428035	9
chr4	47452810	47465676	COMMD8	12866	-	NM_017845	47453661	47465668	5
chr4	47487409	47595503	ATP10D	108094	+	NM_020453	47514557	47593398	23
chr4	47596014	47840123	CORIN	244109	-	NM_006587	47597737	47839966	22
chr4	47654685	47654758	MIR8053	73	+	NR_107020	47654758	47654758	1
chr4	47833361	47898865	LOC101927179	65504	+	NR_125881	47898865	47898865	3
chr4	47849249	47916684	NFXL1	67435	-	NR_103795	47916684	47916684	24
chr4	47916243	47992754	LOC101927157	76511	+	NR_125879	47992754	47992754	3
chr4	47937993	48014961	CNGA1	76968	-	NM_000087	47938437	47954718	11
chr4	48018788	48042190	NIPAL1	23402	+	NM_207330	48018856	48038189	6
chr4	48068409	48136273	TXK	67864	-	NM_003328	48069653	48136187	15
chr4	48137799	48271814	TEC	134015	-	NM_003215	48139432	48230631	18
chr4	48343612	48428215	SLAIN2	84603	+	NM_020846	48343756	48424094	8
chr4	48485359	48491541	SLC10A4	6182	+	NM_152679	48485578	48490956	3
chr4	48492268	48496406	ZAR1	4138	+	NM_175619	48492308	48496261	4
chr4	48499379	48782316	FRYL	282937	-	NM_015030	48501438	48636427	64
chr4	48833059	48863834	OCIAD1	30775	+	NM_017830	48834641	48862779	9
chr4	48887396	48908845	OCIAD2	21449	-	NM_001014446	48887500	48906566	7
chr4	48988264	49064095	CWH43	75831	+	NM_025087	48988446	49063907	16
chr4	52709165	52783003	DCUN1D4	73838	+	NM_001287757	52740480	52779750	12
chr4	52859807	52883786	LRRC66	23979	-	NM_001024611	52860544	52883779	4
chr4	52886860	52904485	SGCB	17625	-	NM_000232	52890122	52904425	6
chr4	52917496	52963471	SPATA18	45975	+	NR_123728	52963471	52963471	13
chr4	53457126	53525502	USP46	68376	-	NM_001286768	53464766	53492397	10
chr4	53525572	53527665	USP46-AS1	2093	+	NR_125363	53527665	53527665	2
chr4	53578620	53580305	DANCR	1685	+	NR_024031	53580305	53580305	3
chr4	53578848	53578914	MIR4449	66	+	NR_039651	53578914	53578914	1
chr4	53579415	53579537	SNORA26	122	+	NR_003016	53579537	53579537	1
chr4	53609683	53617807	ERVMER34-1	8124	-	NM_024534	53609995	53611687	4
chr4	53656160	53681631	LINC01618	25471	+	NR_040106	53681631	53681631	5
chr4	53728494	53733002	RASL11B	4508	+	NM_023940	53728674	53731972	4
chr4	53739150	54232242	SCFD2	493092	-	NM_152540	53740135	54232108	9
chr4	54243819	54326103	FIP1L1	82284	+	NM_001134937	54244005	54325616	18
chr4	54326436	54457753	LNX1	131317	-	NM_001126328	54327073	54440169	11
chr4	54366243	54389443	LNX1-AS1	23200	+	NR_046622	54389443	54389443	4
chr4	54459122	54471548	LNX1-AS2	12426	+	NR_046827	54471548	54471548	2
chr4	54562067	54600525	LOC100506444	38458	+	NR_125918	54600525	54600525	3
chr4	54851665	54853449	RPL21P44	1784	-	NR_027153	54853449	54853449	1
chr4	54875957	54930815	CHIC2	54858	-	NM_012110	54876261	54930467	6
chr4	54966247	54968122	GSX2	1875	+	NM_133267	54966511	54968089	2
chr4	55095263	55164412	PDGFRA	69149	+	NM_006206	55124935	55161439	23
chr4	55524094	55606881	KIT	82787	+	NM_000222	55524181	55604723	21
chr4	55944425	55991762	KDR	47337	-	NM_002253	55946107	55991460	30
chr4	56212387	56239266	SRD5A3	26879	+	NM_024592	56212503	56236258	5
chr4	56232767	56251747	SRD5A3-AS1	18980	-	NR_037969	56251747	56251747	4
chr4	56262079	56292342	TMEM165	30263	+	NR_073070	56292342	56292342	7
chr4	56294067	56413076	CLOCK	119009	-	NM_004898	56301581	56348952	23
chr4	56422691	56458379	PDCL2	35688	-	NM_152401	56422723	56458276	6
chr4	56461395	56502865	NMU	41470	-	NR_120489	56502865	56502865	9
chr4	56686236	56703430	LOC644145	17194	+	NR_003935	56703430	56703430	3
chr4	56719815	56771244	EXOC1	51429	+	NM_018261	56724489	56770661	19
chr4	56814973	56899529	CEP135	84556	+	NM_025009	56818296	56890769	26
chr4	57036360	57196890	KIAA1211	160530	+	NM_020722	57164395	57193970	11
chr4	57204450	57253674	AASDH	49224	-	NM_181806	57204567	57250465	15
chr4	57259528	57301802	PPAT	42274	-	NM_002703	57261517	57301643	11
chr4	57301914	57327534	PAICS	25620	+	NM_006452	57302478	57325704	10
chr4	57333761	57369847	SRP72	36086	+	NM_006947	57333801	57368027	19
chr4	57371374	57390058	ARL9	18684	+	NM_206919	57377497	57390042	4
chr4	57396774	57469489	THEGL	72715	+	NM_001256475	57396842	57469489	9
chr4	57514153	57547872	HOPX	33719	-	NM_001145460	57514952	57523982	5
chr4	57676025	57688035	SPINK2	12010	-	NM_021114	57676304	57687828	4
chr4	57774041	57802010	REST	27969	+	NM_005612	57776804	57798318	4
chr4	57829509	57843826	NOA1	14317	-	NM_032313	57829615	57843751	7
chr4	57844805	57897328	POLR2B	52523	+	NM_001303269	57852521	57897154	26
chr4	57897236	57976551	IGFBP7	79315	-	NM_001553	57897482	57976517	5
chr4	57975927	58071465	IGFBP7-AS1	95538	+	NR_034081	58071465	58071465	5
chr4	58292037	58332152	LOC101928851	40115	+	NR_125907	58332152	58332152	6
chr4	59390679	59402493	LOC105377671	11814	-	NR_133943	59402493	59402493	3
chr4	59849999	59912677	LOC105377247	62678	+	NR_133941	59912677	59912677	3
chr4	59852905	59853872	LOC105377245	967	-	NR_133939	59853872	59853872	3
chr4	61788336	61788402	MIR548AG1	66	+	NR_039652	61788402	61788402	1
chr4	62362838	62938168	ADGRL3	575330	+	NM_015236	62363011	62936626	23
chr4	62937472	63027483	ADGRL3-AS1	90011	-	NR_110595	63027483	63027483	8
chr4	65144176	65275178	TECRL	131002	-	NM_001010874	65145789	65275069	12
chr4	65779998	65870218	LOC401134	90220	-	NR_033976	65870218	65870218	7
chr4	66185280	66536213	EPHA5	350933	-	NM_004439	66189831	66535460	18
chr4	66535678	66559104	EPHA5-AS1	23426	+	NR_034138	66559104	66559104	4
chr4	67142541	67142646	MIR1269A	105	+	NR_031673	67142646	67142646	1
chr4	68283022	68287718	LOC101927237	4696	-	NR_110747	68287718	68287718	3
chr4	68337988	68411256	CENPC	73268	-	NM_001812	68338322	68411073	19
chr4	68424414	68473059	STAP1	48645	+	NM_012108	68424527	68472075	9
chr4	68481478	68566889	UBA6	85411	-	NM_018227	68484714	68566837	33
chr4	68566995	68588222	UBA6-AS1	21227	+	NR_015439	68588222	68588222	2
chr4	68603098	68621804	GNRHR	18706	-	NM_000406	68606197	68620053	3
chr4	68686593	68749716	TMPRSS11D	63123	-	NM_004262	68688054	68749651	10
chr4	68776018	68829232	TMPRSS11A	53214	-	NM_001114387	68777059	68829111	10
chr4	68857529	68863157	TMPRSS11GP	5628	-	NR_033737	68863157	68863157	4
chr4	68918915	68995587	TMPRSS11F	76672	-	NM_207407	68919626	68995538	10
chr4	68919225	68938951	LOC550113	19726	+	NR_046116	68938951	68938951	3
chr4	68926327	68929015	SYT14P1	2688	-	NR_027094	68929015	68929015	2
chr4	69048009	69078188	FTLP10	30179	+	NR_015446	69078188	69078188	3
chr4	69049846	69083798	TMPRSS11BNL	33952	-	NR_104048	69083798	69083798	10
chr4	69092370	69111412	TMPRSS11B	19042	-	NM_182502	69093628	69111276	10
chr4	69176104	69215824	YTHDC1	39720	-	NM_001031732	69179816	69215471	17
chr4	69313166	69363322	TMPRSS11E	50156	+	NM_014058	69313230	69362522	10
chr4	69402902	69434245	UGT2B17	31343	-	NM_001077	69403342	69434202	6
chr4	69512314	69536494	UGT2B15	24180	-	NM_001076	69512821	69536336	6
chr4	69681710	69697735	UGT2B10	16025	+	NM_001075	69681737	69696597	6
chr4	69794176	69817509	UGT2A3	23333	-	NR_024010	69817509	69817509	7
chr4	69962192	69978705	UGT2B7	16513	+	NM_001074	69962238	69978454	6
chr4	70066050	70080449	UGT2B11	14399	-	NM_001073	70066157	70080440	6
chr4	70146216	70160768	UGT2B28	14552	+	NM_053039	70146218	70160527	6
chr4	70345882	70391732	UGT2B4	45850	-	NM_001297616	70346351	70391447	7
chr4	70454134	70505360	UGT2A2	51226	-	NM_001105677	70455089	70505358	6
chr4	70454134	70518967	UGT2A1	64833	-	NM_006798	70455089	70513362	7
chr4	70592685	70626430	SULT1B1	33745	-	NM_014465	70592805	70620935	8
chr4	70706929	70725870	SULT1E1	18941	-	NM_005420	70707711	70723362	8
chr4	70796798	70812288	CSN1S1	15490	+	NM_001890	70798273	70811914	16
chr4	70820973	70826729	CSN2	5756	-	NM_001302770	70822067	70826713	7
chr4	70861647	70868173	STATH	6526	+	NM_003154	70864154	70866666	6
chr4	70894129	70902255	HTN3	8126	+	NM_000200	70896457	70898937	6
chr4	70916131	70924565	HTN1	8434	+	NM_002159	70918793	70921286	6
chr4	70933102	70950988	CSN1S2AP	17886	+	NR_003720	70950988	70950988	13
chr4	70999320	71012421	CSN1S2BP	13101	+	NR_033311	71012421	71012421	8
chr4	71019903	71032326	PRR27	12423	+	NM_214711	71020092	71027314	5
chr4	71062243	71070293	ODAM	8050	+	NM_017855	71062260	71068902	11
chr4	71091787	71100968	FDCSP	9181	+	NM_152997	71096911	71099904	5
chr4	71108332	71117145	CSN3	8813	+	NM_005212	71110536	71115176	5
chr4	71200670	71202833	CABS1	2163	+	NM_033122	71200756	71201944	2
chr4	71226492	71232823	SMR3A	6331	+	NM_012390	71227832	71232711	3
chr4	71248794	71255961	SMR3B	7167	+	NM_006685	71250227	71255565	3
chr4	71263598	71275914	PROL1	12316	+	NM_001302807	71265002	71275373	4
chr4	71296208	71348714	MUC7	52506	+	NM_001145006	71339738	71347595	4
chr4	71384288	71398460	AMTN	14172	+	NM_001286731	71384494	71398182	9
chr4	71457974	71473004	AMBN	15030	+	NM_016519	71458075	71472447	13
chr4	71494460	71512536	ENAM	18076	+	NM_031889	71495217	71510572	9
chr4	71521257	71532348	JCHAIN	11091	-	NM_144646	71522045	71532207	4
chr4	71554195	71556268	UTP3	2073	+	NM_020368	71554394	71555834	1
chr4	71587558	71674339	RUFY3	86781	+	NM_001037442	71588290	71672376	18
chr4	71681498	71705627	GRSF1	24129	-	NM_002092	71690035	71705544	10
chr4	71768056	71853891	MOB1B	85835	+	NM_001244766	71816499	71847774	7
chr4	71859264	71896629	DCK	37365	+	NM_000788	71859552	71895095	7
chr4	72053002	72437804	SLC4A4	384802	+	NM_001098484	72102293	72432764	26
chr4	72607410	72671237	GC	63827	-	NM_001204306	72611892	72649735	14
chr4	72897520	73013918	NPFFR2	116398	+	NM_004885	72897618	73013529	4
chr4	73146685	73434516	ADAMTS3	287831	-	NM_014243	73148852	73434479	22
chr4	73920412	73935476	COX18	15064	-	NM_001297733	73923830	73931111	6
chr4	73939682	74124515	ANKRD17	184833	-	NM_015574	73941947	74124385	34
chr4	74269971	74287129	ALB	17158	+	NM_000477	74270044	74286015	15
chr4	74301935	74321502	AFP	19567	+	NM_001134	74301979	74320997	15
chr4	74347461	74369718	AFM	22257	+	NM_001133	74347492	74368787	15
chr4	74374519	74394250	LOC728040	19731	+	NR_046377	74394250	74394250	4
chr4	74437266	74486348	RASSF6	49082	-	NM_201431	74441951	74486217	11
chr4	74606222	74609433	CXCL8	3211	+	NM_000584	74606375	74608181	4
chr4	74702272	74704477	CXCL6	2205	+	NM_002993	74702467	74703358	4
chr4	74719012	74720201	PF4V1	1189	+	NM_002620	74719079	74719839	3
chr4	74735108	74737019	CXCL1	1911	+	NM_001511	74735187	74736253	4
chr4	74846541	74847841	PF4	1300	-	NM_002619	74846920	74847670	3
chr4	74852155	74853907	PPBP	1752	-	NM_002704	74852988	74853820	3
chr4	74861358	74864446	CXCL5	3088	-	NM_002994	74863353	74864298	4
chr4	74902311	74904490	CXCL3	2179	-	NM_002090	74902978	74904328	4
chr4	74919754	74921116	PPBPP2	1362	-	NR_026769	74921116	74921116	1
chr4	74962753	74964997	CXCL2	2244	-	NM_002089	74963472	74964837	4
chr4	75023828	75168814	MTHFD2L	144986	+	NM_001144978	75023855	75167526	8
chr4	75174186	75182520	EPGN	8334	+	NR_073114	75182520	75182520	6
chr4	75230859	75254477	EREG	23618	+	NM_001432	75231025	75250525	5
chr4	75310814	75320726	AREG	9912	+	NM_001657	75311062	75318354	6
chr4	75669969	75719896	BTC	49927	-	NM_001729	75673250	75719535	6
chr4	75858284	75975325	PARM1	117041	+	NM_015393	75858537	75971457	4
chr4	75881183	75895572	LOC100507388	14389	-	NR_121617	75895572	75895572	4
chr4	76279285	76287776	LOC441025	8491	+	NR_033964	76287776	76287776	4
chr4	76404246	76439640	RCHY1	35394	-	NR_103724	76439640	76439640	9
chr4	76439642	76472542	THAP6	32900	+	NR_133920	76472542	76472542	5
chr4	76481257	76491103	C4orf26	9846	+	NR_046429	76491103	76491103	5
chr4	76501703	76555721	CDKL2	54018	-	NM_003948	76507042	76551172	12
chr4	76567952	76598667	G3BP2	30715	-	NM_203505	76570613	76587209	12
chr4	76649705	76735442	USO1	85737	+	NM_001290049	76650003	76734448	24
chr4	76781025	76823681	PPEF2	42656	-	NM_006239	76781819	76817478	17
chr4	76831807	76862166	NAAA	30359	-	NM_001042402	76832503	76862102	9
chr4	76871058	76912115	SDAD1	41057	-	NM_018115	76871902	76911994	22
chr4	76901942	76927094	LOC101928809	25152	+	NR_125906	76927094	76927094	3
chr4	76922494	76928676	CXCL9	6182	-	NM_002416	76924750	76928602	4
chr4	76932332	77033955	ART3	101623	+	NM_001130017	76997042	77033672	10
chr4	76942268	76944689	CXCL10	2421	-	NM_001565	76943082	76944584	4
chr4	76954839	76957350	CXCL11	2511	-	NM_005409	76955945	76957140	4
chr4	77035811	77069668	NUP54	33857	-	NM_017426	77036518	77069527	12
chr4	77079891	77135052	SCARB2	55161	-	NM_005506	77082865	77134696	12
chr4	77135192	77204936	FAM47E	69744	+	NM_001242936	77138760	77204611	8
chr4	77172852	77232283	FAM47E-STBD1	59431	+	NM_001242939	77172899	77230326	7
chr4	77227178	77232283	STBD1	5105	+	NM_003943	77227922	77231153	2
chr4	77234191	77328458	CCDC158	94267	-	NM_001042784	77234322	77324360	24
chr4	77356252	77704405	SHROOM3	348153	+	NM_020859	77357205	77700330	11
chr4	77494720	77494785	MIR4450	65	+	NR_039654	77494785	77494785	1
chr4	77496703	77496779	MIR548AH	76	+	NR_039655	77496779	77496779	1
chr4	77816081	77819002	SOWAHB	2921	-	NM_001029870	77816620	77819002	1
chr4	77870866	77959768	SEPT11	88902	+	NM_001306147	77917034	77955665	12
chr4	77969176	77997125	CCNI	27949	-	NM_006835	77969371	77987515	7
chr4	78078356	78091213	CCNG2	12857	+	NM_004354	78079685	78087077	8
chr4	78432906	78532988	CXCL13	100082	+	NM_006419	78527019	78532193	5
chr4	78634540	78740544	CNOT6L	106004	-	NM_001286790	78641584	78740391	12
chr4	78783804	78873944	MRPL1	90140	+	NM_020236	78784002	78873761	9
chr4	78978723	79465423	FRAS1	486700	+	NM_025074	78979163	79462278	74
chr4	79472741	79531605	ANXA3	58864	+	NM_005139	79475627	79531269	13
chr4	79567147	79605655	LINC01094	38508	+	NR_038303	79605655	79605655	5
chr4	79697531	79833341	BMP2K	135810	+	NM_198892	79697697	79833187	16
chr4	79839093	79860582	PAQR3	21489	-	NM_001040202	79841692	79860378	6
chr4	79892901	80229953	LINC01088	337052	+	NR_038342	80229953	80229953	6
chr4	80238271	80247171	NAA11	8900	-	NM_032693	80246341	80247031	2
chr4	80327506	80329372	GK2	1866	-	NM_033214	80327692	80329354	1
chr4	80413746	80497614	LINC00989	83868	+	NR_038826	80497614	80497614	4
chr4	80748624	80784401	PCAT4	35777	+	NR_026555	80784401	80784401	2
chr4	80822770	80994626	ANTXR2	171856	-	NM_001286780	80828582	80990654	17
chr4	81106423	81125482	PRDM8	19059	+	NM_020226	81121234	81124686	10
chr4	81187741	81212171	FGF5	24430	+	NM_004464	81187978	81207826	3
chr4	81256873	81884910	C4orf22	628037	+	NM_001206997	81256922	81884766	7
chr4	81952118	81978685	BMP3	26567	+	NM_001201	81952438	81974690	3
chr4	82008523	82136271	PRKG2	127748	-	NM_006259	82010861	82126201	19
chr4	82086093	82114549	LOC101928942	28456	+	NR_125908	82114549	82114549	5
chr4	82347546	82393082	RASGEF1B	45536	-	NM_152545	82348921	82380662	14
chr4	83274466	83295149	HNRNPD	20683	-	NM_031370	83276486	83294831	9
chr4	83343716	83351378	HNRNPDL	7662	-	NR_003249	83351378	83351378	9
chr4	83351632	83382328	ENOPH1	30696	+	NM_021204	83351982	83381273	6
chr4	83405603	83483126	TMEM150C	77523	-	NM_001080506	83406663	83425810	8
chr4	83534265	83542590	LINC00575	8325	-	NR_024088	83542590	83542590	4
chr4	83550689	83720010	SCD5	169321	-	NM_001037582	83552479	83719690	5
chr4	83674489	83674583	MIR575	94	-	NR_030301	83674583	83674583	1
chr4	83739813	83812433	SEC31A	72620	-	NM_001300745	83740226	83803089	25
chr4	83814604	83822069	THAP9-AS1	7465	-	NR_034075	83822069	83822069	6
chr4	83816954	83817193	SNORD143	239	-	NR_132759	83817193	83817193	1
chr4	83819245	83819444	SNORD144	199	-	NR_132760	83819444	83819444	1
chr4	83821802	83841122	THAP9	19320	+	NM_001317776	83827632	83840077	6
chr4	83845756	83934094	LIN54	88338	-	NM_001115007	83849254	83905997	13
chr4	83956238	83996971	COPS4	40733	+	NM_016129	83956377	83996583	10
chr4	84011210	84035911	PLAC8	24701	-	NM_016619	84015839	84029074	5
chr4	84184976	84206067	COQ2	21091	-	NM_015697	84185351	84206067	7
chr4	84213613	84256306	HPSE	42693	-	NM_006665	84216496	84255935	13
chr4	84328495	84377036	HELQ	48541	-	NM_133636	84328605	84376846	18
chr4	84377084	84382876	MRPS18C	5792	+	NM_016067	84377230	84382350	6
chr4	84382093	84406290	FAM175A	24197	-	NM_139076	84383621	84406225	9
chr4	84457066	84527027	GPAT3	69961	+	NM_001256422	84457775	84525920	13
chr4	84889234	85220322	LOC101928978	331088	-	NR_125909	85220322	85220322	9
chr4	85414435	85419387	NKX6-1	4952	-	NM_006168	85414441	85419381	3
chr4	85504056	85572493	CDS1	68437	+	NM_001263	85504554	85569839	13
chr4	85590692	85887544	WDFY3	296852	-	NM_014991	85594020	85781744	68
chr4	85887970	85928168	WDFY3-AS2	40198	+	NR_015359	85928168	85928168	4
chr4	86396283	86923823	ARHGAP24	527540	+	NM_001025616	86491694	86921875	10
chr4	86643620	86643686	MIR4451	66	+	NR_039656	86643686	86643686	1
chr4	86936275	87374283	MAPK10	438008	-	NM_002753	86938511	87115554	14
chr4	87040958	87141079	LOC101929064	100121	+	NR_110879	87141079	87141079	4
chr4	87463634	87463705	MIR4452	71	-	NR_039657	87463705	87463705	1
chr4	87515467	87736328	PTPN13	220861	+	NM_080683	87556409	87735704	48
chr4	87744620	87770416	SLC10A6	25796	-	NM_197965	87744840	87770268	6
chr4	87797357	87813575	C4orf36	16218	-	NM_144645	87808912	87812673	5
chr4	87846045	87856002	LOC100506746	9957	-	NR_038841	87856002	87856002	3
chr4	87856153	88062206	AFF1	206053	+	NM_001166693	87869685	88056853	21
chr4	88081255	88141760	KLHL8	60505	-	NM_001292006	88084670	88116691	10
chr4	88221646	88221735	MIR5705	89	-	NR_049891	88221735	88221735	1
chr4	88224940	88244058	HSD17B13	19118	-	NM_178135	88226369	88243993	7
chr4	88257676	88312455	HSD17B11	54779	-	NM_016245	88258427	88312222	7
chr4	88343727	88380606	NUDT9	36879	+	NM_024047	88344057	88379173	8
chr4	88394481	88450655	SPARCL1	56174	-	NM_001128310	88394926	88420726	12
chr4	88529680	88538025	DSPP	8345	+	NM_014208	88532060	88537720	5
chr4	88571453	88585512	DMP1	14059	+	NM_004407	88577644	88584472	6
chr4	88720701	88733601	IBSP	12900	+	NM_004967	88723513	88733062	7
chr4	88742549	88767968	MEPE	25419	+	NM_001184694	88755866	88767598	4
chr4	88896801	88904563	SPP1	7762	+	NM_001251830	88898870	88904048	8
chr4	88928798	88998931	PKD2	70133	+	NM_000297	88928885	88996846	15
chr4	89011415	89152474	ABCG2	141059	-	NM_001257386	89013507	89061147	16
chr4	89178760	89205983	PPM1K	27223	-	NM_152542	89183746	89199735	7
chr4	89206081	89262809	LOC105369192	56728	+	NR_134238	89262809	89262809	5
chr4	89299890	89364249	HERC6	64359	+	NM_017912	89300073	89363612	23
chr4	89378267	89427319	HERC5	49052	+	NM_016323	89378420	89427029	23
chr4	89442128	89444952	PIGY	2824	-	NM_001042616	89442724	89442940	2
chr4	89442128	89444952	PYURF	2824	-	NM_032906	89443038	89444851	2
chr4	89513573	89629693	HERC3	116120	+	NM_014606	89526974	89628111	26
chr4	89617063	89619386	NAP1L5	2323	-	NM_153757	89618356	89618905	1
chr4	89630939	89651254	FAM13A-AS1	20315	+	NR_002806	89651254	89651254	5
chr4	89647104	89978346	FAM13A	331242	-	NM_014883	89649683	89978115	24
chr4	90033967	90036052	TIGD2	2085	+	NM_145715	90034125	90035703	1
chr4	90165428	90229161	GPRIN3	63733	-	NM_198281	90168930	90171261	2
chr4	90645249	90759447	SNCA	114198	-	NM_001146055	90647778	90756818	6
chr4	90757551	90763142	SNCA-AS1	5591	+	NR_045481	90763142	90763142	4
chr4	90816051	90875780	MMRN1	59729	+	NM_007351	90816122	90874569	8
chr4	91048683	92523370	CCSER1	1474687	+	NM_001145065	91229435	92520208	11
chr4	93183648	93198453	LOC101929194	14805	-	NR_125920	93198453	93198453	3
chr4	93225549	94695706	GRID2	1470157	+	NM_001510	93225807	94693649	16
chr4	94750077	94751142	ATOH1	1065	+	NM_005172	94750077	94751142	1
chr4	95038970	95128707	LOC101929210	89737	-	NR_125922	95128707	95128707	9
chr4	95128758	95212443	SMARCAD1	83685	+	NM_001128430	95129545	95210685	24
chr4	95219706	95264027	HPGDS	44321	-	NM_014485	95220630	95255780	6
chr4	95373007	95589378	PDLIM5	216371	+	NM_001256426	95376439	95585218	17
chr4	95664818	95678684	BMPR1B-AS1	13866	-	NR_121610	95678684	95678684	3
chr4	95679127	96079601	BMPR1B	400474	+	NM_001203	96025575	96075824	13
chr4	96083655	96470361	UNC5C	386706	-	NM_003728	96090384	96470008	16
chr4	96761238	96762625	PDHA2	1387	+	NM_005390	96761301	96762468	1
chr4	98288076	98411315	STPG2-AS1	123239	+	NR_102713	98411315	98411315	6
chr4	98480024	99064391	STPG2	584367	-	NM_174952	98480208	99064301	11
chr4	99182526	99365012	RAP1GDS1	182486	+	NM_001100427	99182716	99363268	15
chr4	99391517	99579812	TSPAN5	188295	-	NM_005723	99393672	99579377	8
chr4	99799606	99851786	EIF4E	52180	-	NM_001130679	99802178	99850263	8
chr4	99916787	99983960	METAP1	67173	+	NM_015143	99916904	99982468	11
chr4	99918537	99918611	MIR3684	74	+	NR_037455	99918611	99918611	1
chr4	99992129	100009939	ADH5	17810	-	NM_000671	99993567	100009851	9
chr4	100010007	100222513	LOC100507053	212506	+	NR_037884	100222513	100222513	10
chr4	100044807	100065449	ADH4	20642	-	NM_001306172	100045592	100064391	10
chr4	100081750	100082804	PCNAP1	1054	-	NR_028270	100082804	100082804	1
chr4	100123794	100140403	ADH6	16609	-	NM_001102470	100125375	100140309	9
chr4	100197522	100212185	ADH1A	14663	-	NM_000667	100197780	100212071	9
chr4	100227543	100242599	ADH1B	15056	-	NM_001286650	100228996	100239341	10
chr4	100257648	100274202	ADH1C	16554	-	NM_000669	100257908	100273832	9
chr4	100333417	100356667	ADH7	23250	-	NM_000673	100334304	100356426	9
chr4	100432160	100463460	C4orf17	31300	+	NM_032149	100434238	100463266	9
chr4	100467863	100485214	TRMT10A	17351	-	NM_001134666	100470244	100480495	8
chr4	100485234	100545154	MTTP	59920	+	NM_000253	100496066	100544005	19
chr4	100737980	100791346	DAPP1	53366	+	NM_014395	100738070	100789342	9
chr4	100799494	100815703	LAMTOR3	16209	-	NM_021970	100803150	100815120	7
chr4	100817406	100867883	DNAJB14	50477	-	NM_001031723	100822184	100867728	8
chr4	100869243	100871512	H2AFZ	2269	-	NM_002106	100869618	100871327	5
chr4	100871650	100958862	LOC256880	87212	+	NR_125923	100958862	100958862	4
chr4	101107026	101111655	DDIT4L	4629	-	NM_145244	101108833	101111140	3
chr4	101111189	101136662	LOC101929353	25473	+	NR_125924	101136662	101136662	5
chr4	101316497	101439250	EMCN	122753	-	NM_016242	101331477	101439071	12
chr4	101581435	101596270	LINC01216	14835	-	NR_046811	101596270	101596270	4
chr4	101944586	102268628	PPP3CA	324042	-	NM_000944	101947021	102267953	14
chr4	102161951	102162029	MIR8066	78	-	NR_107033	102162029	102162029	1
chr4	102251458	102251571	MIR1255A	113	-	NR_031656	102251571	102251571	1
chr4	102268933	102270040	FLJ20021	1107	+	NR_033874	102270040	102270040	2
chr4	102711763	102995969	BANK1	284206	+	NM_017935	102712037	102994900	17
chr4	103172197	103266410	SLC39A8	94213	-	NM_001135147	103174578	103265819	11
chr4	103422485	103538459	NFKB1	115974	+	NM_003998	103446675	103537751	24
chr4	103552642	103682151	MANBA	129509	-	NM_005908	103553213	103682051	17
chr4	103698193	103720732	LOC102723704	22539	+	NR_125932	103720732	103720732	5
chr4	103715539	103790050	UBE2D3	74511	-	NM_181890	103718571	103747665	8
chr4	103749211	103765263	LOC105377348	16052	+	NR_131186	103765263	103765263	2
chr4	103790134	103813963	CISD2	23829	+	NM_001008388	103790241	103808587	3
chr4	103806204	103940896	SLC9B1	134692	-	NM_001100874	103806389	103912868	12
chr4	103946647	103998528	SLC9B2	51881	-	NM_001300754	103947526	103988707	11
chr4	103998781	104021024	BDH2	22243	-	NM_020139	104000858	104017411	10
chr4	104026962	104119566	CENPE	92604	-	NM_001813	104027378	104119476	49
chr4	104346198	104360885	LOC101929448	14687	+	NR_125925	104360885	104360885	4
chr4	104510624	104640973	TACR3	130349	-	NM_001059	104510838	104640832	5
chr4	105389462	105416058	CXXC4	26596	-	NM_025212	105393478	105412959	3
chr4	105412121	105618749	LOC101929468	206628	+	NR_125926	105618749	105618749	10
chr4	106067841	106200960	TET2	133119	+	NM_001127208	106155099	106197676	11
chr4	106092510	106274038	TET2-AS1	181528	-	NR_126420	106274038	106274038	6
chr4	106290233	106395227	PPA2	104994	-	NM_176869	106290881	106395207	12
chr4	106473776	106602070	ARHGEF38	128294	+	NM_001242729	106473922	106599094	14
chr4	106482747	106491392	ARHGEF38-IT1	8645	+	NR_046840	106491392	106491392	3
chr4	106603784	106629881	INTS12	26097	-	NM_020395	106603889	106621162	8
chr4	106629940	106768882	GSTCD	138942	+	NM_024751	106638770	106766734	12
chr4	106736301	106748329	LOC101929529	12028	-	NR_125927	106748329	106748329	4
chr4	106816596	106892828	NPNT	76232	+	NM_001184691	106816809	106890147	13
chr4	106924473	106943635	LOC101929577	19162	-	NR_125928	106943635	106943635	4
chr4	106965473	107237861	TBCK	272388	-	NM_001163436	106967726	107230117	26
chr4	107236766	107270381	AIMP1	33615	+	NM_001142415	107246166	107268849	7
chr4	107279339	107288592	GIMD1	9253	-	NM_001195138	107279339	107288592	2
chr4	107842958	107957453	DKK2	114495	-	NM_014421	107845110	107956748	4
chr4	108534821	108641419	PAPSS1	106598	-	NM_005443	108535404	108641335	12
chr4	108745720	108836204	SGMS2	90484	+	NM_001136258	108816709	108831709	7
chr4	108784634	108853275	LOC101929595	68641	-	NR_125929	108853275	108853275	7
chr4	108852716	108874613	CYP2U1	21897	+	NM_183075	108852799	108871579	5
chr4	108910869	108956331	HADH	45462	+	NM_001184705	108911088	108955513	9
chr4	108968700	109090112	LEF1	121412	-	NM_016269	108984784	109088923	12
chr4	109088680	109097586	LEF1-AS1	8906	+	NR_029374	109097586	109097586	3
chr4	109459345	109541613	RPL34-AS1	82268	-	NR_026968	109541613	109541613	4
chr4	109541721	109551639	RPL34	9918	+	NM_000995	109543115	109546368	6
chr4	109571740	109588978	OSTC	17238	+	NM_001267818	109571811	109588413	5
chr4	109663201	109684235	ETNPPL	21034	-	NM_031279	109663639	109684054	13
chr4	109731876	110223799	COL25A1	491923	-	NM_198721	109735082	110223175	37
chr4	110351118	110354973	SEC24B-AS1	3855	-	NR_039978	110354973	110354973	3
chr4	110354927	110461615	SEC24B	106688	+	NM_001300813	110355025	110460831	25
chr4	110481354	110608872	CCDC109B	127518	+	NM_017918	110481493	110608748	8
chr4	110609784	110624629	CASP6	14845	-	NM_001226	110610485	110624551	7
chr4	110631144	110651242	PLA2G12A	20098	-	NM_030821	110635532	110650965	4
chr4	110661847	110723335	CFI	61488	-	NM_000204	110662048	110723127	13
chr4	110736665	110745893	GAR1	9228	+	NM_032993	110737320	110745587	7
chr4	110749149	110765861	RRH	16712	+	NM_006583	110749183	110765353	7
chr4	110769339	110793471	LRIT3	24132	+	NM_198506	110769357	110791945	4
chr4	110834039	110934118	EGF	100079	+	NM_001963	110834491	110932611	24
chr4	110970228	111119820	ELOVL6	149592	-	NM_024090	110972493	111119491	4
chr4	111397228	111484493	ENPEP	87265	+	NM_001977	111397570	111482714	20
chr4	111538579	111563279	PITX2	24700	-	NM_001204397	111539280	111554154	7
chr4	113066552	113110237	C4orf32	43685	+	NM_152400	113066736	113108094	2
chr4	113152894	113191211	AP1AR	38317	+	NM_018569	113153247	113189565	10
chr4	113196781	113207059	TIFA	10278	-	NM_052864	113199017	113199572	2
chr4	113218498	113363764	ALPK1	145266	+	NM_001102406	113298933	113362366	16
chr4	113434671	113437328	NEUROG2	2657	-	NM_024019	113435812	113436631	2
chr4	113460488	113558151	ZGRF1	97663	-	NM_018392	113460702	113554332	28
chr4	113558119	113578748	LARP7	20629	+	NM_001267039	113565625	113578483	15
chr4	113569029	113569097	MIR367	68	-	NR_029860	113569097	113569097	1
chr4	113569159	113569227	MIR302D	68	-	NR_029859	113569227	113569227	1
chr4	113569338	113569407	MIR302A	69	-	NR_029835	113569407	113569407	1
chr4	113569518	113569586	MIR302C	68	-	NR_029858	113569586	113569586	1
chr4	113569640	113569713	MIR302B	73	-	NR_029857	113569713	113569713	1
chr4	113739238	114304896	ANK2	565658	+	NM_001127493	113825649	114302627	47
chr4	114028018	114028111	MIR1243	93	+	NR_031641	114028111	114028111	1
chr4	114073437	114073518	MIR8082	81	+	NR_107049	114073518	114073518	1
chr4	114372187	114683083	CAMK2D	310896	-	NM_001221	114376910	114682224	19
chr4	114821439	114900878	ARSJ	79439	-	NM_024590	114823429	114899990	2
chr4	115519610	115598202	UGT8	78592	+	NM_001128174	115544036	115597444	6
chr4	115577914	115578010	MIR577	96	+	NR_030303	115578010	115578010	1
chr4	115748928	116035032	NDST4	286104	-	NM_022569	115748971	115998192	14
chr4	117220880	117220924	MIR1973	44	+	NR_031737	117220924	117220924	1
chr4	118004709	118006736	TRAM1L1	2027	-	NM_152402	118005439	118006549	1
chr4	118349553	118610258	LINC01378	260705	+	NR_125757	118610258	118610258	4
chr4	118955499	119179789	NDST3	224290	+	NM_004784	118975065	119176867	14
chr4	119199916	119200978	SNHG8	1062	+	NR_034010	119200978	119200978	4
chr4	119200344	119200475	SNORA24	131	+	NR_002963	119200475	119200475	1
chr4	119201192	119273922	PRSS12	72730	-	NM_003619	119203090	119273875	13
chr4	119437494	119475359	CEP170P1	37865	+	NR_003135	119475359	119475359	8
chr4	119512898	119556180	LOC729218	43282	+	NR_109983	119556180	119556180	10
chr4	119585242	119606496	LOC101929741	21254	-	NR_125930	119606496	119606496	7
chr4	119606524	119633425	METTL14	26901	+	NM_020961	119606689	119631457	11
chr4	119643977	119757326	SEC24D	113349	-	NM_014822	119644669	119754851	23
chr4	119771842	119982402	SYNPO2	210560	+	NM_001286754	119772083	119979089	5
chr4	120056938	120108944	MYOZ2	52006	+	NM_016599	120057680	120107355	6
chr4	120113927	120133799	LOC101929762	19872	-	NR_125931	120133799	120133799	3
chr4	120133781	120216673	USP53	82892	+	NM_019050	120160914	120214366	18
chr4	120217573	120225600	C4orf3	8027	-	NM_001170330	120219933	120225600	3
chr4	120238404	120243316	FABP2	4912	-	NM_000134	120240195	120243257	4
chr4	120326677	120331815	LINC01061	5138	-	NR_037596	120331815	120331815	3
chr4	120375937	120420747	LOC645513	44810	+	NR_037630	120420747	120420747	9
chr4	120415549	120549981	PDE5A	134432	-	NM_001083	120419755	120549826	21
chr4	120720260	120725670	LINC01365	5410	-	NR_110660	120725670	120725670	5
chr4	120860694	120885448	LOC100996694	24754	+	NR_121639	120885448	120885448	2
chr4	120980578	120988013	MAD2L1	7435	-	NM_002358	120981272	120987889	5
chr4	121613067	121844021	PRDM5	230954	-	NM_018699	121616265	121843763	16
chr4	121956781	121993673	NDNF	36892	-	NM_024574	121957418	121966992	4
chr4	122052563	122148621	TNIP3	96058	-	NM_001244764	122053802	122148542	13
chr4	122249796	122302181	QRFPR	52385	-	NM_198179	122250468	122301802	6
chr4	122589151	122618147	ANXA5	28996	-	NM_001154	122589622	122617744	13
chr4	122680087	122686555	TMEM155	6468	-	NM_001317837	122681448	122683038	6
chr4	122685739	122687963	PP12613	2224	+	NR_024365	122687963	122687963	1
chr4	122722471	122738176	EXOSC9	15705	+	NM_001034194	122722579	122738011	13
chr4	122737598	122745088	CCNA2	7490	-	NM_001237	122738792	122744783	8
chr4	122745483	122791652	BBS7	46169	-	NM_176824	122747014	122791468	19
chr4	122800182	122872909	TRPC3	72727	-	NM_001130698	122800890	122872835	12
chr4	123091757	123283914	KIAA1109	192157	+	NM_015312	123091802	123283402	84
chr4	123300120	123350947	ADAD1	50827	+	NM_139243	123301224	123350894	13
chr4	123372625	123377650	IL2	5025	-	NM_000586	123372906	123377595	4
chr4	123533782	123542212	IL21	8430	-	NM_021803	123533864	123542166	5
chr4	123540137	123610311	IL21-AS1	70174	+	NR_104126	123610311	123610311	11
chr4	123651343	123653613	CETN4P	2270	-	NR_024041	123653613	123653613	3
chr4	123653856	123666098	BBS12	12242	+	NM_001178007	123663047	123665180	3
chr4	123747862	123819390	FGF2	71528	+	NM_002006	123747930	123813551	3
chr4	123813798	123844159	NUDT6	30361	-	NM_198041	123813982	123818824	5
chr4	123844224	124240604	SPATA5	396380	+	NM_145207	123844297	124235219	16
chr4	124317949	124324915	SPRY1	6966	+	NM_001258038	124322746	124323706	3
chr4	124573939	124851518	LINC01091	277579	+	NR_027105	124851518	124851518	5
chr4	125421096	125479589	LOC101927087	58493	-	NR_110838	125479589	125479589	9
chr4	125585203	125633887	ANKRD50	48684	-	NM_020337	125590141	125631666	5
chr4	126237566	126414087	FAT4	176521	+	NM_024582	126237566	126412923	17
chr4	126428413	126428462	MIR2054	49	+	NR_031746	126428462	126428462	1
chr4	128554086	128637934	INTU	83848	+	NM_015693	128554189	128637591	16
chr4	128651554	128695447	SLC25A31	43893	+	NM_031291	128651700	128694729	6
chr4	128702975	128755228	HSPA4L	52253	+	NM_001317381	128703214	128754029	20
chr4	128802015	128820377	PLK4	18362	+	NM_014264	128802289	128819696	16
chr4	128838959	128887139	MFSD8	48180	-	NM_152778	128841784	128886288	13
chr4	128886460	128952455	ABHD18	65995	+	NM_001039717	128904110	128951831	11
chr4	128982420	129132298	LARP1B	149878	+	NM_018078	128996106	129131208	20
chr4	129190391	129209984	PGRMC2	19593	-	NM_006320	129192470	129209017	3
chr4	129349170	129440551	LOC100507487	91381	+	NR_125882	129440551	129440551	9
chr4	129730777	129796379	JADE1	65602	+	NM_001287437	129752913	129793417	11
chr4	129805147	130014762	SCLT1	209615	-	NM_144643	129805631	130014258	21
chr4	130014828	130033843	C4orf33	19015	+	NM_173487	130023765	130032946	6
chr4	130645325	130692633	LOC101927282	47308	-	NR_110753	130692633	130692633	5
chr4	132685992	132712637	LOC101927305	26645	+	NR_125884	132712637	132712637	3
chr4	133512243	133599655	LINC01256	87412	+	NR_126401	133599655	133599655	4
chr4	134015015	134070271	LOC101927359	55256	-	NR_125885	134070271	134070271	9
chr4	134070444	134115765	PCDH10	45321	+	NM_032961	134071295	134111315	5
chr4	135117488	135122903	PABPC4L	5415	-	NM_001114734	135121061	135122348	2
chr4	136788137	136834835	LINC00613	46698	-	NR_103763	136834835	136834835	3
chr4	138440072	138453652	PCDH18	13580	-	NM_019035	138442182	138453242	4
chr4	138948576	139051839	LINC00616	103263	-	NR_037866	139051839	139051839	11
chr4	139010167	139099331	SLC7A11-AS1	89164	+	NR_038380	139099331	139099331	7
chr4	139085247	139163503	SLC7A11	78256	-	NM_014331	139093109	139163223	12
chr4	139230864	139345498	LINC00499	114634	+	NR_051987	139345498	139345498	3
chr4	139741110	139933800	LOC105377448	192690	-	NR_133945	139933800	139933800	3
chr4	139936912	139967093	NOCT	30181	+	NM_012118	139937135	139966628	3
chr4	139978870	140060630	ELF2	81760	-	NM_201999	139980136	140058855	9
chr4	140187316	140201492	MGARP	14176	-	NM_032623	140187752	140201312	4
chr4	140211070	140223705	NDUFC1	12635	-	NM_001184988	140213703	140216952	6
chr4	140222675	140311935	NAA15	89260	+	NM_057175	140222931	140309238	20
chr4	140374960	140397069	RAB33B	22109	+	NM_031296	140375349	140394280	2
chr4	140417088	140477923	SETD7	60835	-	NM_001306199	140417506	140477291	8
chr4	140586921	140661899	MGST2	74978	+	NM_001204366	140587173	140625302	6
chr4	140637545	141075233	MAML3	437688	-	NM_018717	140640476	141074481	6
chr4	141178439	141303710	SCOC	125271	+	NM_032547	141264792	141302258	5
chr4	141204879	141294546	SCOC-AS1	89667	-	NR_033939	141294546	141294546	5
chr4	141309606	141348815	CLGN	39209	-	NM_001130675	141310377	141334232	16
chr4	141364528	141419531	MGAT4D	55003	-	NM_001277353	141364589	141419376	11
chr4	141445311	141474924	ELMOD2	29613	+	NM_153702	141446582	141471529	9
chr4	141481049	141489959	UCP1	8910	-	NM_021833	141481049	141489883	6
chr4	141541935	141677471	TBC1D9	135536	-	NM_015130	141543348	141677199	21
chr4	141562344	141564234	TNRC18P1	1890	-	NR_077215	141564234	141564234	1
chr4	141786724	142054616	RNF150	267892	-	NM_020724	141789414	142053962	7
chr4	142142040	142155850	ZNF330	13810	+	NM_014487	142143525	142155143	10
chr4	142242277	142253771	LOC100507639	11494	-	NR_121625	142253771	142253771	4
chr4	142557748	142655140	IL15	97392	+	NM_172175	142642301	142654001	10
chr4	142949181	143767604	INPP4B	818423	-	NM_003866	142949934	143352412	27
chr4	144106069	144145027	USP38	38958	+	NM_001290326	144127341	144141609	11
chr4	144257982	144395718	GAB1	137736	+	NM_207123	144258341	144390342	11
chr4	144264612	144264688	MIR3139	76	+	NR_036091	144264688	144264688	1
chr4	144434615	144478642	SMARCA5	44027	+	NM_003601	144435077	144474337	24
chr4	144434624	144435990	SMARCA5-AS1	1366	-	NR_104027	144435990	144435990	2
chr4	144480624	144482613	GUSBP5	1989	+	NR_003675	144482613	144482613	1
chr4	144498560	144621828	FREM3	123268	-	NM_001168235	144498763	144621828	8
chr4	144792018	144826716	GYPE	34698	-	NM_198682	144797907	144826660	4
chr4	144833483	144903605	LOC101927636	70122	+	NR_125886	144903605	144903605	7
chr4	144917256	144940498	GYPB	23242	-	NM_001304382	144917451	144922395	6
chr4	145030455	145061939	GYPA	31484	-	NM_002099	145032546	145061788	7
chr4	145564067	145567171	HHIP-AS1	3104	-	NR_037595	145567171	145567171	2
chr4	145567147	145659881	HHIP	92734	+	NM_022475	145567827	145659109	13
chr4	145915726	146019693	ANAPC10	103967	-	NM_001256708	145916524	146017251	5
chr4	146019155	146050676	ABCE1	31521	+	NM_002940	146025564	146048725	18
chr4	146054801	146100832	OTUD4	46031	-	NM_001102653	146058581	146095860	21
chr4	146402950	146480325	SMAD1	77375	+	NM_005900	146435765	146479086	7
chr4	146418200	146424132	SMAD1-AS2	5932	-	NR_108077	146424132	146424132	2
chr4	146435729	146438346	SMAD1-AS1	2617	-	NR_126371	146438346	146438346	2
chr4	146540539	146581187	MMAA	40648	+	NM_172250	146560291	146576586	7
chr4	146601355	146653948	C4orf51	52593	+	NM_001080531	146601355	146653712	6
chr4	146678778	146860112	ZNF827	181334	-	NM_178835	146686135	146859559	15
chr4	147030606	147043065	LINC01095	12459	-	NR_038331	147043065	147043065	6
chr4	147096834	147111213	LSM6	14379	+	NM_007080	147104073	147110808	4
chr4	147175139	147443123	SLC10A7	267984	-	NM_001300842	147178004	147442869	13
chr4	147329734	147329840	MIR7849	106	+	NR_107003	147329840	147329840	1
chr4	147560044	147563623	POU4F2	3579	+	NM_004575	147560292	147561960	2
chr4	147627789	147867038	TTC29	239249	-	NM_001300761	147628309	147863807	14
chr4	148402068	148466106	EDNRA	64038	+	NM_001957	148406833	148463770	8
chr4	148538538	148556672	TMEM184C	18134	+	NM_018241	148539107	148555585	10
chr4	148558935	148605381	PRMT9	46446	-	NM_138364	148559682	148605138	12
chr4	148653452	148993927	ARHGAP10	340475	+	NM_024605	148653452	148993232	23
chr4	148703745	148703819	MIR4799	74	+	NR_039962	148703819	148703819	1
chr4	148999914	149363672	NR3C2	363758	-	NM_000901	149002494	149358012	9
chr4	150075446	150199274	LOC101927849	123828	+	NR_125887	150199274	150199274	13
chr4	150999425	151178608	DCLK2	179183	+	NM_001040261	151000179	151177399	17
chr4	151185810	151936649	LRBA	750839	-	NM_006726	151186873	151935794	58
chr4	151503076	151505845	MAB21L2	2769	+	NM_006439	151504181	151505261	1
chr4	152020724	152025804	RPS3A	5080	+	NM_001006	152020804	152025745	6
chr4	152024978	152025043	SNORD73A	65	+	NR_000007	152025043	152025043	1
chr4	152041432	152149182	SH3D19	107750	-	NM_001243349	152043242	152096515	20
chr4	152198324	152212605	PRSS48	14281	+	NM_183375	152198324	152212605	5
chr4	152330397	152584784	FAM160A1	254387	+	NM_001109977	152487411	152583906	14
chr4	152591808	152682175	GATB	90367	-	NM_004564	152592325	152682134	13
chr4	153021904	153025868	LOC100996286	3964	+	NR_121628	153025868	153025868	3
chr4	153242409	153456185	FBXW7	213776	-	NM_033632	153244032	153332955	12
chr4	153258806	153259248	DEAR	442	+	NR_104273	153259248	153259248	2
chr4	153410478	153410568	MIR3140	90	-	NR_036092	153410568	153410568	1
chr4	153457415	153460415	DKFZP434I0714	3000	+	NR_033797	153460415	153460415	1
chr4	153457579	153457668	MIR4453	89	+	NR_039658	153457668	153457668	1
chr4	153547265	153601317	TMEM154	54052	-	NM_152680	153549697	153601085	7
chr4	153690505	153700916	TIGD4	10411	-	NM_145720	153690617	153692156	2
chr4	153701088	153833063	ARFIP1	131975	+	NM_001287432	153750785	153831371	10
chr4	153864134	153900848	FHDC1	36714	+	NM_033393	153864209	153897875	11
chr4	154074269	154260474	TRIM2	186205	+	NM_001130067	154191537	154256118	12
chr4	154228620	154229963	ANXA2P1	1343	-	NR_001562	154229963	154229963	1
chr4	154265800	154336247	MND1	70447	+	NR_045605	154336247	154336247	10
chr4	154387497	154557862	KIAA0922	170365	+	NM_015196	154387549	154557728	35
chr4	154605440	154627242	TLR2	21802	+	NM_003264	154624059	154626414	3
chr4	154631311	154681387	RNF175	50076	-	NM_173662	154631520	154681014	9
chr4	154701741	154710228	SFRP2	8487	-	NM_003013	154702602	154709987	3
chr4	155243805	155412877	DCHS2	169072	-	NM_001142552	155244389	155412507	8
chr4	155456148	155471585	PLRG1	15437	-	NM_002669	155457836	155471460	15
chr4	155484131	155493915	FGB	9784	+	NM_005141	155484170	155491802	8
chr4	155504279	155511897	FGA	7618	-	NM_000508	155505275	155511839	6
chr4	155525285	155533960	FGG	8675	-	NM_000509	155525491	155533761	10
chr4	155661992	155674271	LRAT	12279	+	NM_001301645	155665478	155670288	3
chr4	155702423	155749965	RBM46	47542	+	NM_001277171	155717904	155741570	6
chr4	156129780	156138230	NPY2R	8450	+	NM_000910	156135091	156136237	2
chr4	156263811	156298122	MAP9	34311	-	NM_001039580	156268934	156297002	14
chr4	156275367	156281613	LOC102724776	6246	+	NR_125937	156281613	156281613	3
chr4	156587861	156658214	GUCY1A3	70353	+	NM_000856	156618019	156651383	11
chr4	156680124	156728794	GUCY1B3	48670	+	NM_001291951	156680292	156727561	15
chr4	156750880	156787425	ASIC5	36545	-	NM_017419	156751007	156787378	10
chr4	156824844	156841558	TDO2	16714	+	NM_005651	156824910	156841142	12
chr4	156845269	156875048	CTSO	29779	-	NM_001334	156847187	156874999	8
chr4	157682762	157892546	PDGFC	209784	-	NR_036641	157892546	157892546	7
chr4	157997276	158093242	GLRB	95966	+	NM_000824	157999176	158091880	10
chr4	158141735	158287226	GRIA2	145491	+	NM_001083619	158142194	158284196	16
chr4	158493641	158497303	LOC340017	3662	+	NR_026992	158497303	158497303	3
chr4	159045731	159094202	FAM198B	48471	-	NM_001031700	159048558	159092527	6
chr4	159131400	159176439	TMEM144	45039	+	NM_018342	159133819	159174679	13
chr4	159442865	159574521	RXFP1	131656	+	NM_001253732	159528215	159573207	19
chr4	159587826	159593407	C4orf46	5581	-	NR_077235	159593407	159593407	2
chr4	159593252	159629865	ETFDH	36613	+	NM_004453	159593608	159629679	13
chr4	159630278	159644552	PPID	14274	-	NM_005038	159630887	159644440	10
chr4	159690181	159827954	FNIP2	137773	+	NM_020840	159690364	159825696	17
chr4	159814683	159956333	C4orf45	141650	-	NM_152543	159814854	159956248	5
chr4	160049953	160050046	MIR3688-1	93	-	NR_037459	160050046	160050046	1
chr4	160049956	160050043	MIR3688-2	87	+	NR_039963	160050043	160050043	1
chr4	160188997	160281301	RAPGEF2	92304	+	NM_014247	160189307	160279291	24
chr4	162305043	163085186	FSTL5	780143	-	NM_020116	162306898	163032548	16
chr4	162943884	162968702	LOC101928052	24818	+	NR_125888	162968702	162968702	6
chr4	164047859	164088073	NAF1	40214	-	NM_001128931	164048130	164087879	8
chr4	164245116	164253947	NPY1R	8831	-	NM_000909	164246454	164247706	3
chr4	164264998	164273086	NPY5R	8088	+	NM_001317092	164271425	164272763	5
chr4	164392246	164395047	TKTL2	2801	-	NM_032136	164393005	164394886	1
chr4	164415672	164441691	TMA16	26019	+	NM_018352	164415953	164440666	7
chr4	164445449	165304407	MARCH1	858958	-	NM_001166373	164449899	164775283	8
chr4	165118158	165118863	ANP32C	705	-	NM_012403	165118158	165118863	1
chr4	165426541	165630646	MIR5684	204105	+	NR_049864	165630646	165630646	3
chr4	165675282	165724947	LINC01207	49665	+	NR_038834	165724947	165724947	3
chr4	165798139	165818679	APELA	20540	+	NM_001297550	165798483	165800160	3
chr4	165875597	165898818	TRIM61	23221	-	NM_001012414	165876143	165891154	5
chr4	165878099	165880273	FAM218A	2174	+	NM_153027	165878174	165878648	1
chr4	165953150	165962896	TRIM60	9746	+	NM_001258025	165961224	165962640	4
chr4	165997229	166034024	TMEM192	36795	-	NM_001100389	166000809	166033925	6
chr4	166128769	166244308	KLHL2	115539	+	NM_007246	166129028	166243212	15
chr4	166198943	166201175	GK3P	2232	-	NR_026575	166201175	166201175	1
chr4	166248817	166264314	MSMO1	15497	+	NM_006745	166254522	166263098	6
chr4	166300093	166419699	CPE	119606	+	NM_001873	166300373	166418762	9
chr4	166307393	166307489	MIR578	96	+	NR_030304	166307489	166307489	1
chr4	166605790	166683930	LINC01179	78140	+	NR_121676	166683930	166683930	6
chr4	166651930	166664223	LOC101928131	12293	-	NR_121677	166664223	166664223	4
chr4	166794409	167025609	TLL1	231200	+	NM_012464	166795056	167022028	21
chr4	167654535	168155741	SPOCK3	501206	-	NM_016950	167656071	168155324	12
chr4	169013687	169108893	ANXA10	95206	+	NM_007193	169013851	169108585	12
chr4	169137441	169239958	DDX60	102517	-	NM_017631	169138083	169232410	38
chr4	169277885	169401665	DDX60L	123780	-	NM_001012967	169279297	169393850	38
chr4	169418216	169849608	PALLD	431392	+	NM_001166108	169432655	169846397	22
chr4	169908741	169931468	CBR4	22727	-	NM_032783	169911300	169931240	5
chr4	170015406	170192249	SH3RF1	176843	-	NM_020870	170017669	170190363	12
chr4	170314420	170533778	NEK1	219358	-	NM_001199397	170315660	170523781	36
chr4	170541671	170644338	CLCN3	102667	+	NM_173872	170557079	170641216	14
chr4	170650618	170679093	C4orf27	28475	-	NM_017867	170650728	170679028	8
chr4	170838911	170897053	LOC100506085	58142	-	NR_037878	170897053	170897053	5
chr4	170907747	170947581	MFAP3L	39834	-	NM_021647	170912528	170927028	3
chr4	170981372	171011538	AADAT	30166	-	NM_001286683	170982078	171010841	14
chr4	171147741	171204873	LINC01612	57132	+	NR_125889	171204873	171204873	3
chr4	171961752	171980311	LOC100506122	18559	+	NR_038838	171980311	171980311	5
chr4	172107334	172107443	MIR6082	109	+	NR_106730	172107443	172107443	1
chr4	172734574	173961558	GALNTL6	1226984	+	NM_001034845	172735731	173961251	13
chr4	173555835	173648029	LOC101928314	92194	-	NR_125894	173648029	173648029	3
chr4	174053083	174090803	LOC101930370	37720	-	NR_134242	174090803	174090803	7
chr4	174089903	174245118	GALNT7	155215	+	NM_017423	174089986	174242868	12
chr4	174252526	174255595	HMGB2	3069	-	NM_002129	174253230	174254800	5
chr4	174292092	174298683	SAP30	6591	+	NM_003864	174292333	174298478	4
chr4	174309298	174320617	SCRG1	11319	-	NM_007281	174309491	174312565	3
chr4	174447651	174451378	HAND2	3727	-	NM_021973	174448427	174450440	2
chr4	174451608	174462981	HAND2-AS1	11373	+	NR_003679	174462981	174462981	4
chr4	175015810	175141549	LOC101928509	125739	-	NR_125896	175141549	175141549	5
chr4	175157809	175205402	FBXO8	47593	-	NM_012180	175158562	175184243	6
chr4	175205054	175254531	CEP44	49477	+	NM_001145314	175220272	175252746	11
chr4	175344945	175345015	MIR4276	70	+	NR_036236	175345015	175345015	1
chr4	175411327	175444049	HPGD	32722	-	NM_000860	175413106	175443602	7
chr4	175563161	175750466	GLRA3	187305	-	NM_006529	175564936	175749962	10
chr4	175752878	175797115	LOC101928551	44237	+	NR_125900	175797115	175797115	5
chr4	175839508	175899331	ADAM29	59823	+	NM_001278126	175896676	175899139	6
chr4	176554087	176923842	GPM6A	369755	-	NM_005277	176556055	176733378	8
chr4	176711457	176733340	LOC101928590	21883	+	NR_125901	176733340	176733340	8
chr4	176986984	177103979	WDR17	116995	+	NM_170710	177017670	177100730	31
chr4	177105724	177116822	SPATA4	11098	-	NM_144644	177105930	177116713	6
chr4	177134825	177190373	ASB5	55548	-	NM_080874	177136750	177190259	7
chr4	177241089	177253396	SPCS3	12307	+	NM_021928	177241227	177249481	5
chr4	177604684	177713899	VEGFC	109215	-	NM_005429	177605076	177713465	7
chr4	178230990	178284092	NEIL3	53102	+	NM_018248	178231107	178283625	10
chr4	178351928	178363657	AGA	11729	-	NM_000027	178352861	178363529	9
chr4	178649910	178911904	LINC01098	261994	+	NR_028342	178911904	178911904	6
chr4	178733199	178829090	LINC01099	95891	-	NR_108092	178829090	178829090	2
chr4	181985242	182080302	LINC00290	95060	-	NR_033918	182080302	182080302	3
chr4	183059812	183065668	LOC90768	5856	-	NR_125905	183065668	183065668	5
chr4	183090445	183090531	MIR1305	86	+	NR_031640	183090531	183090531	1
chr4	183164583	183724177	TENM3	559594	+	NM_001080477	183245173	183721504	28
chr4	183811243	183838630	DCTD	27387	-	NM_001921	183812551	183836721	6
chr4	183958817	183961272	FAM92A1P2	2455	+	NR_003612	183961272	183961272	1
chr4	184018173	184020352	WWC2-AS2	2179	-	NR_024008	184020352	184020352	1
chr4	184020462	184241929	WWC2	221467	+	NM_024949	184020644	184236882	23
chr4	184154780	184161787	WWC2-AS1	7007	-	NR_126473	184161787	184161787	2
chr4	184239219	184241927	CLDN22	2708	-	NM_001111319	184240708	184241371	1
chr4	184242916	184243579	CLDN24	663	-	NM_001185149	184242916	184243579	1
chr4	184365743	184370218	CDKN2AIP	4475	+	NM_001317343	184365950	184367249	3
chr4	184415889	184425668	LOC389247	9779	-	NR_033995	184425668	184425668	3
chr4	184426202	184433581	ING2	7379	+	NM_001564	184426348	184432105	2
chr4	184560787	184580372	RWDD4	19585	-	NM_001307922	184562588	184572396	7
chr4	184580419	184634747	TRAPPC11	54328	+	NM_199053	184585020	184633775	31
chr4	184719174	184944683	STOX2	225509	+	NR_132761	184944683	184944683	3
chr4	185009858	185139114	ENPP6	129256	-	NM_153343	185012329	185138972	8
chr4	185262183	185275130	LOC728175	12947	-	NR_040108	185275130	185275130	3
chr4	185286713	185303460	LOC102723766	16747	-	NR_125933	185303460	185303460	7
chr4	185308875	185395726	IRF2	86851	-	NM_002199	185309911	185350218	9
chr4	185505246	185546026	LVCAT8	40780	-	NR_131967	185546026	185546026	2
chr4	185548849	185570629	CASP3	21780	-	NM_004346	185550425	185559607	8
chr4	185570766	185616113	PRIMPOL	45347	+	NM_152683	185578294	185615933	14
chr4	185615218	185655286	CENPU	40068	-	NM_024629	185616441	185655216	13
chr4	185676748	185747268	ACSL1	70520	-	NM_001995	185678278	185724668	21
chr4	185719450	185720200	SLED1	750	-	NR_003542	185720200	185720200	1
chr4	185764449	185776806	MIR3945HG	12357	-	NR_132989	185776806	185776806	3
chr4	185772166	185772264	MIR3945	98	-	NR_037510	185772264	185772264	1
chr4	185814153	185820615	LINC01093	6462	-	NR_039976	185820615	185820615	3
chr4	185859536	185859594	MIR4455	58	-	NR_039660	185859594	185859594	1
chr4	185939994	185941958	HELT	1964	+	NM_001300781	185940082	185941926	4
chr4	186064416	186071538	SLC25A4	7122	+	NM_001151	186064526	186068125	4
chr4	186080815	186125182	CFAP97	44367	-	NM_020827	186083951	186112350	5
chr4	186125390	186285125	SNX25	159735	+	NM_001317781	186168510	186284619	19
chr4	186285031	186300152	LRP2BP	15121	-	NM_018409	186288333	186299340	8
chr4	186317839	186321399	ANKRD37	3560	+	NM_181726	186318077	186321171	5
chr4	186320693	186347139	UFSP2	26446	-	NM_018359	186321545	186347022	12
chr4	186350544	186370821	C4orf47	20277	+	NM_001114357	186350565	186370798	7
chr4	186366337	186392913	CCDC110	26576	-	NM_152775	186366655	186392837	7
chr4	186392584	186393416	LOC105377590	832	+	NR_133944	186393416	186393416	2
chr4	186421814	186456712	PDLIM3	34898	-	NM_014476	186423447	186456588	8
chr4	186506597	186877870	SORBS2	371273	-	NM_001270771	186508780	186611725	24
chr4	186990308	187006252	TLR3	15944	+	NM_003265	186997773	187006027	5
chr4	187065994	187093817	FAM149A	27823	+	NM_015398	187073113	187093141	14
chr4	187110185	187112644	FLJ38576	2459	-	NR_046264	187112644	187112644	1
chr4	187112673	187134617	CYP4V2	21944	+	NM_207352	187112977	187131795	11
chr4	187148671	187179625	KLKB1	30954	+	NM_000892	187149349	187179366	15
chr4	187187117	187210835	F11	23718	+	NM_000128	187188290	187209768	15
chr4	187207251	187422212	F11-AS1	214961	-	NR_033900	187422212	187422212	4
chr4	187454808	187476721	MTNR1A	21913	-	NM_005958	187454842	187476519	2
chr4	187508936	187644987	FAT1	136051	-	NM_005245	187509745	187630981	27
chr4	188225236	188426767	LOC339975	201531	-	NR_038931	188426767	188426767	5
chr4	188454032	188593795	LOC100506272	139763	-	NR_110436	188593795	188593795	3
chr4	188916924	188926203	ZFP42	9279	+	NM_174900	188923961	188924894	4
chr4	189012425	189026741	TRIML2	14316	-	NM_001303419	189012526	189026522	8
chr4	189060597	189068649	TRIML1	8052	+	NM_178556	189060712	189068526	6
chr4	189376731	189523062	LINC01060	146331	+	NR_033869	189523062	189523062	5
chr4	190580759	190582640	LINC01262	1881	+	NR_121679	190582640	190582640	3
chr4	190802669	190806022	LINC01596	3353	+	NR_132380	190806022	190806022	2
chr4	190861973	190884359	FRG1	22386	+	NM_004477	190862164	190884284	9
chr4	190945522	190948412	FRG2	2890	-	NM_001005217	190946715	190948359	4
chr4	190985656	190989019	DBET	3363	+	NR_121644	190989019	190989019	1
chr4_gl000193_random	49162	88375	MGC39584	39213	-	NR_038377	88375	88375	6
chr4_gl000194_random	53588	115073	MAFIP	61485	-	NR_046439	115073	115073	8
chr5	140372	190087	PLEKHG4B	49715	+	NM_052909	140422	182438	18
chr5	191625	195468	LRRC14B	3843	+	NM_001080478	191653	195468	2
chr5	204874	218297	CCDC127	13423	-	NM_145265	205411	216964	3
chr5	218337	257197	SDHA	38860	+	NM_004168	218470	256535	15
chr5	269670	271639	HRAT5	1969	-	NR_104613	271639	271639	2
chr5	271735	315089	PDCD6	43354	+	NM_001267558	306718	314630	7
chr5	304290	438405	AHRR	134115	+	NM_020731	304334	434949	12
chr5	441950	443275	EXOC3-AS1	1325	-	NR_126522	443275	443275	1
chr5	443333	467409	EXOC3	24076	+	NM_007277	446320	467013	13
chr5	470624	473080	PP7080	2456	-	NR_024158	473080	473080	2
chr5	473333	524549	SLC9A3	51216	-	NM_004174	473493	524437	17
chr5	473350	481006	LOC100288152	7656	+	NR_125375	481006	481006	7
chr5	535954	535997	MIR4456	43	-	NR_039661	535997	535997	1
chr5	602283	612325	LOC100996325	10042	-	NR_103444	612325	612325	3
chr5	612404	653666	CEP72	41262	+	NM_018140	612476	653268	12
chr5	659976	693510	TPPP	33534	-	NM_007030	665216	678175	4
chr5	795719	851101	ZDHHC11	55382	-	NM_024786	801221	850717	13
chr5	863849	892939	BRD9	29090	-	NM_023924	864582	892772	16
chr5	892968	918164	TRIP13	25196	+	NM_004237	893113	917218	13
chr5	987291	997455	LOC100506688	10164	-	NR_104614	997455	997455	2
chr5	1009076	1038927	NKD2	29851	+	NM_001271082	1009172	1037783	11
chr5	1050488	1112172	SLC12A7	61684	-	NM_006598	1052474	1112106	24
chr5	1063010	1063089	MIR4635	79	-	NR_039778	1063089	1063089	1
chr5	1173210	1178720	CTD-3080P12.3	5510	-	NR_109911	1178720	1178720	5
chr5	1201709	1225230	SLC6A19	23521	+	NM_001003841	1201765	1222019	12
chr5	1225469	1246304	SLC6A18	20835	+	NM_182632	1225592	1246193	12
chr5	1253286	1295162	TERT	41876	-	NM_198253	1253842	1295104	16
chr5	1309424	1309492	MIR4457	68	-	NR_039662	1309492	1309492	1
chr5	1317858	1345185	CLPTM1L	27327	-	NM_030782	1318483	1344956	17
chr5	1363696	1380188	LINC01511	16492	-	NR_125810	1380188	1380188	2
chr5	1392904	1445543	SLC6A3	52639	-	NM_001044	1394849	1443312	15
chr5	1461541	1524076	LPCAT1	62535	-	NM_024830	1463765	1523959	14
chr5	1510876	1510971	MIR6075	95	-	NR_106723	1510971	1510971	1
chr5	1572072	1594646	SDHAP3	22574	-	NR_003263	1594646	1594646	7
chr5	1597671	1634120	LOC728613	36449	-	NR_003713	1634120	1634120	4
chr5	1708899	1708983	MIR4277	84	-	NR_036240	1708983	1708983	1
chr5	1798498	1799956	MRPL36	1458	-	NM_032479	1798737	1799049	2
chr5	1801495	1816167	NDUFS6	14672	+	NM_004553	1801531	1816030	4
chr5	1856083	1856682	LOC101929034	599	-	NR_104602	1856682	1856682	2
chr5	1877540	1887293	IRX4	9753	-	NM_001278633	1878082	1882761	7
chr5	1887444	1900604	CTD-2194D22.4	13160	+	NR_109912	1900604	1900604	4
chr5	2303833	2312315	LOC100506858	8482	-	NR_104616	2312315	2312315	3
chr5	2746278	2751769	IRX2	5491	-	NM_001134222	2747677	2751527	5
chr5	2752244	2755511	C5orf38	3267	+	NM_001306149	2752378	2753473	4
chr5	3177948	3181346	LINC01377	3398	+	NR_104617	3181346	3181346	2
chr5	3417265	3536208	LINC01019	118943	-	NR_033898	3536208	3536208	5
chr5	3496485	3504118	LINC01017	7633	-	NR_104618	3504118	3504118	3
chr5	3596167	3601517	IRX1	5350	+	NM_024337	3596219	3601154	4
chr5	4773593	4774978	LOC101929153	1385	+	NR_104619	4774978	4774978	2
chr5	5034471	5070115	LINC01020	35644	+	NR_026994	5070115	5070115	7
chr5	5069304	5078424	LOC105374631	9120	-	NR_134266	5078424	5078424	2
chr5	5132197	5140167	CTD-2297D10.2	7970	-	NR_109915	5140167	5140167	4
chr5	5140442	5320412	ADAMTS16	179970	+	NM_139056	5140580	5319251	23
chr5	5422785	5490347	ICE1	67562	+	NM_015325	5423028	5489443	19
chr5	6310553	6337405	FLJ33360	26852	-	NR_028351	6337405	6337405	2
chr5	6372038	6378639	MED10	6601	-	NM_032286	6372615	6378596	4
chr5	6448735	6496834	UBE2QL1	48099	+	NM_001145161	6449006	6491462	2
chr5	6582248	6588613	LINC01018	6365	+	NR_024423	6588613	6588613	5
chr5	6599351	6633473	NSUN2	34122	-	NM_017755	6600038	6633092	19
chr5	6633499	6669675	SRD5A1	36176	+	NM_001047	6633689	6668381	5
chr5	6686437	6707824	LOC100505625	21387	-	NR_103771	6707824	6707824	3
chr5	6714717	6757161	PAPD7	42444	+	NM_001171805	6737656	6755058	13
chr5	6827965	6828034	MIR4278	69	-	NR_036242	6828034	6828034	1
chr5	7301442	7306827	LOC442132	5385	-	NR_033906	7306827	7306827	8
chr5	7347098	7348090	LOC101929261	992	-	NR_134277	7348090	7348090	2
chr5	7396342	7830194	ADCY2	433852	+	NM_020546	7396409	7826984	25
chr5	7830490	7851603	C5orf49	21113	-	NM_001089584	7831962	7851134	3
chr5	7859271	7869150	FASTKD3	9879	-	NM_024091	7859547	7868196	7
chr5	7869216	7901235	MTRR	32019	+	NM_024010	7869246	7900171	15
chr5	8333595	8457677	LOC729506	124082	-	NR_039984	8457677	8457677	6
chr5	8457799	8463209	MIR4458HG	5410	+	NR_039989	8463209	8463209	2
chr5	8461037	8461112	MIR4458	75	+	NR_039663	8461112	8461112	1
chr5	8839843	8881636	LOC101929284	41793	+	NR_109932	8881636	8881636	3
chr5	9035137	9546233	SEMA5A	511096	-	NM_003966	9043008	9380058	23
chr5	9053927	9054007	MIR4636	80	-	NR_039779	9054007	9054007	1
chr5	9511444	9518198	CTD-2201E9.1	6754	+	NR_109935	9518198	9518198	3
chr5	9546311	9550409	SNHG18	4098	+	NR_045196	9550409	9550409	3
chr5	9548938	9549026	SNORD123	88	+	NR_003689	9549026	9549026	1
chr5	9629108	9630463	TAS2R1	1355	-	NM_019599	9629244	9630144	1
chr5	9641426	9903936	LOC285692	262510	-	NR_027112	9903936	9903936	13
chr5	10225619	10250021	FAM173B	24402	-	NR_047669	10250021	10250021	6
chr5	10250032	10266524	CCT5	16492	+	NM_012073	10250452	10264895	11
chr5	10277706	10308168	CMBL	30462	-	NM_138809	10280564	10290874	6
chr5	10353750	10440500	MARCH6	86750	+	NM_005885	10354010	10433796	26
chr5	10440846	10441963	ROPN1L-AS1	1117	-	NR_102746	10441963	10441963	2
chr5	10441973	10465138	ROPN1L	23165	+	NM_001201466	10442279	10465059	6
chr5	10478148	10478257	MIR6131	109	+	NR_106747	10478257	10478257	1
chr5	10493638	10502840	LOC101929412	9202	-	NR_104606	10502840	10502840	3
chr5	10505101	10522196	LOC389273	17095	-	NR_134289	10522196	10522196	3
chr5	10564434	10657928	ANKRD33B	93494	+	NM_001164440	10564579	10650225	4
chr5	10679341	10761387	DAP	82046	-	NM_004394	10681167	10761180	4
chr5	10971953	11904155	CTNND2	932202	-	NM_001332	10973564	11903965	22
chr5	12574968	12805295	LINC01194	230327	+	NR_033383	12805295	12805295	4
chr5	13690436	13944589	DNAH5	254153	-	NM_001369	13692092	13944547	79
chr5	14143810	14510313	TRIO	366503	+	NM_007118	14143834	14508531	57
chr5	14581890	14616287	FAM105A	34397	+	NM_019018	14582003	14610423	8
chr5	14664782	14699842	OTULIN	35060	+	NM_138348	14664934	14693157	7
chr5	14704908	14871887	ANKH	166979	-	NM_054027	14711305	14871556	12
chr5	14712802	14716638	LOC100130744	3836	+	NR_046285	14716638	14716638	2
chr5	14826037	14826121	MIR4637	84	-	NR_039780	14826121	14826121	1
chr5	15191754	15266669	LOC101929454	74915	-	NR_109944	15266669	15266669	3
chr5	15500304	15939905	FBXL7	439601	+	NM_012304	15500785	15937295	4
chr5	15602297	15615111	CTD-2350J17.1	12814	-	NR_109945	15615111	15615111	3
chr5	15935290	15935369	MIR887	79	+	NR_030616	15935369	15935369	1
chr5	16067473	16179897	MARCH11	112424	-	NM_001102562	16067579	16179684	4
chr5	16373469	16441211	LOC101929505	67742	-	NR_104625	16441211	16441211	9
chr5	16451627	16465894	ZNF622	14267	-	NM_033414	16451765	16465774	6
chr5	16473146	16617167	FAM134B	144021	-	NM_001034850	16474849	16617080	9
chr5	16616034	16630078	LOC101929524	14044	+	NR_109946	16630078	16630078	4
chr5	16662015	16936385	MYO10	274370	-	NM_012334	16666800	16935917	41
chr5	17130136	17217531	LOC285696	87395	-	NR_027253	17217531	17217531	3
chr5	17216931	17276954	BASP1	60023	+	NM_001271606	17275325	17276009	2
chr5	17379014	17387419	LOC401177	8405	-	NR_033975	17387419	17387419	3
chr5	17404127	17441803	LOC101929544	37676	+	NR_134275	17441803	17441803	2
chr5	17444118	17484055	LOC102723526	39937	+	NR_134270	17484055	17484055	3
chr5	17807382	17930598	LOC646241	123216	+	NR_134286	17930598	17930598	8
chr5	19473154	20575982	CDH18	1102828	-	NM_001291956	19473334	19839095	15
chr5	21459588	21589481	GUSBP1	129893	+	NR_027026	21589481	21589481	5
chr5	21750974	22853731	CDH12	1102757	-	NM_004061	21751845	22078785	15
chr5	22142460	22152379	PMCHL1	9919	+	NR_003921	22152379	22152379	4
chr5	23507717	23528706	PRDM9	20989	+	NM_020227	23509142	23527882	11
chr5	23951456	24178374	C5orf17	226918	+	NR_131245	24178374	24178374	5
chr5	24487208	24645087	CDH10	157879	-	NM_006727	24487771	24593599	12
chr5	24835388	24840692	LOC340107	5304	-	NR_037896	24840692	24840692	3
chr5	26880708	27038689	CDH9	157981	-	NM_016279	26881244	26988440	12
chr5	27472398	27496508	LINC01021	24110	+	NR_038848	27496508	27496508	5
chr5	28286495	28287772	LOC105374698	1277	-	NR_134265	28287772	28287772	2
chr5	28926976	28927420	LSP1P3	444	+	NR_033961	28927420	28927420	1
chr5	29065350	29073330	LOC101929645	7980	+	NR_109948	29073330	29073330	4
chr5	29143609	29173082	LOC101929660	29473	+	NR_130777	29173082	29173082	9
chr5	29380195	29396083	LOC101929681	15888	-	NR_104628	29396083	29396083	5
chr5	29880666	29882210	LOC105374704	1544	+	NR_134264	29882210	29882210	2
chr5	31193761	31329253	CDH6	135492	+	NM_004932	31267580	31323415	12
chr5	31400601	31532282	DROSHA	131681	-	NM_001100412	31401538	31529166	35
chr5	31532372	31555165	C5orf22	22793	+	NM_018356	31532499	31553009	9
chr5	31639516	32111038	PDZD2	471522	+	NM_178140	31799355	32108241	25
chr5	31936207	31936265	MIR4279	58	-	NR_036241	31936265	31936265	1
chr5	32124823	32174425	GOLPH3	49602	-	NM_022130	32126317	32174140	4
chr5	32227112	32313114	MTMR12	86002	-	NM_001040446	32229883	32312944	16
chr5	32354455	32444844	ZFR	90389	-	NM_016107	32355865	32444764	20
chr5	32394483	32394581	MIR579	98	-	NR_030305	32394581	32394581	1
chr5	32585604	32604185	SUB1	18581	+	NM_006713	32588618	32601190	5
chr5	32710742	32791830	NPR3	81088	+	NM_001204376	32710768	32786451	8
chr5	32947548	32962573	LOC340113	15025	+	NR_033832	32962573	32962573	6
chr5	33440801	33468196	TARS	27395	+	NM_001258437	33441192	33467813	20
chr5	33527286	33892124	ADAMTS12	364838	-	NM_030955	33527292	33891961	24
chr5	33936490	33939023	RXFP3	2533	+	NM_016568	33936845	33938255	1
chr5	33944720	33984780	SLC45A2	40060	-	NM_016180	33944752	33984688	7
chr5	33987090	34008220	AMACR	21130	-	NM_001167595	33988412	34008124	6
chr5	33987090	34124633	C1QTNF3-AMACR	137543	-	NR_037951	34124633	34124633	9
chr5	34017962	34043371	C1QTNF3	25409	-	NM_030945	34020687	34043230	6
chr5	34656432	34832717	RAI14	176285	+	NM_015577	34687024	34830870	18
chr5	34839728	34900606	TTC23L	60878	+	NM_001317949	34839739	34896883	11
chr5	34905365	34915780	RAD1	10415	-	NM_002853	34908869	34914997	6
chr5	34915819	34925787	BRIX1	9968	+	NM_018321	34915843	34925600	10
chr5	34929697	34959069	DNAJC21	29372	+	NM_194283	34929924	34954819	13
chr5	34998205	35048240	AGXT2	50035	-	NM_031900	34998823	35047997	14
chr5	35055801	35230691	PRLR	174890	-	NM_000949	35065190	35089722	10
chr5	35617988	35814713	SPEF2	196725	+	NM_024867	35618099	35814655	37
chr5	35856976	35879705	IL7R	22729	+	NM_002185	35857079	35876588	8
chr5	35904397	35938881	CAPSL	34484	-	NM_144647	35904646	35921222	5
chr5	35938902	35940093	LOC100506406	1191	+	NR_104630	35940093	35940093	2
chr5	35960857	36001130	UGT3A1	40273	-	NM_001171873	35962975	35988585	6
chr5	36035118	36067023	UGT3A2	31905	-	NM_174914	36035799	36066891	7
chr5	36103413	36152015	LMBRD2	48602	-	NM_001007527	36104147	36143451	18
chr5	36147993	36148090	MIR580	97	-	NR_030306	36148090	36148090	1
chr5	36152144	36184142	SKP2	31998	+	NM_032637	36152364	36184113	10
chr5	36192690	36242381	NADK2	49691	-	NM_001287341	36195245	36225714	13
chr5	36249103	36302011	RANBP3L	52908	-	NM_001161429	36249755	36301518	15
chr5	36606456	36688436	SLC1A3	81980	+	NM_004172	36608525	36686371	10
chr5	36871462	36876796	NIPBL-AS1	5334	-	NR_046262	36876796	36876796	1
chr5	36876860	37065921	NIPBL	189061	+	NM_133433	36953798	37064994	47
chr5	37106329	37249530	C5orf42	143201	-	NM_023073	37107703	37247800	52
chr5	37249147	37250748	LOC105374727	1601	+	NR_134263	37250748	37250748	2
chr5	37291734	37371228	NUP155	79494	-	NM_153485	37292001	37371079	35
chr5	37379411	37752774	WDR70	373363	+	NM_018034	37379469	37752675	18
chr5	37812778	37839782	GDNF	27004	-	NM_000514	37815752	37834898	3
chr5	37840539	37874994	GDNF-AS1	34455	+	NR_103441	37874994	37874994	4
chr5	37948592	37951156	LOC105374729	2564	+	NR_134262	37951156	37951156	2
chr5	38148581	38153817	LOC101929745	5236	+	NR_134272	38153817	38153817	2
chr5	38258510	38465582	EGFLAM	207072	+	NM_001205301	38258856	38464088	23
chr5	38282370	38291088	EGFLAM-AS4	8718	-	NR_046219	38291088	38291088	4
chr5	38399915	38403573	EGFLAM-AS2	3658	-	NR_102750	38403573	38403573	3
chr5	38475064	38595507	LIFR	120443	-	NM_002310	38481696	38530749	20
chr5	38556887	38671318	LIFR-AS1	114431	+	NR_103554	38671318	38671318	9
chr5	38557603	38557663	MIR3650	60	-	NR_037423	38557663	38557663	1
chr5	38693314	38845931	OSMR-AS1	152617	-	NR_109951	38845931	38845931	4
chr5	38710468	38720375	LINC01265	9907	-	NR_104631	38720375	38720375	5
chr5	38846100	38935743	OSMR	89643	+	NM_003999	38869146	38933546	18
chr5	38938022	39074510	RICTOR	136488	-	NM_001285439	38942405	39074479	39
chr5	39105353	39270759	FYB	165406	-	NM_001243093	39107544	39270673	19
chr5	39284377	39364655	C9	80278	-	NM_001737	39285300	39364566	11
chr5	39371775	39425335	DAB2	53560	-	NM_001343	39375120	39394422	15
chr5	39520532	39524810	LOC101926940	4278	+	NR_104632	39524810	39524810	3
chr5	40052392	40053426	LINC00603	1034	+	NR_104633	40053426	40053426	2
chr5	40680031	40693837	PTGER4	13806	+	NM_000958	40681095	40692480	3
chr5	40711677	40756072	TTC33	44395	-	NM_012382	40716246	40747120	5
chr5	40759480	40798297	PRKAA1	38817	-	NM_206907	40762879	40798291	10
chr5	40825364	40829244	LOC100506548	3880	-	NR_037665	40829244	40829244	1
chr5	40831429	40835387	RPL37	3958	-	NM_000997	40832605	40835287	4
chr5	40832757	40832837	SNORD72	80	-	NR_002583	40832837	40832837	1
chr5	40841409	40855456	CARD6	14047	+	NM_032587	40841484	40854548	3
chr5	40909598	40983042	C7	73444	+	NM_000587	40909712	40981675	18
chr5	40998121	41071444	MROH2B	73323	-	NM_173489	40998153	41070954	42
chr5	41142247	41261540	C6	119293	-	NM_001115131	41142926	41203332	18
chr5	41307047	41510730	PLCXD3	203683	-	NM_001005473	41313718	41510628	3
chr5	41730166	41870791	OXCT1	140625	-	NM_000436	41731830	41870460	17
chr5	41870131	41872338	OXCT1-AS1	2207	+	NR_046635	41872338	41872338	3
chr5	41904445	41921738	C5orf51	17293	+	NM_175921	41904469	41917401	6
chr5	41925353	41941672	FBXO4	16319	+	NM_001297437	41925411	41941313	6
chr5	42155934	42175447	LOC101926960	19513	-	NR_104636	42175447	42175447	4
chr5	42423876	42721980	GHR	298104	+	NM_000163	42565976	42719526	10
chr5	42756919	42802539	CCDC152	45620	+	NM_001134848	42759223	42799883	9
chr5	42799981	42812024	SEPP1	12043	-	NM_001093726	42800821	42810869	6
chr5	42985500	42993435	FLJ32255	7935	-	NR_104643	42993435	42993435	2
chr5	43014830	43067541	LOC648987	52711	-	NR_104651	43067541	43067541	3
chr5	43039181	43040447	ANXA2R	1266	-	NM_001014279	43039566	43040148	1
chr5	43042235	43045370	LOC153684	3135	+	NR_015447	43045370	43045370	2
chr5	43065288	43067073	LOC100132356	1785	-	NR_034127	43067073	43067073	1
chr5	43067124	43093660	LOC100506639	26536	+	NR_102752	43093660	43093660	3
chr5	43121002	43176426	ZNF131	55424	+	NR_123719	43176426	43176426	8
chr5	43192169	43280952	NIM1K	88783	+	NM_153361	43245877	43280831	4
chr5	43287571	43313614	HMGCS1	26043	-	NM_001098272	43291232	43299067	11
chr5	43376747	43412493	CCL28	35746	-	NM_001301874	43381961	43412418	4
chr5	43444353	43483992	C5orf28	39639	-	NM_022483	43446323	43454071	3
chr5	43486802	43515273	C5orf34	28471	-	NM_198566	43487016	43509441	13
chr5	43526369	43557521	PAIP1	31152	-	NM_183323	43527477	43556030	11
chr5	43573286	43603332	NNT-AS1	30046	-	NR_073113	43603332	43603332	3
chr5	43602790	43705668	NNT	102878	+	NM_012343	43609297	43704506	22
chr5	44305096	44388784	FGF10	83688	-	NM_004465	44305096	44388784	3
chr5	44388833	44414091	FGF10-AS1	25258	+	NR_108034	44414091	44414091	3
chr5	44495245	44510384	BRCAT107	15139	-	NR_131946	44510384	44510384	3
chr5	44744429	44808895	BRCAT54	64466	-	NR_109863	44808895	44808895	4
chr5	44809026	44815618	MRPS30	6592	+	NM_016640	44809064	44815304	5
chr5	45255051	45696220	HCN1	441169	-	NM_021072	45262022	45696195	8
chr5	49692030	49737234	EMB	45204	-	NM_198449	49695106	49736985	9
chr5	49961732	50142356	PARP8	180624	+	NM_001178055	49962929	50137902	27
chr5	50265050	50266021	LOC100287592	971	-	NR_104653	50266021	50266021	2
chr5	50668570	50679166	LOC642366	10596	-	NR_046243	50679166	50679166	2
chr5	50678957	50690563	ISL1	11606	+	NM_002202	50679505	50689444	6
chr5	52083773	52098452	PELO	14679	+	NM_015946	52096228	52097674	3
chr5	52084135	52249485	ITGA1	165350	+	NM_181501	52084187	52248281	29
chr5	52285155	52390609	ITGA2	105454	+	NM_002203	52285298	52386429	30
chr5	52391508	52405602	MOCS2	14094	-	NM_176806	52402924	52405559	7
chr5	52405671	52410956	LOC257396	5285	+	NR_034107	52410956	52410956	3
chr5	52776263	52782304	FST	6041	+	NM_006350	52776621	52781518	6
chr5	52856464	52979171	NDUFS4	122707	+	NM_002495	52856492	52979051	5
chr5	53180613	53606403	ARL15	425790	-	NM_019087	53182390	53606309	5
chr5	53247333	53247429	MIR581	96	-	NR_030307	53247429	53247429	1
chr5	53616773	53710955	LINC01033	94182	+	NR_126379	53710955	53710955	5
chr5	53751430	53752214	HSPB3	784	+	NM_006308	53751619	53752072	1
chr5	53813588	53842416	SNX18	28828	+	NM_001145427	53813782	53839010	2
chr5	53955986	54040086	LOC102467080	84100	-	NR_104658	54040086	54040086	3
chr5	54273694	54281414	ESM1	7720	-	NM_007036	54275159	54281345	3
chr5	54317126	54319997	LOC102467081	2871	-	NR_104662	54319997	54319997	3
chr5	54320106	54329960	GZMK	9854	+	NM_002104	54320150	54329754	5
chr5	54398473	54406080	GZMA	7607	+	NM_006144	54398510	54406010	5
chr5	54408798	54469005	CDC20B	60207	-	NM_152623	54410045	54468828	12
chr5	54455945	54463129	GPX8	7184	+	NR_131337	54463129	54463129	4
chr5	54466359	54466450	MIR449A	91	-	NR_029960	54466450	54466450	1
chr5	54466473	54466570	MIR449B	97	-	NR_030387	54466570	54466570	1
chr5	54468089	54468181	MIR449C	92	-	NR_031572	54468181	54468181	1
chr5	54515424	54523143	MCIDAS	7719	-	NM_001190787	54516193	54522966	7
chr5	54526980	54529545	CCNO	2565	-	NM_021147	54527202	54529351	3
chr5	54552072	54603521	DHX29	51449	-	NM_019030	54552315	54603401	27
chr5	54603575	54721409	SKIV2L2	117834	+	NM_015360	54603841	54720600	27
chr5	54720669	54830906	PLPP1	110237	-	NR_103485	54830906	54830906	7
chr5	54804677	54804754	MIR5687	77	-	NR_049869	54804754	54804754	1
chr5	54824669	54830370	RNF138P1	5701	-	NR_001575	54830370	54830370	1
chr5	54921672	55008163	SLC38A9	86491	-	NM_173514	54922321	54993786	16
chr5	55033844	55112974	DDX4	79130	+	NM_024415	55034791	55112368	22
chr5	55147206	55218682	IL31RA	71476	+	NM_001242638	55149389	55218260	18
chr5	55230924	55290821	IL6ST	59897	-	NR_120480	55290821	55290821	18
chr5	55290994	55299475	FLJ31104	8481	+	NR_102755	55299475	55299475	2
chr5	55395506	55529186	ANKRD55	133680	-	NM_024669	55396009	55528740	12
chr5	55753621	55777596	LOC102467147	23975	-	NR_104664	55777596	55777596	5
chr5	55807220	55902059	C5orf67	94839	-	NM_001287053	55807548	55851999	6
chr5	56110899	56191978	MAP3K1	81079	+	NM_005921	56111400	56189507	20
chr5	56205086	56221359	SETD9	16273	+	NM_001171990	56205472	56221163	6
chr5	56215428	56247957	MIER3	32529	-	NM_152622	56218954	56247929	13
chr5	56469774	56560506	GPBP1	90732	+	NM_022913	56509957	56558579	12
chr5	56775842	56778636	ACTBL2	2794	-	NM_001017992	56777403	56778534	1
chr5	56866168	56913254	LINCR-0003	47086	+	NR_120607	56913254	56913254	6
chr5	56946486	56966816	LOC101928505	20330	+	NR_104668	56966816	56966816	3
chr5	57186157	57194989	LOC101928539	8832	-	NR_109900	57194989	57194989	3
chr5	57403458	57418168	LOC101928569	14710	-	NR_104669	57418168	57418168	5
chr5	57749809	57755966	PLK2	6157	-	NM_001252226	57750409	57755786	15
chr5	57787261	57792185	GAPT	4924	+	NM_152687	57790363	57790837	3
chr5	57837393	57854070	LOC101928600	16677	-	NR_109904	57854070	57854070	4
chr5	57878014	58155222	RAB3C	277208	+	NM_001317915	57878223	58147178	5
chr5	58264865	59783925	PDE4D	1519060	-	NM_001165899	58270490	59481425	17
chr5	59783539	59843484	PART1	59945	+	NR_024617	59843484	59843484	4
chr5	59892738	59995993	DEPDC1B	103255	-	NM_018369	59893579	59995920	11
chr5	60047615	60140101	ELOVL7	92486	-	NM_001297617	60050450	60079945	11
chr5	60169658	60240905	ERCC8	71247	-	NM_001007233	60170441	60217981	13
chr5	60240955	60448864	NDUFAF2	207909	+	NM_174889	60241082	60448782	4
chr5	60453535	60458302	SMIM15	4767	-	NM_001048249	60455773	60455998	3
chr5	60458142	60527907	CTC-436P18.1	69765	+	NR_109908	60527907	60527907	4
chr5	60628099	60841999	ZSWIM6	213900	+	NM_020928	60628099	60840144	14
chr5	60933607	61026824	C5orf64	93217	+	NR_126524	61026824	61026824	4
chr5	60958984	60994259	LOC101928651	35275	-	NR_109910	60994259	60994259	8
chr5	61028616	61031525	LOC100506526	2909	-	NR_105000	61031525	61031525	3
chr5	61601988	61683011	KIF2A	81023	+	NM_001098511	61602299	61681396	21
chr5	61684350	61699728	DIMT1	15378	-	NM_014473	61684836	61699599	12
chr5	61708572	61924416	IPO11	215844	+	NM_016338	61733106	61923145	30
chr5	61874561	61877275	LRRC70	2714	+	NM_181506	61875265	61877134	2
chr5	61874561	61924416	IPO11-LRRC70	49855	+	NR_073584	61924416	61924416	4
chr5	63255874	63258119	HTR1A	2245	-	NM_000524	63256277	63257546	1
chr5	63461670	63668696	RNF180	207026	+	NM_001113561	63496634	63665641	8
chr5	63801773	63908121	RGS7BP	106348	+	NM_001029875	63802451	63905079	6
chr5	63986134	64014017	FAM159B	27883	+	NM_001164442	63986450	64013849	3
chr5	64013977	64064496	SREK1IP1	50519	-	NM_173829	64020210	64064344	5
chr5	64064744	64314590	CWC27	249846	+	NM_005869	64064973	64314148	14
chr5	64444562	64777704	ADAMTS6	333142	-	NM_197941	64447662	64769500	25
chr5	64813592	64858995	CENPK	45403	-	NM_022145	64814301	64850734	11
chr5	64859062	64883376	PPWD1	24314	+	NM_015342	64859137	64883223	11
chr5	64885506	64920187	TRIM23	34681	-	NM_033228	64887310	64920101	13
chr5	64920557	64961954	TRAPPC13	41397	+	NM_001093755	64920887	64960438	13
chr5	64961754	65017941	SGTB	56187	-	NM_019072	64966072	65016634	11
chr5	65018022	65125111	NLN	107089	+	NM_020726	65018200	65118743	13
chr5	65222381	65376851	ERBB2IP	154470	+	NM_001253699	65288546	65374358	26
chr5	65240632	65241401	LOC100303749	769	-	NR_028474	65241401	65241401	1
chr5	65440045	65479444	SREK1	39399	+	NM_001270492	65455099	65474696	13
chr5	65803372	65807432	LOC101928769	4060	-	NR_105001	65807432	65807432	3
chr5	65892175	66465423	MAST4	573248	+	NM_001164664	65892483	66462879	29
chr5	66297445	66299982	LOC101928794	2537	-	NR_111908	66299982	66299982	2
chr5	66478103	66492617	CD180	14514	-	NM_005582	66478684	66492469	3
chr5	67089040	67096886	LOC101928858	7846	+	NR_130779	67096886	67096886	3
chr5	67485703	67494235	LOC102467655	8532	+	NR_105003	67494235	67494235	3
chr5	67511583	67597649	PIK3R1	86066	+	NM_181523	67522503	67593429	16
chr5	68263567	68325754	LOC101928885	62187	-	NR_130778	68325754	68325754	4
chr5	68389775	68426899	SLC30A5	37124	+	NM_022902	68390082	68425444	16
chr5	68462836	68474070	CCNB1	11234	+	NM_031966	68463089	68473458	9
chr5	68485374	68506184	CENPH	20810	+	NM_022909	68485461	68505626	9
chr5	68513572	68525985	MRPS36	12413	+	NM_033281	68513656	68525052	4
chr5	68530621	68573257	CDK7	42636	+	NM_001799	68530802	68572962	12
chr5	68576518	68628620	CCDC125	52102	-	NM_001297697	68578555	68607022	13
chr5	68647552	68665840	AK6	18288	-	NM_001015891	68647887	68665502	5
chr5	68660569	68665840	TAF9	5271	-	NM_001015892	68660769	68661564	3
chr5	68665123	68710630	RAD17	45507	+	NM_133343	68668035	68710119	18
chr5	68710938	68737890	MARVELD2	26952	+	NM_001038603	68715212	68737481	7
chr5	68773299	68781439	LOC101928924	8140	-	NR_134279	68781439	68781439	2
chr5	68788118	68853931	OCLN	65813	+	NM_002538	68800071	68849498	9
chr5	68856050	68888729	GTF2H2C	32679	+	NM_001098728	68860959	68888025	16
chr5	68856073	68888352	GTF2H2C_2	32279	+	NM_001042490	68860959	68888025	17
chr5	68926979	68929028	LOC100272216	2049	-	NR_027439	68929028	68929028	1
chr5	69321071	69338940	SERF1A	17869	+	NM_021967	69321278	69337567	3
chr5	69321077	69338934	SERF1B	17857	+	NM_022978	69321278	69337567	3
chr5	69434688	69586004	SMA4	151316	-	NR_029426	69586004	69586004	10
chr5	69515015	69881629	GUSBP3	366614	-	NR_027386	69881629	69881629	6
chr5	69711196	69746189	GTF2H2B	34993	+	NR_033417	69746189	69746189	15
chr5	69776869	69881549	SMA5	104680	-	NR_034021	69881549	69881549	11
chr5	69782327	69787614	LOC441081	5287	+	NR_073404	69787614	69787614	1
chr5	69812078	69851150	GUSBP9	39072	-	NR_033968	69851150	69851150	4
chr5	70220767	70248838	SMN1	28071	+	NM_000344	70220930	70247818	9
chr5	70220767	70248842	SMN2	28075	+	NM_017411	70220930	70247818	9
chr5	70264309	70320941	NAIP	56632	-	NM_004536	70265930	70308742	17
chr5	70330950	70363497	GTF2H2	32547	-	NM_001515	70331503	70358590	16
chr5	70370029	70388897	LOC647859	18868	-	NR_026578	70388897	70388897	5
chr5	70616857	70742583	LOC102724392	125726	-	NR_134269	70742583	70742583	3
chr5	70671611	70681820	PMCHL2	10209	+	NR_003922	70681820	70681820	4
chr5	70751441	70863649	BDP1	112208	+	NM_018429	70751704	70860712	39
chr5	70883114	70954530	MCCC2	71416	+	NM_022132	70883252	70952687	17
chr5	71014989	71016875	CARTPT	1886	+	NM_004291	71015120	71016442	3
chr5	71403117	71505397	MAP1B	102280	+	NM_005909	71403358	71501066	7
chr5	71465293	71465367	MIR4803	74	+	NR_039967	71465367	71465367	1
chr5	71515235	71616084	MRPS27	100849	-	NM_001286748	71516735	71616048	12
chr5	71616193	71655180	PTCD2	38987	+	NM_024754	71616209	71654254	10
chr5	71735725	71803249	ZNF366	67524	-	NM_152625	71739582	71757323	5
chr5	71852903	71867569	LOC102503427	14666	+	NR_105008	71867569	71867569	4
chr5	71869901	71956496	LOC102477328	86595	-	NR_105007	71956496	71956496	3
chr5	72112417	72210215	TNPO1	97798	+	NM_002270	72112564	72201237	25
chr5	72174417	72174490	MIR4804	73	+	NR_039968	72174490	72174490	1
chr5	72251807	72386349	FCHO2	134542	+	NM_138782	72251923	72383917	26
chr5	72416387	72427644	TMEM171	11257	+	NM_173490	72419200	72427557	4
chr5	72427834	72446419	LOC105379030	18585	-	NR_134252	72446419	72446419	2
chr5	72469022	72470970	TMEM174	1948	+	NM_153217	72469070	72469992	2
chr5	72491116	72497788	LOC340090	6672	-	NR_134291	72497788	72497788	3
chr5	72742084	72744352	FOXD1	2268	-	NM_004472	72742791	72744187	1
chr5	72750014	72768791	LINC01386	18777	-	NR_126410	72768791	72768791	5
chr5	72794249	72801448	BTF3	7199	+	NM_001037637	72794492	72801063	6
chr5	72848024	72861511	ANKRA2	13487	-	NM_023039	72848621	72858706	9
chr5	72861565	72879202	UTP15	17637	+	NM_001284430	72863169	72875919	13
chr5	72921982	73237818	ARHGEF28	315836	+	NM_001080479	72980676	73236838	37
chr5	73602234	73604150	LINC01335	1916	-	NR_105009	73604150	73604150	3
chr5	73618310	73624182	LINC01333	5872	+	NR_105010	73624182	73624182	3
chr5	73665200	73832801	LINC01331	167601	-	NR_126354	73832801	73832801	3
chr5	73923230	73937249	ENC1	14019	-	NM_001256575	73930540	73932310	4
chr5	73935847	74017113	HEXB	81266	+	NM_001292004	74001049	74017000	14
chr5	74017028	74063196	GFM2	46168	-	NM_001281302	74017479	74060931	22
chr5	74062815	74072737	NSA2	9922	+	NR_073403	74072737	74072737	7
chr5	74073398	74162663	FAM169A	89265	-	NM_015566	74077284	74137501	13
chr5	74161717	74163100	LOC441086	1383	+	NR_134288	74163100	74163100	1
chr5	74323288	74326724	GCNT4	3436	-	NM_016591	74324500	74325862	1
chr5	74343543	74348468	LINC01336	4925	-	NR_126375	74348468	74348468	2
chr5	74364121	74532703	ANKRD31	168582	-	NM_001164443	74364343	74532511	25
chr5	74632992	74657926	HMGCR	24934	+	NM_000859	74638430	74656167	20
chr5	74666927	74807806	COL4A3BP	140879	-	NM_001130105	74675170	74807669	19
chr5	74807656	74895646	POLK	87990	+	NM_016218	74842847	74893843	15
chr5	74907300	74967671	ANKDD1B	60371	+	NM_001276713	74907459	74966865	14
chr5	74970023	75013313	POC5	43290	-	NM_001099271	74970259	75008762	12
chr5	75379238	75649764	SV2C	270526	+	NM_001297716	75427575	75648985	13
chr5	75699079	76003957	IQGAP2	304878	+	NM_006633	75699370	76003138	36
chr5	75902435	75904794	LOC101929109	2359	-	NR_134278	75904794	75904794	2
chr5	75911306	75919259	F2RL2	7953	-	NM_004101	75913406	75919055	2
chr5	76008227	76008713	NCRUPAR	486	+	NR_028375	76008713	76008713	1
chr5	76011867	76031605	F2R	19738	+	NM_001311313	76028413	76029328	3
chr5	76114832	76131140	F2RL1	16308	+	NM_005242	76115007	76129626	2
chr5	76145825	76217056	S100Z	71231	+	NM_130772	76171184	76173657	5
chr5	76248679	76265299	CRHBP	16620	+	NM_001882	76248959	76264710	7
chr5	76326209	76361058	AGGF1	34849	+	NM_018046	76326591	76359077	14
chr5	76372531	76383030	ZBED3	10499	-	NM_032367	76372998	76373703	3
chr5	76376258	76376396	SNORA47	138	-	NR_003014	76376396	76376396	1
chr5	76382622	76444176	ZBED3-AS1	61554	+	NR_024398	76444176	76444176	4
chr5	76506705	76724080	PDE8B	217375	+	NM_003719	76506750	76722379	22
chr5	76726757	76788365	WDR41	61608	-	NM_018268	76728959	76788045	13
chr5	76924536	76934522	OTP	9986	-	NM_032109	76926088	76934374	3
chr5	76986993	77072185	TBCA	85192	-	NM_001297738	76988946	77072081	3
chr5	77180479	77254920	LOC101929154	74441	+	NR_105012	77254920	77254920	2
chr5	77298149	77590579	AP3B1	292430	-	NM_003664	77298725	77590403	27
chr5	77654587	77656365	SCAMP1-AS1	1778	-	NR_105014	77656365	77656365	2
chr5	77656326	77776562	SCAMP1	120236	+	NM_004866	77656495	77771491	9
chr5	77781037	77944648	LHFPL2	163611	-	NM_005779	77784719	77806036	5
chr5	78073036	78282357	ARSB	209321	-	NM_000046	78076219	78281071	8
chr5	78293386	78365497	DMGDH	72111	-	NM_013391	78293904	78365443	16
chr5	78365546	78385897	BHMT2	20351	+	NM_017614	78365605	78384397	8
chr5	78407603	78428113	BHMT	20510	+	NM_001713	78407708	78426939	8
chr5	78531924	78623038	JMY	91114	+	NM_152405	78532473	78612130	11
chr5	78669646	78809659	HOMER1	140013	-	NM_004272	78671831	78808597	9
chr5	78908242	78982471	PAPD4	74229	+	NM_173797	78915471	78981096	16
chr5	78985658	79096049	CMYA5	110391	+	NM_153610	78985730	79095439	13
chr5	79232401	79263449	LINC01455	31048	+	NR_131226	79263449	79263449	3
chr5	79272538	79287088	MTX3	14550	-	NM_001010891	79279609	79287061	8
chr5	79287118	79379107	THBS4	91989	+	NM_001306212	79336084	79378964	23
chr5	79362171	79379488	CTD-2201I18.1	17317	-	NR_109930	79379488	79379488	8
chr5	79407049	79551901	SERINC5	144852	-	NR_126061	79551901	79551901	14
chr5	79594916	79596297	LOC644936	1381	-	NR_004845	79596297	79596297	1
chr5	79615789	79617660	SPZ1	1871	+	NM_032567	79616034	79617327	1
chr5	79646423	79647785	CRSP8P	1362	-	NR_003665	79647785	79647785	1
chr5	79703831	79775688	ZFYVE16	71857	+	NM_001284236	79729966	79773196	19
chr5	79783799	79838382	FAM151B	54583	+	NM_205548	79783942	79837651	6
chr5	79852573	79866304	ANKRD34B	13731	-	NM_001004441	79854293	79855838	5
chr5	79904439	79918343	LINC01337	13904	-	NR_125754	79918343	79918343	2
chr5	79922044	79950800	DHFR	28756	-	NM_000791	79924905	79950308	6
chr5	79945818	79946854	MTRNR2L2	1036	-	NM_001190470	79945818	79945905	1
chr5	79950466	80172634	MSH3	222168	+	NM_002439	79950546	80171681	24
chr5	80243511	80256726	RASGRF2-AS1	13215	-	NR_105015	80256726	80256726	4
chr5	80256507	80525981	RASGRF2	269474	+	NM_006909	80256557	80521589	27
chr5	80501461	80746718	RNU5E-1	245257	+	NR_002754	80746718	80746718	2
chr5	80501462	80746718	RNU5D-1	245256	+	NR_002755	80746718	80746718	2
chr5	80529138	80562217	CKMT2	33079	+	NM_001825	80546951	80562077	11
chr5	80533383	80597388	CKMT2-AS1	64005	-	NR_034122	80597388	80597388	4
chr5	80597401	80608965	ZCCHC9	11564	+	NM_032280	80600576	80608481	6
chr5	80625946	80689988	ACOT12	64042	-	NM_130767	80626212	80689933	15
chr5	80713178	81047072	SSBP2	333894	-	NM_012446	80716322	81046861	17
chr5	81267843	81551216	ATG10	283373	+	NM_001131028	81283389	81549244	9
chr5	81569138	81574235	RPS23	5097	-	NM_001025	81571927	81574142	4
chr5	81575280	81614465	ATP6AP1L	39185	+	NM_001017971	81601220	81614119	10
chr5	82135973	82136043	MIR3977	70	+	NR_039773	82136043	82136043	1
chr5	82146683	82155655	LINC01338	8972	-	NR_105016	82155655	82155655	4
chr5	82348664	82373272	TMEM167A	24608	-	NM_174909	82352902	82373142	4
chr5	82360022	82360156	SCARNA18	134	-	NR_003139	82360156	82360156	1
chr5	82373227	82649579	XRCC4	276352	+	NM_001318012	82400738	82649061	8
chr5	82767492	82878122	VCAN	110630	+	NM_004385	82779337	82876253	15
chr5	82934016	83016896	HAPLN1	82880	-	NM_001884	82937314	82969342	5
chr5	83236413	83680685	EDIL3	444272	-	NM_005711	83239237	83680192	11
chr5	85578261	85593365	NBPF22P	15104	+	NR_003719	85593365	85593365	8
chr5	85913783	85916583	COX7C	2800	+	NM_001867	85913872	85915286	3
chr5	85916313	85916392	MIR3607	79	+	NR_037402	85916392	85916392	1
chr5	86042634	86045589	LOC100505878	2955	+	NR_105017	86045589	86045589	3
chr5	86410695	86410771	MIR4280	76	-	NR_036243	86410771	86410771	1
chr5	86415964	86543835	LOC101929380	127871	+	NR_105018	86543835	86543835	4
chr5	86511551	86535018	LOC55338	23467	-	NR_130914	86535018	86535018	3
chr5	86564069	86687743	RASA1	123674	+	NM_002890	86564268	86686700	25
chr5	86614231	86619445	LOC644285	5214	-	NR_130929	86619445	86619445	1
chr5	86690078	86708850	CCNH	18772	-	NM_001239	86690262	86708611	9
chr5	87485449	87564696	TMEM161B	79247	-	NM_001289007	87485868	87564540	13
chr5	87564698	87732491	TMEM161B-AS1	167793	+	NR_039993	87732491	87732491	4
chr5	87704798	87734907	LOC102546226	30109	-	NR_105021	87734907	87734907	6
chr5	87836596	87980620	LINC00461	144024	-	NR_015436	87980620	87980620	5
chr5	87962670	87962757	MIR9-2	87	-	NR_030741	87962757	87962757	1
chr5	88014057	88199922	MEF2C	185865	-	NM_001193347	88018420	88119605	12
chr5	88179146	88328193	MEF2C-AS1	149047	+	NR_109941	88328193	88328193	4
chr5	89312437	89312537	MIR3660	100	-	NR_037433	89312537	89312537	1
chr5	89454155	89585888	LINC01339	131733	-	NR_120601	89585888	89585888	6
chr5	89689151	89705603	CETN3	16452	-	NM_001297765	89689880	89705478	6
chr5	89705816	89706486	LOC731157	670	+	NR_105024	89706486	89706486	2
chr5	89754019	89770585	MBLAC2	16566	-	NM_203406	89756983	89770109	2
chr5	89770680	89810369	POLR3G	39689	+	NM_006467	89781384	89807956	8
chr5	89811444	89825401	LYSMD3	13957	-	NM_001286812	89815113	89821106	3
chr5	89854616	90460033	ADGRV1	605417	+	NR_003149	90460033	90460033	90
chr5	90598802	90610219	LUCAT1	11417	-	NR_103548	90610219	90610219	5
chr5	90664540	90679149	ARRDC3	14609	-	NM_020801	90667216	90678909	8
chr5	90676163	90716532	ARRDC3-AS1	40369	+	NR_027435	90716532	90716532	3
chr5	92745061	92917026	NR2F1-AS1	171965	-	NR_109821	92917026	92917026	7
chr5	92919042	92930315	NR2F1	11273	+	NM_005654	92920729	92929548	3
chr5	92922830	92957593	MIR548AO	34763	+	NR_049801	92957593	92957593	3
chr5	92953430	93447404	FAM172A	493974	-	NM_032042	92956692	93410456	11
chr5	92956401	92956494	MIR2277	93	-	NR_031754	92956494	92956494	1
chr5	93076014	93077309	POU5F2	1295	-	NM_153216	93076282	93077269	1
chr5	93486555	93954309	KIAA0825	467754	-	NM_001145678	93489711	93872831	21
chr5	93954390	94031573	SLF1	77183	+	NM_032290	93964515	94031017	21
chr5	94041241	94620279	MCTP1	579038	-	NM_024717	94043200	94620279	23
chr5	94727047	94786144	FAM81B	59097	+	NM_152548	94727093	94785986	10
chr5	94799598	94890709	TTC37	91111	-	NM_014639	94800310	94882854	43
chr5	94890824	94940806	ARSK	49982	+	NM_198150	94890982	94939230	8
chr5	94955979	94957284	GPR150	1305	+	NM_199243	94955979	94957284	1
chr5	94982480	94992849	RFESD	10369	+	NM_001131066	94987975	94992013	6
chr5	94987884	95018714	SPATA9	30830	-	NR_125327	95018714	95018714	9
chr5	95066849	95132071	RHOBTB3	65222	+	NM_014899	95067386	95128878	12
chr5	95149552	95158577	GLRX	9025	-	NM_001118890	95152216	95158366	3
chr5	95187935	95195836	LINC01554	7901	+	NR_026936	95195836	95195836	3
chr5	95220801	95297775	ELL2	76974	-	NM_012081	95224574	95297425	12
chr5	95297704	95966789	LOC101929710	669085	+	NR_130776	95966789	95966789	5
chr5	95414841	95414916	MIR583	75	+	NR_030309	95414916	95414916	1
chr5	95726039	95768985	PCSK1	42946	-	NM_000439	95728704	95768746	14
chr5	95997740	96110385	CAST	112645	+	NM_001190442	96058381	96107383	31
chr5	96096513	96143892	ERAP1	47379	-	NM_016442	96098903	96139629	20
chr5	96211643	96255406	ERAP2	43763	+	NM_022350	96215389	96253309	19
chr5	96271345	96365115	LNPEP	93770	+	NM_005575	96271859	96364237	18
chr5	96427573	96478520	LIX1	50947	-	NM_153234	96430451	96478280	6
chr5	96496570	96519005	RIOK2	22435	-	NM_018343	96498764	96518895	10
chr5	96840399	97006755	LINC01340	166356	+	NR_105028	97006755	97006755	4
chr5	98104998	98132198	RGMB	27200	+	NM_001012761	98106372	98129457	5
chr5	98105321	98108788	RGMB-AS1	3467	-	NR_033932	98108788	98108788	2
chr5	98190907	98262238	CHD1	71331	-	NM_001270	98192083	98262090	35
chr5	98264837	98266713	LOC100289230	1876	+	NR_036530	98266713	98266713	1
chr5	98869693	98913658	CTD-2151A2.1	43965	+	NR_110562	98913658	98913658	4
chr5	99715208	99723958	LOC100133050	8750	-	NR_027503	99723958	99723958	4
chr5	99871008	99922444	FAM174A	51436	+	NM_198507	99871234	99921888	3
chr5	100142638	100238989	ST8SIA4	96351	-	NM_005668	100147550	100238659	5
chr5	100152185	100152269	MIR548P	84	-	NR_031686	100152269	100152269	1
chr5	101569691	101632253	SLCO4C1	62562	-	NM_180991	101572561	101631966	13
chr5	101707485	101834720	SLCO6A1	127235	-	NM_173488	101709055	101834548	14
chr5	101917071	101953291	LINC00492	36220	+	NR_047462	101953291	101953291	2
chr5	101944195	102007168	LINC00491	62973	-	NR_103754	102007168	102007168	4
chr5	102201526	102366808	PAM	165282	+	NM_000919	102201899	102364769	25
chr5	102421703	102455842	GIN1	34139	-	NM_017676	102423601	102444411	8
chr5	102455957	102539224	PPIP5K2	83267	+	NM_001281471	102465293	102537335	33
chr5	102594402	102614361	C5orf30	19959	+	NM_033211	102611620	102612241	3
chr5	102864134	102877686	LOC102467212	13552	-	NR_104670	102877686	102877686	5
chr5	102884555	102898502	NUDT12	13947	-	NM_031438	102886561	102895949	7
chr5	104435174	104435799	RAB9BP1	625	+	NR_000039	104435799	104435799	1
chr5	106150897	106346715	LOC102467213	195818	-	NR_104671	106346715	106346715	4
chr5	106712589	107006596	EFNA5	294007	-	NM_001962	106716955	107006314	5
chr5	107194733	107717799	FBXL17	523066	-	NM_001163315	107197420	107717392	9
chr5	108063525	108063962	LINC01023	437	-	NR_046368	108063962	108063962	1
chr5	108083522	108532541	FER	449019	+	NM_005246	108133883	108523276	20
chr5	108670409	108745675	PJA2	75266	-	NM_014819	108672931	108719134	10
chr5	109025066	109205326	MAN2A1	180260	+	NM_002372	109026118	109202699	22
chr5	109218882	109221200	LOC100289673	2318	+	NR_033175	109221200	109221200	3
chr5	109755197	110062450	TMEM232	307253	-	NM_001039763	109756280	110003053	14
chr5	110073836	110100861	SLC25A46	27025	+	NM_001303250	110073938	110097482	8
chr5	110405777	110413722	TSLP	7945	+	NR_045089	110413722	110413722	5
chr5	110427869	110466200	WDR36	38331	+	NM_139281	110427986	110462581	23
chr5	110559946	110820748	CAMK4	260802	+	NM_001744	110560181	110820164	11
chr5	110831731	110848295	STARD4	16564	-	NM_001308059	110835583	110837695	7
chr5	110847923	111075423	STARD4-AS1	227500	+	NR_040093	111075423	111075423	7
chr5	111064999	111312628	NREP	247629	-	NM_001142474	111066617	111312436	4
chr5	111248204	111353003	NREP-AS1	104799	+	NR_046678	111353003	111353003	4
chr5	111496222	111498198	EPB41L4A-AS1	1976	+	NR_015370	111498198	111498198	3
chr5	111497181	111497314	SNORA13	133	+	NR_002922	111497314	111497314	1
chr5	111498314	111755010	EPB41L4A	256696	-	NM_022140	111500686	111754736	23
chr5	111563979	111593006	LOC101927023	29027	+	NR_110559	111593006	111593006	4
chr5	111755279	111756677	EPB41L4A-AS2	1398	+	NR_027706	111756677	111756677	1
chr5	111964132	111966618	LOC102467214	2486	+	NR_104672	111966618	111966618	3
chr5	111992124	112018585	LOC102467216	26461	-	NR_104673	112018585	112018585	3
chr5	112043201	112181936	APC	138735	+	NM_001127511	112043414	112179823	14
chr5	112196884	112228776	SRP19	31892	+	NM_001204199	112197073	112227304	5
chr5	112212080	112258031	REEP5	45951	-	NM_005669	112214482	112257887	5
chr5	112312406	112357892	DCP2	45486	+	NM_152624	112312630	112349181	11
chr5	112357795	112824527	MCC	466732	-	NM_001085377	112362998	112824111	19
chr5	112768250	112770728	TSSK1B	2478	-	NM_032028	112769432	112770536	1
chr5	112849390	112930984	YTHDC2	81594	+	NM_022828	112849592	112929080	30
chr5	113698015	113832197	KCNN2	134182	+	NM_021614	113698472	113831879	8
chr5	113783114	114109110	LOC101927078	325996	-	NR_130785	114109110	114109110	13
chr5	113911737	113915667	LOC101927059	3930	+	NR_134282	113915667	113915667	2
chr5	114460458	114516243	TRIM36	55785	-	NM_018700	114462199	114515734	10
chr5	114546526	114598569	PGGT1B	52043	-	NM_005023	114548098	114598548	9
chr5	114602884	114632458	CCDC112	29574	-	NM_001040440	114603572	114632240	10
chr5	114856607	114880591	FEM1C	23984	-	NM_020177	114860004	114879190	3
chr5	114914192	114938176	TICAM2	23984	-	NM_021649	114916245	114916953	2
chr5	114914192	114961876	TMED7-TICAM2	47684	-	NM_001164469	114917011	114961489	4
chr5	114937851	114956116	LOC101927100	18265	+	NR_109874	114956116	114956116	4
chr5	114948904	114961876	TMED7	12972	-	NM_181836	114951905	114961489	3
chr5	114977821	115008349	LOC102467217	30528	-	NR_104674	115008349	115008349	5
chr5	115140429	115152405	CDO1	11976	-	NM_001801	115141129	115152094	5
chr5	115163893	115177548	ATG12	13655	-	NR_073603	115177548	115177548	6
chr5	115177618	115249778	AP3S1	72160	+	NM_001284	115177734	115249187	6
chr5	115298150	115363299	LVRN	65149	+	NM_173800	115298314	115361815	20
chr5	115387162	115394827	ARL14EPL	7665	+	NM_001195581	115387162	115394644	3
chr5	115420672	115628987	COMMD10	208315	+	NM_016144	115420749	115628186	7
chr5	115703112	115710267	LOC101927190	7155	-	NR_104675	115710267	115710267	3
chr5	115779250	115910622	SEMA6A	131372	-	NM_001300780	115782308	115840640	20
chr5	115783193	115807369	SEMA6A-AS1	24176	+	NR_109879	115807369	115807369	3
chr5	116078997	116097905	LOC102467223	18908	-	NR_104678	116097905	116097905	4
chr5	116751207	116915439	LINC00992	164232	+	NR_046089	116915439	116915439	6
chr5	117066055	117601757	LOC102467224	535702	+	NR_104997	117601757	117601757	3
chr5	117618268	117620472	HNCAT21	2204	+	NR_104609	117620472	117620472	2
chr5	117686666	117897812	HRAT56	211146	-	NR_104610	117897812	117897812	10
chr5	117931882	117963787	LOC102467225	31905	+	NR_104998	117963787	117963787	5
chr5	118171768	118324300	DTWD2	152532	-	NM_173666	118176611	118324206	6
chr5	118347497	118406585	LOC105379143	59088	-	NR_134250	118406585	118406585	3
chr5	118406781	118584824	DMXL1	178043	+	NM_001290321	118407264	118582914	44
chr5	118490331	118490411	MIR5706	80	+	NR_049892	118490411	118490411	1
chr5	118604386	118730299	TNFAIP8	125913	+	NM_001286815	118728575	118729076	3
chr5	118788137	118878030	HSD17B4	89893	+	NM_001292027	118807355	118877689	25
chr5	118965253	118971517	FAM170A	6264	+	NM_182761	118965463	118970729	5
chr5	119799972	120023025	PRR16	223053	+	NM_016644	119816898	120022404	3
chr5	120658244	120661532	LOC102467226	3288	+	NR_104999	120661532	120661532	3
chr5	121187649	121188523	FTMT	874	+	NM_177478	121187658	121188387	1
chr5	121297655	121364295	SRFBP1	66640	+	NM_152546	121297727	121362821	8
chr5	121398889	121414196	LOX	15307	-	NM_002317	121402437	121413680	7
chr5	121465207	121489266	ZNF474	24059	+	NM_207317	121487685	121488780	2
chr5	121495870	121518358	LOC100505841	22488	+	NM_001195535	121495924	121518337	3
chr5	121647385	121799914	SNCAIP	152529	+	NR_131762	121799914	121799914	10
chr5	121772191	121814782	MGC32805	42591	-	NR_051996	121814782	121814782	6
chr5	121917193	121920295	LOC101927357	3102	-	NR_134281	121920295	121920295	2
chr5	121964646	122066255	LOC101927379	101609	-	NR_109881	122066255	122066255	12
chr5	122110690	122170234	SNX2	59544	+	NM_003100	122110798	122165343	15
chr5	122181159	122344902	SNX24	163743	+	NM_014035	122181328	122343444	7
chr5	122359077	122372425	PPIC	13348	-	NM_000943	122359569	122372320	5
chr5	122424840	122523745	PRDM6	98905	+	NM_001136239	122425709	122522895	8
chr5	122680578	122759286	CEP120	78708	-	NM_153223	122682212	122758692	21
chr5	122847792	122952738	CSNK1G3	104946	+	NM_001031812	122881357	122950090	13
chr5	123395486	123774213	LINC01170	378727	-	NR_125774	123774213	123774213	6
chr5	123972609	124080805	ZNF608	108196	-	NM_020747	123973592	124080682	9
chr5	124372523	124703427	LOC101927421	330904	+	NR_109882	124703427	124703427	6
chr5	124828953	124937920	LOC101927460	108967	+	NR_109887	124937920	124937920	4
chr5	125515269	125529543	LOC102546228	14274	+	NR_105042	125529543	125529543	4
chr5	125608209	125620867	LOC101927488	12658	-	NR_105039	125620867	125620867	3
chr5	125695787	125829853	GRAMD3	134066	+	NM_001146319	125696023	125828648	14
chr5	125877532	125931082	ALDH7A1	53550	-	NM_001201377	125880656	125930806	18
chr5	125936606	125962944	PHAX	26338	+	NM_032177	125936654	125960536	5
chr5	125967413	125971974	TEX43	4561	+	NM_207408	125967426	125971933	3
chr5	126112314	126172712	LMNB1	60398	+	NM_005573	126113200	126171956	11
chr5	126203405	126366500	MARCH3	163095	-	NM_178450	126206324	126253863	5
chr5	126378249	126409184	C5orf63	30935	-	NM_001164479	126383361	126394687	5
chr5	126626455	126796910	MEGF10	170455	+	NM_032446	126667000	126793010	26
chr5	126853300	126890780	PRRC1	37480	+	NM_001286808	126859171	126889577	10
chr5	126984712	126994322	CTXN3	9610	+	NM_001048252	126993213	126993459	3
chr5	127039080	127277208	LINC01183	238128	+	NM_001317938	127039080	127277160	7
chr5	127357243	127418766	LINC01184	61523	-	NR_015360	127418766	127418766	3
chr5	127419482	127525380	SLC12A2	105898	+	NR_046207	127525380	127525380	27
chr5	127593600	127873735	FBN2	280135	-	NM_001999	127595146	127873296	65
chr5	128300819	128369335	SLC27A6	68516	+	NM_001317984	128301830	128368975	11
chr5	128430441	128449719	ISOC1	19278	+	NM_016048	128430459	128448694	5
chr5	128433380	128433459	MIR4633	79	+	NR_039776	128433459	128433459	1
chr5	128732754	128732840	MIR4460	86	-	NR_039665	128732840	128732840	1
chr5	128795251	128796382	ADAMTS19-AS1	1131	-	NR_125748	128796382	128796382	2
chr5	128796102	129074376	ADAMTS19	278274	+	NM_133638	128796102	129072911	23
chr5	129083883	129100756	KIAA1024L	16873	+	NM_001257308	129083883	129100756	3
chr5	129240522	129522327	CHSY3	281805	+	NM_175856	129240522	129521484	3
chr5	130494975	130501041	HINT1	6066	-	NR_073488	130501041	130501041	5
chr5	130506606	130541119	LYRM7	34513	+	NM_181705	130506713	130535294	5
chr5	130599701	130730382	CDC42SE2	130681	+	NM_020240	130695186	130726784	6
chr5	130759613	130970929	RAPGEF6	211316	-	NM_001164386	130762958	130970723	29
chr5	130977406	131132756	FNIP1	155350	-	NM_133372	130980377	131132614	18
chr5	131142683	131281391	MEIKIN	138708	-	NM_001303622	131142928	131281198	13
chr5	131285666	131347761	ACSL6	62095	-	NM_001205250	131289926	131347613	21
chr5	131396346	131398896	IL3	2550	+	NM_000588	131396399	131398484	5
chr5	131409484	131411863	CSF2	2379	+	NM_000758	131409516	131411545	4
chr5	131520568	131528498	P4HA2-AS1	7930	+	NR_047470	131528498	131528498	3
chr5	131528303	131563556	P4HA2	35253	-	NM_001142599	131528702	131554319	16
chr5	131553541	131553611	MIR6830	70	-	NR_106888	131553611	131553611	1
chr5	131593350	131609147	PDLIM4	15797	+	NM_003687	131593427	131607922	7
chr5	131630144	131679899	SLC22A4	49755	+	NM_003059	131630309	131679528	10
chr5	131646968	131705608	LOC553103	58640	-	NR_110997	131705608	131705608	8
chr5	131701181	131701291	MIR3936	110	-	NR_037500	131701291	131701291	1
chr5	131705400	131731306	SLC22A5	25906	+	NM_001308122	131705664	131729964	11
chr5	131746464	131811736	C5orf56	65272	+	NR_045116	131811736	131811736	4
chr5	131817300	131826465	IRF1	9165	-	NM_002198	131819642	131825170	10
chr5	131877135	131879214	IL5	2079	-	NM_000879	131877502	131879170	4
chr5	131892615	131980313	RAD50	87698	+	NM_005732	131893016	131978056	25
chr5	131973739	131991846	TH2LCRR	18107	-	NR_132125	131991846	131991846	3
chr5	131993864	131996801	IL13	2937	+	NM_002188	131993878	131995974	4
chr5	132009677	132018370	IL4	8693	+	NM_000589	132009742	132018279	4
chr5	132014776	132018321	LOC105379176	3545	-	NR_134248	132018321	132018321	2
chr5	132028318	132073270	KIF3A	44952	-	NM_001300791	132032325	132073111	19
chr5	132083136	132090095	CCNI2	6959	+	NM_001287253	132083187	132088662	6
chr5	132086508	132113067	SEPT8	26559	-	NM_001098811	132087707	132112829	10
chr5	132149015	132152489	SOWAHA	3474	+	NM_175873	132149313	132150963	1
chr5	132157832	132166590	SHROOM1	8758	-	NM_001172700	132158487	132161832	10
chr5	132196873	132202576	GDF9	5703	-	NM_001288825	132197280	132199961	4
chr5	132202318	132204536	UQCRQ	2218	+	NM_014402	132202573	132203274	3
chr5	132209357	132210582	LEAP2	1225	+	NM_052971	132209386	132210138	3
chr5	132211070	132299354	AFF4	88284	-	NM_014423	132216750	132272881	21
chr5	132332676	132362296	ZCCHC10	29620	-	NM_001300816	132334274	132362229	5
chr5	132387661	132440709	HSPA4	53048	+	NM_002154	132387942	132440128	19
chr5	132532151	132948223	FSTL4	416072	-	NM_015082	132534786	132939674	16
chr5	132763287	132763398	MIR1289-2	111	-	NR_031621	132763398	132763398	1
chr5	133249367	133252960	WSPAR	3593	+	NR_131252	133252960	133252960	3
chr5	133291197	133304406	C5orf15	13209	-	NM_020199	133292549	133304275	3
chr5	133304379	133305914	LOC105379183	1535	+	NR_134247	133305914	133305914	2
chr5	133307565	133340824	VDAC1	33259	-	NM_003374	133308461	133328703	9
chr5	133450401	133483920	TCF7	33519	+	NM_003202	133450597	133481994	10
chr5	133492081	133512724	SKP1	20643	-	NM_170679	133493423	133509713	6
chr5	133532147	133561950	PPP2CA	29803	-	NM_002715	133533462	133561552	7
chr5	133561447	133561543	MIR3661	96	+	NR_037434	133561543	133561543	1
chr5	133634114	133706738	CDKL3	72624	-	NM_001300853	133635387	133657566	13
chr5	133706866	133727799	UBE2B	20933	+	NM_003337	133707286	133726044	6
chr5	133737755	133747598	CDKN2AIPNL	9843	-	NM_080656	133738605	133747545	3
chr5	133764741	133770738	LOC102546229	5997	-	NR_105044	133770738	133770738	3
chr5	133842242	133844921	LOC101927934	2679	+	NR_105045	133844921	133844921	2
chr5	133860065	133918920	JADE2	58855	+	NM_001308143	133871547	133915007	12
chr5	133936838	133968533	SAR1B	31695	-	NM_001033503	133942639	133959709	8
chr5	133984474	134063601	SEC24A	79127	+	NM_021982	133984766	134060784	23
chr5	134074169	134087850	CAMLG	13681	+	NM_001745	134074310	134086640	4
chr5	134094423	134166826	DDX46	72403	+	NM_014829	134094628	134164396	23
chr5	134181369	134195425	C5orf24	14056	+	NM_152409	134190590	134191157	2
chr5	134209459	134237323	TXNDC15	27864	+	NM_024715	134210117	134235375	5
chr5	134240809	134298336	PCBD2	57527	+	NM_032151	134240829	134296371	4
chr5	134263728	134263802	MIR4461	74	+	NR_039666	134263802	134263802	1
chr5	134303595	134347397	CATSPER3	43802	+	NM_178019	134303681	134347313	8
chr5	134363423	134369964	PITX1	6541	-	NM_002653	134364468	134369571	3
chr5	134368969	134680370	C5orf66	311401	+	NM_001277348	134669808	134679156	6
chr5	134374520	134375737	C5orf66-AS1	1217	-	NR_105049	134375737	134375737	2
chr5	134571923	134583867	C5orf66-AS2	11944	-	NR_037895	134583867	134583867	4
chr5	134670070	134735577	H2AFY	65507	-	NM_004893	134670665	134724783	9
chr5	134779903	134783038	DCANP1	3135	-	NM_130848	134782063	134782798	1
chr5	134784557	134788089	TIFAB	3532	-	NM_001099221	134785143	134785629	2
chr5	134869971	134871639	NEUROG1	1668	-	NM_006161	134870666	134871380	1
chr5	134906370	134914969	CXCL14	8599	-	NM_004887	134907542	134914504	4
chr5	134984371	134989624	LOC340074	5253	-	NR_027127	134989624	134989624	3
chr5	135170364	135224326	SLC25A48	53962	+	NM_145282	135170536	135223773	5
chr5	135227934	135231516	IL9	3582	-	NM_000590	135228079	135231505	5
chr5	135266005	135277367	FBXL21	11362	+	NR_132347	135277367	135277367	8
chr5	135282599	135290723	LECT2	8124	-	NM_002302	135283019	135290522	4
chr5	135364583	135399507	TGFBI	34924	+	NM_000358	135364744	135398915	17
chr5	135416179	135416287	VTRNA2-1	108	-	NR_030583	135416287	135416287	1
chr5	135465202	135470579	SMAD5-AS1	5377	-	NR_026763	135470579	135470579	2
chr5	135468533	135518422	SMAD5	49889	+	NM_001001419	135489449	135513168	9
chr5	135527155	135528851	LOC389332	1696	-	NR_024418	135528851	135528851	1
chr5	135548998	135701164	TRPC7	152166	-	NM_020389	135549122	135700942	12
chr5	135562342	135651788	TRPC7-AS2	89446	+	NR_133682	135651788	135651788	4
chr5	136310986	136835018	SPOCK1	524032	-	NM_004598	136314342	136834247	11
chr5	136463885	136466658	LOC105379192	2773	+	NR_134246	136466658	136466658	2
chr5	136953188	137071779	KLHL3	118591	-	NM_017415	136957786	137071335	15
chr5	136983260	136983338	MIR874	78	-	NR_030588	136983338	136983338	1
chr5	137087072	137090039	HNRNPA0	2967	-	NM_006805	137088837	137089755	1
chr5	137136881	137146439	NPY6R	9558	+	NR_002713	137146439	137146439	2
chr5	137203544	137223540	MYOT	19996	+	NM_001300911	137206685	137223074	11
chr5	137225124	137278434	PKD2L2	53310	+	NM_001300921	137225180	137272099	15
chr5	137273606	137368802	FAM13B	95196	-	NM_016603	137275913	137354800	23
chr5	137368462	137374622	LOC100130172	6160	+	NR_037900	137374622	137374622	2
chr5	137419580	137428054	WNT8A	8474	+	NR_125351	137428054	137428054	8
chr5	137450860	137475132	NME5	24272	-	NM_003551	137451369	137474469	6
chr5	137475458	137514358	BRD8	38900	-	NM_139199	137475762	137514303	27
chr5	137514416	137523404	KIF20A	8988	+	NM_005733	137515369	137523102	19
chr5	137523336	137549032	CDC23	25696	-	NM_004661	137524666	137549001	16
chr5	137588068	137610253	GFRA3	22185	-	NM_001496	137588656	137610113	8
chr5	137620953	137674044	CDC25C	53091	-	NM_001287583	137621380	137673844	14
chr5	137673223	137685418	FAM53C	12195	+	NM_001135647	137677024	137682648	5
chr5	137688284	137772716	KDM3B	84432	+	NM_016604	137688484	137771389	24
chr5	137774689	137782658	REEP2	7969	+	NR_073449	137782658	137782658	8
chr5	137801180	137805004	EGR1	3824	+	NM_001964	137801450	137803770	2
chr5	137841781	137878989	ETF1	37208	-	NM_001291975	137843993	137854543	12
chr5	137890570	137911318	HSPA9	20748	-	NM_004134	137891725	137911007	17
chr5	137896731	137896799	SNORD63	68	-	NR_002913	137896799	137896799	1
chr5	138080118	138089613	LOC105379194	9495	-	NR_134244	138089613	138089613	2
chr5	138089084	138270723	CTNNA1	181639	+	NM_001290307	138117613	138269512	19
chr5	138205078	138211057	LRRTM2	5979	-	NM_015564	138208698	138210600	2
chr5	138282409	138534065	SIL1	251656	-	NM_001037633	138282805	138463532	11
chr5	138609440	138618873	SNHG4	9433	+	NR_036536	138618873	138618873	5
chr5	138609440	138667366	MATR3	57926	+	NM_199189	138643104	138665084	18
chr5	138614468	138614668	SNORA74A	200	+	NR_002915	138614668	138614668	1
chr5	138677520	138705409	PAIP2	27889	+	NM_016480	138699473	138704487	4
chr5	138702884	138719039	SLC23A1	16155	-	NM_005847	138707694	138718942	15
chr5	138723256	138725605	MZB1	2349	-	NM_016459	138723453	138725545	4
chr5	138727634	138730885	PROB1	3251	-	NM_001161546	138727722	138730770	1
chr5	138732455	138739776	SPATA24	7321	-	NM_194296	138732488	138739749	6
chr5	138745891	138775214	DNAJC18	29323	-	NM_152686	138749836	138775134	8
chr5	138784242	138842328	ECSCR	58086	-	NM_001293739	138784453	138842255	6
chr5	138855112	138862375	TMEM173	7263	-	NM_198282	138855845	138861289	8
chr5	138940750	139008018	UBE2D2	67268	+	NM_181838	138980019	139006386	8
chr5	139026883	139063470	CXXC5	36587	+	NM_001317201	139060108	139062492	3
chr5	139120931	139125808	LOC101929696	4877	-	NR_105053	139125808	139125808	3
chr5	139175405	139224048	PSD2	48643	+	NM_032289	139189025	139222059	15
chr5	139226363	139422884	NRG2	196521	-	NM_013983	139227501	139422654	11
chr5	139482506	139487597	LINC01024	5091	-	NR_102741	139487597	139487597	4
chr5	139493707	139499001	PURA	5294	+	NM_005859	139493766	139494735	1
chr5	139505520	139508391	IGIP	2871	+	NM_001007189	139508061	139508223	1
chr5	139536903	139548370	LOC101929719	11467	+	NR_130738	139548370	139548370	5
chr5	139554652	139623374	CYSTM1	68722	+	NM_032412	139574050	139622996	3
chr5	139624634	139682689	PFDN1	58055	-	NM_002622	139625558	139682658	4
chr5	139712427	139726188	HBEGF	13761	-	NM_001945	139714260	139725913	6
chr5	139739786	139754722	SLC4A9	14936	+	NM_001258426	139739821	139752383	22
chr5	139781398	139919441	ANKHD1	138043	+	NM_017747	139781552	139919003	34
chr5	139781398	139929163	ANKHD1-EIF4EBP3	147765	+	NM_020690	139781552	139928822	36
chr5	139927250	139929163	EIF4EBP3	1913	+	NM_003732	139927322	139928847	3
chr5	139929651	139937678	SRA1	8027	-	NM_001035235	139930284	139937073	5
chr5	139937852	139944189	APBB3	6337	-	NM_133174	139938169	139943830	12
chr5	139943255	139943336	MIR6831	81	-	NR_106889	139943336	139943336	1
chr5	139944149	139948689	SLC35A4	4540	+	NM_080670	139946754	139947729	3
chr5	140011312	140013286	CD14	1974	-	NM_001174104	140011440	140012656	3
chr5	140019011	140024993	TMCO6	5982	+	NM_001300980	140019112	140024683	12
chr5	140024947	140027370	NDUFA2	2423	-	NM_001185012	140025287	140027168	3
chr5	140027383	140042065	IK	14682	+	NM_006083	140027493	140041914	20
chr5	140027428	140027511	MIR3655	83	+	NR_037428	140027511	140027511	1
chr5	140044383	140050553	WDR55	6170	+	NM_017706	140044497	140049239	7
chr5	140050380	140053171	DND1	2791	-	NM_194249	140050877	140053127	4
chr5	140053488	140071312	HARS	17824	-	NM_002109	140053841	140070889	13
chr5	140071010	140078903	HARS2	7893	+	NM_012208	140071233	140078137	13
chr5	140079944	140086266	ZMAT2	6322	+	NM_144723	140080045	140085341	6
chr5	140090860	140090958	VTRNA1-1	98	+	NR_026703	140090958	140090958	1
chr5	140098510	140098598	VTRNA1-2	88	+	NR_026704	140098598	140098598	1
chr5	140105743	140105831	VTRNA1-3	88	+	NR_026705	140105831	140105831	1
chr5	140165720	140391929	PCDHA1	226209	+	NM_031411	140165875	140389522	4
chr5	140174443	140391929	PCDHA2	217486	+	NM_018905	140174549	140389522	4
chr5	140180782	140391929	PCDHA3	211147	+	NM_018906	140180782	140389522	4
chr5	140186658	140391929	PCDHA4	205271	+	NM_018907	140186772	140389522	4
chr5	140201360	140391929	PCDHA5	190569	+	NM_018908	140201360	140389522	4
chr5	140207506	140391929	PCDHA6	184423	+	NM_031849	140207676	140389522	4
chr5	140213968	140391929	PCDHA7	177961	+	NM_018910	140213968	140389522	4
chr5	140220906	140391929	PCDHA8	171023	+	NM_018911	140220906	140389522	4
chr5	140227356	140391929	PCDHA9	164573	+	NM_031857	140228080	140389522	4
chr5	140235467	140391929	PCDHA10	156462	+	NM_018901	140235633	140389522	4
chr5	140247097	140391929	PCDHA11	144832	+	NM_018902	140248688	140389522	4
chr5	140254886	140391929	PCDHA12	137043	+	NM_018903	140255057	140389522	4
chr5	140261853	140391929	PCDHA13	130076	+	NM_018904	140261853	140389522	4
chr5	140306301	140391929	PCDHAC1	85628	+	NM_018898	140306477	140389522	4
chr5	140345746	140391929	PCDHAC2	46183	+	NM_018899	140346351	140389522	4
chr5	140425789	140457609	LOC101926905	31820	-	NR_105056	140457609	140457609	4
chr5	140430960	140433547	PCDHB1	2587	+	NM_013340	140431055	140433512	1
chr5	140474190	140476964	PCDHB2	2774	+	NM_018936	140474374	140476771	1
chr5	140479825	140483407	PCDHB3	3582	+	NM_018937	140480233	140482624	1
chr5	140501331	140505203	PCDHB4	3872	+	NM_018938	140501580	140503968	1
chr5	140514787	140517709	PCDHB5	2922	+	NM_015669	140515016	140517404	1
chr5	140529602	140532868	PCDHB6	3266	+	NM_001303145	140530246	140532223	2
chr5	140535579	140537990	PCDHB17P	2411	+	NR_001280	140537990	140537990	1
chr5	140552201	140555957	PCDHB7	3756	+	NM_018940	140552416	140554798	1
chr5	140557370	140560081	PCDHB8	2711	+	NM_019120	140557615	140560021	1
chr5	140561264	140565796	PCDHB16	4532	+	NM_020957	140562134	140564465	1
chr5	140566700	140571111	PCDHB9	4411	+	NM_019119	140566892	140569285	1
chr5	140571951	140575213	PCDHB10	3262	+	NM_018930	140572125	140574528	1
chr5	140579347	140582618	PCDHB11	3271	+	NM_018931	140579347	140581741	1
chr5	140588290	140591698	PCDHB12	3408	+	NM_018932	140588479	140590867	1
chr5	140593490	140596993	PCDHB13	3503	+	NM_018933	140593695	140596092	1
chr5	140601897	140605860	PCDHB14	3963	+	NM_018934	140603077	140605474	1
chr5	140613904	140617101	PCDHB18P	3197	+	NR_001281	140617101	140617101	1
chr5	140619688	140624312	PCDHB19P	4624	+	NR_001282	140624312	140624312	1
chr5	140624916	140627801	PCDHB15	2885	+	NM_018935	140625146	140627510	1
chr5	140682195	140683630	SLC25A2	1435	-	NM_031947	140682526	140683432	1
chr5	140698056	140700351	TAF7	2295	-	NM_005642	140698561	140699611	1
chr5	140710251	140892546	PCDHGA1	182295	+	NM_018912	140710251	140890740	4
chr5	140718326	140892546	PCDHGA2	174220	+	NM_018915	140718538	140890740	4
chr5	140723600	140892546	PCDHGA3	168946	+	NM_018916	140723600	140890740	4
chr5	140729827	140892546	PCDHGB1	162719	+	NM_018922	140729827	140890740	4
chr5	140734591	140892546	PCDHGA4	157955	+	NM_018917	140734674	140890740	4
chr5	140739702	140892546	PCDHGB2	152844	+	NM_018923	140739702	140890740	4
chr5	140743897	140892546	PCDHGA5	148649	+	NM_018918	140743897	140890740	4
chr5	140749830	140892546	PCDHGB3	142716	+	NM_018924	140749961	140890740	4
chr5	140753650	140892546	PCDHGA6	138896	+	NM_018919	140753650	140890740	4
chr5	140762305	140892546	PCDHGA7	130241	+	NM_018920	140762466	140890740	4
chr5	140767451	140892546	PCDHGB4	125095	+	NM_003736	140767451	140890740	4
chr5	140771482	140892546	PCDHGA8	121064	+	NM_032088	140772380	140890740	4
chr5	140777694	140892546	PCDHGB5	114852	+	NM_018925	140777694	140890740	4
chr5	140782519	140892546	PCDHGA9	110027	+	NM_018921	140782519	140890740	4
chr5	140787769	140892546	PCDHGB6	104777	+	NM_018926	140787769	140890740	4
chr5	140792742	140892546	PCDHGA10	99804	+	NM_018913	140792742	140890740	4
chr5	140797259	140892548	PCDHGB7	95289	+	NM_018927	140797426	140890740	4
chr5	140800536	140892546	PCDHGA11	92010	+	NM_032092	140800794	140890740	4
chr5	140805852	140807825	PCDHGB8P	1973	+	NR_001297	140807825	140807825	1
chr5	140810157	140892546	PCDHGA12	82389	+	NM_003735	140810326	140890740	4
chr5	140855568	140892544	PCDHGC3	36976	+	NM_002588	140855683	140890740	4
chr5	140864740	140892546	PCDHGC4	27806	+	NM_018928	140864740	140890740	4
chr5	140868807	140892546	PCDHGC5	23739	+	NM_018929	140868807	140890740	4
chr5	140894587	140998622	DIAPH1	104035	-	NM_001314007	140896536	140998481	29
chr5	140937877	140944827	LOC100505658	6950	+	NR_038333	140944827	140944827	3
chr5	141000442	141016423	HDAC3	15981	-	NM_003883	141001034	141016357	15
chr5	141016516	141020631	RELL2	4115	+	NM_001130029	141017792	141020011	8
chr5	141018868	141030986	FCHSD1	12118	-	NM_033449	141021064	141030935	20
chr5	141032967	141061800	ARAP3	28833	-	NM_022481	141033516	141060053	33
chr5	141232675	141257975	PCDH1	25300	-	NM_032420	141233606	141257827	5
chr5	141275190	141276260	LOC729080	1070	-	NR_033244	141276260	141276260	1
chr5	141303384	141321612	KIAA0141	18228	+	NM_001142603	141303506	141318324	13
chr5	141323149	141338627	PCDH12	15478	-	NM_016580	141324945	141337416	4
chr5	141346401	141369856	RNF14	23455	+	NM_001201365	141353153	141367355	9
chr5	141380233	141392620	GNPDA1	12387	-	NM_005471	141381593	141391600	7
chr5	141488323	141534008	NDFIP1	45685	+	NM_030571	141488539	141524239	8
chr5	141689991	141704620	SPRY4	14629	-	NM_030964	141693773	141699330	3
chr5	141697198	141697887	SPRY4-IT1	689	-	NR_131221	141697887	141697887	1
chr5	141704857	141843619	LOC101926941	138762	+	NR_120664	141843619	141843619	4
chr5	141971742	142077635	FGF1	105893	-	NM_001144934	141974854	141993692	5
chr5	142125164	142140558	LOC101926975	15394	+	NR_110558	142140558	142140558	4
chr5	142150291	142608572	ARHGAP26	458281	+	NM_001135608	142150326	142602011	23
chr5	142239169	142248475	ARHGAP26-AS1	9306	-	NR_046680	142248475	142248475	6
chr5	142572064	142573731	ARHGAP26-IT1	1667	+	NR_046816	142573731	142573731	2
chr5	142657495	142815077	NR3C1	157582	-	NM_001018075	142661453	142780404	9
chr5	143059424	143059536	MIR5197	112	+	NR_049829	143059536	143059536	1
chr5	143191725	143200284	HMHB1	8559	+	NM_021182	143191832	143200133	2
chr5	143537722	143550278	YIPF5	12556	-	NM_030799	143539960	143549519	6
chr5	143550436	143856944	KCTD16	306508	+	NM_020768	143586277	143853677	4
chr5	145135906	145214932	PRELID2	79026	-	NM_138492	145144503	145202685	8
chr5	145239295	145252531	GRXCR2	13236	-	NM_001080516	145239295	145252531	3
chr5	145316125	145442879	SH3RF2	126754	+	NM_152550	145317491	145442264	10
chr5	145463875	145483946	PLAC8L1	20071	-	NM_001029869	145463994	145483874	4
chr5	145492588	145562350	LARS	69762	-	NM_020117	145493668	145562056	32
chr5	145583162	145668784	RBM27	85622	+	NM_018989	145583328	145665593	21
chr5	145718586	145720083	POU4F3	1497	+	NM_002700	145718675	145720007	2
chr5	145826872	145891069	TCERG1	64197	+	NM_006706	145826912	145890205	22
chr5	145894416	145895676	GPR151	1260	-	NM_194251	145894416	145895676	1
chr5	145969066	146461083	PPP2R2B	492017	-	NM_001271900	145969509	146460671	11
chr5	146293769	146299069	PPP2R2B-IT1	5300	-	NR_047115	146299069	146299069	4
chr5	146614578	146767418	STK32A	152840	+	NM_001287740	146619197	146763999	14
chr5	146770370	146889619	DPYSL3	119249	-	NM_001197294	146773597	146889421	14
chr5	146939556	147041572	JAKMIP2-AS1	102016	+	NR_038902	147041572	147041572	4
chr5	146965003	147162411	JAKMIP2	197408	-	NM_001270941	146981323	147051369	22
chr5	147204142	147218794	SPINK1	14652	-	NM_003122	147204223	147211140	5
chr5	147258273	147261756	SCGB3A2	3483	+	NM_054023	147258366	147261613	3
chr5	147272270	147286101	C5orf46	13831	-	NM_206966	147276555	147286064	4
chr5	147443534	147516925	SPINK5	73391	+	NM_001127698	147443607	147516554	34
chr5	147548108	147555182	SPINK14	7074	+	NM_001001325	147549295	147554961	5
chr5	147582356	147594700	SPINK6	12344	+	NM_001195290	147582659	147594513	5
chr5	147647869	147763413	LOC102546294	115544	-	NR_105057	147763413	147763413	5
chr5	147648422	147665773	SPINK13	17351	+	NM_001040129	147649635	147665611	5
chr5	147691989	147695481	SPINK7	3492	+	NM_032566	147692046	147695247	4
chr5	147715121	147719412	SPINK9	4291	+	NM_001040433	147715176	147719275	4
chr5	147763497	147822399	FBXO38	58902	+	NM_030793	147774339	147821710	22
chr5	147830594	148016624	HTR4	186030	-	NM_199453	147845427	148016577	7
chr5	148206155	148208197	ADRB2	2042	+	NM_000024	148206394	148207636	1
chr5	148361712	148442737	SH3TC2	81025	-	NM_024577	148384273	148442585	17
chr5	148442879	148489350	LOC255187	46471	+	NR_122044	148489350	148489350	3
chr5	148521045	148640001	ABLIM3	118956	+	NM_014945	148521658	148637967	24
chr5	148651400	148721367	AFAP1L1	69967	+	NM_152406	148651531	148719593	19
chr5	148724976	148734146	GRPEL2	9170	+	NM_152407	148725102	148730845	4
chr5	148727678	148737205	GRPEL2-AS1	9527	-	NR_132366	148737205	148737205	2
chr5	148737569	148749221	PCYOX1L	11652	+	NM_024028	148737631	148748217	6
chr5	148753829	148783765	IL17B	29936	-	NM_001317987	148753931	148756453	3
chr5	148786407	148812399	CARMN	25992	+	NR_105059	148812399	148812399	6
chr5	148808480	148808586	MIR143	106	+	NR_029684	148808586	148808586	1
chr5	148810208	148810296	MIR145	88	+	NR_029686	148810296	148810296	1
chr5	148875456	148931115	CSNK1A1	55659	-	NM_001025105	148876415	148930527	11
chr5	148961134	149014527	ARHGEF37	53393	+	NM_001001669	148977332	149011754	13
chr5	149109814	149234585	PPARGC1B	124771	+	NM_133263	149109905	149227121	12
chr5	149112387	149112453	MIR378A	66	+	NR_029870	149112453	149112453	1
chr5	149237518	149324356	PDE6A	86838	-	NM_000440	149240457	149324236	22
chr5	149310926	149312540	LOC644762	1614	-	NR_110534	149312540	149312540	1
chr5	149340299	149366963	SLC26A2	26664	+	NM_000112	149357215	149361376	3
chr5	149372685	149380730	TIGD6	8045	-	NM_030953	149374345	149375911	2
chr5	149380168	149432706	HMGXB3	52538	+	NM_014983	149384415	149431755	20
chr5	149432853	149492935	CSF1R	60082	-	NM_005211	149433631	149465990	22
chr5	149493401	149535422	PDGFRB	42021	-	NM_002609	149495325	149516610	23
chr5	149546343	149564121	CDX1	17778	+	NM_001804	149546439	149563243	3
chr5	149569519	149590635	SLC6A7	21116	+	NM_014228	149569890	149589178	14
chr5	149599053	149669403	CAMK2A	70350	-	NM_015981	149602272	149669188	19
chr5	149675908	149682525	ARSI	6617	-	NM_001012301	149676776	149681936	2
chr5	149737201	149779871	TCOF1	42670	+	NM_001135243	149737309	149778611	27
chr5	149781199	149792499	CD74	11300	-	NM_001025159	149781802	149792312	9
chr5	149823791	149829319	RPS14	5528	-	NM_005617	149823848	149827296	5
chr5	149855078	149865555	LOC102546298	10477	-	NR_105061	149865555	149865555	3
chr5	149877339	149937773	NDST1	60434	+	NM_001301063	149900816	149932894	14
chr5	149980641	150031903	SYNPO	51262	+	NM_001166208	149997929	150029895	3
chr5	150040402	150058930	MYOZ3	18528	+	NM_001122853	150042503	150056437	7
chr5	150070351	150080669	RBM22	10318	-	NM_018047	150071312	150080547	11
chr5	150088308	150138657	DCTN4	50349	-	NM_001135643	150090710	150138555	14
chr5	150157507	150176298	SMIM3	18791	+	NM_032947	150175002	150175185	2
chr5	150226084	150228231	IRGM	2147	+	NM_001145805	150227685	150228231	2
chr5	150273953	150284545	ZNF300	10592	-	NM_001172831	150274985	150282911	7
chr5	150309997	150326146	ZNF300P1	16149	-	NR_026867	150326146	150326146	5
chr5	150399998	150408554	GPX3	8556	+	NM_002084	150400215	150407691	5
chr5	150409503	150467221	TNIP1	57718	-	NM_001252390	150410273	150444656	18
chr5	150480266	150537443	ANXA6	57177	-	NM_001155	150481008	150527462	26
chr5	150560612	150603654	CCDC69	43042	-	NM_015621	150562997	150603531	9
chr5	150632612	150649953	GM2A	17341	+	NM_001167607	150632777	150647201	4
chr5	150655925	150683334	SLC36A3	27409	-	NM_001145017	150656953	150682915	11
chr5	150694538	150727151	SLC36A2	32613	-	NM_181776	150696377	150727021	10
chr5	150827156	150871942	SLC36A1	44786	+	NM_078483	150838353	150867815	11
chr5	150883652	150948505	FAT2	64853	-	NM_001447	150885125	150948492	23
chr5	150901647	150901709	MIR6499	62	-	NR_106752	150901709	150901709	1
chr5	151040656	151066615	SPARC	25959	-	NM_001309443	151043131	151055749	10
chr5	151056505	151067468	CTB-113P19.1	10963	+	NR_109873	151067468	151067468	5
chr5	151122382	151138210	ATOX1	15828	-	NM_004045	151125885	151138112	4
chr5	151149353	151151737	LOC100652758	2384	-	NR_132345	151151737	151151737	2
chr5	151151475	151184915	G3BP1	33440	+	NM_005754	151166181	151183652	12
chr5	151202073	151304397	GLRA1	102324	-	NM_000171	151202233	151304110	9
chr5	151338458	151650010	CTB-12O2.1	311552	+	NR_109876	151650010	151650010	3
chr5	151771101	151784840	NMUR2	13739	-	NM_020167	151771751	151784674	4
chr5	151998524	152351909	LINC01470	353385	-	NR_109877	152351909	152351909	5
chr5	152870083	153193429	GRIA1	323346	+	NM_001258020	153026552	153190785	17
chr5	153369690	153418498	FAM114A2	48808	-	NM_001317993	153372535	153414513	15
chr5	153418518	153437014	MFAP3	18496	+	NM_001242336	153429282	153433273	3
chr5	153570294	153800543	GALNT10	230249	+	NM_198321	153570426	153796532	12
chr5	153726665	153726807	MIR1294	142	+	NR_031626	153726807	153726807	1
chr5	153769328	153825382	SAP30L-AS1	56054	-	NR_037897	153825382	153825382	3
chr5	153825516	153840613	SAP30L	15097	+	NR_024084	153840613	153840613	5
chr5	153854531	153857824	HAND1	3293	-	NM_004821	153855365	153857568	2
chr5	153975571	153975632	MIR3141	61	-	NR_036094	153975632	153975632	1
chr5	154065335	154065421	MIR1303	86	+	NR_031638	154065421	154065421	1
chr5	154092461	154197167	LARP1	104706	+	NM_015315	154092485	154193656	19
chr5	154198051	154230245	FAXDC2	32194	-	NM_032385	154199875	154217738	9
chr5	154209017	154209100	MIR378H	83	+	NR_039667	154209100	154209100	1
chr5	154237808	154256352	CNOT8	18544	+	NM_001301083	154250227	154254999	5
chr5	154266975	154317776	GEMIN5	50801	-	NM_001252156	154267769	154317693	28
chr5	154320632	154348971	MRPL22	28339	+	NM_014180	154320670	154346457	7
chr5	154393259	154397685	KIF4B	4426	+	NM_001099293	154393419	154397124	1
chr5	155753766	156194798	SGCD	441032	+	NM_000337	155756586	156186401	9
chr5	156277548	156279539	PPP1R2P3	1991	+	NR_038443	156279539	156279539	1
chr5	156346292	156390266	TIMD4	43974	-	NM_138379	156346467	156390209	9
chr5	156456423	156486130	HAVCR1	29707	-	NM_001173393	156456743	156484954	9
chr5	156512842	156536248	HAVCR2	23406	-	NM_032782	156514112	156535994	7
chr5	156565450	156569921	MED7	4471	-	NM_004270	156565740	156566442	2
chr5	156589343	156593279	FAM71B	3936	-	NM_130899	156589457	156593179	2
chr5	156607906	156682109	ITK	74203	+	NM_005546	156607988	156679688	17
chr5	156693089	156822606	CYFIP2	129517	+	NM_001291722	156712371	156820008	32
chr5	156768606	156772729	FNDC9	4123	-	NM_001001343	156769869	156770544	2
chr5	156887026	156901730	NIPAL4	14704	+	NM_001099287	156887142	156899968	6
chr5	156904311	157002831	ADAM19	98520	-	NM_033274	156907956	157002704	23
chr5	157052686	157098488	SOX30	45802	-	NM_001308165	157053347	157094857	6
chr5	157098560	157107162	C5orf52	8602	+	NM_001145132	157098622	157107007	3
chr5	157158396	157168455	THG1L	10059	+	NM_001317824	157159985	157166490	6
chr5	157170702	157187717	LSM11	17015	+	NM_173491	157170758	157182272	4
chr5	157212750	157286183	CLINT1	73433	-	NM_014666	157214653	157285978	12
chr5	157747711	157836781	LOC101927697	89070	-	NR_109888	157836781	157836781	7
chr5	158122922	158526788	EBF1	403866	-	NM_001290360	158126118	158526486	16
chr5	158527490	158544486	LOC101927740	16996	+	NR_109890	158544486	158544486	3
chr5	158584416	158637061	RNF145	52645	-	NM_001199380	158585677	158636911	11
chr5	158654722	158672135	LOC105377682	17413	+	NR_134261	158672135	158672135	3
chr5	158690088	158713048	UBLCP1	22960	+	NM_145049	158695923	158711939	11
chr5	158741790	158757481	IL12B	15691	-	NM_002187	158743692	158753790	8
chr5	158758525	158789842	LOC285626	31317	+	NR_037889	158789842	158789842	5
chr5	158875563	158893284	LOC285627	17721	-	NR_027110	158893284	158893284	7
chr5	159203781	159298391	LOC101927766	94610	-	NR_109891	159298391	159298391	3
chr5	159343739	159400017	ADRA1B	56278	+	NM_000679	159343912	159399499	2
chr5	159436106	159492552	TTC1	56446	+	NM_003314	159437535	159492072	8
chr5	159502891	159546452	PWWP2A	43561	-	NM_052927	159505161	159546395	4
chr5	159614373	159665729	FABP6	51356	+	NM_001130958	159626113	159665666	7
chr5	159678658	159766599	CCNJL	87941	-	NR_131769	159766599	159766599	8
chr5	159774774	159797648	C1QTNF2	22874	-	NM_031908	159776174	159797644	3
chr5	159820154	159827104	ZBED8	6950	-	NM_001303251	159820712	159822497	3
chr5	159828647	159846168	SLU7	17521	-	NM_006425	159830291	159842301	16
chr5	159848813	159855751	PTTG1	6938	+	NM_004219	159849319	159855688	6
chr5	159895257	159914433	LOC285628	19176	+	NR_132748	159914433	159914433	2
chr5	159901408	159901490	MIR3142	82	+	NR_036095	159901490	159901490	1
chr5	159912358	159912457	MIR146A	99	+	NR_029701	159912457	159912457	1
chr5	159990126	160279219	ATP10B	289093	-	NM_025153	159992459	160115081	26
chr5	160358785	160365633	LOC285629	6848	-	NR_027111	160365633	160365633	3
chr5	160715435	160975130	GABRB2	259695	-	NM_021911	160721087	160973649	11
chr5	161112657	161129598	GABRA6	16941	+	NM_000811	161112995	161128779	9
chr5	161274196	161326965	GABRA1	52769	+	NM_000806	161277816	161324428	11
chr5	161337467	161428202	LINC01202	90735	-	NR_126372	161428202	161428202	3
chr5	161494647	161582545	GABRG2	87898	+	NM_198903	161495005	161580374	11
chr5	162864576	162872022	CCNG1	7446	+	NM_199246	162866262	162869571	8
chr5	162880585	162887143	NUDCD2	6558	-	NM_145266	162880972	162887056	4
chr5	162887516	162918953	HMMR	31437	+	NM_012484	162887698	162918170	18
chr5	162909609	162921064	HMMR-AS1	11455	-	NR_109892	162921064	162921064	4
chr5	162930069	162946359	MAT2B	16290	+	NM_182796	162930400	162945369	7
chr5	163875427	163894408	LOC101927835	18981	-	NR_105064	163894408	163894408	4
chr5	163897284	163969989	LOC102546299	72705	+	NR_105065	163969989	163969989	4
chr5	166332226	166353375	CTB-7E3.1	21149	-	NR_108020	166353375	166353375	3
chr5	166591938	166595406	LOC101927908	3468	-	NR_134280	166595406	166595406	2
chr5	166711842	167691162	TENM2	979320	+	NM_001122679	166711842	167689815	29
chr5	167656587	167659377	CTB-178M22.2	2790	-	NR_109894	167659377	167659377	3
chr5	167719064	167899308	WWC1	180244	+	NM_001161661	167719157	167896022	23
chr5	167913462	167946309	RARS	32847	+	NM_002887	167913503	167946195	15
chr5	167956581	167957639	FBLL1	1058	+	NR_024356	167957639	167957639	1
chr5	167982627	168006614	PANK3	23987	-	NM_024594	167984575	168006288	7
chr5	167987900	167987978	MIR103A1	78	-	NR_029520	167987978	167987978	1
chr5	167987908	167987970	MIR103B1	62	+	NR_031721	167987970	167987970	1
chr5	168088737	168728133	SLIT3	639396	-	NM_003062	168093458	168727713	36
chr5	168133931	168147889	LOC101927969	13958	+	NR_130737	168147889	168147889	7
chr5	168195150	168195260	MIR218-2	110	-	NR_029632	168195260	168195260	1
chr5	168440231	168465003	LOC728095	24772	+	NR_109897	168465003	168465003	5
chr5	168690604	168690698	MIR585	94	-	NR_030311	168690698	168690698	1
chr5	169010637	169031781	SPDL1	21144	+	NM_017785	169015420	169031211	12
chr5	169064250	169510386	DOCK2	446136	+	NM_004946	169064330	169509862	52
chr5	169290718	169407744	FAM196B	117026	-	NM_001129891	169291276	169310902	4
chr5	169455491	169455570	MIR378E	79	+	NR_039609	169455570	169455570	1
chr5	169532916	169536729	FOXI1	3813	+	NM_144769	169532961	169535615	2
chr5	169618650	169626145	LINC01187	7495	-	NR_108022	169626145	169626145	5
chr5	169659920	169679572	C5orf58	19652	+	NR_131091	169679572	169679572	4
chr5	169675087	169724822	LCP2	49735	-	NM_005565	169675700	169724615	21
chr5	169758396	169762104	LINC01366	3708	+	NR_108024	169762104	169762104	3
chr5	169780490	170163637	KCNIP1	383147	+	NM_001034838	169780880	170162810	8
chr5	169805164	169816681	KCNMB1	11517	-	NM_004137	169805707	169812451	4
chr5	169816496	169849848	CTD-2270F17.1	33352	+	NR_109899	169849848	169849848	3
chr5	170210722	170241050	GABRP	30328	+	NM_014211	170215619	170239262	10
chr5	170288885	170727019	RANBP17	438134	+	NM_022897	170289037	170725862	28
chr5	170736287	170739138	TLX3	2851	+	NM_021025	170736369	170738603	3
chr5	170813659	170813764	MIR3912	105	-	NR_037474	170813764	170813764	1
chr5	170814707	170837888	NPM1	23181	+	NM_002520	170814952	170837569	11
chr5	170846666	170884630	FGF18	37964	+	NM_003862	170847203	170883809	5
chr5	171212875	171218092	SMIM23	5217	+	NM_001289970	171212875	171218092	4
chr5	171288555	171433877	FBXW11	145322	-	NM_033644	171295638	171433506	13
chr5	171469073	171615346	STK10	146273	-	NM_005990	171471885	171615046	19
chr5	171621175	171630458	EFCAB9	9283	+	NM_001171183	171621176	171630349	4
chr5	171636649	171710795	UBTD2	74146	-	NM_152277	171638833	171710669	3
chr5	171712600	171725380	LOC100288254	12780	+	NR_130933	171725380	171725380	2
chr5	171752186	171881527	SH3PXD2B	129341	-	NM_001308175	171752279	171881356	13
chr5	172068268	172118533	NEURL1B	50265	+	NM_001142651	172068409	172113928	5
chr5	172182505	172189565	LOC101928093	7060	+	NM_001287812	172185265	172189520	4
chr5	172195092	172198203	DUSP1	3111	-	NM_004417	172195764	172197955	4
chr5	172261222	172379688	ERGIC1	118466	+	NM_001031711	172261416	172377819	10
chr5	172381785	172386371	LOC100268168	4586	-	NR_026682	172386371	172386371	4
chr5	172385731	172396774	RPL26L1	11043	+	NM_001317981	172386876	172396544	4
chr5	172410762	172461900	ATP6V0E1	51138	+	NM_003945	172410863	172447334	4
chr5	172447728	172447932	SNORA74B	204	+	NR_002988	172447932	172447932	1
chr5	172483354	172566291	CREBRF	82937	+	NM_153607	172507778	172560748	9
chr5	172571444	172591390	BNIP1	19946	+	NM_013979	172571548	172590924	7
chr5	172659106	172662315	NKX2-5	3209	-	NM_001166176	172660345	172662086	2
chr5	172741725	172756506	STC2	14781	-	NM_003714	172744849	172755196	4
chr5	172774457	172774539	MIR8056	82	+	NR_107023	172774539	172774539	1
chr5	173006636	173012071	LOC285593	5435	+	NR_027108	173012071	173012071	4
chr5	173034147	173043666	BOD1	9519	-	NM_138369	173036241	173043439	4
chr5	173134601	173173212	LINC01484	38611	-	NR_108027	173173212	173173212	3
chr5	173213792	173217945	LINC01485	4153	-	NR_108028	173217945	173217945	4
chr5	173315330	173387994	CPEB4	72664	+	NM_030627	173316736	173383140	10
chr5	173416161	173433143	C5orf47	16982	+	NM_001144954	173416266	173428218	5
chr5	173472606	173536182	HMP19	63576	+	NM_015980	173473758	173534508	5
chr5	173763356	173954142	LINC01411	190786	+	NR_125806	173954142	173954142	6
chr5	174151574	174157902	MSX2	6328	+	NM_002449	174151662	174156586	2
chr5	174178736	174178790	MIR4634	54	+	NR_039777	174178790	174178790	1
chr5	174346084	174422734	FLJ16171	76650	-	NR_046113	174422734	174422734	3
chr5	174867674	174871163	DRD1	3489	-	NM_000794	174868761	174870102	2
chr5	174905513	174955621	SFXN1	50108	+	NM_022754	174919106	174953737	11
chr5	175085039	175113245	HRH2	28206	+	NM_001131055	175110236	175112529	3
chr5	175223609	175311023	CPLX2	87414	+	NM_006650	175305742	175307048	5
chr5	175386533	175395318	THOC3	8785	-	NM_032361	175386971	175395211	6
chr5	175476680	175489058	LOC100996385	12378	-	NR_103794	175489058	175489058	3
chr5	175490711	175541801	FAM153B	51090	+	NM_001265615	175516521	175541052	20
chr5	175546551	175552168	LOC100507387	5617	+	NR_038402	175552168	175552168	7
chr5	175570087	175626298	LOC643201	56211	-	NR_036494	175626298	175626298	26
chr5	175665361	175772994	SIMC1	107633	+	NM_001308196	175690433	175772448	12
chr5	175773063	175788810	KIAA1191	15747	-	NM_020444	175774602	175786511	9
chr5	175792470	175800503	ARL10	8033	+	NM_173664	175792566	175798898	4
chr5	175794948	175795034	MIR1271	86	+	NR_031569	175795034	175795034	1
chr5	175810939	175815928	NOP16	4989	-	NM_001256539	175810983	175815540	6
chr5	175815783	175816751	HIGD2A	968	+	NM_138820	175815820	175816498	2
chr5	175819455	175843570	CLTB	24115	-	NM_007097	175819774	175843364	6
chr5	175875355	175937075	FAF2	61720	+	NM_014613	175875408	175933951	11
chr5	175953699	175964421	RNF44	10722	-	NM_014901	175956028	175959473	11
chr5	175969511	176022769	CDHR2	53258	+	NM_001171976	175992353	176022673	32
chr5	176022802	176037131	GPRIN1	14329	-	NM_052899	176023808	176026835	2
chr5	176047084	176057562	SNCB	10478	-	NM_001001502	176047811	176056655	7
chr5	176056439	176056501	MIR4281	62	-	NR_036239	176056501	176056501	1
chr5	176057682	176073642	EIF4E1B	15960	+	NM_001099408	176069788	176072981	9
chr5	176074387	176086059	TSPAN17	11672	+	NM_130465	176074616	176084699	9
chr5	176170205	176170922	LINC01574	717	+	NR_108030	176170922	176170922	2
chr5	176237559	176307899	UNC5A	70340	+	NM_133369	176237751	176306887	15
chr5	176307869	176326333	HK3	18464	-	NM_002115	176308073	176323160	19
chr5	176332005	176433795	UIMC1	101790	-	NM_001199297	176332282	176409616	16
chr5	176449680	176508190	ZNF346	58510	+	NM_001308213	176449739	176491600	9
chr5	176513872	176525143	FGFR4	11271	+	NM_002011	176516603	176524677	18
chr5	176560079	176727214	NSD1	167135	+	NM_172349	176562171	176722460	24
chr5	176728190	176730745	RAB24	2555	-	NM_130781	176728743	176730289	9
chr5	176730762	176733960	PRELID1	3198	+	NM_001271828	176730986	176733571	5
chr5	176732500	176739292	MXD3	6792	-	NM_001142935	176734119	176738831	6
chr5	176758562	176778885	LMAN2	20323	-	NM_006816	176759086	176778648	8
chr5	176784843	176799599	RGS14	14756	+	NM_006480	176785025	176799076	15
chr5	176811431	176825849	SLC34A1	14418	+	NM_003052	176812742	176825287	13
chr5	176827107	176827637	PFN3	530	-	NM_001029886	176827163	176827577	1
chr5	176829138	176836577	F12	7439	-	NM_000505	176829292	176836528	14
chr5	176853686	176869850	GRK6	16164	+	NM_002082	176853846	176868828	16
chr5	176864889	176874945	PRR7-AS1	10056	-	NR_038915	176874945	176874945	4
chr5	176873795	176883287	PRR7	9492	+	NM_030567	176882068	176883122	4
chr5	176883613	176900694	DBN1	17081	-	NM_004395	176884433	176900522	14
chr5	176910394	176924606	PDLIM7	14212	-	NM_005451	176910644	176923513	13
chr5	176928905	176937427	DOK3	8522	-	NM_001144875	176930045	176936541	6
chr5	176938577	176943967	DDX41	5390	-	NM_016222	176938791	176943946	17
chr5	176946789	176981586	FAM193B	34797	-	NR_024019	176981586	176981586	12
chr5	177019212	177023099	TMED9	3887	+	NM_017510	177019215	177022417	5
chr5	177027118	177037346	B4GALT7	10228	+	NM_007255	177027211	177036696	6
chr5	177045500	177099278	LOC202181	53778	-	NR_026921	177099278	177099278	6
chr5	177150364	177207505	FAM153A	57141	-	NM_173663	177151113	177175644	20
chr5	177302261	177311269	LOC728554	9008	+	NR_003615	177311269	177311269	6
chr5	177419235	177423243	PROP1	4008	-	NM_006261	177419709	177422934	3
chr5	177433966	177476088	FAM153C	42122	+	NR_038353	177476088	177476088	12
chr5	177540555	177553107	N4BP3	12552	+	NM_015111	177546584	177549002	5
chr5	177557961	177575571	RMND5B	17610	+	NM_001288794	177565120	177575033	12
chr5	177576464	177580961	NHP2	4497	-	NM_017838	177576713	177580818	4
chr5	177611510	177614433	GMCL1P1	2923	-	NR_003281	177614433	177614433	1
chr5	177631507	177638184	HNRNPAB	6677	+	NM_031266	177631838	177637624	8
chr5	177635474	177659823	PHYKPL	24349	-	NR_103510	177659823	177659823	14
chr5	177664616	178017556	COL23A1	352940	-	NM_173465	177665698	178017198	29
chr5	178029664	178054054	CLK4	24390	-	NM_020666	178030617	178050417	13
chr5	178138521	178157703	ZNF354A	19182	-	NM_005649	178139060	178156023	5
chr5	178191863	178203277	AACSP1	11414	-	NR_024035	178203277	178203277	7
chr5	178286953	178311424	ZNF354B	24471	+	NM_058230	178288048	178311292	5
chr5	178322894	178360212	ZFP2	37318	+	NM_030613	178358314	178359700	5
chr5	178368193	178393218	ZNF454	25025	+	NM_182594	178369792	178392974	5
chr5	178405329	178422124	GRM6	16795	-	NM_000843	178408657	178421945	10
chr5	178450775	178461388	ZNF879	10613	+	NM_001136116	178452005	178460641	5
chr5	178487415	178510978	ZNF354C	23563	+	NM_014594	178489069	178507098	5
chr5	178537851	178772431	ADAMTS2	234580	-	NM_014244	178540867	178772329	22
chr5	178977561	179037027	RUFY1	59466	+	NM_025158	178977570	179036520	18
chr5	179022904	179030742	LOC101928445	7838	-	NR_110560	179030742	179030742	9
chr5	179041178	179050722	HNRNPH1	9544	-	NM_005520	179042546	179050134	14
chr5	179068544	179072047	C5orf60	3503	-	NM_001305388	179069339	179072021	6
chr5	179084762	179101296	LOC105377763	16534	+	NR_134260	179101296	179101296	3
chr5	179105558	179107975	CBY3	2417	-	NM_001164444	179105583	179107919	2
chr5	179125929	179158639	CANX	32710	+	NM_001024649	179132682	179155645	15
chr5	179159850	179204287	MAML1	44437	+	NM_014757	179160113	179201878	5
chr5	179220985	179223513	LTC4S	2528	+	NM_145867	179221081	179223395	5
chr5	179224597	179233952	MGAT4B	9355	-	NM_014275	179225044	179233583	15
chr5	179225277	179225346	MIR1229	69	-	NR_031598	179225346	179225346	1
chr5	179233387	179265077	SQSTM1	31690	+	NM_001142298	179250004	179263593	9
chr5	179264265	179285840	C5orf45	21575	-	NM_016175	179264390	179285796	7
chr5	179286002	179288282	LOC100996419	2280	+	NR_134283	179288282	179288282	2
chr5	179289070	179334856	TBC1D9B	45786	-	NM_198868	179290447	179334821	22
chr5	179382066	179499118	RNF130	117052	-	NM_018434	179382653	179498702	9
chr5	179442302	179442397	MIR340	95	-	NR_029885	179442397	179442397	1
chr5	179527794	179636130	RASGEF1C	108336	-	NM_175062	179528500	179565052	14
chr5	179660594	179719071	MAPK9	58477	-	NM_002752	179663383	179707561	12
chr5	179727689	179780387	GFPT2	52698	-	NM_005110	179728563	179780217	19
chr5	179921398	180005405	CNOT6	84007	+	NM_001303241	179956276	180001200	14
chr5	180017104	180018487	SCGB3A1	1383	-	NM_052863	180017230	180018462	3
chr5	180028505	180076624	FLT4	48119	-	NM_182925	180030191	180076545	30
chr5	180166122	180167058	OR2Y1	936	-	NM_001001657	180166122	180167058	1
chr5	180217540	180237137	MGAT1	19597	-	NM_001114617	180218633	180219971	3
chr5	180256953	180258618	HEIH	1665	-	NR_045680	180258618	180258618	1
chr5	180257956	180262726	LINC00847	4770	+	NR_045679	180262726	180262726	3
chr5	180274610	180288286	ZFP62	13676	-	NM_152283	180275791	180278395	3
chr5	180326076	180377906	BTNL8	51830	+	NM_001040462	180326310	180377544	8
chr5	180415844	180433727	BTNL3	17883	+	NM_197975	180416028	180432872	8
chr5	180467224	180488523	BTNL9	21299	+	NM_152547	180472489	180486862	11
chr5	180470402	180470484	MIR8089	82	-	NR_107056	180470484	180470484	1
chr5	180551356	180552304	OR2V1	948	-	NM_001258283	180551356	180552304	1
chr5	180581942	180582890	OR2V2	948	+	NM_206880	180581942	180582890	1
chr5	180618045	180618908	LOC102577426	863	-	NR_108031	180618908	180618908	2
chr5	180620923	180632293	TRIM7	11370	-	NM_203293	180622165	180632110	7
chr5	180649565	180649633	MIR4638	68	-	NR_039781	180649633	180649633	1
chr5	180650262	180662808	TRIM41	12546	+	NM_201627	180650999	180662379	8
chr5	180663927	180670906	GNB2L1	6979	-	NM_006098	180663976	180670800	8
chr5	180668817	180668889	SNORD96A	72	-	NR_002592	180668889	180668889	1
chr5	180670313	180670376	SNORD95	63	-	NR_002591	180670376	180670376	1
chr5	180673540	180684587	CTC-338M12.4	11047	+	NR_109909	180684587	180684587	3
chr5	180683385	180688119	TRIM52	4734	-	NM_032765	180684414	180687814	2
chr5	180688212	180699308	TRIM52-AS1	11096	+	NR_102762	180699308	180699308	3
chr6	181465	205484	LOC285766	24019	-	NR_126020	205484	205484	8
chr6	292056	351355	DUSP22	59299	+	NM_020185	292539	350868	8
chr6	391738	411443	IRF4	19705	+	NR_046000	411443	411443	10
chr6	485137	693141	EXOC2	208004	-	NR_073064	693141	693141	30
chr6	655938	656964	HUS1B	1026	-	NM_148959	656107	656944	1
chr6	868497	876613	LOC101927691	8116	+	NR_110853	876613	876613	3
chr6	961240	1101567	LINC01622	140327	-	NR_027115	1101567	1101567	5
chr6	1312674	1314993	FOXQ1	2319	+	NM_033260	1312939	1314151	1
chr6	1390068	1395832	FOXF2	5764	+	NM_001452	1390182	1395094	2
chr6	1390548	1390646	MIR6720	98	-	NR_106778	1390646	1390646	1
chr6	1605765	1607591	FOXCUT	1826	+	NR_125804	1607591	1607591	2
chr6	1610680	1614129	FOXC1	3449	+	NM_001453	1610680	1612342	1
chr6	1624034	2245868	GMDS	621834	-	NM_001500	1624403	2245656	11
chr6	2245986	2413825	GMDS-AS1	167839	+	NR_046229	2413825	2413825	7
chr6	2622146	2634837	LINC01600	12691	-	NR_131168	2634837	2634837	3
chr6	2663862	2751154	MYLK4	87292	-	NM_001012418	2671534	2749528	13
chr6	2765665	2785979	WRNIP1	20314	+	NM_130395	2765856	2785516	7
chr6	2832565	2842283	SERPINB1	9718	-	NR_073111	2842283	2842283	8
chr6	2854264	2854341	MIR4645	77	-	NR_039788	2854341	2854341	1
chr6	2854890	2876744	SERPINB9P1	21854	-	NR_033851	2876744	2876744	2
chr6	2884221	2900910	LOC101927730	16689	+	NR_110841	2900910	2900910	5
chr6	2887499	2903546	SERPINB9	16047	-	NM_004155	2890396	2900845	7
chr6	2948392	2972399	SERPINB6	24007	-	NM_001195291	2948531	2969014	8
chr6	2988200	2991405	LINC01011	3205	+	NR_026856	2991405	2991405	3
chr6	3000049	3020110	NQO2	20061	+	NM_001290221	3006786	3019889	10
chr6	3020389	3025005	HTATSF1P2	4616	-	NR_033884	3025005	3025005	1
chr6	3025024	3027658	LOC101927759	2634	+	NR_132750	3027658	3027658	1
chr6	3064121	3115421	RIPK1	51300	+	NM_001317061	3083348	3113573	13
chr6	3118609	3153432	BPHL	34823	+	NR_026648	3153432	3153432	9
chr6	3153900	3157783	TUBB2A	3883	-	NM_001310315	3154096	3155179	4
chr6	3183051	3196001	LOC100507194	12950	-	NR_038296	3196001	3196001	3
chr6	3224494	3227968	TUBB2B	3474	-	NM_178012	3224984	3227777	4
chr6	3259161	3268300	PSMG4	9139	+	NM_001128592	3259256	3267946	4
chr6	3269206	3456793	SLC22A23	187587	-	NM_015482	3273288	3456793	10
chr6	3722835	3752246	PXDC1	29411	-	NM_183373	3723852	3751765	5
chr6	3849599	3851554	FAM50B	1955	+	NM_012135	3850045	3851023	2
chr6	4021568	4065217	PRPF4B	43649	+	NM_003913	4021659	4060850	15
chr6	4068592	4079457	FAM217A	10865	-	NM_173563	4068929	4077648	7
chr6	4079439	4130999	C6orf201	51560	+	NR_104463	4130999	4130999	8
chr6	4115926	4135831	ECI2	19905	-	NR_028588	4135831	4135831	11
chr6	4136305	4157619	LOC100507506	21314	+	NR_103764	4157619	4157619	4
chr6	4186553	4190263	LOC102724096	3710	-	NR_125874	4190263	4190263	3
chr6	4610798	4612153	KU-MEL-3	1355	+	NR_122107	4612153	4612153	2
chr6	4706392	4955778	CDYL	249386	+	NR_026590	4955778	4955778	9
chr6	4995279	5004297	RPP40	9018	-	NM_006638	4995311	5004236	8
chr6	5004049	5240729	LYRM4-AS1	236680	+	NR_126015	5240729	5240729	4
chr6	5085719	5087455	PPP1R3G	1736	+	NM_001145115	5085719	5086796	1
chr6	5108652	5261183	LYRM4	152531	-	NM_001164841	5144412	5260966	4
chr6	5148466	5148556	MIR3691	90	-	NR_037462	5148556	5148556	1
chr6	5261583	5771816	FARS2	510233	+	NM_006567	5368803	5771662	7
chr6	5452700	5458308	LOC101927972	5608	-	NR_125846	5458308	5458308	3
chr6	5665219	5695505	LOC101927950	30286	-	NR_110842	5695505	5695505	4
chr6	5998232	6007838	NRN1	9606	-	NM_001278710	5999208	6006982	4
chr6	6144310	6320924	F13A1	176614	-	NM_000129	6145851	6318897	15
chr6	6169566	6169642	MIR5683	76	+	NR_049863	6169642	6169642	1
chr6	6346697	6623059	LY86-AS1	276362	-	NR_026970	6623059	6623059	8
chr6	6588933	6655216	LY86	66283	+	NM_004271	6588967	6654860	5
chr6	7107829	7252213	RREB1	144384	+	NM_001168344	7182144	7249201	12
chr6	7281375	7313547	SSR1	32172	-	NM_003144	7290096	7313353	8
chr6	7326886	7389942	CAGE1	63056	-	NM_001170692	7327090	7387406	14
chr6	7390061	7418270	RIOK1	28209	+	NM_031480	7390235	7417674	17
chr6	7541869	7586946	DSP	45077	+	NM_004415	7542148	7586111	24
chr6	7590431	7612200	SNRNP48	21769	+	NM_152551	7590490	7609106	9
chr6	7727010	7881961	BMP6	154951	+	NM_001718	7727188	7880576	7
chr6	7881482	7911047	TXNDC5	29565	-	NM_030810	7883376	7911009	10
chr6	7881482	8064647	BLOC1S5-TXNDC5	183165	-	NR_037616	8064647	8064647	13
chr6	7986334	7990577	PIP5K1P1	4243	+	NR_027712	7990577	7990577	1
chr6	8013799	8064647	BLOC1S5	50848	-	NM_001199322	8015881	8054505	6
chr6	8013799	8102828	EEF1E1-BLOC1S5	89029	-	NR_037618	8102828	8102828	7
chr6	8073592	8102828	EEF1E1	29236	-	NM_001135650	8073707	8102754	4
chr6	8086640	8086766	SCARNA27	126	-	NR_003703	8086766	8086766	1
chr6	8413299	8435800	SLC35B3	22501	-	NR_109913	8435800	8435800	12
chr6	8435855	8785678	LOC100506207	349823	+	NR_038980	8785678	8785678	5
chr6	8652441	8654080	HULC	1639	+	NR_004855	8654080	8654080	2
chr6	10396915	10419797	TFAP2A	22882	-	NM_001042425	10398649	10419683	7
chr6	10412550	10416402	TFAP2A-AS1	3852	+	NR_033910	10416402	10416402	3
chr6	10428017	10435055	LINC00518	7038	-	NR_027793	10435055	10435055	3
chr6	10434561	10457012	MIR5689HG	22451	+	NR_132993	10457012	10457012	4
chr6	10439949	10440027	MIR5689	78	+	NR_049872	10440027	10440027	1
chr6	10521567	10629601	GCNT2	108034	+	NM_145649	10529144	10626840	5
chr6	10671650	10695030	C6orf52	23380	-	NR_026736	10695030	10695030	6
chr6	10695187	10709970	PAK1IP1	14783	+	NM_017906	10695218	10709685	10
chr6	10723147	10731362	TMEM14C	8215	+	NM_016462	10724846	10730899	6
chr6	10747991	10760006	TMEM14B	12015	+	NM_001286488	10749478	10759334	6
chr6	10762955	10838788	MAK	75833	-	NM_001242957	10764684	10830881	15
chr6	10873455	10882098	GCM2	8643	-	NM_004752	10874227	10882026	5
chr6	10887063	10974541	SYCP2L	87478	+	NM_001040274	10887359	10964039	30
chr6	10932549	10954322	LOC101928191	21773	-	NR_125851	10954322	10954322	3
chr6	10980992	11044624	ELOVL2	63632	-	NM_017770	10984013	11044463	8
chr6	11043990	11079377	ELOVL2-AS1	35387	+	NR_038964	11079377	11079377	5
chr6	11094265	11138969	SMIM13	44704	+	NM_001135575	11094546	11134835	2
chr6	11102721	11112071	ERVFRD-1	9350	-	NM_207582	11103926	11105543	2
chr6	11183530	11382581	NEDD9	199051	-	NR_073131	11382581	11382581	10
chr6	11538459	11583757	TMEM170B	45298	+	NM_001100829	11538510	11575794	3
chr6	11713887	11779280	ADTRP	65393	-	NM_001143948	11714710	11778992	7
chr6	11990575	12001477	LOC101928253	10902	-	NR_125853	12001477	12001477	3
chr6	12012723	12165232	HIVEP1	152509	+	NM_002114	12015861	12164694	9
chr6	12290528	12297427	EDN1	6899	+	NM_001168319	12290862	12296300	5
chr6	12717036	13288075	PHACTR1	571039	+	NM_001242648	12718976	13287310	15
chr6	13279526	13295818	LOC100130357	16292	-	NM_001242698	13281191	13295543	5
chr6	13305183	13328815	TBC1D7	23632	-	NM_001143965	13305332	13327130	8
chr6	13363586	13487869	GFOD1	124283	-	NM_018988	13364974	13487122	2
chr6	13574760	13615390	SIRT5	40630	+	NM_001242827	13591975	13612097	9
chr6	13615558	13632702	NOL7	17144	+	NM_001317724	13615590	13621059	9
chr6	13621729	13711796	RANBP9	90067	-	NM_005493	13622593	13711737	14
chr6	13786780	13814792	MCUR1	28012	-	NM_001031713	13791040	13814661	9
chr6	13924676	13980240	RNF182	55564	+	NM_001165034	13977350	13978094	3
chr6	14117486	14137148	CD83	19662	+	NM_001251901	14131774	14135467	5
chr6	14280357	14285685	LINC01108	5328	-	NR_108096	14285685	14285685	3
chr6	15246205	15522273	JARID2	276068	+	NM_004973	15246770	15520482	18
chr6	15248045	15248927	JARID2-AS1	882	-	NR_120502	15248927	15248927	2
chr6	15523031	15663289	DTNBP1	140258	-	NM_032122	15523205	15663100	10
chr6	16129316	16148478	MYLIP	19162	+	NM_013262	16129553	16146982	7
chr6	16141786	16141855	MIR4639	69	+	NR_039782	16141855	16141855	1
chr6	16238810	16295780	GMPR	56970	+	NM_006877	16238924	16295417	9
chr6	16299342	16761721	ATXN1	462379	-	NM_000332	16306559	16328541	9
chr6	17102488	17131603	STMND1	29115	+	NM_001190766	17102488	17131112	5
chr6	17281808	17294099	RBM24	12291	+	NM_001143942	17281812	17292350	4
chr6	17393735	17558023	CAP2	164288	+	NM_006366	17421786	17556673	13
chr6	17501595	17511496	LOC101928491	9901	-	NR_110855	17511496	17511496	4
chr6	17600517	17611950	FAM8A1	11433	+	NM_016255	17600640	17608570	5
chr6	17615265	17707065	NUP153	91800	-	NM_001278209	17616327	17706618	23
chr6	17759413	17987854	KIF13A	228441	-	NM_001105568	17761087	17987694	38
chr6	18120717	18122851	NHLRC1	2134	-	NM_198586	18121649	18122837	1
chr6	18128544	18155396	TPMT	26852	-	NM_000367	18130898	18149358	9
chr6	18155618	18224084	KDM1B	68466	+	NM_153042	18160126	18222223	18
chr6	18224399	18264799	DEK	40400	-	NM_003472	18225949	18264218	11
chr6	18387580	18469105	RNF144B	81525	+	NM_182757	18399765	18465298	8
chr6	18572014	18572111	MIR548A1	97	+	NR_030312	18572111	18572111	1
chr6	19068773	19180711	LOC101928519	111938	-	NR_110860	19180711	19180711	11
chr6	19837600	19842431	ID4	4831	+	NM_001546	19837985	19838859	3
chr6	20099915	20212695	MBOAT1	112780	-	NM_001080480	20102516	20212465	13
chr6	20402136	20493945	E2F3	91809	+	NM_001949	20402463	20490661	7
chr6	20534687	21232634	CDKAL1	697947	+	NM_017774	20546581	21231270	16
chr6	21486291	21512123	LINC00581	25832	-	NR_103790	21512123	21512123	4
chr6	21593971	21598849	SOX4	4878	+	NM_003107	21594765	21596190	1
chr6	21666674	22194616	CASC15	527942	+	NR_015410	22194616	22194616	12
chr6	22134830	22147422	NBAT1	12592	-	NR_034143	22147422	22147422	3
chr6	22287472	22303082	PRL	15610	-	NM_001163558	22287630	22297211	6
chr6	22569677	22570750	HDGFL1	1073	+	NM_138574	22569804	22570560	1
chr6	24126413	24147757	NRSN1	21344	+	NM_080723	24134555	24146174	4
chr6	24171982	24383520	DCDC2	211538	-	NM_001195610	24174957	24357978	11
chr6	24357130	24358512	KAAG1	1382	+	NM_181337	24357867	24358122	1
chr6	24403135	24426422	MRS2	23287	+	NM_001286264	24403274	24423922	12
chr6	24426061	24489850	GPLD1	63789	-	NM_001503	24429259	24489739	25
chr6	24495196	24537435	ALDH5A1	42239	+	NM_170740	24495224	24533940	11
chr6	24544331	24646383	KIAA0319	102052	-	NM_001168374	24547392	24600874	22
chr6	24650204	24667115	TDP2	16911	-	NM_016614	24651015	24667090	7
chr6	24667262	24705295	ACOT13	38033	+	NM_001160094	24687909	24701843	4
chr6	24705089	24719403	C6orf62	14314	-	NM_030939	24706364	24718896	5
chr6	24775158	24786325	GMNN	11167	+	NM_015895	24777474	24786027	7
chr6	24797548	24799124	C6orf229	1576	-	NM_001282492	24797637	24799085	2
chr6	24839594	25042396	FAM65B	202802	-	NM_001286446	24840931	25042154	14
chr6	25081294	25138051	CMAHP	56757	-	NR_002174	25138051	25138051	13
chr6	25245145	25261635	LOC101928663	16490	-	NR_110862	25261635	25261635	4
chr6	25279655	25620758	LRRC16A	341103	+	NM_001173977	25280023	25619811	37
chr6	25652428	25702008	SCGN	49580	+	NM_006998	25652631	25701563	11
chr6	25726290	25726790	HIST1H2AA	500	-	NM_170745	25726359	25726755	1
chr6	25727136	25727573	HIST1H2BA	437	+	NM_170610	25727136	25727520	1
chr6	25732660	25733089	HIST1H2APS1	429	+	NR_045125	25733089	25733089	1
chr6	25754926	25781403	SLC17A4	26477	+	NM_001286121	25769283	25779416	13
chr6	25783125	25832287	SLC17A1	49162	-	NM_005074	25799012	25830785	13
chr6	25845327	25874471	SLC17A3	29144	-	NM_001098486	25845609	25868615	13
chr6	25912983	25930954	SLC17A2	17971	-	NM_005835	25913522	25926024	11
chr6	25962916	25987557	TRIM38	24641	+	NM_006355	25966750	25983915	8
chr6	26017259	26018040	HIST1H1A	781	-	NM_005325	26017312	26017960	1
chr6	26020717	26021186	HIST1H3A	469	+	NM_003529	26020717	26021128	1
chr6	26021906	26022278	HIST1H4A	372	+	NM_003538	26021906	26022218	1
chr6	26027123	26027480	HIST1H4B	357	-	NM_003544	26027168	26027480	1
chr6	26031816	26032288	HIST1H3B	472	-	NM_003537	26031877	26032288	1
chr6	26033319	26033796	HIST1H2AB	477	-	NM_003513	26033403	26033796	1
chr6	26043454	26043885	HIST1H2BB	431	-	NM_021062	26043504	26043885	1
chr6	26045638	26046097	HIST1H3C	459	+	NM_003531	26045638	26046049	1
chr6	26055967	26056699	HIST1H1C	732	-	NM_005319	26056014	26056656	1
chr6	26087508	26095469	HFE	7961	+	NM_139009	26087668	26094454	6
chr6	26104175	26104565	HIST1H4C	390	+	NM_003542	26104175	26104487	1
chr6	26107639	26108364	HIST1H1T	725	-	NM_005323	26107697	26108321	1
chr6	26123694	26124132	HIST1H2BC	438	-	NM_003526	26123751	26124132	1
chr6	26124372	26124918	HIST1H2AC	546	+	NM_003512	26124460	26124853	1
chr6	26156558	26157343	HIST1H1E	785	+	NM_005321	26156618	26157278	1
chr6	26158348	26171576	HIST1H2BD	13228	+	NM_138720	26158397	26158778	2
chr6	26184023	26184458	HIST1H2BE	435	+	NM_003523	26184023	26184404	1
chr6	26188937	26189304	HIST1H4D	367	-	NM_003539	26188992	26189304	1
chr6	26197011	26199521	HIST1H3D	2510	-	NM_003530	26197067	26197478	2
chr6	26199011	26199521	HIST1H2AD	510	-	NM_021065	26199078	26199471	1
chr6	26199786	26200216	HIST1H2BF	430	+	NM_003522	26199786	26200167	1
chr6	26204872	26205249	HIST1H4E	377	+	NM_003545	26204872	26205184	1
chr6	26216427	26216872	HIST1H2BG	445	-	NM_003518	26216490	26216871	1
chr6	26217147	26217711	HIST1H2AE	564	+	NM_021052	26217202	26217595	1
chr6	26225382	26225844	HIST1H3E	462	+	NM_003532	26225382	26225793	1
chr6	26234439	26235216	HIST1H1D	777	-	NM_005320	26234495	26235161	1
chr6	26240653	26241021	HIST1H4F	368	+	NM_003540	26240653	26240965	1
chr6	26246838	26247205	HIST1H4G	367	-	NM_003547	26246908	26247205	1
chr6	26250369	26250835	HIST1H3F	466	-	NM_021018	26250422	26250833	1
chr6	26251878	26252303	HIST1H2BH	425	+	NM_003524	26251878	26252259	1
chr6	26271145	26271612	HIST1H3G	467	-	NM_003534	26271201	26271612	1
chr6	26273203	26273640	HIST1H2BI	437	+	NM_003525	26273203	26273584	1
chr6	26285353	26285727	HIST1H4H	374	-	NM_003543	26285415	26285727	1
chr6	26365386	26378548	BTN3A2	13162	+	NM_007047	26368410	26374595	11
chr6	26383323	26395100	BTN2A2	11777	+	NM_001197238	26384049	26394557	8
chr6	26402464	26415444	BTN3A1	12980	+	NM_001145008	26405791	26413920	10
chr6	26421618	26430816	BTN2A3P	9198	+	NR_027795	26430816	26430816	7
chr6	26440699	26453643	BTN3A3	12944	+	NM_006994	26443802	26452639	11
chr6	26458131	26476849	BTN2A1	18718	+	NM_001197234	26458864	26476360	8
chr6	26472171	26482737	LOC285819	10566	-	NR_038992	26482737	26482737	4
chr6	26501494	26510652	BTN1A1	9158	+	NM_001732	26501514	26509402	7
chr6	26521933	26527612	HCG11	5679	+	NR_026790	26527612	26527612	1
chr6	26538571	26547164	HMGN4	8593	+	NM_006353	26545434	26545707	2
chr6	26597170	26600277	ABT1	3107	+	NM_013375	26597210	26598873	3
chr6	26634610	26659980	ZNF322	25370	-	NM_001242797	26637572	26638781	5
chr6	26839265	26924333	GUSBP2	85068	-	NR_003504	26924333	26924333	9
chr6	26924771	26991753	LINC00240	66982	+	NR_026775	26991753	26991753	3
chr6	26987144	26988085	LOC100270746	941	-	NR_026776	26988085	26988085	1
chr6	27100094	27100575	HIST1H2BJ	481	-	NM_021058	27100148	27100529	1
chr6	27100816	27101314	HIST1H2AG	498	+	NM_021064	27100850	27101243	1
chr6	27106071	27114637	HIST1H2BK	8566	-	NM_080593	27114196	27114577	2
chr6	27107087	27107457	HIST1H4I	370	+	NM_003495	27107087	27107399	1
chr6	27114860	27115341	HIST1H2AH	481	+	NM_080596	27114907	27115294	1
chr6	27115404	27115467	MIR3143	63	+	NR_036096	27115467	27115467	1
chr6	27215501	27224399	PRSS16	8898	+	NM_005865	27215516	27223094	12
chr6	27276841	27280011	POM121L2	3170	-	NM_033482	27276841	27279949	1
chr6	27292539	27293741	VN1R10P	1202	+	NR_045612	27293741	27293741	1
chr6	27325601	27343153	ZNF204P	17552	-	NR_024553	27343153	27343153	5
chr6	27356523	27369227	ZNF391	12704	+	NM_001076781	27368149	27369226	3
chr6	27418520	27440897	ZNF184	22377	-	NM_007149	27419081	27440073	6
chr6	27661813	27678001	LINC01012	16188	+	NR_038294	27678001	27678001	4
chr6	27729522	27730966	LOC100131289	1444	+	NR_038929	27730966	27730966	3
chr6	27775256	27775709	HIST1H2BL	453	-	NM_003519	27775303	27775684	1
chr6	27775976	27776445	HIST1H2AI	469	+	NM_003509	27775987	27776380	1
chr6	27777841	27778314	HIST1H3H	473	+	NM_003536	27777851	27778262	1
chr6	27782079	27782518	HIST1H2AJ	439	-	NM_021066	27782131	27782518	1
chr6	27782821	27783267	HIST1H2BM	446	+	NM_003521	27782821	27783202	1
chr6	27791902	27792258	HIST1H4J	356	+	NM_021968	27791902	27792214	1
chr6	27798951	27799305	HIST1H4K	354	-	NM_003541	27798993	27799305	1
chr6	27805657	27806117	HIST1H2AK	460	-	NM_003510	27805724	27806117	1
chr6	27806439	27806888	HIST1H2BN	449	+	NM_003520	27806439	27806820	1
chr6	27833106	27833576	HIST1H2AL	470	+	NM_003511	27833132	27833525	1
chr6	27834569	27835359	HIST1H1B	790	-	NM_005322	27834626	27835307	1
chr6	27839622	27840099	HIST1H3I	477	-	NM_003533	27839682	27840093	1
chr6	27840925	27841289	HIST1H4L	364	-	NM_003546	27840976	27841288	1
chr6	27858092	27858570	HIST1H3J	478	-	NM_003535	27858159	27858570	1
chr6	27860476	27860963	HIST1H2AM	487	-	NM_003514	27860534	27860927	1
chr6	27861202	27861669	HIST1H2BO	467	+	NM_003527	27861240	27861621	1
chr6	27878962	27880174	OR2B2	1212	-	NM_033057	27879023	27880097	1
chr6	27925018	27925960	OR2B6	942	+	NM_012367	27925018	27925960	1
chr6	28048481	28057340	ZNF165	8859	+	NM_003447	28053258	28057248	4
chr6	28058584	28063493	ZSCAN12P1	4909	+	NR_024063	28063493	28063493	2
chr6	28089572	28105094	ZSCAN16-AS1	15522	-	NR_103455	28105094	28105094	3
chr6	28092386	28097856	ZSCAN16	5470	+	NM_025231	28093221	28097728	4
chr6	28109687	28127250	ZKSCAN8	17563	+	NM_001278119	28116185	28121795	7
chr6	28129538	28137373	ZNF192P1	7835	+	NR_103448	28137373	28137373	5
chr6	28183115	28186707	TOB2P1	3592	-	NR_002936	28186707	28186707	1
chr6	28193028	28201264	ZSCAN9	8236	+	NM_001199479	28194862	28200956	5
chr6	28209482	28227030	ZKSCAN4	17548	-	NM_001304506	28212893	28217570	5
chr6	28227074	28228736	NKAPL	1662	+	NM_001007531	28227149	28228358	1
chr6	28234787	28246000	ZSCAN26	11213	+	NM_001111039	28239697	28244873	4
chr6	28249313	28270326	PGBD1	21013	+	NM_032507	28251590	28270061	7
chr6	28292514	28304152	ZSCAN31	11638	-	NM_001243241	28293942	28297460	4
chr6	28317690	28336954	ZKSCAN3	19264	+	NM_001242894	28327363	28334062	7
chr6	28346597	28367544	ZSCAN12	20947	-	NR_028077	28367544	28367544	6
chr6	28400431	28411279	ZSCAN23	10848	-	NM_001012455	28402241	28404043	4
chr6	28471072	28483570	GPX6	12498	-	NM_182701	28472068	28483520	5
chr6	28493788	28502728	GPX5	8940	+	NM_001509	28493790	28501944	5
chr6	28539406	28555112	ZBED9	15706	-	NM_052923	28539687	28554494	4
chr6	28864306	28865097	HCG14	791	+	NR_104117	28865097	28865097	2
chr6	28911560	28912315	LINC01556	755	+	NR_103538	28912315	28912315	1
chr6	29011989	29012952	OR2W1	963	-	NM_030903	29011989	29012952	1
chr6	29053984	29055090	OR2B3	1106	-	NM_001005226	29054083	29055025	1
chr6	29141310	29142351	OR2J2	1041	+	NM_030905	29141412	29142351	1
chr6	29274466	29275432	OR14J1	966	+	NM_030946	29274466	29275432	1
chr6	29323006	29324054	OR5V1	1048	-	NM_030876	29323006	29323972	1
chr6	29341199	29343068	OR12D3	1869	-	NM_030959	29342113	29343064	1
chr6	29364415	29365448	OR12D2	1033	+	NM_013936	29364476	29365400	1
chr6	29393280	29395509	OR11A1	2229	-	NM_013937	29394470	29395418	1
chr6	29407715	29408754	OR10C1	1039	+	NM_013941	29407792	29408731	1
chr6	29454542	29455679	MAS1L	1137	-	NM_052967	29454542	29455679	1
chr6	29497182	29501345	LINC01015	4163	+	NR_037181	29501345	29501345	4
chr6	29550028	29550105	SNORD32B	77	+	NR_003049	29550105	29550105	1
chr6	29555682	29556745	OR2H2	1063	+	NM_007160	29555721	29556660	1
chr6	29758807	29760850	HCG4	2043	-	NR_002139	29760850	29760850	1
chr6	29759682	29765584	LOC554223	5902	+	NR_132323	29765584	29765584	3
chr6	29855536	29858857	HLA-H	3321	+	NR_001434	29858857	29858857	8
chr6	29892368	29894992	HCG4B	2624	-	NR_001317	29894992	29894992	1
chr6	29973747	29977733	HLA-J	3986	+	NR_024240	29977733	29977733	7
chr6	30029016	30032686	ZNRD1	3670	+	NM_014596	30029301	30032474	5
chr6	30038042	30043628	RNF39	5586	-	NM_025236	30038887	30043566	4
chr6	30130982	30140473	TRIM15	9491	+	NM_033229	30131461	30140126	7
chr6	30227338	30234728	HLA-L	7390	+	NR_027822	30234728	30234728	7
chr6	30255173	30294933	HCG18	39760	-	NR_024052	30294933	30294933	5
chr6	30457182	30461982	HLA-E	4800	+	NM_005516	30457308	30460358	8
chr6	30524485	30532473	PRR3	7988	+	NM_025263	30525121	30530272	4
chr6	30552108	30552194	MIR877	86	+	NR_030615	30552194	30552194	1
chr6	30585485	30594174	MRPS18B	8689	+	NM_014046	30585642	30593574	7
chr6	30614815	30620987	C6orf136	6172	+	NM_001109938	30615008	30620692	6
chr6	30644165	30655672	PPP1R18	11507	-	NM_133471	30645045	30653795	3
chr6	30655823	30659197	NRM	3374	-	NM_007243	30656437	30658751	5
chr6	30667583	30685458	MDC1	17875	-	NM_014641	30668241	30682952	15
chr6	30670843	30680961	MDC1-AS1	10118	+	NR_133647	30680961	30680961	3
chr6	30710975	30712327	IER3	1352	-	NM_003897	30711712	30712295	2
chr6	30858659	30858749	MIR4640	90	+	NR_039783	30858749	30858749	1
chr6	30875976	30881880	GTF2H4	5904	+	NM_001517	30876813	30881760	14
chr6	30899126	30899952	SFTA2	826	-	NM_205854	30899264	30899873	3
chr6	30908776	30921998	DPCR1	13222	+	NM_080870	30908776	30920894	3
chr6	31078999	31080332	C6orf15	1333	-	NM_014070	31079157	31080332	2
chr6	31105310	31107127	PSORS1C2	1817	-	NM_014069	31105727	31106803	2
chr6	31236525	31239913	HLA-C	3388	-	NM_002117	31236945	31239848	8
chr6	31430956	31433586	HCP5	2630	+	NR_040662	31433586	31433586	2
chr6	31439005	31440185	HCG26	1180	+	NR_002812	31440185	31440185	1
chr6	31496738	31498008	MCCD1	1270	+	NM_001011700	31496791	31497712	2
chr6	31497995	31510252	DDX39B	12257	-	NM_004640	31498210	31508309	11
chr6	31497995	31514625	ATP6V1G2-DDX39B	16630	-	NR_037853	31514625	31514625	13
chr6	31504150	31504226	SNORD117	76	-	NR_003140	31504226	31504226	1
chr6	31508877	31508955	SNORD84	78	-	NR_003065	31508955	31508955	1
chr6	31510080	31510915	DDX39B-AS1	835	+	NR_133674	31510915	31510915	2
chr6	31512227	31514625	ATP6V1G2	2398	-	NM_130463	31513184	31514336	3
chr6	31514627	31526606	NFKBIL1	11979	+	NM_001144962	31515951	31526388	4
chr6	31556659	31560762	NCR3	4103	-	NM_147130	31556843	31560498	4
chr6	31582993	31584798	AIF1	1805	+	NM_004847	31583888	31584287	3
chr6	31588449	31605554	PRRC2A	17105	+	NM_080686	31590566	31605363	31
chr6	31590855	31590987	SNORA38	132	+	NR_002971	31590987	31590987	1
chr6	31601563	31601635	MIR6832	72	+	NR_106890	31601635	31601635	1
chr6	31620186	31625987	APOM	5801	+	NM_001256169	31624350	31625866	6
chr6	31638727	31640227	LY6G5B	1500	+	NM_021221	31638727	31640059	3
chr6	31668805	31668868	MIR4646	63	-	NR_039789	31668868	31668868	1
chr6	31679752	31681842	LY6G6E	2090	-	NR_024541	31681842	31681842	3
chr6	31686424	31689511	LY6G6C	3087	-	NM_025261	31686872	31689456	3
chr6	31694813	31698042	DDAH2	3229	-	NM_013974	31695013	31696938	7
chr6	31733370	31745108	VWA7	11738	-	NM_025258	31733370	31744556	17
chr6	31745296	31763712	VARS	18416	-	NM_006295	31745370	31762994	30
chr6	31777395	31782835	HSPA1L	5440	-	NM_005527	31777823	31779749	2
chr6	31783290	31785719	HSPA1A	2429	+	NM_005345	31783533	31785459	1
chr6	31802691	31807543	C6orf48	4852	+	NM_001287486	31805105	31807440	5
chr6	31803039	31803103	SNORD48	64	+	NR_002745	31803103	31803103	1
chr6	31804852	31804916	SNORD52	64	+	NR_002742	31804916	31804916	1
chr6	31826828	31830709	NEU1	3881	-	NM_000434	31827495	31830553	6
chr6	31913720	31919861	CFB	6141	+	NM_001710	31913998	31919807	18
chr6	31919863	31926864	NELFE	7001	-	NM_002904	31920077	31926223	11
chr6	31924615	31924717	MIR1236	102	-	NR_031601	31924717	31924717	1
chr6	31926580	31937532	SKIV2L	10952	+	NM_006929	31926969	31937492	28
chr6	31937587	31940032	DXO	2445	-	NM_005510	31937653	31939452	7
chr6	32083044	32096017	ATF6B	12973	-	NM_004381	32083515	32095984	18
chr6	32096483	32098067	FKBPL	1584	-	NM_022110	32096507	32097557	2
chr6	32116139	32119720	PRRT1	3581	-	NM_030651	32116998	32119604	4
chr6	32135982	32145888	AGPAT1	9906	-	NM_032741	32137052	32139273	7
chr6	32137806	32137893	MIR6721	87	-	NR_106779	32137893	32137893	1
chr6	32146161	32148570	RNF5	2409	+	NM_006913	32146288	32148103	6
chr6	32146231	32148567	RNF5P1	2336	+	NR_003129	32148567	32148567	6
chr6	32147592	32147653	MIR6833	61	+	NR_106891	32147653	32147653	1
chr6	32148744	32152099	AGER	3355	-	NM_001206929	32148919	32151999	11
chr6	32152509	32157963	PBX2	5454	-	NM_002586	32154158	32157692	9
chr6	32158542	32163300	GPSM3	4758	-	NM_022107	32159142	32160290	8
chr6	32485153	32498006	HLA-DRB5	12853	-	NM_002125	32485515	32498001	6
chr6	32520489	32527779	HLA-DRB6	7290	-	NR_001298	32527779	32527779	6
chr6	32605182	32611429	HLA-DQA1	6247	+	NM_002122	32605235	32610541	5
chr6	32717688	32717756	MIR3135B	68	-	NR_039668	32717756	32717756	1
chr6	32780539	32784825	HLA-DOB	4286	-	NM_002120	32780992	32784728	6
chr6	32808493	32812712	PSMB8	4219	-	NM_004159	32808735	32812190	6
chr6	32811862	32814277	PSMB8-AS1	2415	+	NR_037175	32814277	32814277	3
chr6	32812985	32821748	TAP1	8763	-	NM_000593	32813355	32821593	11
chr6	32902405	32908847	HLA-DMB	6442	-	NM_002118	32902747	32908584	6
chr6	33080292	33096890	HLA-DPB2	16598	+	NR_001435	33096890	33096890	5
chr6	33130468	33160245	COL11A2	29777	-	NM_080680	33131454	33160017	66
chr6	33168602	33172214	SLC39A7	3612	+	NM_001077516	33169022	33171590	8
chr6	33175611	33175721	MIR219A1	110	+	NR_029633	33175721	33175721	1
chr6	33176285	33180499	RING1	4214	+	NM_002931	33176599	33180176	7
chr6	33217312	33222667	HCG25	5355	+	NR_044997	33222667	33222667	5
chr6	33244916	33246602	B3GALT4	1686	+	NM_003782	33245196	33246333	1
chr6	33255003	33255066	MIR6873	63	-	NR_106933	33255066	33255066	1
chr6	33257373	33258711	PFDN6	1338	+	NM_001265595	33257633	33258622	5
chr6	33258021	33258102	MIR6834	81	+	NR_106892	33258102	33258102	1
chr6	33259430	33267165	RGL2	7735	-	NM_004761	33259878	33266387	18
chr6	33285441	33285461	MIR1234	20	-	NR_031600	33285461	33285461	1
chr6	33378772	33384230	PHF1	5458	+	NR_027692	33384230	33384230	15
chr6	33384318	33386065	CUTA	1747	-	NM_001014433	33384426	33385962	6
chr6	33387846	33421466	SYNGAP1	33620	+	NM_006772	33388041	33419683	19
chr6	33406107	33406214	MIR5004	107	+	NR_049800	33406214	33406214	1
chr6	33422355	33425320	ZBTB9	2965	+	NM_152735	33422877	33424299	2
chr6	33540322	33548070	BAK1	7748	-	NM_001188	33541579	33545381	6
chr6	33551475	33556803	GGNBP1	5328	+	NR_028361	33556803	33556803	6
chr6	33553882	33561115	LINC00336	7233	-	NR_027908	33561115	33561115	2
chr6	33589155	33664348	ITPR3	75193	+	NM_002224	33589379	33663557	58
chr6	33664537	33679528	UQCC2	14991	-	NM_032340	33665429	33679463	4
chr6	33665904	33666011	MIR3934	107	+	NR_037498	33666011	33666011	1
chr6	33689442	33714762	IP6K3	25320	-	NM_001142883	33690496	33703253	7
chr6	33738989	33756906	LEMD2	17917	-	NM_181336	33740404	33756893	9
chr6	33762448	33771793	MLN	9345	-	NM_001040109	33762601	33768940	5
chr6	33857287	33864684	LINC01016	7397	-	NR_038989	33864684	33864684	3
chr6	33866911	33866977	MIR7159	66	+	NR_106982	33866977	33866977	1
chr6	33967748	33967828	MIR1275	80	-	NR_031681	33967828	33967828	1
chr6	33986419	34123399	GRM4	136980	-	NM_001256809	33990597	34123167	9
chr6	34204576	34214008	HMGA1	9432	+	NM_002131	34208557	34212661	6
chr6	34208449	34208513	MIR6835	64	+	NR_106893	34208513	34208513	1
chr6	34214156	34216885	C6orf1	2729	-	NM_178508	34214290	34215262	5
chr6	34254972	34360457	NUDT3	105485	-	NM_006703	34256529	34360139	5
chr6	34254972	34393902	RPS10-NUDT3	138930	-	NM_001202470	34256529	34392998	9
chr6	34385230	34393902	RPS10	8672	-	NM_001204091	34385282	34392998	6
chr6	34433837	34503000	PACSIN1	69163	+	NM_020804	34494082	34500307	10
chr6	34505578	34524110	SPDEF	18532	-	NM_012391	34506050	34512232	6
chr6	34555056	34664627	C6orf106	109571	-	NM_024294	34558341	34664380	5
chr6	34724870	34741634	SNRPC	16764	+	NM_003093	34725320	34741347	6
chr6	34759793	34845291	UHRF1BP1	85498	+	NM_017754	34760027	34840215	21
chr6	34845554	34855848	TAF11	10294	-	NM_005643	34846366	34855734	5
chr6	34857037	35059190	ANKS1A	202153	+	NM_015245	34857179	35056386	24
chr6	35085848	35109187	TCP11	23339	-	NM_001261821	35086045	35103930	11
chr6	35181838	35220856	SCUBE3	39018	+	NM_152753	35182195	35216482	22
chr6	35227490	35263764	ZNF76	36274	+	NM_003427	35248928	35263025	14
chr6	35265594	35289548	DEF6	23954	+	NM_022047	35265633	35289187	11
chr6	35310334	35395968	PPARD	85634	+	NM_001171818	35378864	35393856	9
chr6	35420137	35434881	FANCE	14744	+	NM_021922	35420322	35434122	10
chr6	35436177	35438558	RPL10A	2381	+	NM_007104	35436211	35438527	6
chr6	35438284	35438356	MIR7111	72	+	NR_106961	35438356	35438356	1
chr6	35441373	35464861	TEAD3	23488	-	NM_003214	35442820	35454439	13
chr6	35465650	35480679	TULP1	15029	-	NM_003322	35466103	35480635	15
chr6	35541361	35696360	FKBP5	154999	-	NM_001145775	35543611	35610601	12
chr6	35632493	35632566	MIR5690	73	-	NR_049873	35632566	35632566	1
chr6	35694538	35704724	LOC285847	10186	-	NR_027117	35704724	35704724	10
chr6	35704808	35716690	ARMC12	11882	+	NM_001286576	35704885	35716647	6
chr6	35744370	35747329	CLPSL2	2959	+	NM_001286550	35744395	35747307	4
chr6	35748830	35755841	CLPSL1	7011	+	NM_001010886	35748887	35755787	3
chr6	35762758	35765121	CLPS	2363	-	NM_001252597	35762922	35764627	4
chr6	35773070	35791852	LHFPL5	18782	+	NM_182548	35773447	35787224	4
chr6	35800810	35888957	SRPK1	88147	-	NM_003137	35803080	35888833	16
chr6	35911290	35992413	SLC26A8	81123	-	NM_052961	35911676	35987484	20
chr6	35995453	36079013	MAPK14	83560	+	NM_001315	35995934	36076224	12
chr6	36098260	36112301	MAPK13	14041	+	NM_002754	36098359	36107150	12
chr6	36164549	36200567	BRPF3	36018	+	NM_015695	36168099	36198386	13
chr6	36210944	36276372	PNPLA1	65428	+	NM_001145716	36259176	36275493	8
chr6	36283534	36304662	C6orf222	21128	-	NM_001010903	36285132	36298467	12
chr6	36321997	36355577	ETV7	33580	-	NM_001207035	36322418	36355318	8
chr6	36358328	36410666	PXT1	52338	-	NM_152990	36359546	36393859	5
chr6	36410543	36458920	KCTD20	48377	+	NM_173562	36437874	36454952	8
chr6	36461659	36515293	STK38	53634	-	NM_007271	36463560	36507979	14
chr6	36562089	36572244	SRSF3	10155	+	NR_036610	36572244	36572244	7
chr6	36590212	36590289	MIR3925	77	-	NR_037491	36590289	36590289	1
chr6	36641397	36642903	PANDAR	1506	-	NR_109836	36642903	36642903	1
chr6	36644236	36655116	CDKN1A	10880	+	NM_001220777	36651878	36653577	3
chr6	36665627	36700960	RAB44	35333	+	NM_001257357	36672012	36699870	14
chr6	36708554	36807220	CPNE5	98666	-	NM_020939	36710044	36807153	21
chr6	36822605	36842800	PPIL1	20195	-	NM_016059	36823588	36842548	4
chr6	36839645	36896740	C6orf89	57095	+	NM_001286636	36870125	36891217	10
chr6	36916038	36932613	PI16	16575	+	NM_001199159	36922536	36931720	8
chr6	36935910	36954327	MTCH1	18417	-	NM_001271641	36936678	36953949	12
chr6	36973422	36996845	FGD2	23423	+	NM_173558	36973593	36995939	16
chr6	37137921	37143204	PIM1	5283	+	NM_002648	37138351	37141867	6
chr6	37179953	37225931	TMEM217	45978	-	NR_104442	37225931	37225931	3
chr6	37225479	37300746	TBC1D22B	75267	+	NM_017772	37225693	37298948	13
chr6	37321747	37362514	RNF8	40767	+	NR_046399	37362514	37362514	8
chr6	37400906	37449284	CMTR1	48378	+	NM_015050	37403405	37447921	24
chr6	37450696	37467700	CCDC167	17004	-	NM_138493	37450961	37467639	4
chr6	37475123	37504056	LOC100505530	28933	+	NR_126057	37504056	37504056	4
chr6	37523140	37523198	MIR4462	58	-	NR_039669	37523198	37523198	1
chr6	37600283	37665766	MDGA1	65483	-	NM_153487	37605143	37664587	17
chr6	37787306	38122399	ZFAND3	335093	+	NM_021943	37787721	38120165	6
chr6	38136226	38607924	BTBD9	471698	-	NM_052893	38142760	38565870	12
chr6	38643701	38670952	GLO1	27251	-	NM_006708	38645070	38670830	6
chr6	38683116	38998574	DNAH8	315458	+	NM_001206927	38690585	38998168	93
chr6	38874270	38920883	LOC100131047	46613	-	NR_038401	38920883	38920883	5
chr6	39016556	39055520	GLP1R	38964	+	NM_002062	39016616	39053849	13
chr6	39071838	39082962	SAYSD1	11124	-	NM_001304793	39073207	39077095	3
chr6	39156746	39197251	KCNK5	40505	-	NM_003740	39158665	39196887	5
chr6	39266776	39282237	KCNK17	15461	-	NM_001135111	39268171	39282096	6
chr6	39282473	39290330	KCNK16	7857	-	NM_032115	39282777	39290316	6
chr6	39302875	39693181	KIF6	390306	-	NM_145027	39304307	39693086	23
chr6	39760158	39872653	DAAM2	112495	+	NM_001201427	39824078	39869813	25
chr6	39856565	39865156	LOC100505635	8591	-	NR_125831	39865156	39865156	4
chr6	39872033	39902290	MOCS1	30257	-	NM_001075098	39876822	39902156	11
chr6	40312083	40323745	LINC00951	11662	-	NR_038887	40323745	40323745	3
chr6	40346162	40347631	TDRG1	1469	+	NR_024015	40347631	40347631	2
chr6	40359372	40555203	LRFN2	195831	-	NM_020737	40359681	40400852	3
chr6	40846624	40991019	LOC101929555	144395	-	NR_110873	40991019	40991019	6
chr6	40994639	41006938	UNC5CL	12299	-	NM_173561	40996111	41002813	9
chr6	41010236	41012076	TSPO2	1840	+	NM_001010873	41010724	41011876	4
chr6	41020939	41032630	APOBEC2	11691	+	NM_006789	41021086	41029610	3
chr6	41034530	41040188	OARD1	5658	-	NM_145063	41035073	41039373	6
chr6	41040706	41070146	NFYA	29440	+	NM_002505	41046828	41065149	10
chr6	41068772	41108573	ADCY10P1	39801	+	NR_026938	41108573	41108573	23
chr6	41116998	41122087	TREML1	5089	-	NM_178174	41117341	41122026	6
chr6	41126243	41130924	TREM2	4681	-	NM_018965	41126501	41130820	5
chr6	41157486	41168925	TREML2	11439	-	NM_024807	41160164	41168746	5
chr6	41176291	41185685	TREML3P	9394	-	NR_027256	41185685	41185685	5
chr6	41196061	41206120	TREML4	10059	+	NM_198153	41196165	41204320	6
chr6	41217114	41217327	TREML5P	213	+	NR_002794	41217327	41217327	1
chr6	41242998	41254457	TREM1	11459	-	NM_018643	41243862	41254393	4
chr6	41303527	41318625	NCR2	15098	+	NM_001199509	41303614	41318441	6
chr6	41470181	41487590	LINC01276	17409	+	NR_120347	41487590	41487590	3
chr6	41491632	41516359	FOXP4-AS1	24727	-	NR_126415	41516359	41516359	2
chr6	41514163	41570122	FOXP4	55959	+	NM_001012427	41533498	41566674	17
chr6	41566460	41566526	MIR4641	66	+	NR_039784	41566526	41566526	1
chr6	41604914	41621982	MDFI	17068	+	NM_001300804	41606487	41621313	6
chr6	41651715	41703997	TFEB	52282	-	NM_001167827	41652336	41703903	9
chr6	41704448	41715139	PGC	10691	-	NM_002630	41704589	41715072	9
chr6	41737913	41747643	FRS3	9730	-	NM_006653	41738356	41744725	7
chr6	41748499	41755110	PRICKLE4	6611	+	NM_013397	41751211	41754867	8
chr6	41755180	41757634	TOMM6	2454	+	NM_001134493	41755435	41757066	3
chr6	41765382	41863099	USP49	97717	-	NM_018561	41766414	41774721	7
chr6	41873090	41888885	MED20	15795	-	NM_004275	41874809	41888756	4
chr6	41888964	41900784	BYSL	11820	+	NM_004053	41889300	41900444	7
chr6	41902670	42016632	CCND3	113962	-	NM_001136017	41903677	41908278	5
chr6	42018250	42048644	TAF8	30394	+	NM_138572	42018279	42045283	9
chr6	42068856	42110715	C6orf132	41859	-	NM_001164446	42071498	42110182	5
chr6	42123143	42147794	GUCA1A	24651	+	NM_000409	42141351	42147141	6
chr6	42151021	42162694	GUCA1B	11673	-	NM_002098	42152552	42162558	4
chr6	42174538	42185633	MRPS10	11095	-	NM_018141	42176026	42185587	7
chr6	42192670	42419789	TRERF1	227119	-	NM_033502	42196082	42237328	18
chr6	42531759	42661243	UBR2	129484	+	NM_015255	42532057	42658911	47
chr6	42664332	42690358	PRPH2	26026	-	NM_000322	42666032	42690072	3
chr6	42695313	42695932	ATP6V0CP3	619	+	NR_037141	42695932	42695932	1
chr6	42712233	42713884	TBCC	1651	-	NM_003192	42712770	42713811	1
chr6	42788793	42836296	GLTSCR1L	47503	+	NM_015349	42789760	42833184	12
chr6	42847670	42854731	RPL7L1	7061	+	NM_198486	42847675	42854202	6
chr6	42858002	42858554	C6orf226	552	-	NM_001008739	42858220	42858526	1
chr6	42883726	42893575	PTCRA	9849	+	NM_001243169	42883807	42893420	5
chr6	42896859	42907008	CNPY3	10149	+	NM_006586	42897308	42906529	6
chr6	42928499	42931618	GNMT	3119	+	NM_018960	42928505	42931444	6
chr6	42931610	42946981	PEX6	15371	-	NM_000287	42932072	42946888	17
chr6	42952236	42980083	PPP2R5D	27847	+	NM_001270476	42974779	42979024	16
chr6	42979966	42981618	MEA1	1652	-	NM_014623	42980207	42981551	4
chr6	42981840	42989036	KLHDC3	7196	+	NM_057161	42984930	42988471	11
chr6	42989384	42997337	RRP36	7953	+	NM_033112	42989392	42996966	7
chr6	43005354	43021683	CUL7	16329	-	NM_014780	43005425	43020526	26
chr6	43021766	43027283	MRPL2	5517	-	NM_015950	43022011	43027119	7
chr6	43027331	43042837	KLC4	15506	+	NM_201521	43029073	43042410	16
chr6	43044005	43129458	PTK7	85453	+	NM_002821	43044226	43128619	20
chr6	43139032	43149244	SRF	10212	+	NM_003131	43139394	43146928	7
chr6	43149921	43192325	CUL9	42404	+	NM_015089	43152048	43192183	41
chr6	43193366	43197211	DNPH1	3845	-	NM_006443	43193470	43197194	4
chr6	43211221	43255997	TTBK1	44776	+	NM_032538	43214398	43253114	15
chr6	43265997	43273276	SLC22A7	7279	+	NM_153320	43266096	43272463	10
chr6	43273210	43276530	CRIP3	3320	-	NM_206922	43273551	43276530	8
chr6	43303807	43337181	ZNF318	33374	-	NM_014345	43304895	43337103	10
chr6	43395291	43418163	ABCC10	22872	+	NM_001198934	43395716	43417829	22
chr6	43402279	43402358	MIR6780B	79	+	NR_106894	43402358	43402358	1
chr6	43418089	43424370	DLK2	6281	-	NM_206539	43418276	43422563	6
chr6	43445260	43474294	TJAP1	29034	+	NM_001146016	43466739	43473593	11
chr6	43474702	43478081	LRRC73	3379	-	NM_001271882	43474975	43476561	6
chr6	43479564	43484728	YIPF3	5164	-	NM_015388	43479904	43484545	9
chr6	43484776	43489246	POLR1C	4470	+	NM_203290	43484847	43489038	9
chr6	43490067	43543812	XPO5	53745	-	NM_020750	43491605	43543601	32
chr6	43543877	43588260	POLH	44383	+	NM_006502	43550056	43582294	11
chr6	43588217	43596983	GTPBP2	8766	-	NM_019096	43589350	43596899	12
chr6	43597278	43608688	MAD2L1BP	11410	+	NM_001003690	43597486	43608270	4
chr6	43612766	43638748	RSPH9	25982	+	NM_001193341	43612835	43638724	6
chr6	43638933	43655549	MRPS18A	16616	-	NM_018135	43639498	43655516	6
chr6	43737945	43754223	VEGFA	16278	+	NM_003376	43738443	43752299	8
chr6	43858764	43905944	LINC01512	47180	+	NR_024478	43905944	43905944	2
chr6	43963460	44042389	LOC101929705	78929	-	NR_125864	44042389	44042389	5
chr6	43968336	43973694	C6orf223	5358	+	NM_153246	43968356	43970863	4
chr6	44081372	44095191	MRPL14	13819	-	NM_032111	44081579	44084348	3
chr6	44095375	44123256	TMEM63B	27881	+	NM_018426	44102321	44122620	24
chr6	44126547	44152139	CAPN11	25592	+	NM_007058	44126585	44151669	23
chr6	44184675	44185973	LOC101929726	1298	+	NM_001315494	44185208	44185463	2
chr6	44187241	44201888	SLC29A1	14647	+	NM_001304462	44187433	44201265	14
chr6	44213902	44221625	HSP90AB1	7723	+	NM_001271970	44216366	44221335	12
chr6	44221837	44225627	SLC35B2	3790	-	NM_001286511	44222442	44224479	4
chr6	44221942	44222022	MIR4647	80	-	NR_039790	44222022	44222022	1
chr6	44225902	44233525	NFKBIE	7623	-	NM_004556	44226955	44233500	6
chr6	44238479	44247182	TMEM151B	8703	+	NM_001137560	44238479	44244264	3
chr6	44247896	44265458	TCTE1	17562	-	NM_182539	44247917	44255562	5
chr6	44266462	44281063	AARS2	14601	-	NM_020745	44268283	44281060	22
chr6	44310396	44344904	SPATS1	34508	+	NM_145026	44310832	44344800	9
chr6	44355250	44418161	CDC5L	62911	+	NM_001253	44355560	44414448	16
chr6	44403377	44403459	MIR4642	82	+	NR_039785	44403459	44403459	1
chr6	44794466	45345788	SUPT3H	551322	-	NM_181356	44797552	45290653	13
chr6	45165410	45165507	MIR586	97	-	NR_030313	45165507	45165507	1
chr6	45296053	45518819	RUNX2	222766	+	NM_001024630	45296463	45515042	9
chr6	45866189	46048085	CLIC5	181896	-	NM_001114086	45870824	46047979	6
chr6	46097700	46114436	ENPP4	16736	+	NM_014936	46107320	46111377	4
chr6	46126918	46138747	ENPP5	11829	-	NM_001290072	46129062	46135999	5
chr6	46188466	46459804	RCAN2	271338	-	NM_001251973	46190877	46424713	5
chr6	46244060	46333242	LOC101926915	89182	+	NR_125838	46333242	46333242	4
chr6	46459788	46501217	LOC101926898	41429	+	NR_125837	46501217	46501217	3
chr6	46517316	46620567	CYP39A1	103251	-	NM_001278738	46518102	46620319	12
chr6	46620651	46645927	SLC25A27	25276	+	NM_001204051	46620929	46644386	9
chr6	46655611	46672056	TDRD6	16445	+	NM_001010870	46655865	46669624	4
chr6	46672052	46703430	PLA2G7	31378	-	NM_001168357	46672296	46690628	12
chr6	46714653	46726954	ANKRD66	12301	+	NM_001162435	46714658	46726658	5
chr6	46761093	46807519	MEP1A	46426	+	NM_005588	46761135	46806873	14
chr6	46820241	46922675	ADGRF5	102434	-	NM_015234	46821728	46874499	21
chr6	46871207	46877764	LOC101926962	6557	+	NR_110658	46877764	46877764	4
chr6	46965439	47010099	ADGRF1	44660	-	NM_153840	46967958	46996797	15
chr6	47199262	47277683	TNFRSF21	78421	-	NM_014452	47200500	47277247	6
chr6	47445524	47594996	CD2AP	149472	+	NM_012120	47445980	47591963	18
chr6	47624325	47665533	ADGRF2	41208	+	NM_153839	47641155	47658301	11
chr6	47666288	47689757	ADGRF4	23469	+	NM_153838	47674981	47686178	10
chr6	47749774	47794116	OPN5	44342	+	NM_181744	47749802	47791727	7
chr6	47845763	48036425	PTCHD4	190662	-	NM_001013732	47846038	48036391	3
chr6	49398072	49431041	MUT	32969	-	NM_000255	49399440	49427179	13
chr6	49431095	49460820	CENPQ	29725	+	NM_018132	49437889	49459988	9
chr6	49467670	49495777	GLYATL3	28107	+	NM_001010904	49479703	49494627	6
chr6	49518112	49519808	C6orf141	1696	+	NM_001145652	49518505	49519240	1
chr6	49572889	49604587	RHAG	31698	-	NM_000324	49573525	49604525	10
chr6	49660070	49681303	CRISP2	21233	-	NM_001142408	49660485	49676909	10
chr6	49695091	49712168	CRISP3	17077	-	NM_006061	49696442	49712080	8
chr6	49753363	49755053	PGK2	1690	-	NM_138733	49753646	49754900	1
chr6	49779252	49788216	LOC101927020	8964	+	NR_125839	49788216	49788216	4
chr6	49783205	49792479	LOC101927048	9274	-	NR_110843	49792479	49792479	5
chr6	49801978	49844809	CRISP1	42831	-	NM_001205220	49803028	49825113	8
chr6	49913813	49917157	DEFB133	3344	-	NM_001166478	49913813	49917157	2
chr6	49928004	49931818	DEFB114	3814	-	NM_001037499	49928004	49931818	2
chr6	49936389	49937338	DEFB113	949	-	NM_001037729	49936389	49937338	2
chr6	49976850	49989694	DEFB110	12844	-	NM_001037728	49976850	49989648	2
chr6	50011287	50016364	DEFB112	5077	-	NM_001037498	50011287	50016364	2
chr6	50681256	50740746	TFAP2D	59490	+	NM_172238	50681768	50740577	8
chr6	50786438	50815326	TFAP2B	28888	+	NM_003221	50786604	50811105	7
chr6	51480144	51952423	PKHD1	472279	-	NM_138694	51483878	51949731	67
chr6	51486667	51487375	LOC101927082	708	+	NR_125840	51487375	51487375	2
chr6	52009146	52009232	MIR206	86	+	NR_029713	52009232	52009232	1
chr6	52011611	52015821	LINCMD1	4210	-	NR_131248	52015821	52015821	3
chr6	52013720	52013839	MIR133B	119	+	NR_029903	52013839	52013839	1
chr6	52051184	52055436	IL17A	4252	+	NM_002190	52051229	52054090	3
chr6	52101483	52109298	IL17F	7815	-	NM_052872	52101728	52109227	3
chr6	52128811	52149679	MCM3	20868	-	NM_002388	52129385	52149607	17
chr6	52226925	52272575	PAQR8	45650	+	NM_133367	52268011	52269076	2
chr6	52284993	52360583	EFHC1	75590	+	NM_018100	52285208	52357139	11
chr6	52362199	52441862	TRAM2	79663	-	NM_012288	52367994	52441713	11
chr6	52441999	52448791	TRAM2-AS1	6792	+	NR_103446	52448791	52448791	3
chr6	52529198	52533951	LOC730101	4753	+	NR_024405	52533951	52533951	3
chr6	52535883	52551385	TMEM14A	15502	+	NM_014051	52541900	52550847	5
chr6	52604260	52609957	GSTA7P	5697	-	NR_033760	52609957	52609957	1
chr6	52614884	52628361	GSTA2	13477	-	NM_000846	52615374	52622745	7
chr6	52656177	52668664	GSTA1	12487	-	NM_145740	52656655	52664065	7
chr6	52696540	52710893	GSTA5	14353	-	NM_153699	52696645	52705611	7
chr6	52761438	52774496	GSTA3	13058	-	NM_000847	52761603	52770632	7
chr6	52842745	52860178	GSTA4	17433	-	NM_001512	52843267	52859041	7
chr6	52866097	52926600	ICK	60503	-	NM_016513	52869946	52906034	15
chr6	52929795	52965670	FBXO9	35875	+	NM_033481	52938290	52962628	13
chr6	52991759	53013624	GCM1	21865	-	NM_003643	52993003	53010430	6
chr6	53132195	53213977	ELOVL5	81782	-	NM_001242828	53133924	53160497	9
chr6	53141790	53141869	MIR5685	79	+	NR_049866	53141869	53141869	1
chr6	53199257	53202415	RPS16P5	3158	-	NR_046241	53202415	53202415	1
chr6	53362139	53409927	GCLC	47788	-	NM_001498	53363553	53409443	16
chr6	53426086	53438073	LOC101927136	11987	-	NR_110840	53438073	53438073	4
chr6	53493177	53496192	LINC01564	3015	+	NR_125841	53496192	53496192	3
chr6	53512698	53530506	KLHL31	17808	-	NM_001003760	53516395	53520070	3
chr6	53659777	53788919	LRRC1	129142	+	NM_018214	53660054	53787591	14
chr6	53794779	53862465	LOC101927189	67686	+	NR_125842	53862465	53862465	4
chr6	53863687	53871950	MLIP-IT1	8263	+	NR_046832	53871950	53871950	4
chr6	53883713	54131078	MLIP	247365	+	NM_138569	53883826	54130753	13
chr6	54173202	54254950	TINAG	81748	+	NM_014464	54173348	54254723	11
chr6	54711568	54809897	FAM83B	98329	+	NM_001010872	54735044	54806805	5
chr6	55039070	55147418	HCRTR2	108348	+	NM_001526	55039385	55147252	7
chr6	55192266	55267291	GFRAL	75025	+	NM_207410	55192352	55266651	9
chr6	55299170	55444012	HMGCLL1	144842	-	NM_019036	55300459	55443853	10
chr6	55620237	55740375	BMP5	120138	-	NM_021073	55620330	55739663	7
chr6	55921387	56112378	COL21A1	190991	-	NM_030820	55922454	56047416	30
chr6	56322784	56819426	DST	496642	-	NM_001144769	56323802	56819385	97
chr6	56708783	56729136	LOC101930010	20353	+	NR_125866	56729136	56729136	4
chr6	56819772	56892142	BEND6	72370	+	NM_152731	56846608	56883346	7
chr6	56911329	56920037	KIAA1586	8708	+	NM_001286275	56917498	56919661	4
chr6	56954827	57035098	ZNF451	80271	+	NM_001031623	56955051	57033267	15
chr6	56979708	57037011	LOC101927211	57303	-	NR_110742	57037011	57037011	4
chr6	57037103	57050012	BAG2	12909	+	NM_004282	57037495	57048988	3
chr6	57051790	57087112	RAB23	35322	-	NM_001278667	57055258	57075178	7
chr6	57125321	57128144	LOC100506188	2823	-	NR_109774	57128144	57128144	3
chr6	57182414	57513376	PRIM2	330962	+	NM_000947	57183243	57512702	15
chr6	57254929	57255010	MIR548U	81	+	NR_036097	57255010	57255010	1
chr6	58234830	58263207	GUSBP4	28377	-	NR_132999	58263207	58263207	5
chr6	58246158	58287724	LINC00680-GUSBP4	41566	-	NR_132997	58287724	58287724	9
chr6	58272111	58287724	LINC00680	15613	-	NR_132994	58287724	58287724	6
chr6	62284007	62284534	MTRNR2L9	527	+	NM_001190706	62284232	62284307	1
chr6	62389864	62996100	KHDRBS2	606236	-	NM_152688	62390867	62995853	9
chr6	63985855	64029882	LGSN	44027	-	NM_001143940	63990407	64029848	5
chr6	64281916	64293493	PTP4A1	11577	+	NM_003463	64286785	64290079	6
chr6	64345706	64425418	PHF3	79712	+	NM_001290259	64389920	64423604	17
chr6	64429875	66417118	EYS	1987243	-	NM_001292009	64430491	66205303	44
chr6	66011310	66015504	LOC441155	4194	+	NM_001271675	66012414	66014832	2
chr6	66497771	66499376	SLC25A51P1	1605	+	NR_026540	66499376	66499376	1
chr6	68765242	68770394	LOC102723883	5152	+	NR_125869	68770394	68770394	2
chr6	68936861	69039791	LOC101928280	102930	-	NR_125854	69039791	69039791	4
chr6	69342554	69344216	LOC101928307	1662	-	NR_125872	69344216	69344216	2
chr6	69345631	70099403	ADGRB3	753772	+	NM_001704	69348567	70098783	32
chr6	70385640	70507049	LMBRD1	121409	-	NM_018368	70386049	70506773	16
chr6	70576447	70922157	COL19A1	345710	+	NM_001858	70589459	70916978	51
chr6	70925742	71012786	COL9A1	87044	-	NM_001851	70926599	71012627	38
chr6	71103904	71109120	EVADR	5216	+	NR_125857	71109120	71109120	4
chr6	71123106	71270877	FAM135A	147771	+	NM_001105531	71138045	71269624	22
chr6	71276624	71298606	SDHAF4	21982	+	NM_145267	71276643	71298427	3
chr6	71377473	71571716	SMAP1	194243	+	NM_001281439	71377726	71569937	11
chr6	71571068	71666788	B3GAT2	95720	-	NM_080742	71571365	71666132	4
chr6	71998476	72011973	OGFRL1	13497	+	NM_024576	71998639	72011752	7
chr6	72086662	72086734	MIR30C2	72	-	NR_029598	72086734	72086734	1
chr6	72113253	72113324	MIR30A	71	-	NR_029504	72113324	72113324	1
chr6	72117566	72130448	LINC00472	12882	-	NR_121612	72130448	72130448	4
chr6	72130729	72168575	LINC01626	37846	+	NR_121615	72168575	72168575	8
chr6	72596405	73112845	RIMS1	516440	+	NM_014989	72596726	73110416	34
chr6	73331570	73908573	KCNQ5	577003	+	NM_001160133	73331917	73905137	15
chr6	73340222	73388282	KCNQ5-IT1	48060	+	NR_120503	73388282	73388282	4
chr6	73677409	73677476	MIR4282	67	-	NR_036244	73677476	73677476	1
chr6	73844525	73853237	KCNQ5-AS1	8712	-	NR_046621	73853237	73853237	5
chr6	73933267	73935175	KHDC1L	1908	-	NM_001126063	73933470	73935131	3
chr6	73951037	74019938	KHDC1	68901	-	NM_001251874	73951251	74019437	5
chr6	74062784	74063999	DPPA5	1215	-	NM_001025290	74063042	74063948	3
chr6	74072399	74073898	KHDC3L	1499	+	NM_001017361	74072452	74073583	3
chr6	74078279	74079515	OOEP	1236	-	NM_001080507	74078506	74079515	3
chr6	74104284	74127289	DDX43	23005	+	NM_018665	74104628	74125949	17
chr6	74134855	74162043	MB21D1	27188	-	NM_138441	74134949	74161904	5
chr6	74171453	74211179	MTO1	39726	+	NM_133645	74171577	74210458	13
chr6	74225472	74230755	EEF1A1	5283	-	NM_001402	74227532	74229749	8
chr6	74227967	74228161	SNORD141A	194	-	NR_132980	74228161	74228161	2
chr6	74227967	74228161	SNORD141B	194	-	NR_132981	74228161	74228161	2
chr6	74303101	74363737	SLC17A5	60636	-	NM_012434	74304799	74363609	11
chr6	74403625	74405854	LOC101928489	2229	-	NR_110889	74405854	74405854	2
chr6	74405807	74538041	CD109	132234	+	NM_001159587	74405938	74533357	33
chr6	74779166	75400443	LOC101928516	621277	+	NR_110856	75400443	75400443	4
chr6	75794041	75915623	COL12A1	121582	-	NM_004370	75796262	75912508	66
chr6	75947390	75953644	COX7A2	6254	-	NM_001865	75947645	75953546	4
chr6	75962637	75994632	TMEM30A	31995	-	NM_018247	75965817	75994354	7
chr6	75994729	76001580	LOC100506804	6851	+	NR_040081	76001580	76001580	3
chr6	76005582	76203545	FILIP1	197963	-	NM_001300866	76005625	76124688	7
chr6	76092901	76168615	LOC101928540	75714	+	NR_125859	76168615	76168615	9
chr6	76138122	76138189	MIR4463	67	+	NR_039670	76138189	76138189	1
chr6	76311224	76428001	SENP6	116777	+	NM_015571	76312240	76425310	24
chr6	76458892	76629254	MYO6	170362	+	NM_001300899	76527264	76624729	33
chr6	76630830	76782395	IMPG1	151565	-	NM_001563	76631805	76782205	17
chr6	78170564	78173739	HTR1B	3175	-	NM_000863	78171947	78173120	1
chr6	78400372	78634476	MEI4	234104	+	NM_001282136	78400388	78633063	4
chr6	79577260	79610683	IRAK1BP1	33423	+	NM_001010844	79577293	79608051	4
chr6	79644135	79788011	PHIP	143876	-	NM_017934	79650409	79787785	40
chr6	79910961	79944455	HMGN3	33494	-	NM_001201363	79911404	79944277	7
chr6	79943390	79946517	HMGN3-AS1	3127	+	NR_040671	79946517	79946517	2
chr6	80017385	80023101	LCAL1	5716	-	NR_130915	80023101	80023101	3
chr6	80194707	80247147	LCA5	52440	-	NM_181714	80196720	80228611	9
chr6	80340821	80413387	SH3BGRL2	72566	+	NM_031469	80341178	80409226	4
chr6	80451635	80451669	RNY4	34	+	NR_004393	80451669	80451669	1
chr6	80513299	80521963	LINC01621	8664	-	NR_131786	80521963	80521963	5
chr6	80624528	80657315	ELOVL4	32787	-	NM_022726	80626324	80656996	6
chr6	80714321	80752244	TTK	37923	+	NM_003318	80715560	80751919	22
chr6	80816343	81055987	BCKDHB	239644	+	NM_000056	80816410	81053521	11
chr6	82455446	82462428	FAM46A	6982	-	NM_017633	82459411	82461858	3
chr6	82523002	82523909	LINC01526	907	-	NR_126363	82523909	82523909	2
chr6	82879703	82957471	IBTK	77768	-	NM_001300906	82881141	82950203	29
chr6	83072922	83077133	TPBG	4211	+	NM_006670	83074678	83075941	3
chr6	83602116	83775560	UBE3D	173444	-	NM_198920	83602740	83775437	10
chr6	83777384	83878190	DOPEY1	100806	+	NM_001199942	83806696	83877886	40
chr6	83874592	83903655	PGM3	29063	-	NM_001199917	83878952	83900987	14
chr6	83903031	83906256	RWDD2A	3225	+	NM_033411	83904170	83905991	3
chr6	83920109	84140938	ME1	220829	-	NM_002395	83921642	84140673	14
chr6	84222193	84235421	PRSS35	13228	+	NM_001170423	84233160	84234402	3
chr6	84262604	84419127	SNAP91	156523	-	NM_001256717	84265871	84388521	30
chr6	84562984	84567234	RIPPLY2	4250	+	NM_001009994	84563135	84567108	4
chr6	84569369	84670146	CYB5R4	100777	+	NM_016230	84569501	84669597	16
chr6	84743419	84800605	MRAP2	57186	+	NM_138409	84765037	84799200	4
chr6	84833959	84937353	CEP162	103394	-	NM_001286206	84834788	84925584	27
chr6	85130750	85184647	LINC01611	53897	-	NR_132100	85184647	85184647	5
chr6	85399175	85419252	TBX18-AS1	20077	+	NR_125876	85419252	85419252	3
chr6	85442215	85473954	TBX18	31739	-	NM_001080508	85446402	85473899	8
chr6	86159301	86205509	NT5E	46208	+	NM_002526	86159857	86203722	9
chr6	86215214	86303874	SNX14	88660	-	NM_001304479	86215684	86284080	29
chr6	86317501	86353043	SYNCRIP	35542	-	NM_001159677	86322599	86351157	12
chr6	86386724	86388451	SNHG5	1727	-	NR_003038	86388451	86388451	6
chr6	86387011	86387086	SNORD50A	75	-	NR_002743	86387086	86387086	1
chr6	86387306	86387377	SNORD50B	71	-	NR_003044	86387377	86387377	1
chr6	87647023	87726397	HTR1E	79374	+	NM_000865	87725052	87726150	2
chr6	87795215	87804865	CGA	9650	-	NM_001252383	87795473	87797918	5
chr6	87865268	87973406	ZNF292	108138	+	NM_015021	87865309	87971519	8
chr6	87992696	88038996	GJB7	46300	-	NM_198568	87993958	87994630	3
chr6	88032305	88052046	SMIM8	19741	+	NM_001042493	88046749	88049992	4
chr6	88054570	88075181	C6orf163	20611	+	NM_001010868	88054817	88075114	5
chr6	88106841	88109459	LINC01590	2618	+	NR_026784	88109459	88109459	2
chr6	88117689	88174191	CFAP206	56502	+	NM_001031743	88119557	88173968	13
chr6	88182642	88222057	SLC35A1	39415	+	NM_006416	88182721	88221244	8
chr6	88224095	88299735	RARS2	75640	-	NM_020320	88224130	88299675	20
chr6	88299784	88377172	ORC3	77388	+	NM_012381	88299886	88376841	20
chr6	88384577	88411985	AKIRIN2	27408	-	NM_018064	88385314	88411402	5
chr6	88494577	88621449	LOC101928911	126872	+	NR_110869	88621449	88621449	5
chr6	88757506	88776550	SPACA1	19044	+	NM_030960	88757623	88776053	7
chr6	88849584	88875767	CNR1	26183	-	NM_001160258	88853574	88854993	4
chr6	89235642	89249088	LOC101928936	13446	-	NR_110867	89249088	89249088	3
chr6	89319615	89673348	RNGTT	353733	-	NM_003800	89322437	89673128	16
chr6	89790428	89794879	PNRC1	4451	+	NM_006813	89790613	89793915	2
chr6	89805677	89827800	SRSF12	22123	-	NM_080743	89808296	89827606	5
chr6	89855768	89875288	PM20D2	19520	+	NM_001010853	89855863	89871982	7
chr6	89887222	89941007	GABRR1	53785	-	NM_001267582	89888488	89910896	12
chr6	89966839	90025018	GABRR2	58179	-	NM_002043	89967388	90024884	9
chr6	90036343	90062619	UBE2J1	26276	-	NM_016021	90039397	90062288	8
chr6	90074334	90121995	RRAGD	47661	-	NM_021244	90077774	90121712	7
chr6	90142896	90343553	ANKRD6	200657	+	NM_001242809	90276695	90340723	16
chr6	90341942	90348474	LYRM2	6532	-	NM_020466	90346991	90348435	3
chr6	90348250	90399200	LOC101929057	50950	+	NR_111915	90399200	90399200	4
chr6	90352493	90529513	MDN1	177020	-	NM_014611	90353723	90529326	102
chr6	90539618	90584155	CASP8AP2	44537	+	NM_001137668	90556308	90583528	10
chr6	90604187	90605819	GJA10	1632	+	NM_032602	90604187	90605819	1
chr6	90636246	91006627	BACH2	370381	-	NM_021813	90642126	90718563	9
chr6	91022460	91022552	MIR4464	92	+	NR_039671	91022552	91022552	1
chr6	91223291	91297020	MAP3K7	73729	-	NM_145331	91226219	91296602	17
chr6	92231377	92231455	MIR4643	78	+	NR_039786	92231455	92231455	1
chr6	92338757	92400146	CASC6	61389	-	NR_104154	92400146	92400146	4
chr6	93949739	94129300	EPHA7	179561	-	NM_004440	93953143	94129059	17
chr6	94416800	94486199	TSG1	69399	+	NR_015362	94486199	94486199	10
chr6	96007971	96025327	MANEA-AS1	17356	-	NR_104136	96025327	96025327	3
chr6	96025372	96057328	MANEA	31956	+	NM_024641	96034315	96054281	5
chr6	96463844	96663488	FUT9	199644	+	NM_006581	96651031	96652111	3
chr6	96969701	97003151	UFL1	33450	+	NM_015323	96969749	97001379	19
chr6	97010423	97064512	FHL5	54089	+	NM_020482	97051489	97063648	7
chr6	97241997	97285353	GPR63	43356	-	NM_001143957	97246347	97247607	3
chr6	97337186	97345767	NDUFAF4	8581	-	NM_014165	97338979	97345677	3
chr6	97372495	97588630	KLHL32	216135	+	NM_052904	97414936	97587158	11
chr6	97537842	97862283	MIR548H3	324441	-	NR_031679	97862283	97862283	3
chr6	97590036	97731052	MMS22L	141016	-	NM_198468	97594681	97730353	25
chr6	97753461	98156793	LOC101927314	403332	+	NR_110757	98156793	98156793	5
chr6	98472406	98472495	MIR2113	89	+	NR_031579	98472495	98472495	1
chr6	99282579	99286666	POU3F2	4087	+	NM_005604	99282749	99284081	1
chr6	99321600	99395882	FBXL4	74282	-	NM_001278716	99322153	99374864	10
chr6	99720792	99797531	FAXC	76739	-	NM_032511	99729039	99797248	6
chr6	99817347	99842082	COQ3	24735	-	NM_017421	99817475	99842055	7
chr6	99847840	99873207	PNISR	25367	-	NM_032870	99848415	99862535	12
chr6	99872746	99879190	LOC101927365	6444	+	NR_125843	99879190	99879190	3
chr6	99880183	99963252	USP45	83069	-	NM_001080481	99883591	99958096	18
chr6	99968869	99981059	TSTD3	12190	+	NM_001195131	99973954	99979596	4
chr6	99990262	100016690	CCNC	26428	-	NM_005190	99991430	100016403	12
chr6	100054649	100063454	PRDM13	8805	+	NM_021620	100054910	100062635	4
chr6	100367785	100442114	MCHR2	74329	-	NM_032503	100368815	100404023	6
chr6	100441913	100524295	MCHR2-AS1	82382	+	NR_038384	100524295	100524295	3
chr6	100836749	100911551	SIM1	74802	-	NM_005068	100838236	100911344	11
chr6	100956070	101329248	ASCC3	373178	-	NM_006828	100957261	101315873	42
chr6	101846860	102517958	GRIK2	671098	+	NM_001166247	101847153	102513788	17
chr6	105175967	105307794	HACE1	131827	-	NR_104424	105307794	105307794	26
chr6	105384168	105388402	LINC00577	4234	-	NR_046407	105388402	105388402	3
chr6	105404922	105531207	LIN28B	126285	+	NM_001004317	105405125	105526658	4
chr6	105544698	105585049	BVES	40351	-	NM_001199563	105548963	105581452	8
chr6	105585561	105617819	BVES-AS1	32258	+	NR_037157	105617819	105617819	4
chr6	105605774	105627858	POPDC3	22084	-	NM_022361	105606344	105609784	4
chr6	105725441	105850999	PREP	125558	-	NM_002726	105726018	105850766	15
chr6	106534194	106557814	PRDM1	23620	+	NM_001198	106534428	106555361	7
chr6	106632351	106773695	ATG5	141344	-	NM_004849	106634414	106764083	8
chr6	106959729	107018324	AIM1	58595	+	NM_001624	106960216	107016441	20
chr6	107018902	107077373	RTN4IP1	58471	-	NM_032730	107019870	107076896	9
chr6	107077440	107116292	QRSL1	38852	+	NM_018292	107077556	107113877	11
chr6	107165326	107235300	LOC100422737	69974	-	NR_033557	107235300	107235300	7
chr6	107231999	107232095	MIR587	96	+	NR_030314	107232095	107232095	1
chr6	107349375	107372790	C6orf203	23415	+	NM_001142470	107351308	107372440	5
chr6	107386384	107435636	BEND3	49252	-	NM_001080450	107389907	107420489	5
chr6	107473760	107780779	PDSS2	307019	-	NM_020381	107475822	107780489	8
chr6	107811316	107982513	SOBP	171197	+	NM_018013	107811820	107956670	7
chr6	108023360	108145521	SCML4	122161	-	NM_198081	108026403	108093531	8
chr6	108188959	108279482	SEC63	90523	-	NM_007214	108192907	108279213	21
chr6	108362612	108395941	OSTM1	33329	-	NM_014028	108365988	108395855	6
chr6	108487261	108510013	NR2E1	22752	+	NM_003269	108487969	108508667	9
chr6	108532420	108582464	SNX3	50044	-	NM_003795	108533352	108582125	4
chr6	108616097	108844251	LACE1	228154	+	NM_145315	108616283	108843628	13
chr6	108881025	109005971	FOXO3	124946	+	NM_201559	108882411	108986058	4
chr6	109072856	109091145	LINC00222	18289	+	NR_033376	109091145	109091145	5
chr6	109169618	109295675	ARMC2	126057	+	NM_032131	109175470	109294717	18
chr6	109229342	109245306	ARMC2-AS1	15964	-	NR_104137	109245306	109245306	3
chr6	109307639	109415708	SESN1	108069	-	NM_014454	109308746	109415276	10
chr6	109416355	109485115	CEP57L1	68760	+	NM_001083535	109466424	109484173	13
chr6	109557816	109591717	LOC100996634	33901	+	NM_001277339	109557863	109591574	10
chr6	109615505	109629423	CCDC162P	13918	+	NR_028595	109629423	109629423	4
chr6	109687716	109703762	CD164	16046	-	NM_001142403	109689481	109703581	7
chr6	109711417	109762374	PPIL6	50957	-	NR_104429	109762374	109762374	9
chr6	109761930	109765122	SMPD2	3192	+	NM_003080	109762324	109765108	10
chr6	109765265	109787171	MICAL1	21906	-	NM_001286613	109765393	109786880	25
chr6	109783718	109804440	ZBTB24	20722	-	NM_014797	109787053	109803229	7
chr6	109814058	110012415	AK9	198357	-	NM_001145128	109814571	109996948	41
chr6	110012423	110146634	FIG4	134211	+	NM_014845	110012638	110146468	23
chr6	110299458	110301923	GPR6	2465	+	NM_001286099	110299978	110301404	3
chr6	110421021	110501207	WASF1	80186	-	NM_003931	110421724	110448804	11
chr6	110501623	110553422	CDC40	51799	+	NM_015891	110501647	110551334	15
chr6	110567148	110679475	METTL24	112327	-	NM_001123364	110567148	110679475	5
chr6	110713382	110736753	DDO	23371	-	NM_003649	110713977	110736749	5
chr6	110745891	110797844	SLC22A16	51953	-	NM_033125	110746075	110797777	8
chr6	110931180	111137088	CDK19	205908	-	NM_001300964	110935737	111067352	13
chr6	111135823	111216915	AMD1	81092	+	NM_001287215	111210069	111214819	9
chr6	111279762	111289091	GTF3C6	9329	+	NM_138408	111279972	111288993	6
chr6	111303219	111349466	RPF2	46247	+	NM_032194	111303309	111346785	10
chr6	111367621	111368757	GSTM2P1	1136	-	NR_002932	111368757	111368757	1
chr6	111408780	111544606	SLC16A10	135826	+	NM_018593	111408955	111543438	6
chr6	111580481	111590261	KIAA1919	9780	+	NM_153369	111580903	111588322	4
chr6	111620233	111804918	REV3L	184685	-	NM_001286431	111621218	111737580	35
chr6	111804674	111923497	TRAF3IP2-AS1	118823	+	NR_034108	111923497	111923497	4
chr6	111876580	111927477	TRAF3IP2	50897	-	NM_001164281	111880607	111913289	9
chr6	111981534	112194655	FYN	213121	-	NM_002037	111982941	112041254	14
chr6	112375277	112390887	WISP3	15610	+	NR_125354	112390887	112390887	7
chr6	112391859	112408751	TUBE1	16892	-	NM_016262	112392614	112408637	12
chr6	112408673	112423993	FAM229B	15320	+	NM_001033564	112420486	112421990	4
chr6	112429133	112575917	LAMA4	146784	-	NM_002290	112430639	112575352	39
chr6	112557796	112627885	LOC101927640	70089	+	NR_121193	112627885	112627885	3
chr6	112668531	112672498	RFPL4B	3967	+	NM_001013734	112670910	112671702	3
chr6	113944736	113971277	LOC101927686	26541	-	NR_125844	113971277	113971277	3
chr6	114178513	114184652	MARCKS	6139	+	NM_002356	114178921	114181755	2
chr6	114189178	114194512	LINC01268	5334	-	NR_038863	114194512	114194512	3
chr6	114225550	114242806	FLJ34503	17256	+	NR_027060	114242806	114242806	4
chr6	114257319	114292359	HDAC2	35040	-	NR_033441	114292359	114292359	15
chr6	114290864	114661893	LOC101927768	371029	+	NR_125845	114661893	114661893	10
chr6	114376749	114384041	HS3ST5	7292	-	NM_153612	114378420	114384009	2
chr6	116262692	116381921	FRK	119229	-	NM_002031	116263576	116381474	8
chr6	116359893	116361107	TPI1P3	1214	+	NR_027338	116361107	116361107	1
chr6	116421998	116566853	NT5DC1	144855	+	NM_152729	116422093	116565187	12
chr6	116440084	116447296	COL10A1	7212	-	NM_000493	116441235	116446655	3
chr6	116571130	116575261	TSPYL4	4131	-	NM_021648	116573926	116575171	1
chr6	116596021	116601280	TSPYL1	5259	-	NM_003309	116599679	116600993	1
chr6	116601282	116759442	DSE	158160	+	NM_001080976	116720413	116758508	6
chr6	116782532	116784934	FAM26F	2402	+	NM_001010919	116783092	116784868	3
chr6	116817650	116866773	TRAPPC3L	49123	-	NM_001139444	116818116	116866677	5
chr6	116832807	116839709	FAM26E	6902	+	NM_153711	116832859	116837152	2
chr6	116850175	116880031	FAM26D	29856	+	NM_001256887	116875385	116879374	4
chr6	116892529	116914764	RWDD1	22235	+	NM_016104	116910022	116914264	9
chr6	116937641	116954148	RSPH4A	16507	+	NM_001010892	116937786	116953604	6
chr6	116956780	116989973	ZUFSP	33193	-	NM_145062	116956994	116988355	10
chr6	117002366	117063030	KPNA5	60664	+	NM_002269	117002497	117053486	15
chr6	117073359	117086886	FAM162B	13527	-	NM_001085480	117073759	117086739	4
chr6	117113247	117150220	GPRC6A	36973	-	NM_001286354	117113304	117150176	6
chr6	117198375	117253326	RFX6	54951	+	NM_173560	117198438	117252669	19
chr6	117586720	117594728	VGLL2	8008	+	NM_182645	117586926	117593657	4
chr6	117609529	117747018	ROS1	137489	-	NM_002944	117609654	117746819	43
chr6	117803766	117891020	DCBLD1	87254	+	NM_173674	117803944	117890787	15
chr6	117881432	117923705	GOPC	42273	-	NM_020399	117884416	117923451	9
chr6	117993975	117996447	LOC101927919	2472	-	NR_110854	117996447	117996447	3
chr6	117996616	118031886	NUS1	35270	+	NM_138459	117996833	118028178	5
chr6	118228688	118638839	SLC35F1	410151	+	NM_001029858	118228889	118635415	8
chr6	118781934	119031238	CEP85L	249304	-	NM_001178035	118786567	118973944	14
chr6	118822535	118824996	BRD7P3	2461	+	NR_002730	118824996	118824996	1
chr6	118869441	118881587	PLN	12146	+	NM_002667	118880084	118880243	2
chr6	119103870	119104581	LOC100287632	711	+	NR_037662	119104581	119104581	1
chr6	119134611	119252903	MCM9	118292	-	NM_017696	119135986	119252888	12
chr6	119215240	119230335	ASF1A	15095	+	NM_014034	119215577	119228779	4
chr6	119280993	119470358	FAM184A	189365	-	NM_001100411	119281267	119345777	17
chr6	119390211	119390308	MIR548B	97	-	NR_030315	119390308	119390308	1
chr6	119498365	119670931	MAN1A1	172566	-	NM_005907	119500983	119670230	13
chr6	119773711	119812467	LOC285762	38756	-	NR_046100	119812467	119812467	6
chr6	120336324	120336403	MIR3144	79	+	NR_036098	120336403	120336403	1
chr6	121400639	121655646	TBC1D32	255007	-	NR_104452	121655646	121655646	36
chr6	121756722	121770890	GJA1	14168	+	NM_000165	121767993	121769142	2
chr6	122720695	122754264	HSF2	33569	+	NM_004506	122720882	122753365	13
chr6	122764492	122793026	SERINC1	28534	-	NM_020755	122766188	122792882	10
chr6	122793061	123047518	PKIB	254457	+	NM_001270394	123022632	123046340	8
chr6	123100645	123105218	FABP7	4573	+	NM_001446	123100939	123104912	4
chr6	123110193	123130864	SMPDL3A	20671	+	NM_006714	123110491	123130553	8
chr6	123317115	123394064	CLVS2	76949	+	NM_001010852	123318922	123384906	6
chr6	123537483	123958238	TRDN	420755	-	NM_006073	123539745	123957920	41
chr6	123760748	123792901	HRAT13	32153	+	NR_110844	123792901	123792901	3
chr6	124124990	125146786	NKAIN2	1021796	+	NM_001300737	124443035	125144375	8
chr6	125229391	125284173	RNF217-AS1	54782	-	NR_026876	125284173	125284173	7
chr6	125283690	125407484	RNF217	123794	+	NM_001286398	125283690	125404083	6
chr6	125474874	125584644	TPD52L1	109770	+	NM_001300994	125475097	125584108	6
chr6	125596495	125623282	HDDC2	26787	-	NM_016063	125597291	125623078	6
chr6	125995498	126041364	LOC643623	45866	+	NR_038906	126041364	126041364	4
chr6	126070731	126082415	HEY2	11684	+	NM_012259	126070922	126080948	5
chr6	126102306	126253176	NCOA7	150870	+	NM_001199620	126136500	126249917	18
chr6	126119006	126140004	NCOA7-AS1	20998	-	NR_126386	126140004	126140004	3
chr6	126277860	126301389	HINT3	23529	+	NM_138571	126278123	126298822	5
chr6	126307575	126360420	TRMT11	52845	+	NM_001031712	126307696	126359982	13
chr6	126433836	126443762	MIR5695	9926	-	NR_049880	126443762	126443762	3
chr6	126660934	126804466	CENPW	143532	+	NR_104462	126804466	126804466	4
chr6	126805776	126805859	MIR588	83	+	NR_030316	126805859	126805859	1
chr6	127440047	127520626	RSPO3	80579	+	NM_032784	127440337	127517152	5
chr6	127587826	127609705	RNF146	21879	+	NM_001242851	127601483	127608838	3
chr6	127609856	127664754	ECHDC1	54898	-	NM_001002030	127611013	127652173	6
chr6	127759550	127780535	KIAA0408	20985	-	NM_014702	127765253	127775126	6
chr6	127759550	127840500	SOGA3	80950	-	NM_001012279	127794425	127837759	12
chr6	127898318	127912963	C6orf58	14645	+	NM_001010905	127898330	127912767	6
chr6	128029338	128239776	THEMIS	210438	-	NM_001164687	128031129	128176319	6
chr6	128289923	128841819	PTPRK	551896	-	NM_001291981	128291371	128841503	33
chr6	128349009	128407435	LOC101928140	58426	+	NR_125849	128407435	128407435	5
chr6	129204285	129837710	LAMA2	633425	+	NM_000426	129204390	129837492	65
chr6	129898239	130031370	ARHGAP18	133131	-	NM_033515	129899657	130031281	15
chr6	130152388	130182416	TMEM244	30028	-	NM_001010876	130152463	130182333	5
chr6	130339727	130462594	L3MBTL3	122867	+	NM_032438	130363844	130460898	23
chr6	130465446	130686570	SAMD3	221124	-	NM_001258275	130465664	130536418	14
chr6	130687425	130764210	TMEM200A	76785	+	NM_001258277	130761567	130763043	3
chr6	131148544	131158276	SMLR1	9732	+	NM_001195597	131148553	131156095	2
chr6	131160487	131384462	EPB41L2	223975	-	NM_001431	131179275	131277625	20
chr6	131456825	131604675	AKAP7	147850	+	NM_016377	131456903	131602866	8
chr6	131894343	131905472	ARG1	11129	+	NM_000045	131894422	131905048	8
chr6	131895105	131949379	MED23	54274	-	NM_015979	131895432	131949189	31
chr6	131958374	132068550	ENPP3	110176	+	NM_005021	131958524	132068096	25
chr6	132020783	132022541	OR2A4	1758	-	NM_030908	132021608	132022541	1
chr6	132029580	132032157	CTAGE9	2577	-	NM_001145659	132029823	132032157	1
chr6	132113311	132113371	MIR548H5	60	+	NR_039610	132113371	132113371	1
chr6	132129155	132216295	ENPP1	87140	+	NM_006208	132129175	132211651	25
chr6	132269316	132272518	CTGF	3202	-	NM_001901	132270403	132272312	5
chr6	132436331	132436403	MIR548AJ1	72	-	NR_039673	132436403	132436403	1
chr6	132455117	132490514	LINC01013	35397	+	NR_038981	132490514	132490514	3
chr6	132617193	132722673	MOXD1	105480	-	NM_015529	132618291	132722565	12
chr6	132778662	132834337	STX7	55675	-	NM_003569	132781896	132824669	10
chr6	132859426	132860475	TAAR9	1049	+	NM_175057	132859428	132860475	1
chr6	132873831	132874860	TAAR8	1029	+	NM_053278	132873831	132874860	1
chr6	132891460	132892498	TAAR6	1038	+	NM_175067	132891460	132892498	1
chr6	132909730	132910877	TAAR5	1147	-	NM_003967	132909811	132910825	1
chr6	132929363	132930441	TAAR3	1078	-	NR_028511	132930441	132930441	1
chr6	132938288	132945414	TAAR2	7126	-	NM_001033080	132938288	132945414	2
chr6	132966036	132967165	TAAR1	1129	-	NM_138327	132966122	132967142	1
chr6	133001996	133035194	VNN1	33198	-	NM_004666	133004278	133035174	7
chr6	133043925	133055904	VNN3	11979	-	NM_001291703	133044064	133047915	7
chr6	133065008	133084598	VNN2	19590	-	NM_078488	133065438	133078863	8
chr6	133090506	133119747	SLC18B1	29241	-	NM_052831	133091408	133119595	14
chr6	133135707	133138703	RPS12	2996	+	NM_001016	133135907	133138681	6
chr6	133136445	133136518	SNORD101	73	+	NR_002434	133136518	133136518	1
chr6	133137940	133138016	SNORD100	76	+	NR_002435	133138016	133138016	1
chr6	133138357	133138490	SNORA33	133	+	NR_002436	133138490	133138490	1
chr6	133409218	133427717	LINC00326	18499	+	NR_026969	133427717	133427717	4
chr6	133562494	133853258	EYA4	290764	+	NM_004100	133595918	133849943	20
chr6	133823389	134210144	TARID	386755	-	NR_109982	134210144	134210144	9
chr6	134142284	134175130	LINC01312	32846	+	NR_027030	134175130	134175130	3
chr6	134210258	134216675	TCF21	6417	+	NM_198392	134210535	134212940	3
chr6	134273307	134308638	TBPL1	35331	+	NM_001253676	134301263	134308178	7
chr6	134308718	134373789	SLC2A12	65071	-	NM_145176	134312292	134373618	5
chr6	134435110	134438818	HMGA1P7	3708	-	NR_037938	134438818	134438818	2
chr6	134490383	134639196	SGK1	148813	-	NM_001143676	134491405	134638598	14
chr6	134750167	134800035	LOC101928231	49868	-	NR_125852	134800035	134800035	5
chr6	134758853	134825158	LINC01010	66305	+	NR_038217	134825158	134825158	3
chr6	134846455	134861143	LOC101928304	14688	-	NR_125855	134861143	134861143	4
chr6	135238527	135271260	ALDH8A1	32733	-	NM_022568	135239552	135271191	7
chr6	135281516	135376036	HBS1L	94520	-	NM_006620	135286416	135375829	18
chr6	135300475	135300570	MIR3662	95	-	NR_037435	135300570	135300570	1
chr6	135502452	135540311	MYB	37859	+	NM_001161656	135502651	135539118	16
chr6	135605109	135818903	AHI1	213794	-	NM_001134831	135606782	135813375	29
chr6	135818938	136011976	LINC00271	193038	+	NR_026805	136011976	136011976	4
chr6	136172833	136516709	PDE7B	343876	+	NM_018945	136173136	136512978	13
chr6	136552167	136571449	MTFR2	19282	-	NM_001099286	136552412	136570237	8
chr6	136578000	136610989	BCLAF1	32989	-	NM_001077441	136582247	136601004	13
chr6	136663418	136871957	MAP7	208539	-	NM_003980	136665365	136871546	18
chr6	136878186	137113656	MAP3K5	235470	-	NM_005923	136878895	137113295	30
chr6	136950251	136969336	LOC101928461	19085	+	NR_125858	136969336	136969336	3
chr6	137143701	137235072	PEX7	91371	+	NM_000288	137143803	137234664	10
chr6	137243378	137246798	SLC35D3	3420	+	NM_001008783	137243566	137245834	2
chr6	137303295	137314368	NHEG1	11073	-	NR_027994	137314368	137314368	3
chr6	137321107	137366317	IL20RA	45210	-	NM_014432	137322694	137365865	7
chr6	137464956	137494785	IL22RA2	29829	-	NM_052962	137466760	137482886	7
chr6	137518620	137540567	IFNGR1	21947	-	NM_000416	137519167	137540464	7
chr6	137813335	137815531	OLIG3	2196	-	NM_175747	137814488	137815307	1
chr6	137986782	137995691	LOC102723649	8909	+	NR_125867	137995691	137995691	4
chr6	138051306	138060174	LOC100507406	8868	-	NR_121618	138060174	138060174	3
chr6	138144806	138189370	LOC100130476	44564	-	NR_049793	138189370	138189370	4
chr6	138188324	138204451	TNFAIP3	16127	+	NM_001270508	138192364	138202456	9
chr6	138409641	138428660	PERP	19019	-	NM_022121	138413178	138428477	3
chr6	138483052	138665800	ARFGEF3	182748	+	NM_020340	138483223	138657623	34
chr6	138537126	138539627	PBOV1	2501	-	NM_021635	138539124	138539532	1
chr6	138725335	138734582	HEBP2	9247	+	NM_014320	138725632	138734215	4
chr6	138743180	138893668	NHSL1	150488	-	NM_020464	138745217	138893048	7
chr6	138756349	138756431	MIR3145	82	-	NR_036099	138756431	138756431	1
chr6	139012804	139018425	FLJ46906	5621	+	NR_033896	139018425	139018425	4
chr6	139046347	139094816	GVQW2	48469	-	NM_001242740	139048603	139094687	4
chr6	139094656	139114456	CCDC28A	19800	+	NM_015439	139094811	139113940	6
chr6	139117247	139225207	ECT2L	107960	+	NM_001077706	139134411	139223764	22
chr6	139225151	139309398	REPS1	84247	-	NM_031922	139226200	139308819	20
chr6	139349818	139364439	ABRACL	14621	+	NM_021243	139355297	139364040	3
chr6	139456248	139501946	HECA	45698	+	NM_016217	139456533	139498242	4
chr6	139561198	139613208	TXLNB	52010	-	NM_153235	139563662	139610036	10
chr6	139693391	139695787	CITED2	2396	-	NM_006079	139694268	139695081	2
chr6	139790131	139795733	LINC01625	5602	-	NR_033919	139795733	139795733	4
chr6	140092209	140181608	LOC100132735	89399	+	NR_038399	140181608	140181608	3
chr6	140297455	140414858	LOC100507477	117403	+	NR_121622	140414858	140414858	4
chr6	140299486	140312398	LOC103352541	12912	-	NR_121624	140312398	140312398	3
chr6	140526388	140526463	MIR3668	75	+	NR_037441	140526463	140526463	1
chr6	141004950	141005020	MIR4465	70	+	NR_039675	141005020	141005020	1
chr6	142396744	142409936	NMBR	13192	-	NM_002511	142396784	142409795	3
chr6	142468298	142542085	VTA1	73787	+	NM_016485	142468424	142539780	8
chr6	142623055	142767403	ADGRG6	144348	+	NM_020455	142623466	142764519	26
chr6	142847591	142959026	LOC153910	111435	-	NR_027312	142959026	142959026	3
chr6	143072603	143266338	HIVEP2	193735	-	NM_006734	143074243	143095875	10
chr6	143287558	143358719	LINC01277	71161	-	NR_038987	143358719	143358719	3
chr6	143380499	143661480	AIG1	280981	+	NM_001286587	143382092	143660813	7
chr6	143743968	143771841	ADAT2	27873	-	NM_182503	143749599	143771795	6
chr6	143771917	143811751	PEX3	39834	+	NM_003630	143772179	143810363	12
chr6	143815948	143833020	FUCA2	17072	-	NM_032020	143816843	143832771	7
chr6	143875251	143890476	PHACTR2-AS1	15225	-	NR_027113	143890476	143890476	3
chr6	143929316	144152322	PHACTR2	223006	+	NM_014721	143929446	144144826	13
chr6	144164507	144184943	LTV1	20436	+	NM_032860	144164614	144184664	11
chr6	144185572	144259483	ZC2HC1B	73911	+	NM_001013623	144185676	144258856	8
chr6	144261436	144385736	PLAGL1	124300	-	NM_001080951	144262560	144269273	8
chr6	144326052	144329867	HYMAI	3815	-	NR_002768	144329867	144329867	1
chr6	144416017	144416754	SF3B5	737	-	NM_031287	144416373	144416634	1
chr6	144471653	144513076	STX11	41423	+	NM_003764	144507764	144508628	2
chr6	144612872	145174170	UTRN	561298	+	NM_007124	144612964	145172133	74
chr6	144726790	144726903	SNORA98	113	+	NR_132778	144726903	144726903	1
chr6	145946439	146056991	EPM2A	110552	-	NM_001018041	145946830	146056634	5
chr6	146056004	146207721	LOC100507557	151717	+	NR_038246	146207721	146207721	3
chr6	146119271	146135921	FBXO30	16650	-	NM_032145	146121241	146127541	3
chr6	146205944	146285233	SHPRH	79289	-	NM_001042683	146207826	146276458	30
chr6	146348917	146758734	GRM1	409817	+	NM_001278065	146350653	146747755	10
chr6	146864827	146876092	RAB32	11265	+	NM_006834	146865007	146875741	3
chr6	146915651	146920067	LOC101928661	4416	-	NR_125860	146920067	146920067	3
chr6	146920135	147136597	ADGB	216462	+	NM_024694	146920176	147136353	36
chr6	147122804	147124960	KATNBL1P6	2156	-	NR_003954	147124960	147124960	1
chr6	147162524	147525750	STXBP5-AS1	363226	-	NR_034115	147525750	147525750	11
chr6	147480060	147502128	LUADT1	22068	+	NR_132442	147502128	147502128	3
chr6	147525493	147711612	STXBP5	186119	+	NM_001127715	147525668	147705891	28
chr6	147829827	147891157	SAMD5	61330	+	NM_001030060	147830064	147885592	2
chr6	148663728	148873184	SASH1	209456	+	NM_015278	148664203	148869694	20
chr6	149068270	149398126	UST	329856	+	NM_005715	149068566	149395252	8
chr6	149275396	149285820	UST-AS1	10424	-	NR_038408	149285820	149285820	3
chr6	149539059	149732749	TAB2	193690	+	NM_001292035	149539906	149730855	7
chr6	149721494	149722182	SUMO4	688	+	NM_001002255	149721527	149721815	1
chr6	149768765	149806148	ZC3H12D	37383	-	NM_207360	149771818	149795679	6
chr6	149825630	149867238	PPIL4	41608	-	NM_139126	149826588	149867141	13
chr6	149887527	149912067	GINM1	24540	+	NM_138785	149887550	149911974	8
chr6	149914751	149915720	RPS18P9	969	+	NR_077247	149915720	149915720	1
chr6	149916010	149969940	KATNA1	53930	-	NM_007044	149916171	149959683	11
chr6	149979288	150039392	LATS1	60104	-	NM_004690	149982864	150023262	8
chr6	150045451	150067708	NUP43	22257	-	NR_104456	150067708	150067708	9
chr6	150070830	150132557	PCMT1	61727	+	NM_005389	150070863	150123515	8
chr6	150139893	150185480	LRP11	45587	-	NM_032832	150141684	150185156	7
chr6	150184633	150240644	RAET1E-AS1	56011	+	NR_045126	150240644	150240644	2
chr6	150204510	150217195	RAET1E	12685	-	NM_001243328	150205623	150212037	5
chr6	150238013	150244288	RAET1G	6275	-	NM_001001788	150238047	150244146	5
chr6	150263073	150270368	ULBP2	7295	+	NM_025217	150263208	150268565	5
chr6	150285109	150294849	ULBP1	9740	+	NM_025218	150285185	150291261	5
chr6	150319154	150326280	RAET1K	7126	-	NR_024045	150326280	150326280	4
chr6	150341265	150346668	RAET1L	5403	-	NM_130900	150341265	150346607	4
chr6	150382181	150390283	ULBP3	8102	-	NM_024518	150385742	150390202	5
chr6	150464187	150571528	PPP1R14C	107341	+	NM_030949	150464328	150569956	4
chr6	150690027	150725765	IYD	35738	+	NM_001164694	150690167	150719273	6
chr6	150920998	151164799	PLEKHG1	243801	+	NM_001029884	151054817	151162032	17
chr6	151186814	151423023	MTHFD1L	236209	+	NM_001242767	151186958	151413692	28
chr6	151517807	151549592	LOC102723831	31785	-	NR_125868	151549592	151549592	3
chr6	151561133	151679694	AKAP12	118561	+	NM_005100	151561697	151674875	5
chr6	151685249	151712835	ZBTB2	27586	-	NM_020861	151686655	151694772	3
chr6	151725896	151773316	RMND1	47420	-	NM_017909	151726369	151766946	12
chr6	151773392	151791234	ARMT1	17842	+	NM_024573	151773680	151790245	5
chr6	151815174	151942328	CCDC170	127154	+	NM_025059	151815263	151939282	11
chr6	152011630	152424408	ESR1	412778	+	NM_001122742	152129047	152420101	10
chr6	152442818	152958534	SYNE1	515716	-	NM_182961	152443570	152949466	146
chr6	152469761	152546267	MIR3163	76506	+	NR_036121	152546267	152546267	6
chr6	152701664	152702847	SYNE1-AS1	1183	+	NR_120501	152702847	152702847	2
chr6	153019029	153045715	MYCT1	26686	+	NM_025107	153019037	153043388	2
chr6	153071931	153080902	VIP	8971	+	NM_194435	153073312	153078276	7
chr6	153291657	153304740	FBXO5	13083	-	NM_001142522	153292297	153296721	5
chr6	153308500	153323950	MTRF1L	15450	-	NM_001301871	153311029	153316367	7
chr6	153332031	153452389	RGS17	120358	-	NM_012419	153332708	153365153	5
chr6	154360545	154568001	OPRM1	207456	+	NM_001008503	154360679	154567919	4
chr6	154475617	154677900	IPCEF1	202283	-	NM_001130700	154480962	154587081	12
chr6	154726432	154831753	CNKSR3	105321	-	NM_173515	154727487	154831248	13
chr6	155054511	155155378	SCAF8	100867	+	NM_001286189	155054556	155154529	22
chr6	155174493	155174570	MIR1273C	77	+	NR_036100	155174570	155174570	1
chr6	155411422	155578857	TIAM2	167435	+	NM_012454	155450357	155578255	26
chr6	155577263	155635617	TFB1M	58354	-	NM_016020	155578969	155635562	7
chr6	155585146	155597682	CLDN20	12536	+	NM_001001346	155596853	155597513	2
chr6	155716501	155777037	NOX3	60536	-	NM_015718	155717969	155776934	14
chr6	156267930	156268013	MIR1202	83	+	NR_031606	156268013	156268013	1
chr6	157099063	157531913	ARID1B	432850	+	NM_020732	157099063	157529025	20
chr6	157100811	157100865	MIR4466	54	-	NR_039676	157100865	157100865	1
chr6	157710053	157745291	TMEM242	35238	-	NM_018452	157713932	157744531	4
chr6	157802556	158094977	ZDHHC14	292421	+	NM_024630	157803053	158094154	9
chr6	157950163	157950232	MIR3692	69	+	NR_037463	157950232	157950232	1
chr6	158244202	158366109	SNX9	121907	+	NM_016224	158244466	158363870	18
chr6	158402887	158520207	SYNJ2	117320	+	NM_003898	158402993	158517396	27
chr6	158422138	158423415	SYNJ2-IT1	1277	+	NR_046796	158423415	158423415	3
chr6	158530535	158589312	SERAC1	58777	-	NM_032861	158532397	158579395	17
chr6	158589378	158620376	GTF2H5	30998	+	NM_207118	158591535	158613189	3
chr6	158733691	158932856	TULP4	199165	+	NM_020245	158735048	158927726	14
chr6	158957467	159056467	TMEM181	99000	+	NM_020823	158957478	159052920	17
chr6	159030738	159030822	MIR7161	84	+	NR_106981	159030822	159030822	1
chr6	159057506	159065818	DYNLT1	8312	-	NM_006519	159057858	159065740	5
chr6	159071045	159185908	SYTL3	114863	+	NM_001242384	159084300	159185636	19
chr6	159185692	159185785	MIR3918	93	-	NR_037482	159185785	159185785	1
chr6	159186772	159240456	EZR	53684	-	NM_001111077	159187945	159239125	14
chr6	159239010	159243272	EZR-AS1	4262	+	NR_102425	159243272	159243272	3
chr6	159262157	159278664	OSTCP1	16507	-	NR_028496	159278664	159278664	3
chr6	159290898	159331385	C6orf99	40487	+	NM_001302840	159316267	159331245	4
chr6	159398265	159421198	RSPH3	22933	-	NM_031924	159398569	159421008	8
chr6	159455500	159466184	TAGAP	10684	-	NM_054114	159456858	159465178	10
chr6	159586930	159591039	LOC101929122	4109	-	NR_121668	159591039	159591039	4
chr6	159590428	159693140	FNDC1	102712	+	NM_032532	159590628	159692474	23
chr6	159804562	159817473	LOC102724053	12911	+	NR_125873	159817473	159817473	3
chr6	160100148	160114353	SOD2	14205	-	NM_001024465	160103524	160114199	6
chr6	160148029	160177352	WTAP	29323	+	NM_004906	160157297	160176643	8
chr6	160181290	160183364	LOC100129518	2074	-	NR_037166	160183364	160183364	2
chr6	160182988	160200087	ACAT2	17099	+	NM_005891	160183119	160199861	9
chr6	160199529	160210735	TCP1	11206	-	NM_030752	160200076	160210500	12
chr6	160201281	160201413	SNORA20	132	-	NR_002960	160201413	160201413	1
chr6	160206625	160206765	SNORA29	140	-	NR_002965	160206765	160206765	1
chr6	160211491	160219461	MRPL18	7970	+	NM_014161	160211619	160219155	4
chr6	160221280	160241736	PNLDC1	20456	+	NM_001271862	160221339	160241549	19
chr6	160327973	160329107	MAS1	1134	+	NM_002377	160327987	160328965	1
chr6	160390130	160532534	IGF2R	142404	+	NM_000876	160390278	160526116	48
chr6	160424322	160428696	AIRN	4374	-	NR_047511	160428696	160428696	3
chr6	160514113	160517244	LOC729603	3131	+	NR_003288	160517244	160517244	1
chr6	160542862	160579750	SLC22A1	36888	+	NM_003057	160542967	160579614	11
chr6	160637793	160679963	SLC22A2	42170	-	NM_003058	160638463	160679789	11
chr6	160769404	160873611	SLC22A3	104207	+	NM_021977	160769451	160872088	11
chr6	160887586	160932156	LPAL2	44570	-	NR_028093	160932156	160932156	10
chr6	160952514	161087407	LPA	134893	-	NM_005577	160952760	161085246	40
chr6	161123224	161175085	PLG	51861	+	NM_000301	161123336	161174093	19
chr6	161412758	161538417	MAP3K4	125659	+	NR_120425	161538417	161538417	28
chr6	161551056	161695107	AGPAT4	144051	-	NM_020133	161557571	161653245	9
chr6	161581163	161583014	AGPAT4-IT1	1851	-	NR_024277	161583014	161583014	1
chr6	161768589	163148834	PARK2	1380245	-	NM_004562	161771130	163148700	12
chr6	163148163	163736524	PACRG	588361	+	NM_152410	163149267	163736019	7
chr6	163464011	163475193	PACRG-AS2	11182	-	NR_110871	163475193	163475193	4
chr6	163602676	163613034	PACRG-AS3	10358	-	NR_122120	163613034	163613034	4
chr6	163731016	163745505	PACRG-AS1	14489	-	NR_028390	163745505	163745505	6
chr6	163759373	163768065	DKFZp451B082	8692	-	NR_033862	163768065	163768065	4
chr6	163834096	163834982	CAHM	886	-	NR_037593	163834982	163834982	1
chr6	163835674	163999628	QKI	163954	+	NM_001301085	163836225	163991742	8
chr6	165206865	165235552	MEAT6	28687	-	NR_131926	165235552	165235552	4
chr6	165693152	165723111	C6orf118	29959	-	NM_144980	165693545	165723075	9
chr6	165740775	166075588	PDE10A	334813	-	NM_006661	165746513	165989936	23
chr6	166337535	166401527	LINC00473	63992	-	NR_026861	166401527	166401527	2
chr6	166401038	166403103	LINC00602	2065	+	NR_027284	166403103	166403103	1
chr6	166571145	166582157	T	11012	-	NM_003181	166571802	166581079	9
chr6	166650456	166670432	LOC101929297	19976	+	NR_125862	166670432	166670432	5
chr6	166719167	166721871	PRR18	2704	-	NM_175922	166720742	166721630	1
chr6	166733215	166756094	SFT2D1	22879	-	NR_130112	166756094	166756094	9
chr6	166756118	166764957	LOC100289495	8839	+	NR_040022	166764957	166764957	2
chr6	166778407	166796501	MPC1	18094	-	NM_001270879	166778916	166780325	5
chr6	166822853	167275771	RPS6KA2	452918	-	NM_001006932	166826249	167275658	22
chr6	166874150	166878871	RPS6KA2-IT1	4721	-	NR_046793	166878871	166878871	4
chr6	166922841	166922921	MIR1913	80	-	NR_031734	166922921	166922921	1
chr6	167317185	167318557	RPS6KA2-AS1	1372	+	NR_046644	167318557	167318557	2
chr6	167343003	167370077	RNASET2	27074	-	NM_003730	167343075	167369670	9
chr6	167411294	167411400	MIR3939	106	-	NR_037504	167411400	167411400	1
chr6	167412804	167455906	FGFR1OP	43102	+	NM_007045	167412900	167453466	13
chr6	167525294	167552629	CCR6	27335	+	NM_004367	167549622	167550843	3
chr6	167570359	167571319	GPR31	960	-	NM_005299	167570359	167571319	1
chr6	167584080	167596396	TCP10L2	12316	+	NM_001145121	167585632	167595404	8
chr6	167704802	167729502	UNC93A	24700	+	NM_018974	167704977	167728940	8
chr6	167738573	167756177	TTLL2	17604	+	NM_031949	167738661	167755167	3
chr6	167786576	167797998	TCP10	11422	-	NM_004610	167786656	167796361	8
chr6	168067521	168079903	LOC401286	12382	-	NR_117091	168079903	168079903	3
chr6	168080305	168084467	LOC441178	4162	-	NR_117092	168084467	168084467	4
chr6	168185218	168197539	LINC01558	12321	-	NR_026773	168197539	168197539	4
chr6	168224569	168227476	MLLT4-AS1	2907	-	NR_027906	168227476	168227476	2
chr6	168227670	168372700	MLLT4	145030	+	NM_001207008	168227812	168370615	32
chr6	168376603	168377619	HGC6.3	1016	-	NM_001129895	168376816	168377332	1
chr6	168394866	168397757	KIF25-AS1	2891	-	NR_103750	168397757	168397757	4
chr6	168418552	168445769	KIF25	27217	+	NM_030615	168430265	168445676	9
chr6	168456463	168482237	FRMD1	25774	-	NR_110312	168482237	168482237	16
chr6	168643617	168663258	LOC101929420	19641	+	NR_110870	168663258	168663258	5
chr6	168693509	168720434	DACT2	26925	-	NM_001286351	168694573	168720313	6
chr6	168841830	169068674	SMOC2	226844	+	NM_022138	168842050	169067118	13
chr6	169558186	169563084	LINC01615	4898	-	NR_132623	169563084	169563084	2
chr6	169575398	169582835	LOC101929504	7437	-	NR_125863	169582835	169582835	3
chr6	169615874	169654209	THBS2	38335	-	NM_003247	169617916	169650879	23
chr6	169857302	170102159	WDR27	244857	-	NM_182552	169857686	170089101	26
chr6	170102207	170106453	C6orf120	4246	+	NM_001317342	170102258	170103131	2
chr6	170104001	170124106	PHF10	20105	-	NM_133325	170104098	170124027	12
chr6	170140214	170151638	TCTE3	11424	-	NM_174910	170140280	170151554	4
chr6	170151717	170181680	ERMARD	29963	+	NM_018341	170151753	170181609	18
chr6	170188885	170198921	LINC00242	10036	-	NR_026781	170198921	170198921	2
chr6	170190168	170202969	LINC00574	12801	+	NR_026780	170202969	170202969	3
chr6	170475865	170478251	LOC102724511	2386	+	NR_125878	170478251	170478251	3
chr6	170563421	170571657	LOC154449	8236	-	NR_002787	170571657	170571657	3
chr6	170575756	170585850	LOC285804	10094	-	NR_126021	170585850	170585850	3
chr6	170581561	170588554	LINC01624	6993	+	NR_104177	170588554	170588554	2
chr6	170591293	170599697	DLL1	8404	-	NM_005618	170591961	170599227	11
chr6	170599790	170716159	FAM120B	116369	+	NM_001286379	170600145	170713678	11
chr6	170639848	170639932	MIR4644	84	+	NR_039787	170639932	170639932	1
chr6	170844203	170862417	PSMB1	18214	-	NM_002793	170844307	170862330	6
chr6	170863420	170881958	TBP	18538	+	NM_003194	170866117	170881353	8
chr6	170884659	170893780	PDCD2	9121	-	NM_002598	170886646	170893669	6
chr6_apd_hap1	728408	735577	OR2H1	7169	+	NM_001318014	733024	733975	4
chr6_apd_hap1	826900	831215	UBD	4315	-	NM_006398	827168	830991	2
chr6_apd_hap1	1442003	1605540	HCG17	163537	-	NR_052012	1605540	1605540	4
chr6_apd_hap1	2335935	2342365	HCG22	6430	+	NR_003948	2342365	2342365	4
chr6_apd_hap1	3162290	3180245	EHMT2	17955	-	NM_006709	3162614	3180215	28
chr6_apd_hap1	3447121	3450803	EGFL8	3682	+	NM_030652	3448683	3450474	9
chr6_apd_hap1	4203376	4207888	HLA-DMA	4512	-	NM_006120	4203629	4207802	5
chr6_cox_hap2	350247	354323	LINC01623	4076	-	NR_033379	354323	354323	2
chr6_cox_hap2	393802	414796	TRIM27	20994	-	NM_006510	394870	414437	8
chr6_cox_hap2	481392	491846	ZNF311	10454	-	NM_001010877	481576	490530	7
chr6_cox_hap2	1088813	1119772	GABBR1	30959	-	NM_001470	1090128	1118972	23
chr6_cox_hap2	1143558	1158951	MOG	15393	+	NM_206809	1143787	1157756	8
chr6_cox_hap2	1158970	1163760	ZFP57	4790	-	NM_001109809	1159078	1163609	4
chr6_cox_hap2	1234755	1235098	IFITM4P	343	-	NR_001590	1235098	1235098	1
chr6_cox_hap2	1310646	1314804	HLA-G	4158	+	NM_002127	1311512	1314050	9
chr6_cox_hap2	1582795	1592995	TRIM31	10200	-	NM_007028	1583434	1592714	9
chr6_cox_hap2	1585138	1594629	TRIM31-AS1	9491	+	NR_126470	1594629	1594629	4
chr6_cox_hap2	1616018	1628649	TRIM40	12631	+	NM_001286633	1616947	1627726	6
chr6_cox_hap2	2021202	2037420	GNL1	16218	-	NM_005275	2025896	2036029	12
chr6_cox_hap2	2292696	2310496	LINC00243	17800	-	NR_130726	2310496	2310496	2
chr6_cox_hap2	3116415	3130096	BAG6	13681	-	NM_080702	3116522	3129159	25
chr6_cox_hap2	3135692	3138168	C6orf47	2476	-	NM_021184	3136458	3137343	1
chr6_cox_hap2	3192745	3195198	LY6G6D	2453	+	NM_021246	3192745	3195198	3
chr6_cox_hap2	3240358	3242211	SAPCD1	1853	+	NM_001039651	3240417	3241894	5
chr6_cox_hap2	3241498	3242952	SAPCD1-AS1	1454	-	NR_126423	3242952	3242952	2
chr6_cox_hap2	3274736	3284332	LSM2	9596	-	NM_021177	3275101	3284105	5
chr6_cox_hap2	3340716	3356577	SLC44A4	15861	-	NM_025257	3341150	3356511	21
chr6_cox_hap2	3479582	3484305	TNXA	4723	-	NR_001284	3484305	3484305	13
chr6_cox_hap2	3479582	3547813	TNXB	68231	-	NM_019105	3479776	3536637	44
chr6_cox_hap2	3591245	3592810	LOC100507547	1565	-	NR_037172	3592810	3592810	3
chr6_cox_hap2	3591896	3602139	PPT2	10243	+	NM_138717	3592071	3601408	9
chr6_cox_hap2	3592443	3606743	PPT2-EGFL8	14300	+	NR_037861	3606743	3606743	16
chr6_cox_hap2	3934126	3947195	HLA-DRB3	13069	-	NM_022555	3934443	3947155	6
chr6_cox_hap2	4072510	4080111	HLA-DQB1	7601	-	NM_001243962	4073283	4080032	5
chr6_cox_hap2	4072926	4073776	HLA-DQB1-AS1	850	+	NR_133907	4073776	4073776	3
chr6_cox_hap2	4266465	4272158	PSMB9	5693	+	NM_002800	4266534	4271837	6
chr6_cox_hap2	4690689	4701118	WDR46	10429	-	NM_001164267	4690862	4700761	15
chr6_cox_hap2	4725993	4729534	ZBTB22	3541	-	NM_001145338	4726600	4728505	2
chr6_cox_hap2	4730148	4734611	DAXX	4463	-	NM_001350	4730335	4733518	8
chr6_dbb_hap3	1832804	1852944	ABCF1	20140	+	NM_001025091	1832899	1852113	26
chr6_dbb_hap3	2144492	2162051	DDR1	17559	+	NM_001297652	2150608	2161191	17
chr6_dbb_hap3	2176096	2188360	VARS2	12264	+	NM_020442	2176725	2188112	30
chr6_dbb_hap3	2825414	2827641	LTA	2227	+	NM_001159740	2826060	2827011	4
chr6_dbb_hap3	2833875	2835743	LTB	1868	-	NM_002341	2834026	2835735	4
chr6_dbb_hap3	2839498	2842231	LST1	2733	+	NM_205839	2840619	2841998	5
chr6_dbb_hap3	2919235	2923427	CSNK2B	4192	+	NM_001282385	2920188	2923283	7
chr6_dbb_hap3	2930040	2933731	LY6G5C	3691	-	NM_025262	2930313	2933731	3
chr6_dbb_hap3	3151143	3199039	C2	47896	+	NM_001282457	3187036	3198722	14
chr6_dbb_hap3	3235414	3256039	C4A	20625	+	NM_007293	3235465	3255899	41
chr6_dbb_hap3	3235414	3256040	C4B	20626	+	NM_001002029	3235465	3255899	41
chr6_dbb_hap3	3235414	3256040	C4B_2	20626	+	NM_001242823	3235465	3255899	41
chr6_dbb_hap3	4006438	4013897	HLA-DQB2	7459	-	NM_001300790	4006793	4013814	6
chr6_mann_hap4	1333523	1336701	PPP1R11	3178	+	NM_021959	1333780	1335676	3
chr6_mann_hap4	1645156	1662712	TRIM39-RPP21	17556	+	NM_001199119	1645163	1662664	10
chr6_mann_hap4	1660980	1662712	RPP21	1732	+	NM_001199121	1661025	1662627	5
chr6_mann_hap4	2283510	2351537	MUC22	68027	+	NM_001198815	2326817	2351073	5
chr6_mann_hap4	2584754	2584875	MIR6891	121	-	NR_106951	2584875	2584875	2
chr6_mann_hap4	3017575	3021267	LY6G6F	3692	+	NM_001003693	3017575	3021263	6
chr6_mann_hap4	3034009	3037375	C6orf25	3366	+	NM_138272	3034049	3035741	6
chr6_mann_hap4	3245059	3252311	C2-AS1	7252	-	NR_104191	3252311	3252311	3
chr6_mann_hap4	3505440	3534689	NOTCH4	29249	-	NM_004557	3506034	3534550	30
chr6_mann_hap4	3603310	3682528	C6orf10	79218	-	NM_001286474	3603593	3682322	26
chr6_mann_hap4	3703951	3717767	BTNL2	13816	-	NM_001304561	3704581	3717760	8
chr6_mann_hap4	3749678	3754894	HLA-DRA	5216	+	NM_019111	3749787	3753746	5
chr6_mann_hap4	4501242	4515019	HLA-DPB1	13777	+	NM_002121	4501358	4511561	6
chr6_mcf_hap5	383133	453829	OR2J3	70696	+	NM_001005216	383214	453771	2
chr6_mcf_hap5	991650	1359214	HLA-F	367564	+	NM_018950	991774	1359180	7
chr6_mcf_hap5	1150097	1295564	HLA-A	145467	+	NM_002116	1150181	1295135	10
chr6_mcf_hap5	1501606	1510596	TRIM10	8990	-	NM_052828	1503350	1510520	8
chr6_mcf_hap5	1950031	1966940	PPP1R10	16909	-	NM_002714	1951180	1959576	20
chr6_mcf_hap5	1976518	1996456	ATAT1	19938	+	NM_001031722	1976836	1996278	13
chr6_mcf_hap5	2492151	2507972	CCHCR1	15821	-	NM_019052	2492304	2506768	18
chr6_mcf_hap5	2514036	2520412	POU5F1	6376	-	NM_002701	2514300	2520339	5
chr6_mcf_hap5	2523452	2527623	PSORS1C3	4171	-	NR_026816	2527623	2527623	3
chr6_mcf_hap5	2547502	2553759	HCG27	6257	+	NR_026791	2553759	2553759	2
chr6_mcf_hap5	2701428	2704782	HLA-B	3354	-	NM_005514	2702039	2704728	8
chr6_mcf_hap5	3087408	3110152	MSH5	22744	+	NM_025259	3087927	3110005	25
chr6_mcf_hap5	3087408	3112321	MSH5-SAPCD1	24913	+	NR_037846	3112321	3112321	29
chr6_mcf_hap5	3318795	3329068	STK19	10273	+	NR_026717	3329068	3329068	8
chr6_mcf_hap5	3737843	3741026	HCG23	3183	+	NR_044996	3741026	3741026	3
chr6_mcf_hap5	3882323	3897292	HLA-DRB4	14969	-	NM_021983	3882640	3897221	6
chr6_mcf_hap5	4308821	4314252	HLA-DOA	5431	-	NM_002119	4311477	4314176	5
chr6_mcf_hap5	4713621	4718055	RPS18	4434	+	NM_022551	4713666	4718017	6
chr6_qbl_hap6	995238	1017689	HLA-F-AS1	22451	-	NR_026972	1017689	1017689	6
chr6_qbl_hap6	1235683	1238972	HCG9	3289	+	NR_028032	1238972	1238972	3
chr6_qbl_hap6	1272780	1274624	HCG8	1844	-	NR_103542	1274624	1274624	2
chr6_qbl_hap6	1445146	1474192	TRIM26	29046	-	NM_003449	1446567	1459807	10
chr6_qbl_hap6	1587514	1604407	TRIM39	16893	+	NM_021253	1589989	1602937	9
chr6_qbl_hap6	1980908	1986135	TUBB	5227	+	NM_001293213	1981214	1985105	5
chr6_qbl_hap6	2244469	2249599	MUC21	5130	+	NM_001010909	2244720	2249156	7
chr6_qbl_hap6	2378425	2403713	PSORS1C1	25288	+	NM_014068	2393252	2403554	6
chr6_qbl_hap6	2378682	2384073	CDSN	5391	-	NM_001264	2379616	2384017	2
chr6_qbl_hap6	2422153	2427844	TCF19	5691	+	NM_001077511	2423097	2426345	4
chr6_qbl_hap6	2461711	2772598	MICB	310887	+	NM_001289160	2767124	2771391	6
chr6_qbl_hap6	2661006	2676636	MICA	15630	+	NM_001289153	2672087	2673752	6
chr6_qbl_hap6	2836981	2839752	TNF	2771	+	NM_000594	2837156	2838954	4
chr6_qbl_hap6	2991987	2998733	CLIC1	6746	-	NM_001287593	2992248	2997715	7
chr6_qbl_hap6	3089162	3091686	HSPA1B	2524	+	NM_005346	3089378	3091304	1
chr6_qbl_hap6	3161185	3163563	ZBTB12	2378	-	NM_181842	3161494	3162874	2
chr6_qbl_hap6	3267200	3270475	CYP21A1P	3275	+	NR_040090	3270475	3270475	10
chr6_qbl_hap6	3941245	3946758	HLA-DQA2	5513	+	NM_020056	3941303	3946265	5
chr6_qbl_hap6	4021716	4038655	TAP2	16939	-	NM_018833	4022172	4038116	12
chr6_qbl_hap6	4264796	4281012	HLA-DPA1	16216	-	NM_001242525	4268877	4273798	6
chr6_qbl_hap6	4393583	4400853	RXRB	7270	-	NM_001291989	4394681	4400782	9
chr6_qbl_hap6	4404636	4406835	HSD17B8	2199	+	NM_014234	4404668	4406658	9
chr6_qbl_hap6	4450267	4471978	VPS52	21711	-	NM_022553	4450836	4471688	20
chr6_qbl_hap6	4499711	4514410	TAPBP	14699	-	NM_003190	4501783	4514064	8
chr6_ssto_hap7	344677	385401	LOC100129636	40724	+	NR_125387	385401	385401	4
chr6_ssto_hap7	1298114	1359404	ZNRD1-AS1	61290	-	NR_026751	1359404	1359404	6
chr6_ssto_hap7	1953167	1973134	DHX16	19967	-	NM_003587	1953290	1972922	20
chr6_ssto_hap7	2027817	2042770	FLOT1	14953	-	NM_005803	2028199	2042283	13
chr6_ssto_hap7	2959803	2964865	GPANK1	5062	-	NM_001199237	2960845	2963060	4
chr6_ssto_hap7	2985531	3001955	ABHD16A	16424	-	NM_021160	2985794	3001876	20
chr6_ssto_hap7	3306068	3342155	CYP21A2	36087	+	NM_000500	3306175	3341619	10
chr6_ssto_hap7	3850433	3993164	HLA-DRB1	142731	-	NM_001243965	3934616	3993069	8
chr6_ssto_hap7	4292680	4302272	LOC100294145	9592	+	NR_037178	4302272	4302272	2
chr6_ssto_hap7	4367204	4430060	BRD2	62856	+	NM_005104	4421447	4429273	14
chr6_ssto_hap7	4839528	4857918	KIFC1	18390	+	NM_002263	4839978	4857686	11
chr7	144444	149438	LOC102723672	4994	-	NR_134325	149438	149438	3
chr7	149717	155461	LOC100507642	5744	+	NR_108064	155461	155461	3
chr7	174919	176013	LOC105375115	1094	+	NR_134324	176013	176013	3
chr7	192968	300740	FAM20C	107772	+	NM_020223	193199	299946	10
chr7	330135	331454	WI2-2373I1.2	1319	+	NM_001195127	330135	331454	3
chr7	419390	422845	LOC442497	3455	+	NR_033960	422845	422845	3
chr7	536896	559481	PDGFA	22585	-	NM_002607	540080	558638	7
chr7	560027	564869	HRAT92	4842	+	NR_033963	564869	564869	3
chr7	588833	767313	PRKAR1B	178480	-	NM_001164758	590066	751142	11
chr7	601594	605256	LOC101927000	3662	+	NR_132384	605256	605256	2
chr7	642481	648139	LOC101926963	5658	+	NR_110054	648139	648139	2
chr7	766337	826116	DNAAF5	59779	+	NM_017802	766357	825290	13
chr7	856251	914557	SUN1	58306	+	NM_025154	878507	912968	18
chr7	916190	936071	GET4	19881	+	NM_015949	916282	935059	9
chr7	937536	995043	ADAP1	57507	-	NM_001284308	938557	995043	11
chr7	1004485	1015235	COX19	10750	-	NM_001031617	1009013	1015145	3
chr7	1022834	1029276	CYP2W1	6442	+	NM_017781	1022847	1028458	9
chr7	1036622	1177893	C7orf50	141271	-	NM_032350	1037260	1167021	5
chr7	1062568	1062662	MIR339	94	-	NR_029898	1062662	1062662	1
chr7	1084208	1098905	GPR146	14697	+	NM_001303473	1097151	1098153	2
chr7	1126442	1133451	GPER1	7009	+	NM_001039966	1131364	1132492	3
chr7	1192542	1199855	ZFAND2A	7313	-	NM_182491	1192704	1197848	5
chr7	1200009	1205594	LOC101927021	5585	+	NR_110065	1205594	1205594	4
chr7	1272653	1276613	UNCX	3960	+	NM_001080461	1272653	1276613	3
chr7	1473994	1499109	MICALL2	25115	-	NM_182924	1474231	1498962	17
chr7	1509912	1544018	INTS1	34106	-	NM_001080453	1510212	1543596	48
chr7	1570367	1582679	MAFK	12312	+	NM_002360	1578828	1580011	3
chr7	1581870	1596066	TMEM184A	14196	-	NM_001097620	1586587	1595120	9
chr7	1606969	1609668	PSMG3	2699	-	NM_001134340	1607333	1608975	3
chr7	1609708	1629261	PSMG3-AS1	19553	+	NR_021487	1629261	1629261	6
chr7	1654105	1656328	TFAMP1	2223	+	NR_001288	1656328	1656328	1
chr7	1748797	1787590	ELFN1	38793	+	NM_001128636	1784232	1786719	2
chr7	1778265	1781946	ELFN1-AS1	3681	-	NR_120508	1781946	1781946	2
chr7	1855427	2272583	MAD1L1	417156	-	NM_001013837	1855705	2269768	19
chr7	1883815	1883889	MIR4655	74	-	NR_039799	1883889	1883889	1
chr7	2273925	2281833	FTSJ2	7908	-	NM_013393	2274756	2281804	3
chr7	2281856	2290780	NUDT1	8924	+	NM_198949	2282626	2290636	5
chr7	2291404	2354110	SNX8	62706	-	NM_013321	2294690	2354056	11
chr7	2297149	2297212	MIR6836	63	-	NR_106895	2297212	2297212	1
chr7	2394473	2420377	EIF3B	25904	+	NM_001037283	2394556	2419132	19
chr7	2443194	2474216	CHST12	31022	+	NM_018641	2472274	2473519	2
chr7	2477397	2487485	LOC101927181	10088	+	NR_108066	2487485	2487485	2
chr7	2514771	2516017	GRIFIN	1246	-	NM_001291784	2514771	2516017	4
chr7	2552162	2568063	LFNG	15901	+	NM_001166355	2552288	2566846	9
chr7	2566707	2566779	MIR4648	72	+	NR_039791	2566779	2566779	1
chr7	2577443	2595392	BRAT1	17949	-	NM_152743	2577702	2594065	14
chr7	2598605	2654368	IQCE	55763	+	NM_152558	2598815	2649796	22
chr7	2671602	2704436	TTYH3	32834	+	NM_025250	2671789	2701373	14
chr7	2719155	2755070	AMZ1	35915	+	NM_133463	2740085	2752512	7
chr7	2767740	2883959	GNA12	116219	-	NM_007353	2770814	2883795	4
chr7	2945709	3083579	CARD11	137870	-	NM_032415	2946271	2998140	25
chr7	3180564	3198206	LOC100129603	17642	-	NR_126024	3198206	3198206	4
chr7	3341079	4308631	SDK1	967552	+	NM_152744	3341218	4305016	45
chr7	4721929	4811074	FOXK1	89145	+	NM_001037165	4721939	4802095	9
chr7	4815261	4834026	AP5Z1	18765	+	NM_014855	4815346	4831016	17
chr7	4828195	4828270	MIR4656	75	-	NR_039800	4828270	4828270	1
chr7	4838739	4923335	RADIL	84596	-	NM_018059	4839008	4917770	15
chr7	4897368	4901625	PAPOLB	4257	-	NM_020144	4899527	4901441	1
chr7	4931875	4998844	MMD2	66969	-	NR_072989	4998844	4998844	9
chr7	5013615	5037800	RNF216P1	24185	+	NR_023384	5037800	5037800	8
chr7	5085451	5109119	RBAK	23668	+	NM_001204456	5087707	5105232	6
chr7	5085451	5112854	RBAK-RBAKDN	27403	+	NM_001204513	5087707	5112096	6
chr7	5111690	5112854	RBAKDN	1164	+	NR_015343	5112854	5112854	3
chr7	5160940	5184177	ZNF890P	23237	-	NR_034163	5184177	5184177	6
chr7	5229834	5273486	WIPI2	43652	+	NM_001033518	5230050	5270578	13
chr7	5322560	5343704	SLC29A4	21144	+	NM_001040661	5327447	5342570	11
chr7	5346422	5463177	TNRC18	116755	-	NM_001080495	5347736	5460877	30
chr7	5515427	5553399	FBXL18	37972	-	NM_024963	5521405	5553305	5
chr7	5535449	5535548	MIR589	99	-	NR_030318	5535548	5535548	1
chr7	5553484	5565176	LOC221946	11692	+	NR_126168	5565176	5565176	4
chr7	5566778	5570232	ACTB	3454	-	NM_001101	5567378	5569288	6
chr7	5632435	5646287	FSCN1	13852	+	NM_003088	5632567	5645105	5
chr7	5659671	5821361	RNF216	161690	-	NM_207111	5662490	5800700	17
chr7	5702062	5720092	RNF216-IT1	18030	-	NR_046834	5720092	5720092	3
chr7	5751470	5751541	MIR6874	71	-	NR_106934	5751541	5751541	1
chr7	5862790	5894066	ZNF815P	31276	+	NR_023382	5894066	5894066	7
chr7	5920428	5925994	OCM	5566	+	NM_001097622	5920520	5925720	4
chr7	5938340	5965603	CCZ1	27263	+	NM_015622	5938430	5965318	15
chr7	6012869	6048737	PMS2	35868	-	NM_000535	6013029	6048650	15
chr7	6048881	6063465	AIMP2	14584	+	NM_006303	6048994	6063322	4
chr7	6061877	6098860	EIF2AK1	36983	-	NM_014413	6064303	6098714	15
chr7	6071006	6076183	ANKRD61	5177	+	NM_001271700	6071006	6076017	3
chr7	6144549	6201195	USP42	56646	+	NM_032172	6150764	6199088	18
chr7	6201411	6312242	CYTH3	110831	-	NM_004227	6204574	6312138	13
chr7	6369039	6388590	FAM220A	19551	-	NM_001037163	6370005	6370785	2
chr7	6414125	6443598	RAC1	29473	+	NM_018890	6414366	6442077	7
chr7	6448746	6487643	DAGLB	38897	-	NM_139179	6449467	6487473	15
chr7	6500711	6523849	KDELR2	23138	-	NM_006854	6502771	6523688	5
chr7	6536408	6591067	GRID2IP	54659	-	NM_001145118	6537404	6591067	22
chr7	6617064	6628610	ZDHHC4	11546	+	NM_001134388	6620192	6628541	9
chr7	6629651	6648357	C7orf26	18706	+	NM_001303039	6629914	6647792	7
chr7	6655526	6663921	ZNF853	8395	+	NM_017560	6655805	6662602	3
chr7	6676952	6697910	ZNF316	20958	+	NM_001278559	6682040	6694242	9
chr7	6728063	6746566	ZNF12	18503	-	NM_006956	6730478	6744804	6
chr7	6774935	6791232	PMS2CL	16297	+	NR_002217	6791232	6791232	6
chr7	6793739	6838396	RSPH10B2	44657	+	NM_001099697	6797308	6838174	21
chr7	6793739	6838396	RSPH10B	44657	+	NM_173565	6797308	6838174	21
chr7	6838565	6865926	CCZ1B	27361	-	NM_198097	6838854	6865828	15
chr7	7106594	7106676	MIR3683	82	-	NR_037454	7106676	7106676	1
chr7	7115400	7136417	LOC100131257	21017	-	NR_034022	7136417	7136417	1
chr7	7222245	7288280	C1GALT1	66035	+	NM_020156	7273950	7283358	4
chr7	7294784	7317700	LOC101927354	22916	+	NR_108073	7317700	7317700	4
chr7	7398243	7575460	COL28A1	177217	-	NM_001037763	7398263	7572506	35
chr7	7589734	7605696	LOC101927391	15962	-	NR_110084	7605696	7605696	5
chr7	7606615	7647110	MIOS	40495	+	NM_019005	7612106	7646723	13
chr7	7676193	7758238	RPA3	82045	-	NM_002947	7676630	7680049	8
chr7	7680266	7918851	UMAD1	238585	+	NM_001302350	7841323	7917169	5
chr7	7989469	8008383	LOC100505921	18914	-	NR_110018	8008383	8008383	5
chr7	8008373	8128709	GLCCI1	120336	+	NM_138426	8008981	8126168	8
chr7	8152814	8302242	ICA1	149428	-	NM_004968	8153552	8275556	14
chr7	8301854	8382911	LOC100505938	81057	+	NR_125740	8382911	8382911	6
chr7	8473584	8792593	NXPH1	319009	+	NM_152745	8475343	8791399	3
chr7	9673899	9675447	PER4	1548	+	NR_002790	9675447	9675447	1
chr7	10971579	10979813	NDUFA4	8234	-	NM_002489	10973262	10979684	4
chr7	11013498	11209250	PHF14	195752	+	NR_033436	11209250	11209250	17
chr7	11410061	11871824	THSD7A	461763	-	NM_015204	11415420	11871572	27
chr7	12250847	12276890	TMEM106B	26043	+	NM_018374	12254436	12271601	9
chr7	12370508	12443852	VWDE	73344	-	NM_001135924	12370808	12443342	29
chr7	12610202	12693228	SCIN	83026	+	NM_001112706	12610412	12692340	16
chr7	12726451	12730558	ARL4A	4107	+	NM_212460	12727879	12728482	2
chr7	13930855	14031050	ETV1	100195	-	NM_001163148	13935490	14028677	13
chr7	14184673	14881075	DGKB	696402	-	NM_004080	14188755	14880888	25
chr7	15239942	15601640	AGMO	361698	-	NM_001004320	15240909	15601470	13
chr7	15650836	15726308	MEOX2	75472	-	NM_005924	15652011	15726027	3
chr7	15707571	15721604	LOC105375166	14033	+	NR_134258	15721604	15721604	4
chr7	15728002	15736517	MEOX2-AS1	8515	+	NR_110094	15736517	15736517	2
chr7	16127151	16460947	ISPD	333796	-	NM_001101426	16131319	16460947	10
chr7	16250110	16310229	ISPD-AS1	60119	+	NR_038947	16310229	16310229	5
chr7	16501105	16505474	SOSTDC1	4369	-	NM_015464	16502172	16505293	2
chr7	16566504	16621114	LRRC72	54610	+	NM_001195280	16566577	16621114	9
chr7	16639400	16685442	ANKMY2	46042	-	NM_020319	16640385	16685198	10
chr7	16685758	16746148	BZW2	60390	+	NM_001159767	16705068	16745713	12
chr7	16793350	16824161	TSPAN13	30811	+	NM_014399	16793592	16823116	6
chr7	16832263	16844738	AGR2	12475	-	NM_006408	16832531	16841420	8
chr7	16899029	16921613	AGR3	22584	-	NM_176813	16899205	16918242	8
chr7	17338275	17385775	AHR	47500	+	NM_001621	17338888	17382688	11
chr7	17414540	17506880	KCCAT333	92340	+	NR_110014	17506880	17506880	4
chr7	17503068	17598533	LOC101927630	95465	-	NR_110013	17598533	17598533	4
chr7	17830384	17980131	SNX13	149747	-	NM_015132	17833668	17979918	26
chr7	18066399	18067486	PRPS1L1	1087	-	NM_175886	18066448	18067405	1
chr7	18126571	18708466	HDAC9	581895	+	NM_001204144	18201947	18706150	13
chr7	18166842	18166932	MIR1302-6	90	-	NR_031635	18166932	18166932	1
chr7	19155090	19157295	TWIST1	2205	-	NM_000474	19156335	19156944	2
chr7	19184404	19185044	FERD3L	640	-	NM_152898	19184484	19184985	1
chr7	19735084	19748660	TWISTNB	13576	-	NM_001002926	19737938	19748639	4
chr7	19744980	19745059	MIR3146	79	-	NR_036101	19745059	19745059	1
chr7	19758937	19812404	TMEM196	53467	-	NM_152774	19761697	19812319	4
chr7	19958603	20180049	LOC101927668	221446	-	NR_110114	20180049	20180049	6
chr7	20174278	20257013	MACC1	82735	-	NM_182762	20180568	20201485	7
chr7	20181538	20193154	MACC1-AS1	11616	+	NR_046756	20193154	20193154	4
chr7	20336330	20351335	LOC101927769	15005	+	NR_110117	20351335	20351335	5
chr7	20367923	20371385	LOC101927811	3462	-	NR_110119	20371385	20371385	4
chr7	20370724	20455382	ITGB8	84658	+	NM_002214	20371429	20449620	14
chr7	20655244	20796637	ABCB5	141393	+	NM_001163941	20662908	20795247	28
chr7	20821893	20826508	SP8	4615	-	NM_198956	20823908	20825381	3
chr7	20866916	20867439	RPL23P8	523	+	NR_026673	20867439	20867439	1
chr7	20875049	21061771	LINC01162	186722	+	NR_126381	21061771	21061771	5
chr7	21467688	21554151	SP4	86463	+	NM_003112	21467869	21550887	6
chr7	21510675	21510764	MIR1183	89	+	NR_031594	21510764	21510764	1
chr7	21582832	21941186	DNAH11	358354	+	NM_001277115	21582863	21940872	82
chr7	21940516	21985542	CDCA7L	45026	-	NM_001127370	21941939	21956434	11
chr7	22157907	22396533	RAPGEF5	238626	-	NM_012294	22162023	22349639	26
chr7	22459062	22539901	STEAP1B	80839	-	NM_207342	22459422	22534474	5
chr7	22602955	22613617	LOC100506178	10662	+	NR_038393	22613617	22613617	4
chr7	22689578	22705152	LOC401312	15574	-	NR_122075	22705152	22705152	5
chr7	22765013	22767239	LOC541472	2226	-	NR_131935	22767239	22767239	2
chr7	22766765	22771621	IL6	4856	+	NM_000600	22766881	22771192	5
chr7	22852250	22862471	TOMM7	10221	-	NM_019059	22852788	22862398	3
chr7	22896231	22896305	SNORD93	74	+	NR_003075	22896305	22896305	1
chr7	22980877	23053770	FAM126A	72893	-	NM_032581	22985207	23030730	11
chr7	23140846	23145322	KLHL7-AS1	4476	-	NR_046220	23145322	23145322	3
chr7	23145352	23215038	KLHL7	69686	+	NR_033328	23215038	23215038	12
chr7	23221445	23240630	NUPL2	19185	+	NM_007342	23221704	23240364	7
chr7	23286315	23314729	GPNMB	28414	+	NM_002510	23286476	23313843	11
chr7	23338939	23349180	MALSU1	10241	+	NM_138446	23338971	23349162	4
chr7	23349827	23509995	IGF2BP3	160168	-	NM_006547	23351980	23509729	15
chr7	23530006	23531031	RPS2P32	1025	+	NR_026676	23531031	23531031	1
chr7	23544400	23571660	TRA2A	27260	-	NM_001282759	23545177	23556014	10
chr7	23624334	23626146	CLK2P1	1812	-	NR_002711	23626146	23626146	1
chr7	23636997	23684327	CCDC126	47330	+	NM_138771	23650934	23682734	4
chr7	23719732	23742269	FAM221A	22537	+	NM_199136	23719837	23741783	7
chr7	23749785	23872130	STK31	122345	+	NR_048542	23872130	23872130	24
chr7	24323806	24331484	NPY	7678	+	NM_000905	24324859	24331306	4
chr7	24612964	24733322	MPP6	120358	+	NM_016447	24663286	24727233	13
chr7	24737973	24797639	DFNA5	59666	-	NM_004403	24738644	24789393	10
chr7	24836155	25019831	OSBPL3	183676	-	NM_015550	24839801	24932091	23
chr7	25158269	25164980	CYCS	6711	-	NM_018947	25163319	25163738	3
chr7	25174315	25219817	C7orf31	45502	-	NM_138811	25175590	25218927	10
chr7	25264190	25268105	NPVF	3915	-	NM_022150	25264740	25268058	3
chr7	25989538	25989606	MIR148A	68	-	NR_029597	25989606	25989606	1
chr7	26191846	26226756	NFE2L3	34910	+	NM_004289	26192118	26225403	4
chr7	26229555	26240413	HNRNPA2B1	10858	-	NM_031243	26232135	26240197	12
chr7	26240830	26253227	CBX3	12397	+	NM_007276	26242618	26251828	6
chr7	26331514	26413949	SNX10	82435	+	NR_037670	26413949	26413949	8
chr7	26443107	26535986	LOC441204	92879	+	NR_015364	26535986	26535986	5
chr7	26572739	26578444	KIAA0087	5705	-	NR_022006	26578444	26578444	2
chr7	26677489	26686889	C7orf71	9400	+	NM_001145531	26678763	26686159	4
chr7	26706680	26904362	SKAP2	197682	-	NM_003930	26709718	26904048	13
chr7	27132613	27135625	HOXA1	3012	-	NM_153620	27134914	27135531	3
chr7	27135712	27139877	HOTAIRM1	4165	+	NR_038366	27139877	27139877	3
chr7	27139972	27142394	HOXA2	2422	-	NM_006735	27140344	27142119	2
chr7	27145808	27166639	HOXA3	20831	-	NM_153631	27147533	27150259	4
chr7	27161537	27168379	HOXA-AS2	6842	+	NR_122069	27168379	27168379	4
chr7	27168125	27170399	HOXA4	2274	-	NM_002141	27168843	27170352	2
chr7	27179982	27195547	HOXA-AS3	15565	+	NR_038832	27195547	27195547	3
chr7	27180670	27183287	HOXA5	2617	-	NM_019102	27181453	27183226	2
chr7	27185201	27187393	HOXA6	2192	-	NM_024014	27185276	27187368	2
chr7	27193337	27196296	HOXA7	2959	-	NM_006896	27194527	27196164	2
chr7	27202056	27205149	HOXA9	3093	-	NM_152739	27203221	27205076	2
chr7	27202056	27219880	HOXA10-HOXA9	17824	-	NR_037940	27219880	27219880	3
chr7	27208517	27211534	HOXA10-AS	3017	+	NR_046609	27211534	27211534	3
chr7	27209098	27209182	MIR196B	84	-	NR_029911	27209182	27209182	1
chr7	27210209	27219880	HOXA10	9671	-	NR_037939	27219880	27219880	2
chr7	27220775	27224835	HOXA11	4060	-	NM_005523	27222414	27224763	2
chr7	27225026	27228912	HOXA11-AS	3886	+	NR_002795	27228912	27228912	2
chr7	27236498	27239725	HOXA13	3227	-	NM_000522	27237816	27239696	2
chr7	27240039	27246878	HOTTIP	6839	+	NR_037843	27246878	27246878	3
chr7	27281047	27286848	EVX1-AS	5801	-	NR_120507	27286848	27286848	4
chr7	27282163	27287438	EVX1	5275	+	NM_001304520	27284785	27286044	4
chr7	27565058	27702620	HIBADH	137562	-	NM_152740	27565832	27702407	8
chr7	27655592	27667111	TSL	11519	+	NR_122122	27667111	27667111	3
chr7	27778991	27869386	TAX1BP1	90395	+	NM_001206901	27788143	27868448	17
chr7	27870192	28220437	JAZF1	350245	-	NM_175061	27872418	28220196	5
chr7	28220075	28280996	JAZF1-AS1	60921	+	NR_034097	28280996	28280996	4
chr7	28338939	28865511	CREB5	526572	+	NM_182899	28534547	28858896	10
chr7	28992973	28998029	TRIL	5056	-	NM_014817	28995226	28997662	2
chr7	29019582	29052985	LOC100506497	33403	+	NR_038965	29052985	29052985	5
chr7	29035246	29186153	CPVL	150907	-	NM_031311	29035387	29160677	13
chr7	29164648	29167788	LOC101928168	3140	+	NR_120523	29167788	29167788	3
chr7	29186162	29553951	CHN2	367789	+	NM_001293069	29186199	29552351	14
chr7	29238655	29248586	LOC102724484	9931	-	NR_120522	29248586	29248586	3
chr7	29603426	29606911	PRR15	3485	+	NM_175887	29605945	29606335	2
chr7	29685537	29724754	LOC646762	39217	-	NR_024278	29724754	29724754	2
chr7	29720349	29720444	MIR550A3	95	-	NR_039600	29720444	29720444	1
chr7	29724387	29725437	ZNRF2P2	1050	-	NR_027347	29725437	29725437	1
chr7	29724769	29727859	DPY19L2P3	3090	+	NR_036482	29727859	29727859	2
chr7	29846169	29956682	WIPF3	110513	+	NM_001080529	29874340	29954132	9
chr7	29959718	30029905	SCRN1	70187	-	NM_001145514	29963572	30029856	8
chr7	30050198	30066417	FKBP14	16219	-	NR_046478	30066417	30066417	5
chr7	30067976	30157961	PLEKHA8	89985	+	NM_001197027	30068378	30157603	14
chr7	30174551	30202381	MTURN	27830	+	NM_152793	30174752	30197164	3
chr7	30323922	30407308	ZNRF2	83386	+	NM_147128	30324973	30402050	5
chr7	30329409	30329506	MIR550A1	97	+	NR_030319	30329506	30329506	1
chr7	30329409	30329506	MIR550B1	97	-	NR_037513	30329506	30329506	1
chr7	30409665	30412410	DKFZP586I1420	2745	+	NR_002186	30412410	30412410	1
chr7	30430500	30443670	LINC01176	13170	+	NR_108081	30443670	30443670	3
chr7	30464142	30518393	NOD1	54251	-	NM_006092	30465253	30496537	14
chr7	30536236	30544457	GGCT	8221	-	NM_001199815	30536793	30544325	4
chr7	30587972	30617395	LOC401320	29423	-	NR_038889	30617395	30617395	7
chr7	30634350	30673648	GARS	39298	+	NM_001316772	30634699	30673476	17
chr7	30691558	30739719	CRHR2	48161	-	NM_001202481	30693075	30726065	14
chr7	30791750	30797218	INMT	5468	+	NM_006774	30791766	30795467	3
chr7	30791750	30932002	INMT-FAM188B	140252	+	NR_037598	30932002	30932002	20
chr7	30811032	30932002	FAM188B	120970	+	NM_032222	30811109	30931620	18
chr7	30951414	30965131	AQP1	13717	+	NM_198098	30951524	30963244	4
chr7	31003635	31019146	GHRHR	15511	+	NM_000823	31003683	31018859	13
chr7	31092075	31151093	ADCYAP1R1	59018	+	NM_001199636	31102880	31146298	17
chr7	31377074	31380538	NEUROD6	3464	-	NM_022728	31377868	31378882	2
chr7	31553684	31693303	CCDC129	139619	+	NM_001257967	31589106	31692443	15
chr7	31726630	31748069	PPP1R17	21439	+	NM_006658	31732055	31746897	5
chr7	31790792	32339016	PDE1C	548224	-	NM_001191058	31792997	32338347	19
chr7	32496509	32498106	LOC100130673	1597	-	NR_038454	32498106	32498106	1
chr7	32524944	32534870	LSM5	9926	-	NM_001139499	32526872	32528915	5
chr7	32535037	32628353	AVL9	93316	+	NM_015060	32535321	32623519	16
chr7	32620552	32758780	DPY19L1P1	138228	-	NR_036680	32758780	32758780	17
chr7	32767561	32769595	ZNRF2P1	2034	+	NR_003502	32769595	32769595	1
chr7	32772592	32772689	MIR550A2	97	+	NR_030320	32772689	32772689	1
chr7	32772592	32772689	MIR550B2	97	-	NR_037514	32772689	32772689	1
chr7	32797897	32802536	LINC00997	4639	+	NR_036501	32802536	32802536	1
chr7	32865913	32878356	DPY19L1P2	12443	+	NR_132360	32878356	32878356	6
chr7	32907777	32931468	KBTBD2	23691	-	NM_015483	32908956	32919216	4
chr7	32956426	32982782	RP9P	26356	-	NR_003500	32982782	32982782	6
chr7	32997015	33046543	FKBP9	49528	+	NM_001284341	32997185	33044963	11
chr7	33053724	33102409	NT5C3A	48685	-	NM_001002009	33054341	33075581	10
chr7	33134409	33149002	RP9	14593	-	NM_203288	33134845	33148984	6
chr7	33169151	33645680	BBS9	476529	+	NM_198428	33185864	33644838	23
chr7	33944522	34195484	BMPER	250962	+	NM_133468	33945225	34192885	16
chr7	34386123	34797884	NPSR1-AS1	411761	-	NR_033664	34797884	34797884	5
chr7	34697850	34917944	NPSR1	220094	+	NM_001300933	34698024	34917796	9
chr7	34968492	35077653	DPY19L1	109161	-	NM_015283	34971184	35077508	22
chr7	35120898	35225774	DPY19L2P1	104876	-	NR_002833	35225774	35225774	22
chr7	35242041	35293711	TBX20	51670	-	NM_001077653	35242041	35293231	8
chr7	35353465	35416086	LOC401324	62621	+	NR_038864	35416086	35416086	3
chr7	35672269	35734772	HERPUD2	62503	-	NM_022373	35673299	35733940	9
chr7	35756046	35759322	LOC100506725	3276	+	NR_108082	35759322	35759322	3
chr7	35794573	35840235	SEPT7-AS1	45662	-	NR_120511	35840235	35840235	6
chr7	35840595	35946715	SEPT7	106120	+	NM_001011553	35840819	35943903	13
chr7	36134919	36140262	LOC101928618	5343	+	NR_108089	36140262	36140262	2
chr7	36192835	36341152	EEPD1	148317	+	NM_030636	36193933	36338815	8
chr7	36363758	36429734	KIAA0895	65976	-	NM_001100425	36366368	36429683	7
chr7	36429411	36493401	ANLN	63990	+	NM_018685	36429635	36492209	24
chr7	36552548	36764154	AOAH	211606	-	NM_001177506	36552639	36763753	22
chr7	36637439	36639726	AOAH-IT1	2287	-	NR_046764	36639726	36639726	3
chr7	36892510	37488929	ELMO1	596419	-	NM_001206480	36895155	37382294	22
chr7	36958961	36959037	MIR1200	76	-	NR_031604	36959037	36959037	1
chr7	37037400	37053235	ELMO1-AS1	15835	+	NR_104120	37053235	37053235	3
chr7	37779995	37780913	GPR141	918	+	NM_181791	37779995	37780913	1
chr7	37888198	37940002	NME8	51804	+	NM_016616	37889868	37936694	18
chr7	37945534	37956525	SFRP4	10991	-	NM_003014	37947080	37956139	6
chr7	37960162	37991542	EPDR1	31380	+	NM_017549	37960541	37989998	3
chr7	38217807	38270272	STARD3NL	52465	+	NM_032016	38247105	38268455	9
chr7	38299243	38313248	TARP	14005	-	NM_001003799	38305090	38305267	4
chr7	38381177	38418238	TRG-AS1	37061	+	NR_040085	38418238	38418238	4
chr7	38423296	38671167	AMPH	247871	-	NM_001635	38424418	38670951	21
chr7	38724945	38726689	FAM183BP	1744	-	NR_028347	38726689	38726689	2
chr7	38763542	38948800	VPS41	185258	-	NM_014396	38765845	38948774	29
chr7	39017608	39504390	POU6F2	486782	+	NM_001166018	39046449	39504285	11
chr7	39444197	39445945	POU6F2-AS1	1748	-	NR_046711	39445945	39445945	4
chr7	39605974	39651688	YAE1D1	45714	+	NM_001282446	39606017	39649585	3
chr7	39663151	39747723	RALA	84572	+	NM_005402	39726266	39745844	5
chr7	39773166	39834222	LINC00265	61056	+	NR_026999	39834222	39834222	12
chr7	39989958	40136733	CDK13	146775	+	NM_031267	39990240	40134579	14
chr7	40172341	40174251	MPLKIP	1910	-	NM_138701	40172657	40174166	2
chr7	40174574	40900366	SUGCT	725792	+	NM_001193311	40174598	40900078	15
chr7	41004276	41019537	LINC01450	15261	-	NR_110831	41019537	41019537	3
chr7	41141201	41173099	LINC01449	31898	+	NR_110832	41173099	41173099	6
chr7	41728600	41742706	INHBA	14106	-	NM_002192	41729247	41739972	3
chr7	41733513	41818976	INHBA-AS1	85463	+	NR_027118	41818976	41818976	4
chr7	42000547	42276618	GLI3	276071	-	NM_000168	42003927	42262852	15
chr7	42701325	42746046	LINC01448	44721	-	NR_110833	42746046	42746046	3
chr7	42948871	42951689	C7orf25	2818	-	NM_001099858	42949233	42951666	2
chr7	42956461	42971805	PSMA2	15344	-	NM_002787	42957172	42971757	8
chr7	42971938	42977453	MRPL32	5515	+	NM_031903	42971985	42977175	3
chr7	43152197	43602938	HECW1	450741	+	NM_015052	43283504	43601525	30
chr7	43190493	43190593	MIR3943	100	+	NR_037508	43190593	43190593	1
chr7	43548326	43562141	LOC100506895	13815	-	NR_038276	43562141	43562141	3
chr7	43622691	43666978	STK17A	44287	+	NM_004760	43622842	43664441	7
chr7	43670750	43769140	COA1	98390	-	NR_047701	43769140	43769140	8
chr7	43798271	43846941	BLVRA	48670	+	NM_001253823	43810757	43846834	9
chr7	43906156	43909145	MRPS24	2989	-	NM_032014	43906297	43909094	4
chr7	43906156	43946231	URGCP-MRPS24	40075	-	NM_001204871	43908584	43946174	7
chr7	43915492	43966010	URGCP	50518	-	NM_001290076	43916265	43921539	7
chr7	43966034	43995735	UBE2D4	29701	+	NM_015983	43966131	43992294	7
chr7	43980493	44058793	POLR2J4	78300	-	NR_003655	44058793	44058793	16
chr7	44040488	44049723	SPDYE1	9235	+	NM_175064	44040624	44047367	7
chr7	44068485	44080222	RASA4CP	11737	-	NR_024116	44080222	44080222	9
chr7	44078647	44083895	LINC00957	5248	+	NR_072982	44083895	44083895	3
chr7	44084238	44101316	DBNL	17078	+	NM_001284315	44089837	44100515	11
chr7	44091364	44091428	MIR6837	64	+	NR_106896	44091428	44091428	1
chr7	44102325	44105186	PGAM2	2861	-	NM_000290	44102362	44105128	3
chr7	44111660	44122139	POLM	10479	-	NR_104299	44122139	44122139	11
chr7	44112976	44113032	MIR6838	56	-	NR_106897	44113032	44113032	1
chr7	44143959	44154164	AEBP1	10205	+	NM_001129	44144264	44153860	21
chr7	44150447	44150511	MIR4649	64	+	NR_039792	44150511	44150511	1
chr7	44154278	44163169	POLD2	8891	-	NM_006230	44154383	44163158	11
chr7	44178462	44180916	MYL7	2454	-	NM_021223	44178519	44180904	7
chr7	44183869	44229022	GCK	45153	-	NM_000162	44184734	44228552	10
chr7	44240577	44253893	YKT6	13316	+	NM_006555	44240734	44251881	7
chr7	44256748	44365230	CAMK2B	108482	-	NM_001220	44259660	44365020	24
chr7	44421964	44530385	NUDCD3	108421	-	NM_015332	44425609	44530199	6
chr7	44552134	44580914	NPC1L1	28780	-	NM_013389	44553045	44580858	20
chr7	44605015	44614137	DDX56	9122	-	NM_019082	44605600	44613494	14
chr7	44617493	44621894	TMED4	4401	-	NM_182547	44619077	44621805	5
chr7	44646120	44748669	OGDH	102549	+	NM_001165036	44663942	44747598	23
chr7	44788164	44809479	ZMIZ2	21315	+	NM_001300959	44795848	44807222	18
chr7	44836234	44842722	PPIA	6488	+	NM_001300981	44839070	44841021	6
chr7	44866487	44887725	H2AFV	21238	-	NM_138635	44869742	44887570	5
chr7	44915891	44924984	PURB	9093	-	NM_033224	44924008	44924947	1
chr7	44921346	44921399	MIR4657	53	-	NR_039801	44921399	44921399	1
chr7	45002259	45018704	MYO1G	16445	-	NM_033054	45002337	45018560	22
chr7	45022626	45026259	SNHG15	3633	-	NR_003697	45026259	45026259	5
chr7	45024976	45025109	SNORA9	133	-	NR_002952	45025109	45025109	1
chr7	45039344	45116069	CCM2	76725	+	NR_030770	45116069	45116069	10
chr7	45120035	45128493	NACAD	8458	-	NM_001146334	45120107	45128493	8
chr7	45139698	45151346	TBRG4	11648	-	NM_001261834	45139923	45151268	11
chr7	45143947	45144081	SNORA5A	134	-	NR_002919	45144081	45144081	1
chr7	45144504	45144641	SNORA5C	137	-	NR_002991	45144641	45144641	1
chr7	45145566	45145698	SNORA5B	132	-	NR_002990	45145698	45145698	1
chr7	45197366	45223850	RAMP3	26484	+	NM_005856	45197427	45223011	3
chr7	45614124	45762714	ADCY1	148590	+	NM_021116	45614142	45753594	20
chr7	45763385	45808617	SEPT7P2	45232	-	NR_024271	45808617	45808617	13
chr7	45927958	45933267	IGFBP1	5309	+	NM_000596	45928251	45932690	4
chr7	45951843	45960871	IGFBP3	9028	-	NM_000598	45954418	45960739	5
chr7	47314751	47621742	TNS3	306991	-	NM_022748	47317673	47479234	31
chr7	47661536	47669491	LINC01447	7955	+	NR_108090	47669491	47669491	4
chr7	47694841	47701246	C7orf65	6405	+	NM_001123065	47694876	47698826	3
chr7	47801073	47806370	LINC00525	5297	+	NR_038407	47806370	47806370	3
chr7	47814249	47988071	PKD1L1	173822	-	NM_138295	47814740	47988037	57
chr7	47834888	47859444	C7orf69	24556	+	NM_001302627	47853116	47859195	4
chr7	48002884	48019222	HUS1	16338	-	NR_037917	48019222	48019222	9
chr7	48026745	48068716	SUN3	41971	-	NM_152782	48026926	48068535	11
chr7	48075107	48100894	C7orf57	25787	+	NM_001100159	48075905	48099869	9
chr7	48128199	48148330	UPP1	20131	+	NM_001287426	48134380	48147954	10
chr7	48211056	48687091	ABCA13	476035	+	NM_152701	48211080	48685108	62
chr7	48964156	48967049	CDC14C	2893	+	NR_003595	48967049	48967049	1
chr7	49813256	49952138	VWC2	138882	+	NM_198570	49815031	49951781	4
chr7	49977023	50132860	ZPBP	155837	-	NM_001159878	49977123	50132790	8
chr7	50135681	50198852	C7orf72	63171	+	NM_001161834	50135681	50198765	9
chr7	50343678	50472798	IKZF1	129120	+	NM_001291839	50358657	50468325	6
chr7	50511826	50518088	FIGNL1	6262	-	NM_001287496	50512960	50514652	4
chr7	50526133	50633154	DDC	107021	-	NM_001082971	50530928	50611783	15
chr7	50599456	50611161	DDC-AS1	11705	+	NR_033845	50611161	50611161	5
chr7	50657759	50861159	GRB10	203400	-	NM_001001555	50660648	50742320	17
chr7	51083908	51384515	COBL	300607	-	NM_001287436	51085247	51384330	14
chr7	53103348	53104618	POM121L12	1270	+	NM_182595	53103364	53104255	1
chr7	53723201	53879624	LINC01446	156423	-	NR_038371	53879624	53879624	6
chr7	54268916	54270114	HPVC1	1198	-	NR_004422	54270114	54270114	1
chr7	54398389	54417538	LINC01445	19149	+	NR_120515	54417538	54417538	3
chr7	54610017	54638773	VSTM2A	28756	+	NM_001301009	54610423	54636912	5
chr7	54624662	54639419	VSTM2A-OT1	14757	+	NR_038994	54639419	54639419	4
chr7	54819939	54826939	SEC61G	7000	-	NM_001012456	54820103	54825281	4
chr7	54827005	54872656	LOC100996654	45651	+	NR_110040	54872656	54872656	3
chr7	55086724	55275031	EGFR	188307	+	NM_005228	55086970	55273310	28
chr7	55247442	55256642	EGFR-AS1	9200	-	NR_047551	55256642	55256642	2
chr7	55306128	55323328	ELDR	17200	-	NR_110426	55323328	55323328	4
chr7	55433140	55501435	LANCL2	68295	+	NM_018697	55433718	55499013	9
chr7	55538305	55640200	VOPP1	101895	-	NM_030796	55540547	55640017	5
chr7	55748766	55772260	FKBP9P1	23494	-	NR_003949	55772260	55772260	6
chr7	55861236	55930482	SEPT14	69246	-	NM_207366	55863605	55929689	10
chr7	55954969	56009918	ZNF713	54949	+	NM_182633	55980329	56007699	7
chr7	56019610	56023033	MRPS17	3423	+	NM_015969	56020888	56022871	3
chr7	56032269	56067875	GBAS	35606	+	NM_001483	56032302	56066765	10
chr7	56078743	56119268	PSPH	40525	-	NM_004577	56079454	56088905	8
chr7	56119377	56131682	CCT6A	12305	+	NM_001762	56119541	56130778	14
chr7	56128162	56128295	SNORA15	133	+	NR_002957	56128295	56128295	1
chr7	56131916	56148365	SUMF2	16449	+	NM_015411	56131947	56147305	9
chr7	56147975	56160689	PHKG1	12714	-	NM_001258459	56148746	56156634	11
chr7	56169265	56174187	CHCHD2	4922	-	NM_016139	56169543	56174106	4
chr7	56182373	56184090	NUPR2	1717	-	NM_001145712	56183713	56184007	2
chr7	56491396	56516068	LOC650226	24672	-	NR_029420	56516068	56516068	6
chr7	56549797	56551012	LOC100240728	1215	-	NR_108095	56551012	56551012	2
chr7	56563915	56564977	DKFZp434L192	1062	+	NR_026929	56564977	56564977	1
chr7	56601922	56605823	LOC101928401	3901	-	NR_108099	56605823	56605823	2
chr7	56876816	56880429	LOC401357	3613	-	NR_130727	56880429	56880429	1
chr7	56943077	56949839	LOC100130849	6762	-	NR_038450	56949839	56949839	5
chr7	57023491	57023571	MIR4283-1	80	-	NR_036246	57023571	57023571	1
chr7	57023491	57023571	MIR4283-2	80	-	NR_036270	57023571	57023571	1
chr7	57187325	57207571	ZNF479	20246	-	NM_033273	57187546	57200031	5
chr7	57233376	57247863	GUSBP10	14487	-	NR_030766	57247863	57247863	4
chr7	57472730	57472796	MIR3147	66	+	NR_036102	57472796	57472796	1
chr7	57509882	57533265	ZNF716	23383	+	NM_001159279	57509994	57529655	4
chr7	62751669	62764434	ZNF733P	12765	-	NR_003952	62764434	62764434	3
chr7	62809447	62812152	LOC100287704	2705	+	NR_028348	62812152	62812152	2
chr7	62809447	62812152	LOC100287834	2705	+	NR_028349	62812152	62812152	2
chr7	63484795	63490480	LINC01005	5685	-	NR_039987	63490480	63490480	4
chr7	63505820	63538927	ZNF727	33107	+	NM_001159522	63505999	63538927	4
chr7	63667580	63680668	ZNF735	13088	+	NM_001159524	63667580	63680668	4
chr7	63688851	63727309	ZNF679	38458	+	NM_153363	63709495	63727247	5
chr7	63774250	63817012	ZNF736	42762	+	NM_001170905	63774528	63809525	4
chr7	63894070	63895895	YWHAEP1	1825	+	NR_029404	63895895	63895895	1
chr7	63980254	64023505	ZNF680	43251	-	NM_178558	63981538	64023332	4
chr7	64035072	64078967	LOC100128885	43895	+	NR_077227	64078967	64078967	3
chr7	64042987	64044129	LOC641746	1142	+	NR_033245	64044129	64044129	1
chr7	64126460	64171960	ZNF107	45500	+	NM_016220	64152319	64169034	7
chr7	64139441	64139554	MIR6839	113	+	NR_106898	64139554	64139554	1
chr7	64254765	64314178	ZNF138	59413	+	NR_073389	64314178	64314178	3
chr7	64363619	64391955	ZNF273	28336	+	NR_003099	64391955	64391955	5
chr7	64434829	64451414	ZNF117	16585	-	NM_015852	64438496	64441798	4
chr7	64450732	64467124	ERV3-1	16392	-	NM_001007253	64451589	64453404	2
chr7	64498731	64535091	CCT6P3	36360	+	NR_033416	64535091	64535091	11
chr7	64838711	64866048	ZNF92	27337	+	NM_001287533	64863255	64864788	5
chr7	65111923	65235797	LOC441242	123874	-	NR_038378	65235797	65235797	8
chr7	65112766	65183667	INTS4P2	70901	+	NR_027392	65183667	65183667	13
chr7	65216091	65228662	CCT6P1	12571	+	NR_003110	65228662	65228662	12
chr7	65220512	65220646	SNORA22	134	+	NR_002961	65220646	65220646	1
chr7	65338256	65424550	VKORC1L1	86294	+	NM_173517	65338358	65419287	3
chr7	65425671	65447301	GUSB	21630	-	NM_001293104	65425883	65445221	11
chr7	65540775	65558329	ASL	17554	+	NM_000048	65541068	65557899	17
chr7	65579804	65619553	CRCP	39749	+	NR_024548	65619553	65619553	7
chr7	65670258	65825438	TPST1	155180	+	NM_003596	65705412	65821829	6
chr7	65841030	65865395	LINC00174	24365	-	NR_026873	65865395	65865395	5
chr7	65995291	66057394	GS1-124K5.11	62103	-	NR_111973	66057394	66057394	11
chr7	66093867	66108216	KCTD7	14349	+	NM_001167961	66094051	66105381	5
chr7	66119505	66134589	LOC100996437	15084	+	NR_110037	66134589	66134589	4
chr7	66147077	66276448	RABGEF1	129371	+	NM_001287060	66260560	66274271	10
chr7	66274979	66309813	GTF2IRD1P1	34834	-	NR_003934	66309813	66309813	11
chr7	66386202	66423538	TMEM248	37336	+	NM_017994	66406852	66420509	7
chr7	66452689	66460588	SBDS	7899	-	NM_016038	66453357	66460404	5
chr7	66461791	66704507	TYW1	242716	+	NM_018264	66461965	66703516	16
chr7	66579308	66579384	MIR4650-1	76	-	NR_039793	66579384	66579384	1
chr7	66579308	66579384	MIR4650-2	76	-	NR_039794	66579384	66579384	1
chr7	66741117	66767429	PMS2P4	26312	-	NR_046299	66767429	66767429	6
chr7	66767624	66786513	STAG3L4	18889	+	NR_040585	66786513	66786513	6
chr7	66800962	66805012	LINC01372	4050	+	NR_108104	66805012	66805012	3
chr7	67485239	67497677	LOC102723427	12438	+	NR_120514	67497677	67497677	6
chr7	69061123	69062481	LOC100507468	1358	-	NR_108105	69062481	69062481	2
chr7	69063904	70258054	AUTS2	1194150	+	NM_015570	69064639	70255982	19
chr7	70597522	71178586	WBSCR17	581064	+	NM_022479	70597788	71177131	11
chr7	70772657	70772756	MIR3914-1	99	-	NR_037477	70772756	70772756	1
chr7	70772659	70772754	MIR3914-2	95	+	NR_037479	70772754	70772754	1
chr7	71244475	71877360	CALN1	632885	-	NM_031468	71252759	71868354	7
chr7	72039491	72298813	TYW1B	259322	-	NM_001145440	72040482	72298654	15
chr7	72299951	72307978	SBDSP1	8027	+	NR_024110	72307978	72307978	5
chr7	72333320	72339656	SPDYE7P	6336	-	NR_003666	72339656	72339656	6
chr7	72349905	72421979	POM121	72074	+	NM_001257190	72396950	72419009	16
chr7	72418831	72425302	NSUN5P2	6471	-	NR_033323	72425302	72425302	11
chr7	72430015	72439997	TRIM74	9982	-	NM_198853	72430412	72436688	5
chr7	72440164	72443674	LOC541473	3510	+	NR_003602	72443674	72443674	5
chr7	72440212	72443674	LOC100101148	3462	+	NR_104007	72443674	72443674	4
chr7	72467817	72476466	STAG3L3	8649	-	NR_040582	72476466	72476466	9
chr7	72476643	72491707	PMS2P2	15064	+	NR_003614	72491707	72491707	5
chr7	72634673	72649979	NCF1B	15306	+	NR_003186	72649979	72649979	8
chr7	72716512	72722864	NSUN5	6352	-	NM_001168347	72717394	72722787	10
chr7	72726531	72742085	TRIM50	15554	-	NM_001281450	72726916	72738785	7
chr7	72742154	72772646	FKBP6	30492	+	NM_001135211	72742275	72756897	9
chr7	72848108	72850450	FZD9	2342	+	NM_003508	72848337	72850113	1
chr7	72854727	72936615	BAZ1B	81888	-	NM_032408	72856525	72936263	20
chr7	72950682	72972065	BCL7B	21383	-	NM_001301061	72951627	72971819	7
chr7	72983276	72993013	TBL2	9737	-	NM_012453	72984836	72992879	7
chr7	73007523	73038870	MLXIPL	31347	-	NM_032954	73008194	73038822	17
chr7	73082173	73086440	VPS37D	4267	+	NM_001077621	73082288	73085706	4
chr7	73095247	73097781	DNAJC30	2534	-	NM_032317	73097072	73097753	1
chr7	73097897	73112551	WBSCR22	14654	+	NM_001202560	73097955	73112216	13
chr7	73113534	73134017	STX1A	20483	-	NM_004603	73114736	73133961	10
chr7	73125646	73125727	MIR4284	81	+	NR_036247	73125727	73125727	1
chr7	73149398	73150330	ABHD11-AS1	932	+	NR_026690	73150330	73150330	4
chr7	73150424	73153197	ABHD11	2773	-	NM_001301058	73151003	73153127	4
chr7	73183326	73184600	CLDN3	1274	-	NM_001306	73183716	73184379	1
chr7	73245192	73247023	CLDN4	1831	+	NM_001305	73245531	73246161	1
chr7	73248920	73256855	WBSCR27	7935	-	NM_152559	73249072	73256470	6
chr7	73275488	73280223	WBSCR28	4735	+	NM_182504	73275524	73280203	3
chr7	73442118	73484236	ELN	42118	+	NM_001278939	73442517	73483030	34
chr7	73498106	73536855	LIMK1	38749	+	NM_002314	73498320	73535631	16
chr7	73588705	73611429	EIF4H	22724	+	NM_022170	73588713	73609638	7
chr7	73605527	73605624	MIR590	97	+	NR_030321	73605624	73605624	1
chr7	73624086	73644164	LAT2	20078	+	NM_032464	73630305	73639072	14
chr7	73645831	73668788	RFC2	22957	-	NM_181471	73646435	73668713	11
chr7	73703804	73820273	CLIP2	116469	+	NM_003388	73731876	73818178	17
chr7	73868119	74016920	GTF2IRD1	148801	+	NM_001199207	73922410	74016760	27
chr7	74071990	74175022	GTF2I	103032	+	NM_032999	74103462	74173168	35
chr7	74103270	74143256	LOC101926943	39986	-	NR_110044	74143256	74143256	4
chr7	74188308	74203720	NCF1	15412	+	NM_000265	74188378	74203504	11
chr7	74210482	74267872	GTF2IRD2	57390	-	NM_173537	74211000	74251500	16
chr7	74298091	74306731	STAG3L2	8640	-	NR_040584	74306731	74306731	8
chr7	74441223	74489717	WBSCR16	48494	-	NM_148842	74442135	74489573	11
chr7	74508346	74565623	GTF2IRD2B	57277	+	NM_001003795	74524756	74565103	16
chr7	74572383	74587802	NCF1C	15419	-	NR_003187	74587802	74587802	11
chr7	74601103	74653459	GTF2IP4	52356	-	NR_003580	74653459	74653459	24
chr7	74601103	74867641	GTF2IP1	266538	-	NR_002206	74867641	74867641	24
chr7	74702376	74988276	PMS2P5	285900	-	NR_027776	74988276	74988276	6
chr7	74800771	74867509	GATSL2	66738	-	NM_001145064	74807604	74867341	9
chr7	74936532	74946587	SPDYE8P	10055	+	NR_003664	74946587	74946587	8
chr7	74977963	74988292	PMS2P7	10329	-	NR_130940	74988292	74988292	6
chr7	74988446	74997085	STAG3L1	8639	+	NR_040583	74997085	74997085	11
chr7	75024902	75034896	TRIM73	9994	+	NM_198924	75028217	75034491	5
chr7	75039604	75046071	NSUN5P1	6467	+	NR_033322	75046071	75046071	11
chr7	75046059	75115565	POM121C	69506	-	NM_001099415	75048078	75070774	15
chr7	75122946	75133628	SPDYE5	10682	+	NM_001306141	75123367	75131261	8
chr7	75137068	75157453	PMS2P3	20385	-	NR_028059	75157453	75157453	9
chr7	75162618	75368290	HIP1	205672	-	NM_005338	75167492	75368238	31
chr7	75398841	75419064	CCL26	20223	-	NM_006072	75399010	75401494	4
chr7	75441113	75443033	CCL24	1920	-	NM_002991	75441113	75443033	3
chr7	75508316	75518244	RHBDD2	9928	+	NM_001040457	75511391	75517667	5
chr7	75544419	75616173	POR	71754	+	NM_000941	75583310	75615799	16
chr7	75544514	75544587	MIR4651	73	+	NR_039795	75544587	75544587	1
chr7	75573100	75573234	SNORA14A	134	+	NR_002955	75573234	75573234	1
chr7	75616154	75623992	TMEM120A	7838	-	NM_031925	75616489	75623888	12
chr7	75625654	75677321	STYXL1	51667	-	NM_016086	75625785	75659841	9
chr7	75677336	75696827	MDH2	19491	+	NM_005918	75677478	75695728	9
chr7	75831210	75916609	SRRM3	85399	+	NM_001291831	75864384	75915144	16
chr7	75931874	75933614	HSPB1	1740	+	NM_001540	75932029	75933490	3
chr7	75956107	75988342	YWHAG	32235	-	NM_012479	75958893	75988125	2
chr7	76018645	76039012	SSC4D	20367	-	NM_080744	76019375	76033756	11
chr7	76026840	76071388	ZP3	44548	+	NM_007155	76054434	76071373	9
chr7	76090971	76135312	DTX2	44341	+	NM_020892	76109826	76134918	12
chr7	76099336	76104317	FDPSP2	4981	-	NR_003262	76104317	76104317	1
chr7	76139739	76157199	UPK3B	17460	+	NM_182684	76139969	76144521	7
chr7	76178657	76257299	LOC100133091	78642	+	NR_029411	76257299	76257299	3
chr7	76239302	76256620	POMZP3	17318	-	NM_012230	76240781	76255381	7
chr7	76610138	76653076	DTX2P1-UPK3BP1-PMS2P11	42938	+	NR_023383	76653076	76653076	11
chr7	76668796	76682355	PMS2P9	13559	+	NR_028058	76682355	76682355	5
chr7	76751933	76924521	CCDC146	172588	+	NM_020879	76796985	76924183	19
chr7	76822687	76829150	FGL2	6463	-	NM_006682	76825595	76829110	2
chr7	76940067	77045717	GSAP	105650	-	NM_017439	76940674	77045638	31
chr7	77044514	77054760	LOC101927243	10246	+	NR_110073	77054760	77054760	5
chr7	77166772	77269388	PTPN12	102616	+	NM_002835	77166863	77268597	18
chr7	77286976	77325582	APTR	38606	-	NR_134251	77325582	77325582	4
chr7	77325742	77409120	RSBN1L	83378	+	NM_198467	77325786	77408485	8
chr7	77423044	77427747	TMEM60	4703	-	NM_032936	77423288	77423690	2
chr7	77428108	77586821	PHTF2	158713	+	NM_001127358	77469572	77584195	18
chr7	77646373	79082890	MAGI2	1436517	-	NM_012301	77648631	79082636	22
chr7	77976558	77988770	RPL13AP17	12212	+	NR_003680	77988770	77988770	6
chr7	78638303	78641593	MAGI2-AS2	3290	+	NR_046689	78641593	78641593	3
chr7	79082272	79100524	MAGI2-AS3	18252	+	NR_038346	79100524	79100524	4
chr7	79400571	79400606	MIR548M	35	+	NR_031667	79400606	79400606	1
chr7	79764139	79848725	GNAI1	84586	+	NM_002069	79764476	79846809	8
chr7	80000832	80003755	LOC101927269	2923	-	NR_110075	80003755	80003755	4
chr7	80087950	80141325	GNAT3	53375	-	NM_001102386	80087986	80141242	8
chr7	80231503	80303734	CD36	72231	+	NM_001001547	80276056	80303463	14
chr7	80371853	80548667	SEMA3C	176814	-	NM_006379	80374209	80546097	18
chr7	81205701	81320722	LOC100128317	115021	-	NR_126025	81320722	81320722	11
chr7	81331443	81399452	HGF	68009	-	NM_000601	81331896	81399287	18
chr7	81575759	82073122	CACNA2D1	497363	-	NM_000722	81579707	82072775	39
chr7	81638492	81659271	LOC101927356	20779	+	NR_110076	81659271	81659271	5
chr7	82383320	82792197	PCLO	408877	-	NM_033026	82387890	82791908	25
chr7	82993221	83278479	SEMA3E	285258	-	NM_012431	82996901	83277858	17
chr7	83587658	83824217	SEMA3A	236559	-	NM_006080	83590686	83823902	17
chr7	84161791	84213634	LOC101927378	51843	+	NR_110080	84213634	84213634	4
chr7	84624871	84751247	SEMA3D	126376	-	NM_152754	84628755	84751207	17
chr7	85050437	85118654	LINC00972	68217	+	NR_134240	85118654	85118654	4
chr7	86273229	86494192	GRM3	220963	+	NM_000840	86394461	86493671	6
chr7	86506222	86689014	KIAA1324L	182792	-	NM_001142749	86509786	86688829	22
chr7	86781676	86825648	DMTF1	43972	+	NM_001142327	86794257	86824456	18
chr7	86825477	86849031	TMEM243	23554	-	NM_024315	86825951	86848819	4
chr7	86954663	86974808	TP53TG1	20145	-	NR_015381	86974808	86974808	3
chr7	86974950	87029112	CROT	54162	+	NM_001143935	86978384	87027960	19
chr7	87031360	87105019	ABCB4	73659	-	NM_018849	87031411	87104781	28
chr7	87133178	87342639	ABCB1	209461	-	NM_000927	87133558	87229500	29
chr7	87257728	87461613	RUNDC3B	203885	+	NM_138290	87258139	87459345	12
chr7	87463813	87505692	SLC25A40	41879	-	NM_018843	87465563	87488042	12
chr7	87505543	87538856	DBF4	33313	+	NM_006716	87506047	87537478	12
chr7	87563565	87832204	ADAM22	268639	+	NM_021723	87563780	87825806	31
chr7	87834431	87856308	SRI	21877	-	NM_198901	87835792	87856229	8
chr7	87845974	87848539	LOC102723885	2565	+	NR_120517	87848539	87848539	2
chr7	87905743	87936228	STEAP4	30485	-	NM_001205315	87908712	87913584	6
chr7	88388681	88966371	ZNF804B	577690	+	NM_181646	88389290	88966346	4
chr7	88423419	88425031	C7orf62	1612	-	NM_152706	88423494	88424256	2
chr7	89511666	89840949	STEAP2-AS1	329283	-	NR_110029	89840949	89840949	3
chr7	89748713	89754914	DPY19L2P4	6201	+	NR_003551	89754914	89754914	3
chr7	89783688	89794141	STEAP1	10453	+	NM_012449	89789102	89794048	5
chr7	89840999	89866992	STEAP2	25993	+	NM_001244945	89854396	89866236	6
chr7	89874487	89940377	CFAP69	65890	+	NM_001039706	89874738	89939552	23
chr7	89964536	89973408	LOC101927446	8872	+	NR_110085	89973408	89973408	6
chr7	89975978	90020769	GTPBP10	44791	+	NM_033107	89976055	90014468	10
chr7	90025605	90027550	LOC101409256	1945	+	NR_102424	90027550	90027550	1
chr7	90032647	90045268	CLDN12	12621	+	NM_001185072	90041990	90042725	4
chr7	90225675	90839905	CDK14	614230	+	NM_001287135	90225941	90747495	15
chr7	90893782	90898132	FZD1	4350	+	NM_003505	90894195	90896139	1
chr7	91502190	91510034	MTERF1	7844	-	NM_001301135	91502907	91504047	4
chr7	91570188	91739987	AKAP9	169799	+	NM_147185	91570413	91739473	50
chr7	91741462	91764059	CYP51A1	22597	-	NM_001146152	91742978	91758346	10
chr7	91763876	91810039	CYP51A1-AS1	46163	+	NR_122109	91810039	91810039	5
chr7	91774197	91794590	LRRD1	20393	-	NM_001161528	91774201	91794516	5
chr7	91828282	91875414	KRIT1	47132	-	NM_194456	91830049	91871449	20
chr7	91875547	92030698	ANKIB1	155151	+	NM_019004	91924292	92028263	20
chr7	92041863	92066628	LOC105375396	24765	-	NM_001317905	92047657	92066248	10
chr7	92076761	92089381	GATAD1	12620	+	NR_052016	92089381	92089381	6
chr7	92116336	92157845	PEX1	41509	-	NM_001282678	92116770	92147204	24
chr7	92158086	92169795	RBM48	11709	+	NM_032120	92158127	92166251	5
chr7	92167788	92169079	MGC16142	1291	+	NR_026902	92169079	92169079	1
chr7	92190071	92219708	FAM133B	29637	-	NM_001040057	92191595	92210911	12
chr7	92190367	92219696	FAM133DP	29329	-	NR_034169	92219696	92219696	10
chr7	92234234	92465941	CDK6	231707	-	NM_001145306	92244453	92462637	8
chr7	92465796	92546501	LOC101927497	80705	+	NR_110086	92546501	92546501	5
chr7	92728825	92747336	SAMD9	18511	-	NM_017654	92730640	92735410	3
chr7	92759366	92777701	SAMD9L	18335	-	NM_001303497	92760529	92765284	6
chr7	92817898	92855832	HEPACAM2	37934	-	NM_001288804	92818579	92855759	11
chr7	92861652	92990435	VPS50	128783	+	NM_001257998	92875430	92987748	29
chr7	93053798	93204042	CALCR	150244	-	NM_001164737	93055667	93125243	16
chr7	93112071	93112167	MIR653	96	-	NR_030388	93112167	93112167	1
chr7	93113247	93113331	MIR489	84	-	NR_030164	93113331	93113331	1
chr7	93346239	93346317	MIR4652	78	+	NR_039796	93346317	93346317	1
chr7	93514708	93520303	TFPI2	5595	-	NM_001271004	93516202	93519990	5
chr7	93520205	93522897	LOC105375401	2692	+	NR_134235	93522897	93522897	2
chr7	93535819	93540485	GNGT1	4666	+	NM_021955	93536058	93540230	3
chr7	93551015	93555826	GNG11	4811	+	NM_004126	93551449	93555528	2
chr7	93592081	93633694	BET1	41613	-	NR_133908	93633694	93633694	7
chr7	94023872	94060544	COL1A2	36672	+	NM_000089	94024343	94059705	52
chr7	94139169	94186328	CASD1	47159	+	NM_022900	94139396	94185070	18
chr7	94214535	94285521	SGCE	70986	-	NM_001099401	94214810	94285410	12
chr7	94285636	94299006	PEG10	13370	+	NM_001184962	94292766	94293846	2
chr7	94536948	94925727	PPP1R9A	388779	+	NM_001166160	94539425	94919615	20
chr7	94927668	94953884	PON1	26216	-	NM_000446	94928255	94953787	9
chr7	94989183	95025687	PON3	36504	-	NM_000940	94989284	95025662	9
chr7	95034173	95064384	PON2	30211	-	NM_000305	95034641	95064263	9
chr7	95115212	95169543	ASB4	54331	+	NM_016116	95115283	95167071	5
chr7	95212808	95225925	PDK4	13117	-	NM_002612	95214952	95225605	11
chr7	95401817	95739634	DYNC1I1	337817	+	NM_001278422	95434041	95739383	16
chr7	95749531	95951459	SLC25A13	201928	-	NM_001160210	95750502	95951268	18
chr7	95848973	95849068	MIR591	95	-	NR_030322	95849068	95849068	1
chr7	96110937	96132835	C7orf76	21898	-	NM_001201450	96113170	96125607	5
chr7	96250968	96293650	LOC100506136	42682	-	NR_038948	96293650	96293650	5
chr7	96318078	96339203	SHFM1	21125	-	NM_006304	96318235	96339075	3
chr7	96597826	96643377	DLX6-AS1	45551	-	NR_015448	96643377	96643377	3
chr7	96635289	96640352	DLX6	5063	+	NM_005222	96635289	96639359	3
chr7	96649701	96654143	DLX5	4442	-	NM_005221	96650047	96653935	3
chr7	96745904	96811075	SDHAF3	65171	+	NM_020186	96747035	96810527	2
chr7	97361270	97369784	TAC1	8514	+	NM_003182	97361924	97369232	7
chr7	97481428	97501854	ASNS	20426	-	NM_183356	97481570	97498468	14
chr7	97592969	97593038	MIR5692A1	69	+	NR_049875	97593038	97593038	1
chr7	97592974	97593033	MIR5692A2	59	+	NR_049876	97593033	97593033	1
chr7	97595907	97601638	MGC72080	5731	-	NR_002822	97601638	97601638	4
chr7	97614012	97619416	OCM2	5404	-	NM_006188	97614269	97619416	4
chr7	97736196	97838944	LMTK2	102748	+	NM_014916	97736489	97834804	14
chr7	97841565	97842271	BHLHA15	706	+	NM_177455	97841621	97842191	1
chr7	97844754	97881563	TECPR1	36809	-	NM_015395	97846701	97875458	26
chr7	97910978	97922275	BRI3	11297	+	NM_001159491	97911107	97922002	3
chr7	97920961	98030427	BAIAP2L1	109466	-	NM_018842	97922832	98030164	14
chr7	98246596	98259181	NPTX2	12585	+	NM_002523	98246773	98257941	5
chr7	98444110	98467673	TMEM130	23563	-	NM_152913	98445678	98467484	8
chr7	98476112	98610866	TRRAP	134754	+	NM_001244580	98478773	98609978	72
chr7	98479272	98479352	MIR3609	80	+	NR_037403	98479352	98479352	1
chr7	98479319	98479513	SCARNA28	194	+	NR_132754	98479513	98479513	1
chr7	98610787	98634102	LOC101927550	23315	+	NR_110102	98634102	98634102	6
chr7	98625057	98741743	SMURF1	116686	-	NM_020429	98628206	98741403	19
chr7	98771196	98805089	KPNA7	33893	-	NM_001145715	98771330	98805089	10
chr7	98870923	98895594	MYH16	24671	+	NR_002147	98895594	98895594	16
chr7	98923495	98963885	ARPC1A	40390	+	NM_001190996	98931016	98963552	10
chr7	98972297	98992404	ARPC1B	20107	+	NM_005720	98983337	98992112	10
chr7	98992297	99006305	PDAP1	14008	-	NM_014891	98994304	99006171	6
chr7	99006600	99017239	BUD31	10639	+	NM_003910	99008715	99017064	6
chr7	99014361	99036462	PTCD1	22101	-	NM_015545	99017589	99032865	8
chr7	99014361	99063824	ATP5J2-PTCD1	49463	-	NM_001198879	99017589	99063764	9
chr7	99036562	99054996	CPSF4	18434	+	NM_001081559	99036705	99054123	8
chr7	99055783	99063824	ATP5J2	8041	-	NM_004889	99055949	99063764	4
chr7	99070514	99085217	ZNF789	14703	+	NM_213603	99074079	99085111	5
chr7	99090853	99097877	ZNF394	7024	-	NM_032164	99091151	99097716	3
chr7	99102272	99131445	ZKSCAN5	29173	+	NM_145102	99103667	99129872	7
chr7	99143922	99149757	FAM200A	5835	-	NM_145111	99144308	99146030	2
chr7	99156044	99174076	ZNF655	18032	+	NM_001083956	99158182	99171207	4
chr7	99195901	99208456	GS1-259H13.2	12555	+	NM_001195541	99202011	99208188	6
chr7	99214570	99230030	ZSCAN25	15460	+	NM_145115	99217229	99227643	8
chr7	99245811	99277649	CYP3A5	31838	-	NM_001291829	99245927	99264667	14
chr7	99282301	99332823	CYP3A7-CYP3A51P	50522	-	NM_001256497	99282848	99332716	15
chr7	99302659	99332823	CYP3A7	30164	-	NM_000765	99303122	99332716	13
chr7	99354582	99381811	CYP3A4	27229	-	NM_017460	99355755	99381704	13
chr7	99425635	99463727	CYP3A43	38092	+	NR_103869	99463727	99463727	14
chr7	99473684	99474656	OR2AE1	972	-	NM_001005276	99473684	99474656	1
chr7	99488029	99517223	TRIM4	29194	-	NM_033017	99489785	99517024	7
chr7	99520891	99527243	GJC3	6352	-	NM_181538	99521167	99527243	2
chr7	99564349	99573735	AZGP1	9386	-	NM_001185	99564625	99573643	4
chr7	99578384	99581860	AZGP1P1	3476	+	NR_036679	99581860	99581860	2
chr7	99613194	99639312	ZKSCAN1	26118	+	NM_001287054	99621237	99631820	8
chr7	99647416	99662663	ZSCAN21	15247	+	NM_145914	99654629	99662240	4
chr7	99661469	99679387	ZNF3	17918	-	NM_017715	99662410	99674980	6
chr7	99686582	99689822	COPS6	3240	+	NM_006833	99686613	99689412	10
chr7	99690350	99699563	MCM7	9213	-	NM_005916	99690554	99698917	15
chr7	99691182	99691266	MIR25	84	-	NR_029498	99691266	99691266	1
chr7	99691390	99691470	MIR93	80	-	NR_029510	99691470	99691470	1
chr7	99691615	99691697	MIR106B	82	-	NR_029831	99691697	99691697	1
chr7	99699129	99704803	AP4M1	5674	+	NM_004722	99699337	99704505	15
chr7	99704692	99717481	TAF6	12789	-	NM_001190415	99704868	99717369	15
chr7	99717264	99723128	CNPY4	5864	+	NM_152755	99717367	99722511	6
chr7	99724316	99726121	MBLAC1	1805	+	NM_203397	99725018	99725819	2
chr7	99746529	99751833	LAMTOR4	5304	+	NM_001008395	99746595	99751587	4
chr7	99752042	99756344	C7orf43	4302	-	NM_001303470	99752633	99754754	11
chr7	99754227	99754292	MIR4658	65	-	NR_039802	99754292	99754292	1
chr7	99756864	99766373	GAL3ST4	9509	-	NM_024637	99757550	99764718	4
chr7	99767228	99775049	GPC2	7821	-	NM_152742	99767852	99774822	10
chr7	99775346	99812010	STAG3	36664	+	NM_001282716	99778179	99811638	34
chr7	99798277	99869855	GATS	71578	-	NR_028039	99869855	99869855	8
chr7	99816870	99819111	PVRIG	2241	+	NM_024070	99817533	99818874	6
chr7	99905324	99919819	SPDYE3	14495	+	NM_001004351	99905508	99917613	11
chr7	99918262	99933930	PMS2P1	15668	-	NR_003613	99933930	99933930	7
chr7	99933687	99965454	STAG3L5P-PVRIG2P-PILRB	31767	+	NR_036569	99965454	99965454	18
chr7	99933701	99938951	STAG3L5P	5250	+	NR_103720	99938951	99938951	4
chr7	99949940	99951559	PVRIG2P	1619	+	NR_103728	99951559	99951559	5
chr7	99954273	99954344	MIR6840	71	+	NR_106899	99954344	99954344	1
chr7	99955625	99965454	PILRB	9829	+	NM_178238	99955925	99965000	4
chr7	99971067	99997722	PILRA	26655	+	NM_013439	99971279	99997530	7
chr7	99998494	100026431	ZCWPW1	27937	-	NM_017984	99998636	100018272	18
chr7	100026412	100031749	MEPCE	5337	+	NM_001194992	100029048	100031177	5
chr7	100032911	100034094	PPP1R35	1183	-	NM_145030	100032982	100033997	4
chr7	100054237	100061894	C7orf61	7657	-	NM_001004323	100054374	100061648	3
chr7	100064141	100076902	TSC22D4	12761	-	NM_001303043	100064581	100075661	5
chr7	100081549	100092424	NYAP1	10875	+	NM_173564	100082934	100091526	7
chr7	100136833	100165843	AGFG2	29010	+	NM_006076	100136969	100162614	12
chr7	100169852	100171270	SAP25	1418	-	NM_001168682	100169909	100170791	6
chr7	100171633	100183811	LRCH4	12178	-	NM_001289934	100171874	100183723	18
chr7	100171657	100172356	ZASP	699	-	NM_001289933	100171672	100172179	1
chr7	100183955	100198740	FBXO24	14785	+	NM_033506	100184248	100198522	10
chr7	100187023	100201661	PCOLCE-AS1	14638	-	NR_038910	100201661	100201661	9
chr7	100199881	100205798	PCOLCE	5917	+	NM_002593	100200079	100205726	9
chr7	100209724	100213000	MOSPD3	3276	+	NM_001040097	100210414	100212806	6
chr7	100218038	100239173	TFR2	21135	-	NM_003227	100218479	100239132	18
chr7	100240725	100254084	ACTL6B	13359	-	NM_016188	100240868	100253977	14
chr7	100254183	100264049	LOC105375429	9866	+	NR_133946	100264049	100264049	3
chr7	100271362	100276792	GNB2	5430	+	NM_005273	100273888	100276424	10
chr7	100277129	100286870	GIGYF1	9741	-	NM_022574	100279341	100285861	24
chr7	100303675	100305123	POP7	1448	+	NM_005837	100304453	100304876	2
chr7	100318422	100321323	EPO	2901	+	NM_000799	100318603	100320756	5
chr7	100331248	100395419	ZAN	64171	+	NM_003386	100331791	100395354	48
chr7	100400186	100425143	EPHB4	24957	-	NM_004444	100401082	100424652	17
chr7	100450340	100464634	SLC12A9	14294	+	NM_020246	100451819	100464227	14
chr7	100464949	100471076	TRIP6	6127	+	NM_003302	100465119	100470925	9
chr7	100465657	100465729	MIR6875	72	+	NR_106935	100465729	100465729	1
chr7	100472700	100486285	SRRT	13585	+	NM_015908	100473211	100486170	20
chr7	100486343	100487339	UFSP1	996	-	NM_001015072	100486463	100486892	1
chr7	100487614	100493754	ACHE	6140	-	NM_001302622	100487834	100491853	5
chr7	100547051	100611619	MUC3A	64568	+	NM_005960	100547256	100610315	13
chr7	100612903	100662230	MUC12	49327	+	NM_001164462	100612903	100661917	12
chr7	100657600	100660889	LOC102724094	3289	-	NR_120520	100660889	100660889	3
chr7	100663363	100702140	MUC17	38777	+	NM_001040105	100663416	100701325	13
chr7	100728719	100735019	TRIM56	6300	+	NM_030961	100730593	100732861	3
chr7	100770369	100782547	SERPINE1	12178	+	NM_000602	100771674	100780723	9
chr7	100797685	100804557	AP1S1	6872	+	NM_001283	100797795	100803847	5
chr7	100802753	100802836	MIR4653	83	+	NR_039797	100802836	100802836	1
chr7	100805789	100808852	VGF	3063	-	NM_003378	100806276	100808124	2
chr7	100813773	100823557	NAT16	9784	-	NM_198571	100815359	100818088	4
chr7	100839011	100844302	MOGAT3	5291	-	NM_178176	100839226	100844135	7
chr7	100849257	100861011	PLOD3	11754	-	NM_001084	100849561	100860555	19
chr7	100860984	100867471	ZNHIT1	6487	+	NM_006349	100861476	100867239	5
chr7	100875372	100882101	CLDN15	6729	-	NM_001185080	100875690	100880862	6
chr7	100882892	100888371	FIS1	5479	-	NM_016068	100883086	100888285	5
chr7	100951620	100964425	LOC101927746	12805	+	NR_110115	100964425	100964425	3
chr7	100956647	100965104	IFT22	8457	-	NM_001287525	100958414	100959798	6
chr7	101006100	101202304	COL26A1	196204	+	NM_133457	101006313	101200810	13
chr7	101206034	101212286	LINC01007	6252	-	NR_103749	101212286	101212286	3
chr7	101256604	101272576	MYL10	15972	-	NM_138403	101256754	101272398	8
chr7	101459183	101927250	CUX1	468067	+	NM_001913	101459310	101926382	23
chr7	101928352	101962178	SH2B2	33826	+	NM_020979	101928449	101962097	7
chr7	101936368	101936453	MIR4285	85	+	NR_036245	101936453	101936453	1
chr7	101986191	101996889	SPDYE6	10698	-	NM_001146210	101988541	101996468	8
chr7	102004307	102021080	LOC100289561	16773	+	NM_001242713	102006508	102020987	5
chr7	102004307	102067129	LOC100630923	62822	+	NR_038967	102067129	102067129	9
chr7	102036803	102067129	PRKRIP1	30326	+	NM_024653	102036858	102065558	6
chr7	102046188	102046302	MIR548O	114	-	NR_031669	102046302	102046302	1
chr7	102073976	102097268	ORAI2	23292	+	NM_001126340	102079403	102087499	4
chr7	102096666	102105321	ALKBH4	8655	-	NM_017621	102097840	102105283	3
chr7	102105329	102113615	LRWD1	8286	+	NM_001317721	102107809	102113496	15
chr7	102106188	102106273	MIR5090	85	+	NR_049813	102106273	102106273	1
chr7	102111915	102111978	MIR4467	63	+	NR_039677	102111978	102111978	1
chr7	102113547	102119381	POLR2J	5834	-	NM_006234	102114095	102119307	4
chr7	102123585	102158224	RASA4B	34639	-	NM_001277335	102124038	102158157	20
chr7	102178365	102213068	POLR2J3	34703	-	NM_001097615	102207497	102212968	9
chr7	102191678	102202757	SPDYE2B	11079	+	NM_001166339	102193702	102201622	9
chr7	102191678	102202757	SPDYE2	11079	+	NM_001031618	102193702	102201622	9
chr7	102220092	102257205	RASA4	37113	-	NM_006989	102223217	102257136	21
chr7	102277194	102312176	POLR2J2	34982	-	NM_032959	102306577	102312048	9
chr7	102277471	102283238	UPK3BL	5767	-	NM_001114403	102277971	102283188	6
chr7	102389398	102449672	FAM185A	60274	+	NM_001145268	102389654	102448849	8
chr7	102453307	102715288	FBXL13	261981	-	NR_105043	102715288	102715288	21
chr7	102553343	102585556	LRRC17	32213	+	NM_005824	102574360	102582750	5
chr7	102715327	102740210	ARMC10	24883	+	NM_031905	102715719	102739000	7
chr7	102740022	102789569	NAPEPLD	49547	-	NM_198990	102743875	102769223	6
chr7	102781716	102782850	RPL19P12	1134	-	NR_026660	102782850	102782850	1
chr7	102815461	102920913	DPY19L2P2	105452	-	NR_027768	102920913	102920913	23
chr7	102937872	102955133	PMPCB	17261	+	NM_004279	102937906	102952718	13
chr7	102952920	102985320	DNAJC2	32400	-	NM_014377	102953015	102985069	17
chr7	102987970	103009842	PSMC2	21872	+	NM_002803	102988158	103008501	12
chr7	102993176	103086624	SLC26A5	93448	-	NM_206883	102993356	103061961	20
chr7	103085653	103154454	LOC101927870	68801	+	NR_110141	103154454	103154454	4
chr7	103112230	103629963	RELN	517733	-	NM_005045	103113258	103629803	65
chr7	103766787	103848495	ORC5	81708	-	NM_002553	103767294	103848352	14
chr7	103969103	104549003	LHFPL3	579900	+	NM_199000	103969227	104546662	3
chr7	104436953	104444539	LHFPL3-AS1	7586	-	NR_034141	104444539	104444539	4
chr7	104535074	104567092	LHFPL3-AS2	32018	-	NR_027374	104567092	104567092	4
chr7	104622193	104631612	LINC01004	9419	-	NR_039981	104631612	104631612	1
chr7	104650988	104654588	KMT2E-AS1	3600	-	NR_024586	104654588	104654588	1
chr7	104654636	104754532	KMT2E	99896	+	NM_182931	104681399	104753780	27
chr7	104756820	105029377	SRPK2	272557	-	NM_182692	104758284	105029253	16
chr7	105096959	105162685	PUS7	65726	-	NM_019042	105098236	105148959	16
chr7	105172531	105208124	RINT1	35593	+	NM_021930	105172762	105207758	15
chr7	105205579	105221976	EFCAB10	16397	-	NR_027068	105221976	105221976	5
chr7	105245220	105517031	ATXN7L1	271811	-	NM_020725	105248298	105517004	12
chr7	105603656	105676877	CDHR3	73221	+	NM_152750	105603764	105673143	19
chr7	105730813	105753093	SYPL1	22280	-	NM_006754	105732250	105752975	6
chr7	105888731	105925638	NAMPT	36907	-	NM_005746	105891528	105925330	11
chr7	106297210	106301634	CCDC71L	4424	-	NM_175884	106300634	106301342	1
chr7	106505722	106549423	PIK3CG	43701	+	NM_001282426	106508006	106545832	11
chr7	106685177	106802256	PRKAR2B	117079	+	NM_002736	106685352	106800027	11
chr7	106809405	106842974	HBP1	33569	+	NM_001244262	106809457	106841876	11
chr7	106842188	107204959	COG5	362771	-	NM_006348	106843960	107204434	22
chr7	107110501	107116125	GPR22	5624	+	NM_005295	107114505	107115807	3
chr7	107204401	107218968	DUS4L	14567	+	NM_181581	107207515	107218005	8
chr7	107220421	107263762	BCAP29	43341	+	NM_018844	107221217	107258808	8
chr7	107296960	107302243	SLC26A4-AS1	5283	-	NR_028137	107302243	107302243	2
chr7	107301079	107358252	SLC26A4	57173	+	NM_000441	107302086	107355891	21
chr7	107384141	107402112	CBLL1	17971	+	NR_024199	107402112	107402112	7
chr7	107405911	107443678	SLC26A3	37767	-	NM_000111	107406299	107434954	21
chr7	107531551	107561643	DLD	30092	+	NM_000108	107531695	107559704	14
chr7	107564245	107643804	LAMB1	79559	-	NM_002291	107564395	107643330	34
chr7	107663995	107770801	LAMB4	106806	-	NM_007356	107664483	107763609	34
chr7	107788070	108096841	NRCAM	308771	-	NM_001193582	107790354	107880508	31
chr7	108110865	108168605	PNPLA8	57740	-	NM_001256011	108112844	108155635	11
chr7	108202587	108210212	THAP5	7625	-	NM_001130475	108204634	108210013	3
chr7	108210188	108215294	DNAJB9	5106	+	NM_012328	108212170	108213797	3
chr7	108524031	108524644	C7orf66	613	-	NM_001024607	108524063	108524589	2
chr7	109599283	109600270	EIF3IP1	987	-	NR_003024	109600270	109600270	1
chr7	110303105	111202573	IMMP2L	899468	-	NM_001244606	110303657	111161503	7
chr7	110731061	110765509	LRRN3	34448	+	NM_001099660	110762828	110764955	4
chr7	111366163	111846462	DOCK4	480299	-	NM_014705	111368329	111846193	52
chr7	111448560	111461835	DOCK4-AS1	13275	+	NR_103806	111461835	111461835	2
chr7	111846642	111983989	ZNF277	137347	+	NM_021994	111846771	111982784	12
chr7	112063198	112117258	IFRD1	54060	+	NM_001007245	112090743	112115574	13
chr7	112120907	112130943	LSMEM1	10036	+	NM_001134468	112124871	112130004	4
chr7	112258119	112260704	LOC100996249	2585	+	NR_110159	112260704	112260704	3
chr7	112262435	112348122	LOC101928012	85687	+	NR_110158	112348122	112348122	8
chr7	112402436	112430478	TMEM168	28042	-	NM_001287497	112407251	112424880	6
chr7	112459201	112579932	C7orf60	120731	-	NM_152556	112461798	112579805	5
chr7	112594689	112635698	HRAT17	41009	-	NR_110162	112635698	112635698	6
chr7	112720467	112727833	GPR85	7366	-	NM_018970	112723663	112724776	3
chr7	112756772	112758637	LINC00998	1865	-	NR_024412	112758637	112758637	3
chr7	113516881	113559082	PPP1R3A	42201	-	NM_002711	113517777	113559051	4
chr7	113726364	114333827	FOXP2	607463	+	NR_033766	114333827	114333827	20
chr7	114293399	114293510	MIR3666	111	+	NR_037439	114293510	114293510	1
chr7	114562208	114659970	MDFIC	97762	+	NM_001166345	114563088	114655989	5
chr7	114719011	114766368	LINC01393	47357	+	NR_120521	114766368	114766368	4
chr7	114763652	114871409	LINC01392	107757	-	NR_126407	114871409	114871409	5
chr7	115575201	115670867	TFEC	95666	-	NM_012252	115580604	115624495	8
chr7	115850546	115898837	TES	48291	+	NM_015641	115850761	115897536	7
chr7	115915659	115926781	LOC102724434	11122	-	NR_130922	115926781	115926781	4
chr7	116139654	116148595	CAV2	8941	+	NM_001206747	116139874	116146175	3
chr7	116164838	116201239	CAV1	36401	+	NM_001753	116165116	116199341	3
chr7	116203647	116254874	LINC01510	51227	-	NR_120506	116254874	116254874	5
chr7	116312458	116438440	MET	125982	+	NM_000245	116339138	116436178	21
chr7	116502562	116559313	CAPZA2	56751	+	NM_006136	116502665	116557921	10
chr7	116592500	116594388	ST7-AS1	1888	-	NR_002330	116594388	116594388	1
chr7	116593380	116870075	ST7	276695	+	NM_018412	116593594	116869911	15
chr7	116593952	116599867	ST7-OT4	5915	+	NR_002329	116599867	116599867	5
chr7	116660264	116660373	MIR6132	109	+	NR_106748	116660373	116660373	1
chr7	116752345	116785646	ST7-AS2	33301	-	NR_002331	116785646	116785646	6
chr7	116822734	116849991	ST7-OT3	27257	+	NR_002332	116849991	116849991	9
chr7	116916685	116963343	WNT2	46658	-	NM_003391	116918208	116963043	5
chr7	117003275	117067577	ASZ1	64302	-	NM_130768	117003649	117067514	13
chr7	117120016	117308718	CFTR	188702	+	NM_000492	117120148	117307162	27
chr7	117350705	117513561	CTTNBP2	162856	-	NM_033427	117351590	117513469	23
chr7	117824085	117844093	LSM8	20008	+	NM_016200	117824277	117832056	4
chr7	117864711	117882784	ANKRD7	18073	+	NM_019644	117864884	117880015	7
chr7	119259483	119547429	LVCAT5	287946	-	NR_131960	119547429	119547429	5
chr7	119913721	120390387	KCND2	476666	+	NM_012281	119914686	120387912	6
chr7	120427373	120498177	TSPAN12	70804	-	NM_012338	120428645	120496817	8
chr7	120590816	120615711	ING3	24895	+	NM_019071	120590950	120614898	12
chr7	120628750	120937498	CPED1	308748	+	NM_024913	120629675	120935706	23
chr7	120965420	120981158	WNT16	15738	+	NM_016087	120965469	120979399	4
chr7	120988904	121036422	FAM3C	47518	-	NM_014888	120990514	121023023	10
chr7	121513158	121702090	PTPRZ1	188932	+	NM_002851	121513553	121701274	30
chr7	121713597	121784344	AASS	70747	-	NM_005763	121716542	121773780	24
chr7	121941362	121944565	FEZF1	3203	-	NM_001160264	121942050	121944491	5
chr7	121943711	121950131	FEZF1-AS1	6420	+	NR_036484	121950131	121950131	7
chr7	121958477	122526813	CADPS2	568336	-	NM_001167940	121960218	122526391	30
chr7	122337765	122339208	RNF133	1443	-	NM_139175	122337841	122338972	1
chr7	122341719	122343021	RNF148	1302	-	NM_198085	122341886	122342804	1
chr7	122634758	122635754	TAS2R16	996	-	NM_016945	122634812	122635688	1
chr7	122753587	122840025	SLC13A1	86438	-	NM_022444	122755571	122840000	15
chr7	123092235	123174718	IQUB	82483	-	NM_178827	123092796	123152394	13
chr7	123177051	123241705	NDUFA5	64654	-	NR_111926	123241705	123241705	8
chr7	123241920	123277934	ASB15	36014	+	NM_001290258	123254556	123277035	12
chr7	123254214	123265011	LOC102724555	10797	-	NR_111922	123265011	123265011	5
chr7	123295860	123304147	LMOD2	8287	+	NM_207163	123296017	123303799	3
chr7	123321980	123389125	WASL	67145	-	NM_003941	123324572	123388788	11
chr7	123454192	123459484	HYALP1	5292	+	NR_002731	123459484	123459484	2
chr7	123485222	123517531	HYAL4	32309	+	NM_012269	123508327	123517209	5
chr7	123565285	123611461	SPAM1	46176	+	NM_003117	123593624	123610302	7
chr7	123634675	123667700	LOC105375483	33025	+	NR_133947	123667700	123667700	5
chr7	123670969	123673523	TMEM229A	2554	-	NM_001136002	123671914	123673057	1
chr7	123977433	123992150	LOC101928211	14717	-	NR_110180	123992150	123992150	4
chr7	124385654	124406079	GPR37	20425	-	NM_005302	124386578	124405030	2
chr7	124417345	124430864	C7orf77	13519	-	NM_001024603	124417555	124430678	4
chr7	124462439	124570037	POT1	107598	-	NR_003104	124570037	124570037	20
chr7	124569926	124785287	POT1-AS1	215361	+	NR_125718	124785287	124785287	11
chr7	124824622	125019375	LOC101928283	194753	+	NR_110188	125019375	125019375	9
chr7	124869632	124904345	LOC101928254	34713	-	NR_110182	124904345	124904345	5
chr7	126078651	126892428	GRM8	813777	-	NM_001127323	126086129	126883258	11
chr7	126698141	126698238	MIR592	97	-	NR_030323	126698238	126698238	1
chr7	126855180	126869975	LOC101928333	14795	+	NR_110194	126869975	126869975	3
chr7	127010096	127032778	ZNF800	22682	-	NM_176814	127011867	127031611	6
chr7	127116936	127125858	LOC100506682	8922	+	NR_110024	127125858	127125858	4
chr7	127220681	127225654	GCC1	4973	-	NM_024523	127222067	127225236	2
chr7	127228405	127231759	ARF5	3354	+	NM_001662	127228552	127231353	6
chr7	127233688	127241851	FSCN3	8163	+	NM_020369	127233907	127240453	7
chr7	127250345	127255780	PAX4	5435	-	NM_006193	127251117	127255574	9
chr7	127292201	127732659	SND1	440458	+	NM_014390	127292427	127732110	24
chr7	127637561	127640130	SND1-IT1	2569	+	NR_027330	127640130	127640130	1
chr7	127667123	127671002	LRRC4	3879	-	NM_022143	127668731	127670693	2
chr7	127721912	127722012	MIR593	100	+	NR_030324	127722012	127722012	1
chr7	127847924	127847996	MIR129-1	72	+	NR_029596	127847996	127847996	1
chr7	127881330	127897682	LEP	16352	+	NM_000230	127892071	127894816	3
chr7	127937737	127947816	MGC27345	10079	-	NR_046216	127947816	127947816	1
chr7	127950435	127983962	RBM28	33527	-	NM_018077	127950849	127983847	19
chr7	127990378	128001739	PRRT4	11361	-	NM_001114726	127991285	128000045	6
chr7	128032330	128050041	IMPDH1	17711	-	NM_001304521	128033060	128049955	14
chr7	128095883	128098472	HILPDA	2589	+	NM_001098786	128097322	128097514	2
chr7	128116782	128142978	METTL2B	26196	+	NM_018396	128116819	128141970	9
chr7	128281294	128301052	LINC01000	19758	+	NR_024368	128301052	128301052	5
chr7	128312319	128327926	FAM71F2	15607	+	NM_001290255	128315833	128323213	6
chr7	128349114	128371797	FAM71F1	22683	+	NR_104243	128371797	128371797	9
chr7	128379345	128413477	CALU	34132	+	NM_001199672	128388408	128409221	8
chr7	128412542	128415844	OPN1SW	3302	-	NM_001708	128412593	128415844	5
chr7	128431463	128462187	CCDC136	30724	+	NM_001201372	128431547	128457913	10
chr7	128470482	128499328	FLNC	28846	+	NM_001458	128470691	128498577	48
chr7	128502856	128505903	ATP6V1F	3047	+	NM_001198909	128502958	128505632	3
chr7	128506463	128512101	LOC100130705	5638	+	NM_001195150	128506463	128508829	2
chr7	128516918	128550773	KCP	33855	-	NM_001135914	128517096	128550730	37
chr7	128577990	128590096	IRF5	12106	+	NM_001098630	128582135	128588872	9
chr7	128594233	128695227	TNPO3	100994	-	NR_034053	128695227	128695227	24
chr7	128695276	128697293	TPI1P2	2017	+	NR_002187	128697293	128697293	1
chr7	128766324	128768050	LOC407835	1726	+	NR_002144	128768050	128768050	1
chr7	128784711	128809535	TSPAN33	24824	+	NM_178562	128784820	128807715	8
chr7	128828712	128853385	SMO	24673	+	NM_005631	128828992	128852292	12
chr7	128864854	129070052	AHCYL2	205198	+	NM_015328	128864917	129066886	17
chr7	129074273	129128239	STRIP2	53966	+	NM_020704	129074313	129125670	21
chr7	129142319	129152773	SMKR1	10454	+	NM_001195243	129142665	129152282	2
chr7	129251542	129396922	NRF1	145380	+	NM_001293163	129297191	129395021	12
chr7	129410222	129410332	MIR182	110	-	NR_029614	129410332	129410332	1
chr7	129414532	129414609	MIR96	77	-	NR_029512	129414609	129414609	1
chr7	129414744	129414854	MIR183	110	-	NR_029615	129414854	129414854	1
chr7	129470572	129592800	UBE2H	122228	-	NM_003344	129474776	129592395	7
chr7	129658125	129691291	ZC3HC1	33166	-	NM_001282190	129658503	129691097	11
chr7	129710348	129775560	KLHDC10	65212	+	NM_014997	129710483	129770586	10
chr7	129804552	129845338	TMEM209	40786	-	NM_001301163	129806290	129845215	14
chr7	129847703	129856684	SSMEM1	8981	+	NM_145268	129847750	129856310	3
chr7	129906702	129929637	CPA2	22935	+	NM_001869	129906721	129929587	11
chr7	129932973	129964020	CPA4	31047	+	NM_016352	129933020	129962516	11
chr7	129984629	130008571	CPA5	23942	+	NM_080385	129986326	130008438	13
chr7	130005490	130006968	LOC105375504	1478	-	NR_133928	130006968	130006968	2
chr7	130020211	130027949	CPA1	7738	+	NM_001868	130020361	130027852	10
chr7	130033611	130081051	CEP41	47440	-	NM_018718	130038731	130080807	11
chr7	130126015	130146138	MEST	20123	+	NM_177524	130135209	130144897	12
chr7	130126897	130131013	MESTIT1	4116	-	NR_004382	130131013	130131013	2
chr7	130135951	130136045	MIR335	94	+	NR_029899	130136045	130136045	1
chr7	130146079	130353598	COPG2	207519	-	NM_012133	130146516	130353508	13
chr7	130353485	130372268	TSGA13	18783	-	NM_001304968	130353853	130370048	9
chr7	130417381	130418860	KLF14	1479	-	NM_138693	130417888	130418860	1
chr7	130561505	130561569	MIR29A	64	-	NR_029503	130561569	130561569	1
chr7	130562217	130562298	MIR29B1	81	-	NR_029517	130562298	130562298	1
chr7	130598222	130606705	LOC100506860	8483	+	NR_109780	130606705	130606705	4
chr7	130626518	130794675	LINC-PINT	168157	-	NR_109855	130794675	130794675	5
chr7	130794854	131181398	MKLN1	386544	+	NM_001145354	130827671	131172487	19
chr7	130994502	131012538	MKLN1-AS	18036	-	NR_125364	131012538	131012538	6
chr7	131185020	131241376	PODXL	56356	-	NM_001018111	131189069	131241118	9
chr7	131594978	131633712	LOC101928782	38734	+	NR_110836	131633712	131633712	6
chr7	131808090	132261323	PLXNA4	453233	-	NM_020911	131815237	132193452	32
chr7	132333552	132413528	FLJ40288	79976	+	NR_046323	132413528	132413528	5
chr7	132443729	132445392	LOC100506937	1663	+	NR_134332	132445392	132445392	2
chr7	132469622	132766918	CHCHD3	297296	-	NR_133671	132766918	132766918	11
chr7	132783830	132793271	LOC105375512	9441	-	NR_133931	132793271	132793271	3
chr7	132937822	133750513	EXOC4	812691	+	NM_021807	132937857	133749281	18
chr7	132975634	132975742	MIR6133	108	+	NR_106749	132975742	132975742	1
chr7	133485245	133509641	LOC101928861	24396	-	NR_120513	133509641	133509641	4
chr7	133812104	133948933	LRGUK	136829	+	NM_144648	133812120	133948727	20
chr7	133974089	134001827	SLC35B4	27738	-	NM_032826	133979584	134001503	10
chr7	134127106	134143888	AKR1B1	16782	-	NM_001628	134127479	134143814	10
chr7	134212343	134226166	AKR1B10	13823	+	NM_020299	134212663	134225841	10
chr7	134233848	134264592	AKR1B15	30744	+	NM_001080538	134249371	134264301	12
chr7	134331530	134364567	BPGM	33037	+	NM_199186	134346259	134363783	4
chr7	134464163	134655480	CALD1	191317	+	NM_033157	134552484	134653096	15
chr7	134671258	134820530	AGBL3	149272	+	NM_178563	134672684	134820013	17
chr7	134777060	134855578	C7orf49	78518	-	NM_001305630	134779325	134853674	3
chr7	134832765	134850967	TMEM140	18202	+	NM_018295	134849193	134849751	2
chr7	134868589	134896316	WDR91	27727	-	NM_014149	134870902	134896254	15
chr7	134891746	134891830	MIR6509	84	-	NR_106764	134891830	134891830	1
chr7	134916730	134943244	STRA8	26514	+	NM_182489	134916730	134943244	9
chr7	135046546	135194875	CNOT4	148329	-	NM_001190850	135047636	135123079	12
chr7	135242661	135333499	NUP205	90838	+	NM_015135	135242692	135333304	43
chr7	135347220	135361160	C7orf73	13940	+	NM_001130929	135347327	135358913	3
chr7	135365986	135412933	SLC13A4	46947	-	NM_012450	135366310	135412244	16
chr7	135414345	135433594	FAM180A	19249	-	NM_205855	135418722	135433328	4
chr7	135611502	135662204	LUZP6	50702	-	NM_001128619	135612021	135612198	4
chr7	135611502	135662204	MTPN	50702	-	NM_145808	135614673	135661848	4
chr7	136553398	136701771	CHRM2	148373	+	NM_001006630	136699612	136701013	4
chr7	136583519	136849088	LOC349160	265569	-	NR_046103	136849088	136849088	4
chr7	136587913	136588041	MIR490	128	+	NR_030165	136588041	136588041	1
chr7	136912091	137028546	PTN	116455	-	NM_002825	136912766	136939720	5
chr7	137074384	137531609	DGKI	457225	-	NM_004717	137075965	137531608	34
chr7	137559724	137686847	CREB3L2	127123	-	NM_194071	137565221	137686451	12
chr7	137638093	137642712	LOC100130880	4619	+	NM_001243523	137638214	137642571	4
chr7	137761177	137803050	AKR1D1	41873	+	NM_005989	137761264	137801408	9
chr7	137808503	137808567	MIR4468	64	+	NR_039678	137808567	137808567	1
chr7	138145078	138270332	TRIM24	125254	+	NM_003852	138145293	138269696	19
chr7	138279029	138363790	SVOPL	84761	-	NM_001139456	138279354	138363790	15
chr7	138391038	138482941	ATP6V0A4	91903	-	NM_020632	138391368	138455992	22
chr7	138482738	138490769	TMEM213	8031	+	NM_001085429	138482849	138487814	3
chr7	138516126	138666064	KIAA1549	149938	-	NM_001164665	138522650	138666015	20
chr7	138710451	138720775	ZC3HAV1L	10324	-	NM_080660	138711289	138720763	5
chr7	138728265	138794465	ZC3HAV1	66200	-	NM_020119	138732339	138794077	13
chr7	138818489	138876732	TTC26	58243	+	NM_001287513	138824716	138874178	18
chr7	138916230	138992982	UBN2	76752	+	NM_173569	138916230	138982582	18
chr7	139025104	139108203	LUC7L2	83099	+	NM_001244585	139056157	139107086	11
chr7	139025195	139031065	C7orf55	5870	+	NR_073058	139031065	139031065	3
chr7	139025877	139108203	C7orf55-LUC7L2	82326	+	NM_001244584	139026130	139107086	11
chr7	139102208	139112272	LOC100129148	10064	-	NR_033999	139112272	139112272	3
chr7	139138087	139168457	KLRG2	30370	-	NM_198508	139138332	139168388	5
chr7	139208673	139229731	CLEC2L	21058	+	NM_001080511	139208673	139229088	5
chr7	139246315	139477693	HIPK2	231378	-	NM_001113239	139257672	139477422	15
chr7	139478046	139720125	TBXAS1	242079	+	NM_001130966	139529186	139719899	17
chr7	139723543	139763521	PARP12	39978	-	NM_022750	139724359	139762647	12
chr7	139784545	139876741	KDM7A	92196	-	NM_030647	139790893	139876737	20
chr7	139877060	139879440	JHDM1D-AS1	2380	+	NR_024451	139879440	139879440	1
chr7	140033551	140098350	SLC37A3	64799	-	NM_207113	140035211	140082326	15
chr7	140103842	140126050	RAB19	22208	+	NM_001008749	140107446	140125950	4
chr7	140152839	140179369	MKRN1	26530	-	NM_013446	140154316	140179144	8
chr7	140218219	140302342	DENND2A	84123	-	NM_015689	140218506	140302197	18
chr7	140372952	140394908	ADCK2	21956	+	NM_052853	140373130	140394603	8
chr7	140395135	140396877	NDUFB2-AS1	1742	-	NR_024454	140396877	140396877	2
chr7	140396480	140406446	NDUFB2	9966	+	NM_004546	140396544	140404734	4
chr7	140433812	140624564	BRAF	190752	-	NM_004333	140434396	140624503	18
chr7	140705960	140714781	MRPS33	8821	-	NM_053035	140706229	140710433	3
chr7	140774031	141180179	TMEM178B	406148	+	NM_001195278	140774110	141170586	4
chr7	141251077	141354209	AGK	103132	+	NM_018238	141255266	141352724	16
chr7	141356527	141401953	KIAA1147	45426	-	NM_001080392	141362455	141401953	9
chr7	141404137	141438030	WEE2-AS1	33893	-	NR_015392	141438030	141438030	7
chr7	141408152	141431071	WEE2	22919	+	NM_001105558	141408558	141430120	12
chr7	141438120	141450288	SSBP1	12168	+	NR_046269	141450288	141450288	8
chr7	141463896	141464997	TAS2R3	1101	+	NM_016943	141463958	141464909	1
chr7	141478288	141479188	TAS2R4	900	+	NM_016944	141478288	141479188	1
chr7	141490016	141491166	TAS2R5	1150	+	NM_018980	141490161	141491061	1
chr7	141536077	141541221	PRSS37	5144	-	NM_001171951	141536194	141540849	5
chr7	141618675	141619620	OR9A4	945	+	NM_001001656	141618675	141619620	1
chr7	141627156	141646807	CLEC5A	19651	-	NM_001301167	141629903	141646092	6
chr7	141672430	141673573	TAS2R38	1143	-	NM_176817	141672487	141673489	1
chr7	141695678	141806547	MGAM	110869	+	NM_004668	141705330	141805691	48
chr7	141811548	141922124	MGAM2	110576	+	NM_001293626	141816673	141921859	48
chr7	141940555	141946886	MOXD2P	6331	-	NR_024346	141946886	141946886	11
chr7	141951957	141957878	PRSS58	5921	-	NM_001001317	141952040	141957527	6
chr7	141968100	141972068	TRY2P	3968	-	NR_036483	141972068	141972068	3
chr7	142374130	142375525	MTRNR2L6	1395	+	NM_001190487	142375062	142375137	1
chr7	142457318	142460927	PRSS1	3609	+	NM_002769	142457335	142460871	5
chr7	142478756	142482399	PRSS3P2	3643	+	NR_001296	142482399	142482399	5
chr7	142552775	142568847	EPHB6	16072	+	NM_001280794	142562434	142568657	19
chr7	142568955	142583490	TRPV6	14535	-	NM_018646	142569459	142583381	15
chr7	142605266	142630820	TRPV5	25554	-	NM_019841	142605679	142630556	15
chr7	142636602	142637957	C7orf34	1355	+	NM_178829	142636643	142637674	2
chr7	142638200	142659503	KEL	21303	-	NM_000420	142638338	142659293	19
chr7	142723286	142724219	OR9A2	933	-	NM_001001658	142723286	142724219	1
chr7	142749437	142750379	OR6V1	942	+	NM_001001667	142749437	142750379	1
chr7	142759380	142760882	OR6W1P	1502	-	NR_002140	142760882	142760882	1
chr7	142829173	142836834	PIP	7661	+	NM_002652	142829209	142836735	4
chr7	142880511	142881528	TAS2R39	1017	+	NM_176881	142880511	142881528	1
chr7	142919171	142920143	TAS2R40	972	+	NM_176882	142919171	142920143	1
chr7	142952391	142983427	LOC105375545	31036	-	NR_133932	142983427	142983427	3
chr7	142960521	142966222	GSTK1	5701	+	NM_015917	142960606	142965930	8
chr7	142981991	142985142	TMEM139	3151	+	NM_001242774	142983050	142983922	5
chr7	142985307	143004789	CASP2	19482	+	NM_032982	142985548	143002164	11
chr7	143013218	143049097	CLCN1	35879	+	NM_000083	143013305	143049058	23
chr7	143050492	143059840	FAM131B	9348	-	NM_001031690	143053642	143059696	7
chr7	143078359	143088206	ZYX	9847	+	NM_003461	143078664	143087775	10
chr7	143079778	143079893	MIR6892	115	+	NR_106952	143079893	143079893	1
chr7	143088204	143105985	EPHA1	17781	-	NM_005232	143088549	143105898	18
chr7	143104905	143220540	EPHA1-AS1	115635	+	NR_033897	143220540	143220540	5
chr7	143140545	143141502	TAS2R60	957	+	NM_177437	143140545	143141502	1
chr7	143174965	143175889	TAS2R41	924	+	NM_176883	143174965	143175889	1
chr7	143268893	143271480	CTAGE15	2587	+	NM_001008747	143268910	143271244	1
chr7	143318044	143422176	TCAF2	104132	+	NM_001130025	143400087	143421823	7
chr7	143452181	143454843	CTAGE6	2662	-	NM_178561	143452417	143454751	1
chr7	143507082	143512482	TCAF2P1	5400	+	NR_110549	143512482	143512482	5
chr7	143509060	143533810	LOC154761	24750	-	NR_015421	143533810	143533810	3
chr7	143548460	143599278	TCAF1	50818	-	NM_001206938	143554188	143573701	9
chr7	143632325	143633279	OR2F2	954	+	NM_001004685	143632325	143633279	1
chr7	143657019	143658108	OR2F1	1089	+	NM_012369	143657063	143658017	1
chr7	143701089	143702025	OR6B1	936	+	NM_001005281	143701089	143702025	1
chr7	143747494	143748430	OR2A5	936	+	NM_012365	143747494	143748430	1
chr7	143771312	143772245	OR2A25	933	+	NM_001004488	143771312	143772245	1
chr7	143792200	143793133	OR2A12	933	+	NM_001004135	143792200	143793133	1
chr7	143806675	143807632	OR2A2	957	+	NM_001005480	143806675	143807632	1
chr7	143826205	143827138	OR2A14	933	+	NM_001001659	143826205	143827138	1
chr7	143880547	143883173	CTAGE4	2626	+	NM_198495	143880596	143882930	1
chr7	143883175	143892791	ARHGEF35	9616	-	NM_001003702	143884021	143885476	2
chr7	143892413	143996682	LOC101928605	104269	+	NR_126022	143996682	143996682	5
chr7	143929003	143929936	OR2A1	933	-	NM_001005287	143929003	143929936	1
chr7	143935665	144052811	OR2A1-AS1	117146	-	NR_126023	144052811	144052811	5
chr7	143947563	143948548	OR2A9P	985	-	NR_002157	143948548	143948548	1
chr7	143947766	143948696	OR2A20P	930	-	NR_002158	143948696	143948696	1
chr7	143955788	143956721	OR2A7	933	-	NM_001005328	143955788	143956721	1
chr7	143956088	143983096	ARHGEF34P	27008	-	NR_033942	143983096	143983096	13
chr7	143963766	143966877	CTAGE8	3111	-	NM_001278507	143964009	143966343	1
chr7	144015217	144016150	OR2A42	933	+	NM_001001802	144015217	144016150	1
chr7	144052488	144077725	ARHGEF5	25237	+	NM_005435	144059762	144077149	15
chr7	144094332	144107320	NOBOX	12988	-	NM_001080413	144094332	144107320	10
chr7	144149033	144533146	TPK1	384113	-	NM_022445	144150637	144532695	9
chr7	145813452	148118088	CNTNAP2	2304636	+	NM_014141	145813968	148112708	24
chr7	146778029	146794701	LOC101928700	16672	-	NR_110829	146794701	146794701	4
chr7	146991341	147254962	MIR548I4	263621	-	NR_031690	147254962	147254962	3
chr7	147075108	147075213	MIR548F4	105	-	NR_031645	147075213	147075213	1
chr7	147368770	147370236	LOC105375556	1466	+	NR_133929	147370236	147370236	2
chr7	147626684	148043927	MIR548T	417243	+	NR_036093	148043927	148043927	4
chr7	148287656	148312952	C7orf33	25296	+	NM_145304	148288017	148312493	3
chr7	148395932	148498202	CUL1	102270	+	NM_003592	148427214	148497674	22
chr7	148504463	148581441	EZH2	76978	-	NM_001203248	148504737	148544390	20
chr7	148684618	148686516	GHET1	1898	+	NR_130107	148686516	148686516	1
chr7	148700153	148725782	PDIA4	25629	-	NM_004911	148700885	148725500	10
chr7	148766732	148787869	ZNF786	21137	-	NM_152411	148767514	148787732	4
chr7	148799877	148823438	ZNF425	23561	-	NM_001001661	148800703	148823305	4
chr7	148823507	148880118	ZNF398	56611	+	NM_020781	148863342	148876893	7
chr7	148892553	148923339	ZNF282	30786	+	NM_001303481	148892681	148921372	9
chr7	148936741	148952700	ZNF212	15959	+	NM_012256	148936869	148951506	5
chr7	148959261	148982085	ZNF783	22824	+	NM_001195220	148959424	148979434	6
chr7	148982371	148994403	LOC155060	12032	+	NR_036573	148994403	148994403	11
chr7	149128453	149158053	ZNF777	29600	-	NM_015694	149128866	149153113	6
chr7	149169883	149194898	ZNF746	25015	-	NM_001163474	149171474	149194627	7
chr7	149244244	149321881	ZNF767P	77637	-	NR_027789	149321881	149321881	9
chr7	149412101	149431664	KRBA1	19563	+	NM_032534	149416729	149431136	17
chr7	149461452	149470295	ZNF467	8843	-	NM_207336	149461802	149468121	5
chr7	149473130	149531053	SSPO	57923	+	NM_198455	149473130	149530918	110
chr7	149535508	149564568	ZNF862	29060	+	NM_001099220	149535700	149561373	8
chr7	149564782	149570951	ATP6V0E2-AS1	6169	-	NR_027040	149570951	149570951	4
chr7	149570056	149577801	ATP6V0E2	7745	+	NR_110612	149577801	149577801	5
chr7	149944300	150020758	ACTR3C	76458	-	NM_001164458	149946074	149992385	8
chr7	150020295	150035245	LRRC61	14950	+	NM_001142928	150033950	150034730	3
chr7	150026937	150029811	ZBED6CL	2874	+	NM_138434	150027493	150028204	1
chr7	150035406	150038763	RARRES2	3357	-	NM_002889	150035713	150037698	6
chr7	150065878	150071133	REPIN1	5255	+	NM_013400	150068330	150070034	4
chr7	150076405	150095719	ZNF775	19314	+	NM_173680	150085558	150095183	3
chr7	150102839	150109558	LOC728743	6719	+	NR_027237	150109558	150109558	3
chr7	150130741	150145228	LINC00996	14487	+	NR_034033	150145228	150145228	4
chr7	150147717	150176483	GIMAP8	28766	+	NM_175571	150163786	150174868	5
chr7	150211944	150218161	GIMAP7	6217	+	NM_153236	150217062	150217965	2
chr7	150264457	150271041	GIMAP4	6584	+	NM_018326	150266989	150270148	3
chr7	150322463	150329736	GIMAP6	7273	-	NM_001244072	150324806	150327230	3
chr7	150382793	150390728	GIMAP2	7935	+	NM_015660	150384147	150390388	3
chr7	150413644	150421368	GIMAP1	7724	+	NM_130759	150416135	150418013	3
chr7	150413644	150440737	GIMAP1-GIMAP5	27093	+	NM_001199577	150416135	150440151	6
chr7	150434435	150440737	GIMAP5	6302	+	NM_018384	150437972	150440151	3
chr7	150488375	150498448	TMEM176B	10073	-	NM_014020	150488618	150493657	7
chr7	150497853	150502208	TMEM176A	4355	+	NM_018487	150498638	150501956	7
chr7	150549564	150558379	AOC1	8815	+	NM_001091	150553558	150558297	5
chr7	150642043	150675402	KCNH2	33359	-	NM_000238	150642452	150675001	15
chr7	150688143	150711687	NOS3	23544	+	NM_000603	150690891	150711257	27
chr7	150709296	150721586	ATG9B	12290	-	NR_073169	150721586	150721586	18
chr7	150725508	150744869	ABCB8	19361	+	NM_001282291	150725602	150742436	17
chr7	150745378	150749843	ASIC3	4465	+	NM_020321	150745972	150749773	11
chr7	150750898	150755052	CDK5	4154	-	NM_004935	150751095	150754935	12
chr7	150755298	150773614	SLC4A2	18316	+	NM_001199692	150759074	150773454	23
chr7	150773707	150777970	FASTK	4263	-	NM_001258461	150773811	150777853	10
chr7	150778171	150780620	TMUB1	2449	-	NM_001136044	150778635	150779650	3
chr7	150782917	150841523	AGAP3	58606	+	NM_001281300	150814842	150841030	16
chr7	150845675	150864635	GBX1	18960	-	NM_001098834	150845675	150864635	2
chr7	150872784	150884919	ASB10	12135	-	NM_080871	150873198	150884809	6
chr7	150887960	150902582	IQCA1L	14622	-	NM_001304419	150888066	150902540	19
chr7	150904922	150924460	ABCF2	19538	-	NM_005692	150905156	150923544	16
chr7	150929574	150935913	CHPF2	6339	+	NM_001284295	150929850	150935767	5
chr7	150935506	150935624	MIR671	118	+	NR_030407	150935624	150935624	1
chr7	150936058	150974231	SMARCD3	38173	-	NM_003078	150936188	150972238	14
chr7	151038846	151075548	NUB1	36702	+	NM_016118	151038862	151074311	15
chr7	151078206	151107791	WDR86	29585	-	NM_001284262	151078667	151093203	6
chr7	151106246	151110440	WDR86-AS1	4194	+	NR_109857	151110440	151110440	6
chr7	151125917	151137899	CRYGN	11982	-	NR_131779	151137899	151137899	4
chr7	151130574	151130725	MIR3907	151	-	NR_037468	151130725	151130725	1
chr7	151163097	151217010	RHEB	53913	-	NM_005614	151164204	151216597	8
chr7	151253200	151574316	PRKAG2	321116	-	NM_016203	151254286	151573705	16
chr7	151574126	151576308	PRKAG2-AS1	2182	+	NR_038926	151576308	151576308	3
chr7	151653463	151717019	GALNTL5	63556	+	NR_033169	151717019	151717019	10
chr7	151722758	151819432	GALNT11	96674	+	NM_022087	151791312	151818762	12
chr7	151832009	152133090	KMT2C	301081	-	NM_170606	151833916	152132871	59
chr7	152133979	152140100	FABP5P3	6121	+	NR_002935	152140100	152140100	2
chr7	152161208	152162630	LINC01003	1422	+	NR_027387	152162630	152162630	1
chr7	152343586	152373250	XRCC2	29664	-	NM_005431	152345726	152373164	3
chr7	152456833	152552464	ACTR3B	95631	+	NM_020445	152456967	152551638	12
chr7	153097003	153109319	LINC01287	12316	-	NR_125776	153109319	153109319	4
chr7	153584181	154686000	DPP6	1101819	+	NM_001039350	153584768	154684190	26
chr7	154720226	154741196	PAXIP1-AS2	20970	+	NR_024476	154741196	154741196	8
chr7	154735399	154794682	PAXIP1	59283	-	NM_007349	154735858	154794639	21
chr7	154795142	154797413	PAXIP1-AS1	2271	+	NR_028090	154797413	154797413	1
chr7	154858778	154863267	HTR5A-AS1	4489	-	NR_038945	154863267	154863267	2
chr7	154862033	154879102	HTR5A	17069	+	NM_024012	154862609	154876197	2
chr7	155089485	155101945	INSIG1	12460	+	NM_198336	155089995	155100068	6
chr7	155149682	155160628	BLACE	10946	-	NR_103545	155160628	155160628	6
chr7	155250823	155257526	EN2	6703	+	NM_001427	155251072	155255382	2
chr7	155293952	155326539	CNPY1	32587	-	NM_001103176	155295762	155301732	4
chr7	155434609	155437100	LOC100506302	2491	-	NR_126344	155437100	155437100	3
chr7	155437202	155574179	RBM33	136977	+	NM_053043	155437570	155567735	18
chr7	155594933	155604967	SHH	10034	-	NM_000193	155595593	155604816	3
chr7	155755325	155759037	LOC389602	3712	+	NM_001291913	155755523	155757596	2
chr7	156230482	156238282	LOC285889	7800	-	NR_038232	156238282	156238282	3
chr7	156264792	156395889	LINC01006	131097	-	NR_103858	156395889	156395889	2
chr7	156333184	156333795	LINC00244	611	+	NR_024119	156333795	156333795	1
chr7	156431059	156433348	C7orf13	2289	-	NR_026865	156433348	156433348	1
chr7	156433352	156469820	RNF32	36468	+	NM_030936	156436571	156469349	9
chr7	156473569	156685902	LMBR1	212333	-	NM_022458	156476771	156685687	17
chr7	156742416	156765876	NOM1	23460	+	NM_138400	156742431	156762397	11
chr7	156797546	156803347	MNX1	5801	-	NM_005515	156798213	156803044	3
chr7	156803550	156809118	MNX1-AS1	5568	+	NR_038835	156809118	156809118	2
chr7	156931654	157062066	UBE3C	130412	+	NM_014671	156931966	157060449	23
chr7	157129710	157210133	DNAJB6	80423	+	NM_058246	157151266	157208792	10
chr7	157258924	157292410	LOC101927914	33486	+	NR_110157	157292410	157292410	4
chr7	157331745	158380494	PTPRN2	1048749	-	NM_002847	157333407	158380361	23
chr7	157367027	157367114	MIR153-2	87	-	NR_029689	157367114	157367114	1
chr7	157647276	157658782	LOC100506585	11506	+	NR_038966	157658782	157658782	4
chr7	158325409	158325505	MIR595	96	-	NR_030325	158325505	158325505	1
chr7	158383320	158384625	LINC01022	1305	+	NR_132379	158384625	158384625	2
chr7	158384307	158384388	MIR5707	81	+	NR_049893	158384388	158384388	1
chr7	158423860	158497522	NCAPG2	73662	-	NR_104054	158497522	158497522	31
chr7	158523688	158622319	ESYT2	98631	-	NM_020728	158526897	158622253	22
chr7	158649268	158738883	WDR60	89615	+	NM_018051	158649426	158738470	25
chr7	158801044	158818929	LINC00689	17885	+	NR_024394	158818929	158818929	5
chr7	158820865	158937649	VIPR2	116784	-	NM_003382	158823306	158937463	13
chr7_gl000195_random	42937	86719	LOC389831	43782	-	NM_001242480	44723	49117	4
chr8	116085	117024	OR4F21	939	-	NM_001005504	116085	117024	1
chr8	158344	182318	RPL23AP53	23974	-	NR_003572	182318	182318	4
chr8	182136	197340	ZNF596	15204	+	NM_001287256	190895	196362	6
chr8	325930	333174	FAM87A	7244	-	NR_103537	333174	333174	4
chr8	356807	419875	FBXO25	63068	+	NM_183421	363079	418804	11
chr8	439789	495781	TDRP	55992	-	NM_175075	442398	494757	4
chr8	564736	681239	ERICH1	116503	-	NM_001303100	566570	681161	6
chr8	687604	1087777	ERICH1-AS1	400173	+	NR_073397	1087777	1087777	4
chr8	688547	690374	LOC401442	1827	+	NR_134292	690374	690374	1
chr8	1244293	1250823	LOC286083	6530	-	NR_111948	1250823	1250823	3
chr8	1449531	1656642	DLGAP2	207111	+	NM_004745	1496859	1649572	12
chr8	1513675	1569830	DLGAP2-AS1	56155	-	NR_103863	1569830	1569830	4
chr8	1710128	1712750	LOC101927752	2622	-	NR_134303	1712750	1712750	2
chr8	1711869	1734736	CLN8	22867	+	NM_018941	1719220	1728733	3
chr8	1749290	1749358	MIR3674	68	+	NR_037445	1749358	1749358	1
chr8	1765396	1765473	MIR596	77	+	NR_030326	1765473	1765473	1
chr8	1772141	1906807	ARHGEF10	134666	+	NM_001308153	1774276	1905429	30
chr8	1919562	1924610	KBTBD11-OT1	5048	+	NR_126346	1924610	1924610	3
chr8	1922043	1955109	KBTBD11	33066	+	NM_014867	1949358	1951230	2
chr8	1993157	2093380	MYOM2	100223	+	NM_003970	1998880	2092905	37
chr8	2024668	2024720	MIR7160	52	+	NR_106983	2024720	2024720	1
chr8	2387218	2585991	LOC101927815	198773	-	NR_125425	2585991	2585991	6
chr8	2792874	4852328	CSMD1	2059454	-	NM_033225	2796106	4851938	70
chr8	6261076	6264069	LOC100287015	2993	-	NR_040040	6264069	6264069	2
chr8	6264112	6501140	MCPH1	237028	+	NM_024596	6264188	6500570	14
chr8	6357174	6420784	ANGPT2	63610	-	NM_001118887	6360621	6420455	9
chr8	6473123	6565730	MCPH1-AS1	92607	-	NR_125386	6565730	6565730	5
chr8	6479644	6479741	MIR8055	97	-	NR_107022	6479741	6479741	1
chr8	6565877	6619021	AGPAT5	53144	+	NM_018361	6566189	6614909	8
chr8	6602684	6602765	MIR4659A	81	+	NR_039803	6602765	6602765	1
chr8	6602688	6602761	MIR4659B	73	-	NR_039807	6602761	6602761	1
chr8	6666040	6693166	XKR5	27126	-	NM_001289973	6668718	6681190	9
chr8	6693075	6699975	GS1-24F4.2	6900	+	NR_045217	6699975	6699975	3
chr8	6728096	6735529	DEFB1	7433	-	NM_005218	6728202	6735379	2
chr8	6782215	6783598	DEFA6	1383	-	NM_001926	6782339	6783557	2
chr8	6793341	6795860	DEFA4	2519	-	NM_001925	6793541	6794421	3
chr8	6808247	6809121	DEFA8P	874	-	NR_073407	6809121	6809121	2
chr8	6816810	6817683	DEFA9P	873	-	NR_073408	6817683	6817683	2
chr8	6825662	6826635	DEFA10P	973	-	NR_029386	6826635	6826635	2
chr8	6835170	6837614	DEFA1B	2444	-	NM_001302265	6835291	6836647	4
chr8	6835170	6837614	DEFA1	2444	-	NM_004084	6835291	6836156	3
chr8	6844699	6847243	DEFT1P2	2544	-	NR_036687	6847243	6847243	3
chr8	6844699	6847243	DEFT1P	2544	-	NR_036686	6847243	6847243	3
chr8	6873390	6875816	DEFA3	2426	-	NM_005217	6873511	6874372	3
chr8	6886122	6887011	DEFA11P	889	-	NR_073421	6887011	6887011	2
chr8	6912821	6914261	DEFA5	1440	-	NM_021010	6912952	6914219	2
chr8	7125762	7128636	LINC00965	2874	-	NR_027000	7128636	7128636	1
chr8	7159132	7212876	FAM66B	53744	-	NR_027423	7212876	7212876	7
chr8	7189908	7191501	USP17L1	1593	+	NM_001256873	7189908	7191501	1
chr8	7194636	7196229	USP17L4	1593	+	NM_001256874	7194636	7196229	1
chr8	7215497	7220490	ZNF705G	4993	-	NM_001164457	7215497	7220468	5
chr8	7272384	7274354	DEFB4B	1970	-	NM_001205266	7272482	7274349	2
chr8	7286415	7287870	DEFB103A	1455	-	NM_001081551	7286505	7287652	2
chr8	7286415	7287870	DEFB103B	1455	-	NM_018661	7286505	7287652	2
chr8	7305275	7321192	SPAG11B	15917	-	NM_058200	7305536	7321025	4
chr8	7327829	7332604	DEFB104A	4775	-	NM_080389	7327877	7332590	2
chr8	7327829	7332604	DEFB104B	4775	-	NM_001040702	7327877	7332590	2
chr8	7340025	7343909	DEFB106A	3884	-	NM_152251	7340125	7343904	2
chr8	7340025	7343909	DEFB106B	3884	-	NM_001040704	7340125	7343904	2
chr8	7345190	7347115	DEFB105A	1925	+	NM_152250	7345242	7347073	3
chr8	7345190	7347115	DEFB105B	1925	+	NM_001040703	7345242	7347073	3
chr8	7353367	7366833	DEFB107A	13466	+	NM_001037668	7353455	7366745	2
chr8	7353367	7366833	DEFB107B	13466	+	NM_001040705	7353455	7366745	2
chr8	7397148	7399972	PRR23D1	2824	+	NM_001282479	7397326	7399402	4
chr8	7397149	7399972	PRR23D2	2823	+	NM_001282478	7397326	7399402	4
chr8	7421309	7431920	FAM90A7P	10611	-	NR_046343	7431920	7431920	3
chr8	7627105	7628835	FAM90A10P	1730	+	NR_046351	7628835	7628835	3
chr8	7705401	7721319	SPAG11A	15918	+	NM_001081552	7705568	7721057	4
chr8	7752086	7754238	DEFB4A	2152	+	NM_004942	7752234	7754132	2
chr8	7783858	7809935	ZNF705B	26077	+	NM_001193630	7804943	7809913	7
chr8	7812534	7866277	FAM66E	53743	+	NR_027424	7866277	7866277	7
chr8	7829182	7830775	USP17L8	1593	-	NM_001256872	7829182	7830775	1
chr8	7833914	7835507	USP17L3	1593	-	NM_001256871	7833914	7835507	1
chr8	7847936	7855043	DEFB109P1B	7107	-	NR_003668	7855043	7855043	2
chr8	7946462	7946611	MIR548I3	149	-	NR_031689	7946611	7946611	1
chr8	8086091	8102387	FAM86B3P	16296	+	NR_024361	8102387	8102387	9
chr8	8175257	8239344	SGK223	64087	-	NM_001080826	8175675	8239257	5
chr8	8559665	8561617	CLDN23	1952	+	NM_194284	8559908	8560787	1
chr8	8641998	8751131	MFHAS1	109133	-	NM_004225	8643531	8750568	3
chr8	8860313	8890849	ERI1	30536	+	NM_153332	8860573	8887544	7
chr8	8905954	8906028	MIR4660	74	+	NR_039804	8906028	8906028	1
chr8	8993763	9009152	PPP1R3B	15389	-	NM_001201329	8998303	8999161	2
chr8	9046508	9060366	LOC101929128	13858	+	NR_125431	9060366	9060366	4
chr8	9182560	9192590	LOC157273	10030	+	NR_040039	9192590	9192590	3
chr8	9413444	9639856	TNKS	226412	+	NM_003747	9413449	9634246	27
chr8	9599181	9599278	MIR597	97	+	NR_030327	9599278	9599278	1
chr8	9757573	9760839	LINC00599	3266	-	NR_024281	9760839	9760839	3
chr8	9760897	9760982	MIR124-1	85	-	NR_029668	9760982	9760982	1
chr8	9911778	10286401	MSRA	374623	+	NM_012331	9912026	10285822	6
chr8	10332074	10339484	LINCR-0001	7410	+	NR_120604	10339484	10339484	5
chr8	10383055	10411676	PRSS55	28621	+	NM_001197020	10383095	10411542	5
chr8	10463859	10512617	RP1L1	48758	-	NM_178857	10464404	10480711	4
chr8	10524487	10524580	MIR4286	93	+	NR_036248	10524580	10524580	1
chr8	10530146	10558103	C8orf74	27957	+	NM_001040032	10530175	10557981	4
chr8	10581277	10588084	SOX7	6807	-	NM_031439	10583247	10587943	2
chr8	10622470	10697409	PINX1	74939	-	NM_017884	10622910	10697266	7
chr8	10682882	10682953	MIR1322	71	-	NR_031711	10682953	10682953	1
chr8	10697535	10704019	LOC101929229	6484	+	NR_125432	10704019	10704019	3
chr8	10753656	11058875	XKR6	305219	-	NM_173683	10755461	11058848	3
chr8	10892715	10892812	MIR598	97	-	NR_030328	10892812	10892812	1
chr8	10920161	10924599	LOC101929269	4438	-	NR_134308	10924599	10924599	2
chr8	11141999	11185654	MTMR9	43655	+	NM_015458	11142397	11180297	10
chr8	11188494	11189695	SLC35G5	1201	+	NM_054028	11188615	11189632	1
chr8	11197145	11225961	TDH	28816	+	NR_001578	11225961	11225961	9
chr8	11225910	11296166	FAM167A-AS1	70256	+	NR_026814	11296166	11296166	7
chr8	11278972	11324276	FAM167A	45304	-	NM_053279	11281881	11301920	3
chr8	11351520	11422108	BLK	70588	+	NM_001715	11400733	11421617	13
chr8	11434043	11438850	LINC00208	4807	+	NR_040035	11438850	11438850	3
chr8	11534427	11617511	GATA4	83084	+	NM_001308094	11606429	11615984	7
chr8	11562870	11563067	SNORA99	197	+	NR_132779	11563067	11563067	1
chr8	11618764	11620732	C8orf49	1968	+	NR_103552	11620732	11620732	1
chr8	11627171	11644854	NEIL2	17683	+	NM_001135748	11628956	11643782	5
chr8	11653081	11696818	FDFT1	43737	+	NM_001287742	11660341	11696118	10
chr8	11700033	11725659	CTSB	25626	-	NM_147780	11702633	11710963	12
chr8	11831445	11832108	DEFB136	663	-	NM_001033018	11831445	11832108	2
chr8	11839829	11842099	DEFB135	2270	+	NM_001033017	11839829	11842099	2
chr8	11850685	11858261	DEFB134	7576	-	NM_001302695	11851488	11853760	3
chr8	11921897	11929256	DEFB130	7359	-	NM_001037804	11921897	11929256	2
chr8	11921897	11929256	LOC100133267	7359	-	NM_001195257	11921897	11929256	2
chr8	11946846	11973025	ZNF705D	26179	+	NM_001039615	11965702	11970667	7
chr8	11973290	12008698	FAM66D	35408	+	NR_027425	12008698	12008698	6
chr8	11985366	11986806	LOC392196	1440	-	NR_003275	11986806	11986806	1
chr8	11989925	11991518	USP17L7	1593	-	NM_001256869	11989925	11991518	1
chr8	11994676	11996269	USP17L2	1593	-	NM_201402	11994676	11996269	1
chr8	12030962	12034776	FAM90A2P	3814	-	NR_046354	12034776	12034776	5
chr8	12039612	12051624	FAM86B1	12012	-	NM_001083537	12041114	12051579	7
chr8	12219527	12268510	FAM66A	48983	+	NR_026789	12268510	12268510	5
chr8	12236775	12237298	LOC649352	523	-	NR_046415	12237298	12237298	1
chr8	12250792	12257874	DEFB109P1	7082	-	NR_024044	12257874	12257874	2
chr8	12272029	12275541	FAM90A25P	3512	-	NR_073395	12275541	12275541	4
chr8	12283123	12293852	FAM86B2	10729	-	NM_001137610	12283397	12293852	8
chr8	12294521	12424354	LOC100506990	129833	+	NR_040092	12424354	12424354	6
chr8	12394587	12523120	LOC729732	128533	-	NR_047662	12523120	12523120	9
chr8	12579405	12612992	LONRF1	33587	-	NM_152271	12580604	12612929	12
chr8	12584740	12584813	MIR3926-1	73	-	NR_037492	12584813	12584813	1
chr8	12584745	12584808	MIR3926-2	63	+	NR_037495	12584808	12584808	1
chr8	12623570	12668910	LOC340357	45340	-	NR_015383	12668910	12668910	4
chr8	12651751	12675800	LINC00681	24049	+	NR_102423	12675800	12675800	2
chr8	12803182	12887284	KIAA1456	84102	+	NM_020844	12863711	12879553	5
chr8	12940871	13372429	DLC1	431558	-	NM_182643	12943319	13357580	18
chr8	13424351	13425797	C8orf48	1446	+	NM_001007090	13424500	13425460	1
chr8	13487198	13490085	LOC102725080	2887	+	NR_134450	13490085	13490085	2
chr8	13947372	15095792	SGCZ	1148420	-	NM_139167	13947951	15095132	8
chr8	14710946	14711019	MIR383	73	-	NR_029875	14711019	14711019	1
chr8	15397595	15624158	TUSC3	226563	+	NM_006765	15397939	15615318	11
chr8	15965386	16050300	MSR1	84914	-	NM_138715	15967593	16035497	10
chr8	16850333	16859674	FGF20	9341	-	NM_019851	16850580	16859541	3
chr8	16884746	16980148	MICU3	95402	+	NM_181723	16884788	16976284	15
chr8	17013835	17080241	ZDHHC2	66406	+	NM_016353	17014232	17074721	13
chr8	17086739	17104387	CNOT7	17648	-	NM_013354	17088228	17102661	7
chr8	17104400	17155533	VPS37A	51133	+	NM_152415	17104753	17143936	12
chr8	17154305	17271040	MTMR7	116735	-	NM_004686	17157370	17270801	14
chr8	17354596	17428077	SLC7A2	73481	+	NM_001008539	17400848	17422655	12
chr8	17433941	17500642	PDGFRL	66701	+	NM_006207	17434761	17500310	7
chr8	17501302	17658426	MTUS1	157124	-	NM_001001924	17503434	17613316	15
chr8	17539086	17539166	MIR548V	80	-	NR_036103	17539166	17539166	1
chr8	17721899	17753047	FGL1	31148	-	NM_201552	17722100	17743063	9
chr8	17780365	17887457	PCM1	107092	+	NM_006197	17793119	17885171	39
chr8	17913807	17942507	ASAH1	28700	-	NM_001127505	17915042	17942310	14
chr8	17942376	17955160	LOC101929066	12784	+	NR_125429	17955160	17955160	5
chr8	18027970	18081198	NAT1	53228	+	NM_001291962	18074402	18080429	6
chr8	18248754	18258723	NAT2	9969	+	NM_000015	18257513	18258386	2
chr8	18384812	18871196	PSD3	486384	-	NM_015310	18393252	18871093	16
chr8	19041185	19103032	LOC100128993	61847	-	NR_038919	19103032	19103032	5
chr8	19171080	19253729	SH2D4A	82649	+	NM_022071	19177058	19252153	10
chr8	19261671	19540261	CSGALNACT1	278590	-	NR_024040	19540261	19540261	10
chr8	19674917	19709586	INTS10	34669	+	NM_018142	19675048	19709316	17
chr8	19796581	19824770	LPL	28189	+	NM_000237	19796951	19822821	10
chr8	20002365	20040717	SLC18A1	38352	-	NM_001135691	20003273	20038475	17
chr8	20054703	20079207	ATP6V1B2	24504	+	NM_001693	20054917	20077913	14
chr8	20103675	20112803	LZTS1	9128	-	NM_021020	20107232	20112692	3
chr8	20133283	20147969	LZTS1-AS1	14686	+	NR_047509	20147969	20147969	3
chr8	20811143	20826449	LOC102467222	15306	+	NR_130774	20826449	20826449	5
chr8	20831496	20852630	LOC286114	21134	+	NR_033894	20852630	20852630	5
chr8	21155749	21166960	LOC101929172	11211	+	NR_104677	21166960	21166960	3
chr8	21549529	21646346	GFRA2	96817	-	NM_001495	21550789	21645671	9
chr8	21766383	21771219	DOK2	4836	-	NM_003974	21766821	21771112	5
chr8	21777179	21864096	XPO7	86917	+	NM_015024	21777281	21862599	28
chr8	21881620	21894408	NPM2	12788	+	NM_001286680	21882759	21894193	10
chr8	21900263	21906319	FGF17	6056	+	NM_003867	21900439	21905760	5
chr8	21911065	21940038	DMTN	28973	+	NM_001114137	21924386	21938974	15
chr8	21946713	21961891	FAM160B2	15178	+	NM_022749	21946764	21960442	17
chr8	21964382	21966932	NUDT18	2550	-	NM_024815	21964810	21966813	5
chr8	21971931	21988565	HR	16634	-	NM_005144	21973212	21986683	19
chr8	21995526	21999464	REEP4	3938	-	NM_025232	21995999	21998995	8
chr8	22004342	22014344	LGI3	10002	-	NM_139278	22005672	22014055	8
chr8	22019183	22021991	SFTPC	2808	+	NM_003018	22019341	22021554	6
chr8	22022652	22069840	BMP1	47188	+	NM_006129	22022918	22069241	20
chr8	22077215	22089851	PHYHIP	12636	-	NM_001099335	22078865	22085870	6
chr8	22102474	22102556	MIR320A	82	-	NR_029714	22102556	22102556	1
chr8	22102618	22108680	POLR3D	6062	+	NM_001722	22102962	22108031	9
chr8	22112088	22132675	LOC100507071	20587	-	NR_134293	22132675	22132675	2
chr8	22132809	22213584	PIWIL2	80775	+	NM_018068	22136899	22213018	23
chr8	22224761	22291640	SLC39A14	66879	+	NM_001135154	22262223	22291517	9
chr8	22298482	22398657	PPP3CC	100175	+	NM_001243974	22298922	22398315	15
chr8	22409250	22433008	SORBS3	23758	+	NM_005775	22412019	22432241	21
chr8	22437986	22455538	PDLIM2	17552	+	NM_176871	22438117	22452162	10
chr8	22457113	22461662	C8orf58	4549	+	NM_001013842	22457233	22460819	7
chr8	22462144	22477983	CCAR2	15839	+	NR_033902	22477983	22477983	21
chr8	22477946	22526661	BIN3	48715	-	NM_018688	22478934	22526564	9
chr8	22497883	22499722	BIN3-IT1	1839	-	NR_027715	22499722	22499722	1
chr8	22545173	22550815	EGR3	5642	-	NM_004430	22547985	22550457	2
chr8	22570764	22785421	PEBP4	214657	-	NM_144962	22570882	22785227	7
chr8	22735484	22745535	LOC101929237	10051	+	NR_125433	22745535	22745535	4
chr8	22844929	22877710	RHOBTB2	32781	+	NM_001160036	22852096	22874982	12
chr8	22877647	22926700	TNFRSF10B	49053	-	NM_147187	22880183	22926407	10
chr8	22925741	22941132	LOC286059	15391	+	NR_038873	22941132	22941132	3
chr8	22941867	22961070	LOC254896	19203	+	NR_046173	22961070	22961070	4
chr8	22960326	22974950	TNFRSF10C	14624	+	NM_003841	22960634	22974544	5
chr8	22993100	23021543	TNFRSF10D	28443	-	NM_003840	22995382	23021448	9
chr8	23048969	23082680	TNFRSF10A	33711	-	NM_003844	23049206	23082574	10
chr8	23082733	23088439	LOC389641	5706	+	NR_033928	23088439	23088439	3
chr8	23101149	23119513	CHMP7	18364	+	NM_152272	23104208	23118112	11
chr8	23145604	23153792	R3HCC1	8188	+	NR_125897	23153792	23153792	9
chr8	23154409	23261722	LOXL2	107313	-	NM_002318	23155555	23225864	14
chr8	23193720	23223638	LOC100507156	29918	+	NR_038323	23223638	23223638	3
chr8	23286664	23315244	ENTPD4	28580	-	NM_001128930	23290438	23307413	13
chr8	23386307	23432976	SLC25A37	46669	+	NM_001317813	23423626	23429368	5
chr8	23536205	23540450	NKX3-1	4245	-	NM_006167	23538733	23540402	2
chr8	23559963	23564111	NKX2-6	4148	-	NM_001136271	23559963	23564111	2
chr8	23699433	23712320	STC1	12887	-	NM_003155	23702282	23712036	4
chr8	24151552	24216531	ADAM28	64979	+	NM_014265	24151662	24211917	23
chr8	24153326	24406131	LOC101929294	252805	-	NR_125808	24406131	24406131	6
chr8	24241797	24263526	ADAMDEC1	21729	+	NM_001145271	24250804	24262811	15
chr8	24298508	24367077	ADAM7	68569	+	NM_003817	24298621	24366059	22
chr8	24347824	24372381	LOC101929315	24557	-	NR_125809	24372381	24372381	5
chr8	24771273	24776606	NEFM	5333	+	NM_005382	24771306	24776119	3
chr8	24808468	24814383	NEFL	5915	-	NM_006158	24810322	24814029	5
chr8	24811309	24811381	MIR6841	72	-	NR_106900	24811381	24811381	1
chr8	25042286	25270619	DOCK5	228333	+	NM_024940	25042423	25268814	52
chr8	25202917	25202990	MIR6876	73	+	NR_106936	25202990	25202990	1
chr8	25276773	25282556	GNRH1	5783	-	NM_001083111	25276934	25280846	4
chr8	25285363	25315984	KCTD9	30621	-	NM_017634	25287372	25315762	12
chr8	25316446	25365433	CDCA2	48987	+	NM_001317907	25317755	25364071	15
chr8	25699245	25902640	EBF2	203395	-	NM_022659	25702124	25902375	16
chr8	26149006	26230195	PPP2R2A	81189	+	NM_002717	26149335	26227929	10
chr8	26240522	26270644	BNIP3L	30122	+	NM_004331	26240646	26267928	6
chr8	26362195	26371483	PNMA2	9288	-	NM_007257	26365176	26366271	3
chr8	26371708	26515693	DPYSL2	143985	+	NM_001197293	26371841	26513222	14
chr8	26605666	26722922	ADRA1A	117256	-	NM_033303	26606106	26722486	3
chr8	27092839	27115956	STMN4	23117	-	NM_001283053	27096775	27101240	8
chr8	27142402	27168836	TRIM35	26434	-	NM_171982	27145066	27168752	6
chr8	27168998	27316908	PTK2B	147910	+	NM_173174	27255101	27316026	36
chr8	27290886	27290951	MIR6842	65	+	NR_106901	27290951	27290951	1
chr8	27317277	27336813	CHRNA2	19536	-	NM_000742	27319145	27328575	7
chr8	27348518	27402439	EPHX2	53921	+	NM_001979	27348725	27402039	19
chr8	27454433	27472328	CLU	17895	-	NM_001831	27455757	27468088	9
chr8	27468117	27468268	MIR6843	151	-	NR_106902	27468268	27468268	1
chr8	27491576	27534286	SCARA3	42710	+	NM_182826	27491717	27534117	6
chr8	27559189	27559284	MIR3622B	95	-	NR_037418	27559284	27559284	1
chr8	27559193	27559276	MIR3622A	83	+	NR_037417	27559276	27559276	1
chr8	27590832	27630170	CCDC25	39338	-	NM_018246	27593732	27630057	9
chr8	27632057	27662424	ESCO2	30367	+	NM_001017420	27633031	27660955	11
chr8	27667137	27695612	PBK	28475	-	NM_001278945	27667821	27690630	8
chr8	27727398	27850369	SCARA5	122971	-	NM_173833	27729450	27845132	9
chr8	27743555	27743633	MIR4287	78	-	NR_036249	27743633	27743633	1
chr8	27879480	27941388	NUGGC	61908	-	NM_001010906	27880833	27931927	19
chr8	27947747	28048669	ELP3	100922	+	NM_001284222	27954758	28047242	15
chr8	28174648	28200871	PNOC	26223	+	NM_006228	28186674	28196961	4
chr8	28203101	28243977	ZNF395	40876	-	NM_018660	28206235	28218641	10
chr8	28285925	28347835	FBXO16	61910	-	NM_172366	28286243	28340963	9
chr8	28351721	28431785	FZD3	80064	+	NM_017412	28360530	28420528	8
chr8	28362632	28362699	MIR4288	67	-	NR_036250	28362699	28362699	1
chr8	28555919	28558981	EXTL3-AS1	3062	-	NR_126027	28558981	28558981	3
chr8	28558989	28611207	EXTL3	52218	+	NM_001440	28573576	28608383	7
chr8	28625174	28747698	INTS9	122524	-	NM_018250	28625662	28747399	17
chr8	28747910	28910242	HMBOX1	162332	+	NM_001135726	28821384	28908672	10
chr8	28924794	29120610	KIF13B	195816	-	NM_015254	28928020	29120551	40
chr8	29190578	29208267	DUSP4	17689	-	NM_001394	29194542	29207795	4
chr8	29578775	29605625	LINC00589	26850	-	NR_026765	29605625	29605625	4
chr8	29605824	29656008	LOC101929450	50184	+	NR_125815	29656008	29656008	4
chr8	29672519	29686020	LOC101929470	13501	-	NR_125817	29686020	29686020	3
chr8	29779028	29811123	FAM183CP	32095	+	NR_024473	29811123	29811123	3
chr8	29814787	29814864	MIR3148	77	-	NR_036104	29814864	29814864	1
chr8	29920257	30108213	MIR548O2	187956	-	NR_039605	30108213	30108213	2
chr8	29920527	29940724	SARAF	20197	-	NM_016127	29921403	29940465	6
chr8	29952921	29995222	LEPROTL1	42301	+	NM_001128208	29953028	29995018	4
chr8	29989186	30002200	MBOAT4	13014	-	NM_001100916	29989458	30002117	3
chr8	30013812	30041155	DCTN6	27343	+	NM_006571	30013899	30040689	7
chr8	30239634	30242917	RBPMS-AS1	3283	-	NR_046205	30242917	30242917	3
chr8	30242016	30429778	RBPMS	187762	+	NM_006867	30242608	30416466	10
chr8	30436030	30515738	GTF2E2	79708	-	NM_002095	30436437	30511115	8
chr8	30496116	30503469	SMIM18	7353	+	NM_001206847	30502826	30503114	3
chr8	30535579	30585486	GSR	49907	-	NM_000637	30537036	30585352	13
chr8	30601681	30624520	UBXN8	22839	+	NM_005671	30601706	30623910	8
chr8	30643125	30670352	PPP2CB	27227	-	NM_001009552	30643750	30669937	7
chr8	30689059	30706533	TEX15	17474	-	NM_031271	30690801	30706533	4
chr8	30853317	30891231	PURG	37914	-	NM_001015508	30854108	30890298	2
chr8	30890777	31031277	WRN	140500	+	NM_000553	30915963	31030618	35
chr8	31497267	32600770	NRG1	1103503	+	NM_013962	31497500	32600286	5
chr8	31883251	31996993	NRG1-IT1	113742	+	NR_104158	31996993	31996993	3
chr8	32298261	32300241	NRG1-IT3	1980	+	NR_047475	32300241	32300241	3
chr8	33228343	33330664	FUT10	102321	-	NM_032664	33230094	33318970	5
chr8	33342684	33358778	MAK16	16094	+	NM_032509	33342724	33356147	10
chr8	33356026	33370703	TTI2	14677	-	NM_001265581	33356690	33370131	8
chr8	33405271	33424646	RNF122	19375	-	NM_024787	33406270	33424241	6
chr8	33448847	33457624	DUSP26	8777	-	NM_001305115	33449530	33455033	4
chr8	34641438	34722316	LINC01288	80878	+	NR_125746	34722316	34722316	4
chr8	35092974	35652181	UNC5D	559207	+	NM_080872	35093302	35648081	17
chr8	35529680	35567838	LOC101929550	38158	-	NR_125819	35567838	35567838	5
chr8	36641841	36793643	KCNU1	151802	+	NR_134267	36793643	36793643	28
chr8	37263981	37351431	LINC01605	87450	-	NR_121620	37351431	37351431	7
chr8	37553268	37557539	ZNF703	4271	+	NM_025069	37553497	37556192	2
chr8	37575096	37591011	LOC101929622	15915	+	NR_125820	37591011	37591011	3
chr8	37592278	37594944	LOC102723701	2666	-	NR_125821	37594944	37594944	2
chr8	37594096	37615319	ERLIN2	21223	+	NM_007175	37595440	37611633	12
chr8	37604073	37605564	LOC728024	1491	-	NR_003671	37605564	37605564	1
chr8	37620100	37637286	PROSC	17186	+	NM_007198	37620177	37635622	8
chr8	37654400	37701504	ADGRA2	47104	+	NM_032777	37654786	37699873	19
chr8	37701397	37707431	BRF2	6034	-	NM_018310	37702007	37707301	4
chr8	37716464	37757015	RAB11FIP1	40551	-	NM_001002814	37720412	37756959	6
chr8	37791799	37797647	GOT1L1	5848	-	NM_152413	37791810	37797547	9
chr8	37820513	37824184	ADRB3	3671	-	NM_000025	37821735	37823987	2
chr8	37888019	37917883	EIF4EBP1	29864	+	NM_004095	37888091	37917453	3
chr8	37963010	37997598	ASH2L	34588	+	NM_004674	37963068	37996589	16
chr8	38000217	38008600	STAR	8383	-	NM_000349	38001790	38008336	7
chr8	38020838	38034248	LSM1	13410	-	NM_014462	38021187	38033838	4
chr8	38034105	38070819	BAG4	36714	+	NM_004874	38034387	38068011	5
chr8	38089008	38120287	DDHD2	31279	+	NM_015214	38090512	38117639	18
chr8	38120649	38126738	PLPP5	6089	-	NM_001102559	38121961	38126717	7
chr8	38132560	38239790	WHSC1L1	107230	-	NM_023034	38133158	38205689	24
chr8	38243958	38267042	LETM2	23084	+	NM_001286819	38245501	38265792	11
chr8	38268655	38326352	FGFR1	57697	-	NM_001174064	38271145	38297890	19
chr8	38368351	38386180	C8orf86	17829	-	NM_207412	38369904	38386155	3
chr8	38585703	38710546	TACC1	124843	+	NM_001146216	38677347	38705541	13
chr8	38758752	38831430	PLEKHA2	72678	+	NM_021623	38775447	38827302	13
chr8	38831667	38846181	HTRA4	14514	+	NM_153692	38831782	38845617	9
chr8	38846326	38854041	TM2D2	7715	-	NM_078473	38848850	38853958	4
chr8	38854504	38962779	ADAM9	108275	+	NM_003816	38854582	38961219	22
chr8	38965047	39142436	ADAM32	177389	+	NM_145004	38965294	39142318	25
chr8	39172181	39260375	ADAM5	88194	+	NR_001448	39260375	39260375	15
chr8	39308563	39380508	ADAM3A	71945	-	NR_024107	39380508	39380508	22
chr8	39420630	39437653	LOC100130964	17023	+	NR_046245	39437653	39437653	5
chr8	39442086	39587583	ADAM18	145497	+	NM_014237	39442141	39587459	20
chr8	39601254	39695808	ADAM2	94554	-	NM_001464	39602378	39695704	21
chr8	39771327	39786309	IDO1	14982	+	NM_002164	39771441	39785704	10
chr8	39792473	39873910	IDO2	81437	+	NM_194294	39792715	39873121	11
chr8	40010986	40012827	C8orf4	1841	+	NM_020130	40011051	40011372	1
chr8	40388110	40755343	ZMAT4	367233	-	NM_024645	40389741	40683195	7
chr8	41119475	41166990	SFRP1	47515	-	NM_003012	41122685	41166678	3
chr8	41348080	41368499	GOLGA7	20419	+	NM_016099	41348373	41364625	6
chr8	41386724	41402565	GINS4	15841	+	NM_032336	41387721	41399606	8
chr8	41391823	41435887	LOC102723729	44064	-	NR_125824	41435887	41435887	3
chr8	41435706	41482520	GPAT4	46814	+	NM_178819	41456658	41478520	13
chr8	41503828	41504878	NKX6-3	1050	-	NM_152568	41503967	41504874	2
chr8	41510743	41754280	ANK1	243537	-	NM_001142446	41513245	41753998	43
chr8	41517958	41518026	MIR486-1	68	-	NR_030161	41518026	41518026	1
chr8	41517961	41518025	MIR486-2	64	+	NR_106984	41518025	41518025	1
chr8	41786996	41909544	KAT6A	122548	-	NM_006766	41789722	41906495	17
chr8	42010463	42028701	AP3M2	18238	+	NM_001134296	42012205	42026579	10
chr8	42032235	42065194	PLAT	32959	-	NM_000930	42033510	42050703	14
chr8	42112840	42128479	LOC101929897	15639	-	NR_125823	42128479	42128479	3
chr8	42128819	42190171	IKBKB	61352	+	NM_001556	42129618	42188497	22
chr8	42195972	42229331	POLB	33359	+	NM_002690	42196142	42229175	14
chr8	42231585	42234674	DKK4	3089	-	NM_014420	42231617	42234563	4
chr8	42249278	42263455	VDAC3	14177	+	NM_005662	42251729	42262980	10
chr8	42273979	42397356	SLC20A2	123377	-	NM_006749	42275320	42329908	11
chr8	42396297	42408140	SMIM19	11843	+	NM_001135676	42401615	42407751	4
chr8	42552561	42592209	CHRNB3	39648	+	NM_000749	42552689	42591761	6
chr8	42607779	42623929	CHRNA6	16150	-	NM_004198	42608321	42623573	6
chr8	42691816	42698474	THAP1	6658	-	NM_018105	42693104	42698237	3
chr8	42704779	42751866	RNF170	47087	-	NM_001160224	42705933	42743007	6
chr8	42751339	42751418	MIR4469	79	-	NR_039679	42751418	42751418	1
chr8	42752032	42885682	HOOK3	133650	+	NM_032410	42752274	42873641	22
chr8	42911441	42940932	FNTA	29491	+	NM_002027	42911489	42940425	9
chr8	42948648	42978323	POMK	29675	+	NM_032237	42958691	42978020	5
chr8	42995591	43057970	HGSNAT	62379	+	NM_152419	42995639	43054712	18
chr8	43147584	43218328	POTEA	70744	+	NM_001005365	43147627	43212038	14
chr8	47752507	47767407	LINC00293	14900	+	NR_027012	47767407	47767407	12
chr8	48100929	48104439	LOC100287846	3510	+	NR_037168	48104439	48104439	1
chr8	48173469	48648563	SPIDR	475094	+	NM_001080394	48173550	48648012	20
chr8	48649475	48650726	CEBPD	1251	-	NM_005195	48649872	48650682	1
chr8	48685668	48872743	PRKDC	187075	-	NM_006904	48686733	48872686	86
chr8	48872762	48890719	MCM4	17957	+	NM_182746	48873704	48889338	17
chr8	48920994	48974454	UBE2V2	53460	+	NM_003350	48921014	48973388	4
chr8	49464126	49611069	LOC101929268	146943	+	NR_105002	49611069	49611069	4
chr8	49532962	49536455	LOC101929217	3493	+	NR_105004	49536455	49536455	2
chr8	49627473	49647870	EFCAB1	20397	-	NM_001142857	49637300	49647710	6
chr8	49830238	49833999	SNAI2	3761	-	NM_003068	49831365	49833824	3
chr8	49966894	49988642	C8orf22	21748	+	NM_001256596	49985389	49987732	5
chr8	50409321	50424739	LOC100507464	15418	-	NR_134294	50424739	50424739	2
chr8	50822348	51706678	SNTG1	884330	+	NM_001287813	51306798	51705389	20
chr8	52232136	52722005	PXDNL	489869	-	NM_144651	52232450	52721904	23
chr8	52730134	52811746	PCMTD1	81612	-	NM_052937	52732910	52773711	6
chr8	53023391	53322439	ST18	299048	-	NM_014682	53025757	53126817	26
chr8	53106921	53112112	LOC101929341	5191	+	NR_134310	53112112	53112112	2
chr8	53446596	53478021	FAM150A	31425	-	NM_207413	53451002	53477816	5
chr8	53535017	53627026	RB1CC1	92009	-	NM_001083617	53536341	53598029	24
chr8	53852467	53853454	NPBWR1	987	+	NM_005285	53852467	53853454	1
chr8	54138275	54164257	OPRK1	25982	-	NM_001282904	54141856	54147661	5
chr8	54628102	54755871	ATP6V1H	127769	-	NM_015941	54628523	54754250	14
chr8	54764367	54871864	RGS20	107497	+	NM_170587	54764459	54871018	6
chr8	54879113	54935016	TCEA1	55903	-	NR_109901	54935016	54935016	12
chr8	54958926	55014577	LYPLA1	55651	-	NM_006330	54960624	55014383	9
chr8	55047780	55061074	MRPL15	13294	+	NM_014175	55047843	55060279	5
chr8	55370494	55373456	SOX17	2962	+	NM_022454	55370698	55372555	2
chr8	55528626	55543394	RP1	14768	+	NM_006269	55533526	55542913	4
chr8	56015016	56438710	XKR4	423694	+	NM_052898	56015048	56436786	3
chr8	56361756	56367881	SBF1P1	6125	-	NR_027765	56367881	56367881	1
chr8	56429746	56433537	LOC105375843	3791	-	NR_134323	56433537	56433537	2
chr8	56651302	56685966	TMEM68	34664	-	NM_152417	56652690	56675518	6
chr8	56685790	56739004	TGS1	53214	+	NM_024831	56686177	56737262	13
chr8	56792385	56925006	LYN	132621	+	NM_002350	56854418	56922669	13
chr8	56980738	56987140	RPS20	6402	-	NM_001146227	56982296	56986942	6
chr8	56986397	56986460	SNORD54	63	-	NR_002437	56986460	56986460	1
chr8	57025500	57026541	MOS	1041	-	NM_005372	57025500	57026541	1
chr8	57073467	57123859	PLAG1	50392	-	NM_002655	57078801	57080828	5
chr8	57124196	57131357	CHCHD7	7161	+	NR_133934	57131357	57131357	6
chr8	57212569	57233241	SDR16C5	20672	-	NM_138969	57214038	57228906	7
chr8	57287276	57303269	SDR16C6P	15993	-	NR_103832	57303269	57303269	4
chr8	57353512	57359293	PENK	5781	-	NM_001135690	57353830	57358512	4
chr8	57358365	57464626	LOC101929415	106261	+	NR_125813	57464626	57464626	4
chr8	57430877	57472382	LINC00968	41505	-	NR_038236	57472382	57472382	3
chr8	57870487	57906430	IMPAD1	35943	-	NM_017813	57876351	57906144	5
chr8	58130834	58145513	LINC01606	14679	+	NR_038235	58145513	58145513	10
chr8	58173784	58179170	LOC286177	5386	+	NR_038874	58179170	58179170	3
chr8	58192101	58197290	LINC00588	5189	+	NR_026772	58197290	58197290	4
chr8	58256345	58277415	LOC101929488	21070	+	NR_125818	58277415	58277415	9
chr8	58658707	58662756	LOC286178	4049	+	NR_134276	58662756	58662756	2
chr8	58890916	58896685	LINC01602	5769	+	NR_130934	58896685	58896685	3
chr8	58907112	59062277	FAM110B	155165	+	NM_147189	59058789	59059902	5
chr8	59168329	59184660	LOC101929528	16331	-	NR_105005	59184660	59184660	8
chr8	59323822	59364060	UBXN2B	40238	+	NM_001077619	59323944	59360110	8
chr8	59402736	59412720	CYP7A1	9984	-	NM_000780	59404033	59412657	6
chr8	59465727	59495419	SDCBP	29692	+	NM_001007069	59477592	59494299	9
chr8	59496063	59572404	NSMAF	76341	-	NM_003580	59496664	59572190	31
chr8	59717976	60031767	TOX	313791	-	NM_014729	59720305	60031546	9
chr8	61101422	61193954	CA8	92532	-	NM_004056	61121343	61193706	9
chr8	61314729	61326377	LINC01301	11648	-	NR_103854	61326377	61326377	3
chr8	61429468	61536203	RAB2A	106735	+	NM_002865	61429766	61533328	8
chr8	61591323	61780586	CHD7	189263	+	NM_017780	61653991	61778492	38
chr8	61878679	61880307	LOC100130298	1628	-	NR_034003	61880307	61880307	2
chr8	62200524	62414204	CLVS1	213680	+	NM_173519	62212386	62412101	6
chr8	62413114	62627199	ASPH	214085	-	NM_004318	62415917	62626930	25
chr8	62627346	62627418	MIR4470	72	+	NR_039680	62627418	62627418	1
chr8	63161500	63912211	NKAIN3	750711	+	NR_130764	63912211	63912211	7
chr8	63890419	63897460	UG0898H09	7041	+	NR_027378	63897460	63897460	1
chr8	63927638	63951610	GGH	23972	-	NM_003878	63927890	63951327	9
chr8	63972047	63998612	TTPA	26565	-	NM_000370	63973810	63998580	5
chr8	64080283	64081001	YTHDF3-AS1	718	-	NR_102684	64081001	64081001	1
chr8	64081111	64125346	YTHDF3	44235	+	NM_001277815	64098723	64122264	6
chr8	64378406	64388040	LOC102724612	9634	+	NR_125825	64388040	64388040	4
chr8	64681987	64698054	LINC01289	16067	+	NR_038875	64698054	64698054	3
chr8	64769499	65281115	LOC102724623	511616	-	NR_125826	65281115	65281115	5
chr8	65285884	65300061	MIR124-2HG	14177	+	NR_109792	65300061	65300061	3
chr8	65291705	65291814	MIR124-2	109	+	NR_029669	65291814	65291814	1
chr8	65486865	65489820	LOC401463	2955	-	NR_015374	65489820	65489820	2
chr8	65492794	65496191	BHLHE22	3397	+	NM_152414	65493347	65494493	1
chr8	65508528	65711348	CYP7B1	202820	-	NM_004820	65509198	65711144	6
chr8	66073379	66092575	LINC00251	19196	-	NR_038901	66092575	66092575	4
chr8	66439242	66474901	LINC01299	35659	-	NR_033893	66474901	66474901	5
chr8	66514690	66546452	ARMC1	31762	-	NM_018120	66516628	66539633	7
chr8	66556887	66622798	MTFR1	65911	+	NM_014637	66582187	66621279	8
chr8	66626568	66753969	PDE7A	127401	-	NM_001242318	66631524	66753743	13
chr8	66933790	67012755	DNAJC5B	78965	+	NM_033105	66963782	67012266	6
chr8	67039277	67087718	TRIM55	48441	+	NM_033058	67039503	67086716	11
chr8	67088611	67090880	CRH	2269	-	NM_000756	67089121	67089712	2
chr8	67104348	67109554	LINC00967	5206	+	NR_039979	67109554	67109554	3
chr8	67331821	67341212	RRS1-AS1	9391	-	NR_040434	67341212	67341212	3
chr8	67341262	67342968	RRS1	1706	+	NM_015169	67341366	67342464	1
chr8	67344717	67381044	ADHFE1	36327	+	NM_144650	67344751	67380587	14
chr8	67405490	67430759	C8orf46	25269	+	NM_152765	67405883	67428311	6
chr8	67474409	67525484	MYBL1	51075	-	NM_001080416	67476931	67525073	16
chr8	67542487	67579452	VCPIP1	36965	-	NM_025054	67546735	67579193	3
chr8	67579786	67593377	C8orf44	13591	+	NM_019607	67589943	67592189	3
chr8	67579786	67774257	C8orf44-SGK3	194471	+	NM_001204173	67705971	67771816	19
chr8	67624652	67774257	SGK3	149605	+	NM_001033578	67705971	67771816	17
chr8	67679631	67680240	PTTG3P	609	-	NR_002734	67680240	67680240	1
chr8	67782983	67834283	MCMDC2	51300	+	NM_173518	67786375	67831404	15
chr8	67834164	67837777	SNHG6	3613	-	NR_002599	67837777	67837777	4
chr8	67834708	67834784	SNORD87	76	-	NR_002598	67834784	67834784	1
chr8	67858735	67874825	TCF24	16090	-	NM_001193502	67860285	67874000	4
chr8	67900366	67940786	PPP1R42	40420	-	NM_001013626	67900617	67929982	6
chr8	67955314	67974562	COPS5	19248	-	NM_006837	67955467	67974231	8
chr8	67976602	68108849	CSPP1	132247	+	NM_024790	67976633	68107828	29
chr8	68109883	68255912	ARFGEF1	146029	-	NM_006421	68111168	68255522	39
chr8	68334404	68658620	CPA6	324216	-	NM_020361	68334738	68658364	11
chr8	68864602	69143897	PREX2	279295	+	NM_024870	68864629	69143613	40
chr8	69215702	69243726	C8orf34-AS1	28024	-	NR_038877	69243726	69243726	3
chr8	69242956	69731258	C8orf34	488302	+	NM_052958	69243247	69730481	14
chr8	69824037	70016425	LINC01592	192388	-	NR_039986	70016425	70016425	5
chr8	70337105	70360479	LINC01603	23374	-	NR_110433	70360479	70360479	4
chr8	70378858	70573147	SULF1	194289	+	NM_015170	70476210	70570770	23
chr8	70584567	70747299	SLCO5A1	162732	-	NM_030958	70585103	70744908	10
chr8	70963885	70983562	PRDM14	19677	-	NM_024504	70964311	70982095	8
chr8	71024266	71316020	NCOA2	291754	-	NM_006540	71025866	71128980	23
chr8	71383368	71397922	LOC101926892	14554	+	NR_110653	71397922	71397922	4
chr8	71485452	71520694	TRAM1	35242	-	NM_001317804	71487166	71520341	12
chr8	71520811	71575513	LACTB2-AS1	54702	+	NR_038881	71575513	71575513	4
chr8	71549500	71581447	LACTB2	31947	-	NM_016027	71550094	71581355	7
chr8	71581599	71648177	XKR9	66578	+	NM_001287259	71593293	71646659	6
chr8	72109667	72274467	EYA1	164800	-	NM_000503	72111574	72267140	18
chr8	72753776	72756731	MSC	2955	-	NM_005098	72754895	72756413	2
chr8	72755357	72968547	MSC-AS1	213190	+	NR_033652	72968547	72968547	5
chr8	72933485	72987819	TRPA1	54334	-	NM_007332	72935140	72987644	27
chr8	73114986	73163869	LOC392232	48883	-	NR_033867	73163869	73163869	20
chr8	73449625	73850584	KCNB2	400959	+	NM_004770	73479969	73850326	3
chr8	73644279	73664078	LOC101926908	19799	+	NR_110656	73664078	73664078	3
chr8	73921096	73959987	TERF1	38891	+	NM_017489	73921121	73958372	10
chr8	73976777	74005507	SBSPON	28730	-	NM_153225	73979575	74005302	5
chr8	74153658	74171737	C8orf89	18079	-	NM_001243237	74153691	74171693	4
chr8	74202873	74205869	RPL7	2996	-	NM_000971	74203278	74205847	7
chr8	74206836	74237520	RDH10	30684	+	NM_172037	74207524	74235271	6
chr8	74223140	74268696	RDH10-AS1	45556	-	NR_125388	74268696	74268696	6
chr8	74332308	74353753	STAU2-AS1	21445	+	NR_038406	74353753	74353753	3
chr8	74332603	74659162	STAU2	326559	-	NM_001164380	74333606	74621380	15
chr8	74692331	74791145	UBE2W	98814	-	NM_001271015	74692714	74791144	6
chr8	74857372	74884522	TCEB1	27150	-	NM_001204860	74858864	74872003	5
chr8	74888376	74895018	TMEM70	6642	+	NR_033334	74895018	74895018	4
chr8	74903563	74941307	LY96	37744	+	NM_015364	74903677	74941289	5
chr8	75146934	75233596	JPH1	86662	-	NM_001317830	75149457	75233522	6
chr8	75262617	75279335	GDAP1	16718	+	NM_001040875	75263595	75276602	6
chr8	75460777	75460852	MIR5681A	75	+	NR_049860	75460852	75460852	1
chr8	75460784	75460844	MIR5681B	60	-	NR_049871	75460844	75460844	1
chr8	75512100	75670587	MIR2052HG	158487	+	NR_033830	75670587	75670587	6
chr8	75617927	75617982	MIR2052	55	+	NR_031744	75617982	75617982	1
chr8	75736771	75767264	PI15	30493	+	NM_015886	75737484	75761488	6
chr8	75896707	75946793	CRISPLD1	50086	+	NM_031461	75898222	75944477	15
chr8	76135351	76191124	CASC9	55773	-	NR_103849	76191124	76191124	2
chr8	76452202	76479061	HNF4G	26859	+	NM_004133	76452227	76476331	10
chr8	77318888	77436567	LINC01111	117679	+	NR_105006	77436567	77436567	6
chr8	77523113	77595510	ZFHX4-AS1	72397	-	NR_024360	77595510	77595510	4
chr8	77593514	77779521	ZFHX4	186007	+	NM_024721	77616323	77776801	11
chr8	77879003	77879086	MIR3149	83	-	NR_130460	77879086	77879086	1
chr8	77892493	77913280	PEX2	20787	-	NM_001172086	77895496	77896414	5
chr8	78362932	78388567	LOC102724874	25635	+	NR_125830	78388567	78388567	3
chr8	79428335	79517502	PKIA	89167	+	NM_006823	79510619	79514056	4
chr8	79446126	79470738	PKIA-AS1	24612	-	NR_125389	79470738	79470738	3
chr8	79578281	79631997	ZC2HC1A	53716	+	NM_016010	79578383	79629728	9
chr8	79635082	79636609	LOC101241902	1527	-	NR_077236	79636609	79636609	1
chr8	79645006	79717758	IL7	72752	-	NM_000880	79645947	79717157	6
chr8	80523048	80578410	STMN2	55362	+	NM_001199214	80523430	80577051	6
chr8	80676244	80680098	HEY1	3854	-	NM_001040708	80677422	80679898	5
chr8	80680376	80715077	LINC01607	34701	+	NR_125410	80715077	80715077	4
chr8	80681614	80783972	LOC101927040	102358	-	NR_110954	80783972	80783972	6
chr8	80831094	80942506	MRPS28	111412	-	NM_014018	80831214	80942483	3
chr8	80947102	81083894	TPD52	136792	-	NM_001025253	80950350	81083678	8
chr8	81153623	81153708	MIR5708	85	+	NR_049894	81153708	81153708	1
chr8	81397853	81438500	ZBTB10	40647	+	NM_001277145	81398018	81431763	6
chr8	81540685	81787016	ZNF704	246331	-	NM_001033723	81553600	81733829	9
chr8	81880045	82024303	PAG1	144258	-	NM_018440	81888778	81905462	9
chr8	82192717	82197012	FABP5	4295	+	NM_001444	82192830	82196802	4
chr8	82352563	82359719	PMP2	7156	-	NM_002677	82355632	82359621	4
chr8	82370617	82373758	FABP9	3141	-	NM_001080526	82370617	82373758	4
chr8	82390731	82395473	FABP4	4742	-	NM_001442	82391099	82395402	4
chr8	82437280	82443550	FABP12	6270	-	NM_001105281	82437280	82443550	4
chr8	82569150	82598589	IMPA1	29439	-	NM_001144878	82571585	82598150	10
chr8	82605890	82607207	SLC10A5	1317	-	NM_001010893	82605890	82607207	1
chr8	82613565	82633539	ZFAND1	19974	-	NM_024699	82614929	82633516	8
chr8	82644687	82671748	CHMP4C	27061	+	NM_152284	82644861	82670779	5
chr8	82711817	82754521	SNX16	42704	-	NM_022133	82713731	82752221	9
chr8	83824338	83874159	LOC101927141	49821	+	NR_134295	83874159	83874159	4
chr8	84315992	84321132	LINC01419	5140	+	NR_122034	84321132	84321132	2
chr8	85095452	85834078	RALYL	738626	+	NM_001100392	85441556	85833146	10
chr8	86019322	86058314	LRRCC1	38992	+	NM_033402	86019530	86057746	19
chr8	86084311	86089276	LOC102723322	4965	-	NR_134311	86089276	86089276	3
chr8	86089618	86126753	E2F5	37135	+	NM_001083588	86089655	86126097	8
chr8	86126287	86132651	C8orf59	6364	-	NM_001099672	86126794	86129728	5
chr8	86157715	86196302	CA13	38587	+	NM_198584	86158057	86193578	7
chr8	86240457	86290383	CA1	49926	-	NM_001738	86240788	86253864	9
chr8	86351055	86361267	CA3	10212	+	NM_005181	86351138	86360382	7
chr8	86354036	86377144	CA3-AS1	23108	-	NR_121630	86377144	86377144	3
chr8	86376130	86393721	CA2	17591	+	NM_000067	86376310	86393018	7
chr8	86775049	86776128	REXO1L2P	1079	-	NR_003594	86776128	86776128	1
chr8	87060690	87081851	PSKH2	21161	-	NM_033126	87060690	87081851	3
chr8	87111138	87166454	ATP6V0D2	55316	+	NM_152565	87111207	87165206	8
chr8	87226287	87242604	SLC7A13	16317	-	NM_138817	87226641	87242506	4
chr8	87354993	87480178	WWP1	125185	+	NM_007013	87386279	87479122	25
chr8	87484577	87526577	RMDN1	42000	-	NM_001317807	87484684	87519338	10
chr8	87526655	87573726	CPNE3	47071	+	NM_003909	87540773	87570638	17
chr8	87586162	87755903	CNGB3	169741	-	NM_019098	87588031	87755855	18
chr8	87878675	88394955	CNBD1	516280	+	NM_173538	87878723	88394855	11
chr8	88882970	88886296	DCAF4L2	3326	-	NM_152418	88885011	88886199	1
chr8	89049459	89339717	MMP16	290258	-	NM_005941	89053688	89339435	10
chr8	90729626	90769939	LOC101929709	40313	-	NR_125822	90769939	90769939	5
chr8	90769974	90803292	RIPK2	33318	+	NM_003821	90770288	90802644	11
chr8	90914095	90940095	OSGIN2	26000	+	NM_004337	90921882	90937760	6
chr8	90945563	90996952	NBN	51389	-	NM_001024688	90947809	90993676	17
chr8	91013579	91064227	DECR1	50648	+	NM_001359	91013720	91064125	10
chr8	91070835	91095109	CALB1	24274	-	NM_004929	91072400	91094925	11
chr8	91233715	91400187	LINC00534	166472	+	NR_051989	91400187	91400187	4
chr8	91605002	91618291	LINC01030	13289	-	NR_104062	91618291	91618291	3
chr8	91634222	91658133	TMEM64	23911	-	NM_001008495	91637898	91658133	3
chr8	91803920	91971630	NECAB1	167710	+	NM_022351	91804114	91967740	13
chr8	91970705	91997485	C8orf88	26780	-	NM_001190972	91971234	91992663	6
chr8	92006501	92053203	TMEM55A	46702	-	NM_018710	92007904	92052977	7
chr8	92072133	92082417	OTUD6B-AS1	10284	-	NR_110438	92082417	92082417	3
chr8	92082423	92099323	OTUD6B	16900	+	NM_001286745	92088947	92097096	8
chr8	92114846	92231464	LRRC69	116618	+	NM_001129890	92114889	92231228	8
chr8	92217712	92217786	MIR4661	74	+	NR_039805	92217786	92217786	1
chr8	92221721	92410382	SLC26A7	188661	+	NM_001282356	92261879	92407325	20
chr8	92967194	93115454	RUNX1T1	148260	-	NM_175634	92972469	93088280	12
chr8	93577670	93667722	LOC102724710	90052	-	NR_125827	93667722	93667722	5
chr8	93725189	93798288	FLJ46284	73099	-	NR_046114	93798288	93798288	3
chr8	93895757	93978372	TRIQK	82615	-	NM_001171796	93898849	93929217	6
chr8	94041978	94042067	MIR8084	89	+	NR_107051	94042067	94042067	1
chr8	94146323	94179079	C8orf87	32756	-	NM_001242668	94146522	94178996	3
chr8	94358694	94712661	LINC00535	353967	-	NR_033858	94712661	94712661	11
chr8	94712734	94741478	FAM92A1	28744	+	NR_104267	94741478	94741478	9
chr8	94743730	94753224	RBM12B	9494	-	NM_203390	94745632	94748638	3
chr8	94752338	94753047	RBM12B-AS1	709	+	NR_027259	94753047	94753047	1
chr8	94767071	94831460	TMEM67	64389	+	NR_024522	94831460	94831460	29
chr8	94928249	94928347	MIR378D2	98	-	NR_039602	94928347	94928347	1
chr8	94929082	94938296	PDP1	9214	+	NM_018444	94934287	94935901	2
chr8	95139393	95229531	CDH17	90138	-	NM_001144663	95140467	95206913	18
chr8	95261484	95274547	GEM	13063	-	NM_181702	95262537	95272731	5
chr8	95384187	95487343	RAD54B	103156	-	NM_012415	95384397	95479767	15
chr8	95439939	95449180	FSBP	9241	-	NM_001256141	95444358	95449096	2
chr8	95500004	95565746	KIAA1429	65742	-	NM_015496	95500933	95565675	24
chr8	95649512	95651695	LOC100288748	2183	-	NR_034034	95651695	95651695	1
chr8	95653363	95719694	ESRP1	66331	+	NM_017697	95653546	95709154	16
chr8	95732102	95806076	DPY19L4	73974	+	NM_181787	95732226	95802138	19
chr8	95835517	95892721	INTS8	57204	+	NR_073444	95892721	95892721	29
chr8	95892452	95907482	CCNE2	15030	-	NM_057749	95893859	95906449	12
chr8	95938199	95961615	TP53INP1	23416	-	NM_001135733	95944313	95953169	5
chr8	96037213	96070944	NDUFAF6	33731	+	NM_152416	96037236	96070165	9
chr8	96079035	96085410	LOC105375650	6375	-	NR_132986	96085410	96085410	2
chr8	96085138	96085224	MIR3150B	86	-	NR_037484	96085224	96085224	1
chr8	96085141	96085221	MIR3150A	80	+	NR_036105	96085221	96085221	1
chr8	96145948	96168913	PLEKHF2	22965	+	NM_024613	96166272	96167022	2
chr8	96219234	96228602	LINC01298	9368	-	NR_046232	96228602	96228602	3
chr8	96257140	96281462	C8orf37	24322	-	NM_177965	96259844	96281417	6
chr8	96281063	96822371	C8orf37-AS1	541308	+	NR_038201	96822371	96822371	6
chr8	96959212	96960576	LOC100500773	1364	-	NR_036611	96960576	96960576	1
chr8	97154557	97173020	GDF6	18463	-	NM_001001557	97156790	97172920	2
chr8	97238903	97247862	UQCRB	8959	-	NR_045639	97247862	97247862	5
chr8	97251625	97273841	MTERF3	22216	-	NM_001286643	97252056	97270918	9
chr8	97274113	97346779	PTDSS1	72666	+	NM_014754	97274268	97345794	13
chr8	97384153	97399666	LOC102724804	15513	-	NR_125828	97399666	97399666	3
chr8	97505881	97624037	SDC2	118156	+	NM_002998	97506499	97621776	5
chr8	97657454	98155731	CPQ	498277	+	NM_016134	97797125	98155411	8
chr8	97964091	98458725	LOC101927066	494634	-	NR_125390	98458725	98458725	3
chr8	98285713	98290176	TSPYL5	4463	-	NM_033512	98288818	98290072	1
chr8	98656406	98742488	MTDH	86082	+	NM_178812	98656734	98736898	12
chr8	98787808	98864830	LAPTM4B	77022	+	NM_018407	98787964	98863702	7
chr8	98881248	99048946	MATN2	167698	+	NM_002380	98900328	99047940	19
chr8	99053937	99057818	RPL30	3881	-	NM_000989	99054028	99057595	5
chr8	99054313	99054445	SNORA72	132	-	NR_002581	99054445	99054445	1
chr8	99076749	99105838	ERICH5	29089	+	NM_173549	99076897	99105561	3
chr8	99114566	99129418	HRSP12	14852	-	NM_005836	99115069	99129324	6
chr8	99129520	99172069	POP1	42549	+	NM_001145861	99135565	99170499	16
chr8	99204386	99306621	NIPAL2	102235	-	NM_024759	99205278	99306365	12
chr8	99439249	99443023	KCNS2	3774	+	NM_020697	99440207	99441641	2
chr8	99466858	99954799	STK3	487941	-	NM_001256312	99468069	99895984	13
chr8	99956630	99964332	OSR2	7702	+	NM_001286841	99960400	99963929	5
chr8	100025493	100889814	VPS13B	864321	+	NM_017890	100026016	100887894	62
chr8	100548863	100548958	MIR599	95	-	NR_030329	100548958	100548958	1
chr8	100549013	100549089	MIR875	76	-	NR_030596	100549089	100549089	1
chr8	100890222	100906242	COX6C	16020	-	NM_004374	100899732	100904249	4
chr8	100973165	101118344	RGS22	145179	-	NM_001286692	100974666	101118149	28
chr8	101036209	101036312	MIR1273A	103	-	NR_031675	101036312	101036312	1
chr8	101145587	101158099	FBXO43	12512	-	NR_036491	101158099	101158099	5
chr8	101162838	101166230	POLR2K	3392	+	NM_005034	101163583	101165544	4
chr8	101170262	101254132	SPAG1	83870	+	NM_172218	101174508	101253250	19
chr8	101269286	101348446	RNF19A	79160	-	NM_001280539	101270783	101300402	11
chr8	101394990	101395073	MIR4471	83	+	NR_039681	101395073	101395073	1
chr8	101521979	101572014	ANKRD46	50035	-	NM_001270379	101522804	101542061	6
chr8	101585111	101661893	SNX31	76782	-	NM_152628	101586092	101661742	14
chr8	101715143	101734315	PABPC1	19172	-	NM_002568	101716525	101733811	15
chr8	101715195	101715252	MIR7705	57	-	NR_106992	101715252	101715252	1
chr8	101930803	101965623	YWHAZ	34820	-	NM_003406	101932920	101961117	6
chr8	102064281	102088479	FLJ42969	24198	+	NR_033962	102088479	102088479	3
chr8	102209265	102218292	ZNF706	9027	-	NM_001267709	102212229	102213969	4
chr8	102381120	102381823	NACAP1	703	+	NR_002182	102381823	102381823	1
chr8	102504667	102681952	GRHL2	177285	+	NM_024915	102504997	102678931	16
chr8	102698769	103137135	NCALD	438366	-	NM_001040630	102701536	102731857	6
chr8	102996659	103007078	LOC104054148	10419	+	NR_126152	103007078	103007078	5
chr8	103137659	103137743	MIR5680	84	+	NR_049859	103137743	103137743	1
chr8	103216728	103251346	RRM2B	34618	-	NM_015713	103220360	103251102	9
chr8	103251678	103264402	UBR5-AS1	12724	+	NR_125415	103264402	103264402	3
chr8	103264501	103424917	UBR5	160416	-	NM_001282873	103266529	103424462	59
chr8	103563847	103573245	ODF1	9398	+	NM_024410	103563955	103573112	2
chr8	103661004	103668130	KLF10	7126	-	NM_005655	103662359	103667829	4
chr8	103838529	103876428	AZIN1	37899	-	NM_015878	103840794	103855880	13
chr8	103876498	103990104	AZIN1-AS1	113606	+	NR_126338	103990104	103990104	4
chr8	104033247	104085285	ATP6V1C1	52038	+	NM_001695	104053064	104080975	13
chr8	104145190	104153570	BAALC-AS2	8380	-	NR_027071	104153570	104153570	2
chr8	104152920	104242533	BAALC	89613	+	NM_024812	104153125	104240327	3
chr8	104166841	104166917	MIR3151	76	+	NR_036106	104166917	104166917	1
chr8	104169217	104184368	BAALC-AS1	15151	-	NR_109954	104184368	104184368	3
chr8	104310660	104345094	FZD6	34434	+	NM_001164615	104312335	104343737	7
chr8	104383742	104395232	CTHRC1	11490	+	NM_138455	104383884	104394828	4
chr8	104410865	104427563	SLC25A32	16698	-	NR_102338	104427563	104427563	8
chr8	104426941	104455680	DCAF13	28739	+	NM_015420	104427218	104455110	11
chr8	104512975	105266656	RIMS2	753681	+	NM_001100117	104513114	105264048	24
chr8	105352023	105368917	DCSTAMP	16894	+	NM_030788	105360780	105368426	4
chr8	105391651	105479277	DPYS	87626	-	NM_001385	105393425	105479148	10
chr8	105501458	105601252	LRP12	99794	-	NM_013437	105502900	105601125	7
chr8	106331146	106816767	ZFPM2	485621	+	NM_012082	106331169	106815766	8
chr8	106792637	107072731	ZFPM2-AS1	280094	-	NR_125796	107072731	107072731	8
chr8	107282405	107764921	OXR1	482516	+	NM_001198533	107371841	107763169	17
chr8	107771710	107782472	ABRA	10762	-	NM_139166	107773264	107782418	2
chr8	108261709	108510283	ANGPT1	248574	-	NM_001146	108264082	108509786	9
chr8	108911543	109095913	RSPO2	184370	-	NM_178565	108913302	109094866	6
chr8	109213971	109260959	EIF3E	46988	-	NM_001568	109214113	109260931	13
chr8	109455852	109499136	EMC2	43284	+	NM_014673	109455887	109498827	11
chr8	109795345	109799770	TMEM74	4425	-	NM_153015	109796409	109797327	2
chr8	110099652	110131812	TRHR	32160	+	NM_003301	110099741	110131684	2
chr8	110253147	110346350	NUDCD1	93203	-	NM_032869	110255237	110346239	10
chr8	110346551	110358189	ENY2	11638	+	NR_036472	110358189	110358189	5
chr8	110374705	110543500	PKHD1L1	168795	+	NM_177531	110374809	110542319	78
chr8	110551928	110578225	EBAG9	26297	+	NM_198120	110563053	110576788	7
chr8	110586404	110704020	SYBU	117616	-	NM_001099743	110587134	110656888	8
chr8	110656343	110660313	LOC100132813	3970	+	NM_001317989	110656354	110657576	2
chr8	110979232	110986959	KCNV1	7727	-	NM_014379	110980316	110986617	3
chr8	111949918	112039662	LINC01608	89744	-	NR_125417	112039662	112039662	6
chr8	112111189	112248432	LINC01609	137243	-	NR_125418	112248432	112248432	4
chr8	113235158	114449242	CSMD3	1214084	-	NM_198123	113236999	114449083	71
chr8	113655721	113655812	MIR2053	91	+	NR_031745	113655812	113655812	1
chr8	116420723	116681255	TRPS1	260532	-	NM_014112	116426250	116635864	7
chr8	116962735	117337297	LINC00536	374562	-	NR_046215	117337297	117337297	14
chr8	117657054	117768062	EIF3H	111008	-	NM_003756	117657244	117768036	8
chr8	117778741	117786921	UTP23	8180	+	NM_032334	117778842	117784081	3
chr8	117858172	117887105	RAD21	28933	-	NM_006265	117859738	117878968	14
chr8	117886662	117889107	RAD21-AS1	2445	+	NR_033886	117889107	117889107	2
chr8	117886966	117887039	MIR3610	73	-	NR_037404	117887039	117887039	1
chr8	117950463	117956239	AARD	5776	+	NM_001025357	117950482	117954940	2
chr8	117962511	118188953	SLC30A8	226442	+	NM_001172811	118159268	118184920	10
chr8	118532951	118552501	MED30	19550	+	NM_080651	118533115	118552217	4
chr8	118811601	119124058	EXT1	312457	-	NM_000127	118811950	119123285	11
chr8	119201695	119634234	SAMD12	432539	-	NR_109794	119634234	119634234	5
chr8	119633239	119738306	SAMD12-AS1	105067	+	NR_038210	119738306	119738306	5
chr8	119935795	119964383	TNFRSF11B	28588	-	NM_002546	119936612	119964060	5
chr8	120075181	120081021	LOC101927513	5840	-	NR_134297	120081021	120081021	2
chr8	120079423	120119202	COLEC10	39779	+	NM_006438	120079520	120118430	6
chr8	120220609	120257914	MAL2	37305	+	NM_052886	120220711	120255728	5
chr8	120428551	120436678	NOV	8127	+	NM_002514	120428772	120435372	5
chr8	120569316	120651106	ENPP2	81790	-	NM_001130863	120569760	120651020	26
chr8	120743013	120845074	TAF2	102061	-	NM_003184	120744163	120844804	26
chr8	120846180	120868170	DSCC1	21990	-	NM_024094	120847132	120868035	9
chr8	120885894	121063157	DEPTOR	177263	+	NM_022783	120886086	121061943	9
chr8	121137346	121384273	COL14A1	246927	+	NM_021110	121160081	121383470	48
chr8	121408082	121457647	MRPL13	49565	-	NM_014078	121408342	121457334	7
chr8	121457637	121535875	MTBP	78238	+	NM_022045	121457710	121535576	22
chr8	121547984	121824309	SNTB1	276325	-	NM_021021	121551116	121824083	7
chr8	121773492	121789072	LOC101927543	15580	+	NR_125419	121789072	121789072	5
chr8	122625270	122653630	HAS2	28360	-	NM_005328	122626348	122641580	4
chr8	122651585	122657564	HAS2-AS1	5979	+	NR_002835	122657564	122657564	4
chr8	123426565	123580883	LOC105375734	154318	-	NR_131202	123580883	123580883	4
chr8	123682623	123706345	LINC01151	23722	-	NR_126348	123706345	123706345	4
chr8	123793900	123986755	ZHX2	192855	+	NM_014943	123963750	123966264	4
chr8	124025403	124054663	DERL1	29260	-	NM_001134671	124027686	124054362	8
chr8	124084919	124164392	TBC1D31	79473	+	NM_145647	124085009	124164179	22
chr8	124191286	124222319	FAM83A	31033	+	NM_207006	124195096	124221736	6
chr8	124213411	124214983	FAM83A-AS1	1572	-	NR_024479	124214983	124214983	3
chr8	124228027	124228103	MIR4663	76	-	NR_039808	124228103	124228103	1
chr8	124232195	124253638	C8orf76	21443	-	NM_032847	124232342	124253586	6
chr8	124238428	124286727	ZHX1-C8orf76	48299	-	NM_001204180	124238712	124279533	6
chr8	124260689	124287781	ZHX1	27092	-	NR_037873	124287781	124287781	4
chr8	124332090	124408705	ATAD2	76615	-	NM_014109	124333373	124408597	28
chr8	124428964	124460330	WDYHV1	31366	+	NR_133926	124460330	124460330	7
chr8	124510126	124553493	FBXO32	43367	-	NM_058229	124515612	124553254	9
chr8	124657914	124665190	KLHL38	7276	-	NM_001081675	124657978	124665166	3
chr8	124693033	124749666	ANXA13	56633	-	NM_001003954	124693479	124749574	12
chr8	124780678	124827690	FAM91A1	47012	+	NM_001317917	124796732	124824944	24
chr8	124864226	125132302	FER1L6	268076	+	NM_001039112	124968238	125132031	41
chr8	124996377	125053023	FER1L6-AS1	56646	-	NR_040044	125053023	125053023	6
chr8	125058311	125183763	FER1L6-AS2	125452	-	NR_103547	125183763	125183763	5
chr8	125204931	125259639	LOC101927588	54708	-	NR_125420	125259639	125259639	3
chr8	125323158	125384940	TMEM65	61782	-	NM_194291	125326200	125384398	7
chr8	125463047	125465266	TRMT12	2219	+	NM_017956	125463168	125464515	1
chr8	125474737	125486804	RNF139-AS1	12067	-	NR_108047	125486804	125486804	2
chr8	125487007	125500859	RNF139	13852	+	NM_007218	125487350	125499885	2
chr8	125500734	125551329	TATDN1	50595	-	NR_027427	125551329	125551329	13
chr8	125520755	125520817	MIR6844	62	-	NR_106903	125520817	125520817	1
chr8	125551342	125562227	NDUFB9	10885	+	NM_005005	125551427	125562133	4
chr8	125563010	125740748	MTSS1	177738	-	NM_001282971	125565232	125740196	15
chr8	125834219	125834300	MIR4662B	81	-	NR_039809	125834300	125834300	1
chr8	125834226	125834293	MIR4662A	67	+	NR_039806	125834293	125834293	1
chr8	125954249	125963337	LINC00964	9088	+	NR_027321	125963337	125963337	4
chr8	125985538	125991630	ZNF572	6092	+	NM_152412	125987882	125990100	3
chr8	126009230	126010440	LOC105375744	1210	-	NR_134457	126010440	126010440	2
chr8	126010719	126034525	SQLE	23806	+	NM_003129	126011645	126034187	11
chr8	126036502	126104061	KIAA0196	67559	-	NM_014846	126036858	126096140	29
chr8	126104082	126379367	NSMCE2	275285	+	NM_173685	126114572	126379127	8
chr8	126442562	126450647	TRIB1	8085	+	NM_025195	126443144	126448713	3
chr8	126934766	126963441	LINC00861	28675	-	NR_038447	126963441	126963441	4
chr8	127337739	127341778	LOC101927657	4039	+	NR_125421	127341778	127341778	3
chr8	127564682	127570711	FAM84B	6029	-	NM_174911	127568701	127569634	2
chr8	128025398	128033259	PCAT1	7861	+	NR_045262	128033259	128033259	2
chr8	128084938	128094466	PCAT2	9528	-	NR_119373	128094466	128094466	4
chr8	128092118	128104840	PRNCR1	12722	+	NR_109833	128104840	128104840	1
chr8	128200030	128209872	CASC19	9842	-	NR_120364	128209872	128209872	3
chr8	128219626	128231513	CCAT1	11887	-	NR_108049	128231513	128231513	2
chr8	128256881	128404876	CASC21	147995	+	NR_117099	128404876	128404876	4
chr8	128301920	128494384	CASC8	192464	-	NR_117100	128494384	128494384	6
chr8	128412643	128414395	CCAT2	1752	+	NR_109834	128414395	128414395	1
chr8	128427856	128429441	POU5F1B	1585	+	NM_001159542	128428111	128429191	1
chr8	128712852	128746213	CASC11	33361	-	NR_117102	128746213	128746213	4
chr8	128748314	128753680	MYC	5366	+	NM_002467	128748839	128753204	3
chr8	128806778	129113499	PVT1	306721	+	NR_003367	129113499	129113499	9
chr8	128808207	128808274	MIR1204	67	+	NR_031609	128808274	128808274	1
chr8	128958804	128960969	TMEM75	2165	-	NR_103558	128960969	128960969	1
chr8	128972878	128972941	MIR1205	63	+	NR_031610	128972941	128972941	1
chr8	129021143	129021202	MIR1206	59	+	NR_031611	129021202	129021202	1
chr8	129061397	129061484	MIR1207	87	+	NR_031612	129061484	129061484	1
chr8	129162361	129162434	MIR1208	73	+	NR_031613	129162434	129162434	1
chr8	129417515	129576925	LINC00824	159410	-	NR_121672	129576925	129576925	8
chr8	130228712	130253486	LINC00977	24774	-	NR_033916	130253486	130253486	3
chr8	130363939	130692485	CCDC26	328546	-	NR_130917	130692485	130692485	4
chr8	130496302	130496388	MIR3686	86	-	NR_037457	130496388	130496388	1
chr8	130760441	130799134	GSDMC	38693	-	NM_031415	130760746	130789833	14
chr8	130851838	131028897	FAM49B	177059	-	NR_046360	131028897	131028897	15
chr8	131020579	131020699	MIR5194	120	-	NR_049826	131020699	131020699	1
chr8	131064350	131455906	ASAP1	391556	-	NM_001247996	131066976	131373953	31
chr8	131094983	131097014	ASAP1-IT2	2031	-	NR_045385	131097014	131097014	1
chr8	131307600	131308779	ASAP1-IT1	1179	-	NR_002765	131308779	131308779	1
chr8	131792546	132052835	ADCY8	260289	-	NM_001115	131792635	132052579	18
chr8	132916355	133025886	EFR3A	109531	+	NM_015137	132916559	133023142	23
chr8	133036466	133071627	OC90	35161	-	NM_001080399	133036727	133067273	14
chr8	133073732	133117512	HHLA1	43780	-	NM_001145095	133076241	133117512	16
chr8	133133104	133493004	KCNQ3	359900	-	NM_004519	133141508	133492779	15
chr8	133572744	133573726	HPYR1	982	-	NR_026684	133573726	133573726	1
chr8	133584200	133687863	LRRC6	103663	-	NR_073525	133687863	133687863	13
chr8	133722191	133772914	TMEM71	50723	-	NM_144649	133723212	133771125	10
chr8	133787603	133861052	PHF20L1	73449	+	NM_016018	133790074	133858168	21
chr8	133879204	134147143	TG	267939	+	NM_003235	133879245	134147038	48
chr8	134048972	134115310	SLA	66338	-	NM_001045556	134050768	134072405	9
chr8	134058725	134058826	MIR7848	101	-	NR_107002	134058826	134058826	1
chr8	134203281	134243932	WISP1	40651	+	NM_003882	134203387	134239953	5
chr8	134249413	134309547	NDRG1	60134	-	NM_001135242	134251120	134296554	16
chr8	134467090	134584183	ST3GAL1	117093	-	NM_173344	134472006	134488267	10
chr8	134676003	134696309	LOC105375773	20306	-	NR_134463	134696309	134696309	4
chr8	134787793	134789595	LOC101927798	1802	-	NR_125422	134789595	134789595	3
chr8	134898738	134914650	LOC101927822	15912	+	NR_125424	134914650	134914650	4
chr8	135490030	135725292	ZFAT	235262	-	NM_001289394	135490724	135669963	17
chr8	135610313	135612932	ZFAT-AS1	2619	+	NR_002438	135612932	135612932	2
chr8	135812762	135812850	MIR30B	88	-	NR_029666	135812850	135812850	1
chr8	135817118	135817188	MIR30D	70	-	NR_029599	135817188	135817188	1
chr8	135850311	135854880	NCRNA00250	4569	+	NR_126028	135854880	135854880	3
chr8	135862177	135894142	LOC101927845	31965	+	NR_125427	135894142	135894142	3
chr8	136246373	136311962	LINC01591	65589	+	NR_120395	136311962	136311962	6
chr8	136469707	136659852	KHDRBS3	190145	+	NM_006558	136470109	136659327	9
chr8	138418343	138425831	LOC101927915	7488	-	NR_125428	138425831	138425831	3
chr8	139142265	139509065	FAM135B	366800	-	NM_015912	139144835	139380226	20
chr8	139600477	139926249	COL22A1	325772	-	NM_152888	139601495	139895415	65
chr8	140613080	140715299	KCNK9	102219	-	NR_104210	140715299	140715299	4
chr8	140742585	141468678	TRAPPC9	726093	-	NM_031466	140743303	141468663	23
chr8	141521396	141527252	CHRAC1	5856	+	NM_017444	141521598	141525346	3
chr8	141541263	141645646	AGO2	104383	-	NM_012154	141542142	141645605	19
chr8	141668480	142011412	PTK2	342932	-	NM_001199649	141669564	141900836	33
chr8	142138719	142205900	DENND3	67181	+	NM_014957	142146745	142204332	23
chr8	142217264	142264728	SLC45A4	47464	-	NM_001286646	142221670	142264328	8
chr8	142264665	142266916	LOC105375787	2251	+	NM_001317971	142264723	142266812	2
chr8	142350647	142354720	LINC01300	4073	+	NR_024441	142354720	142354720	4
chr8	142366586	142377365	GPR20	10779	-	NM_005293	142366946	142368023	2
chr8	142431487	142442554	PTP4A3	11067	+	NM_032611	142432340	142441144	5
chr8	142443928	142517330	MROH5	73402	-	NM_207414	142444057	142517249	30
chr8	142867602	142867674	MIR1302-7	72	-	NR_031636	142867674	142867674	1
chr8	143079636	143079657	MIR4539	21	-	NR_130468	143079657	143079657	1
chr8	143257699	143257779	MIR4472-1	80	+	NR_039682	143257779	143257779	1
chr8	143279716	143290364	LINC00051	10648	+	NR_024378	143290364	143290364	3
chr8	143293440	143484610	TSNARE1	191170	-	NM_145003	143310844	143436085	14
chr8	143545376	143626368	ADGRB1	80992	+	NM_001702	143545559	143625778	30
chr8	143692404	143695833	ARC	3429	-	NM_015193	143694441	143695632	3
chr8	143719948	143722024	LOC101928087	2076	+	NR_134305	143722024	143722024	2
chr8	143738873	143751412	JRK	12539	-	NM_001279352	143740266	143747477	5
chr8	143751725	143764145	PSCA	12420	+	NR_033343	143764145	143764145	3
chr8	143781528	143785584	LY6K	4056	+	NM_017527	143781945	143784789	3
chr8	143783669	143808391	LOC100288181	24722	-	NR_038925	143808391	143808391	3
chr8	143808620	143818350	THEM6	9730	+	NM_016647	143808764	143816857	2
chr8	143822361	143823829	SLURP1	1468	-	NM_020427	143822560	143823803	3
chr8	143831627	143833952	LYPD2	2325	-	NM_205545	143831700	143833869	3
chr8	143845751	143859264	LYNX1	13513	-	NM_023946	143846022	143857375	5
chr8	143866297	143868008	LY6D	1711	-	NM_003695	143866636	143867932	3
chr8	143916216	143928262	GML	12046	+	NM_002066	143921853	143928106	4
chr8	143953772	143961236	CYP11B1	7464	-	NM_000497	143955788	143961229	9
chr8	143991974	143999259	CYP11B2	7285	-	NM_000498	143993395	143999256	9
chr8	144063447	144099807	LOC100133669	36360	-	NR_026913	144099807	144099807	2
chr8	144077244	144079080	CDC42P3	1836	+	NR_102426	144079080	144079080	1
chr8	144099901	144103827	LY6E	3926	+	NM_002346	144102356	144103206	4
chr8	144120625	144135720	C8orf31	15095	+	NR_126398	144135720	144135720	8
chr8	144239330	144242053	LY6H	2723	-	NM_001130478	144239666	144241616	5
chr8	144295067	144299044	GPIHBP1	3977	+	NM_001301772	144295142	144298887	5
chr8	144329097	144344875	ZFP41	15778	+	NM_173832	144332010	144332610	3
chr8	144349606	144359101	GLI4	9495	+	NM_138465	144351566	144358974	4
chr8	144362324	144363870	MINCR	1546	-	NR_120682	144363870	144363870	3
chr8	144373558	144382120	ZNF696	8562	+	NM_030895	144375171	144378970	3
chr8	144391496	144442147	TOP1MT	50651	-	NM_001258446	144391610	144411585	15
chr8	144448792	144450805	RHPN1-AS1	2013	-	NR_026785	144450805	144450805	1
chr8	144451024	144466390	RHPN1	15366	+	NM_052924	144451157	144464821	15
chr8	144499848	144501320	MAFA-AS1	1472	+	NR_126358	144501320	144501320	2
chr8	144510229	144512602	MAFA	2373	-	NM_201589	144511514	144512576	1
chr8	144519824	144623620	ZC3H3	103796	-	NM_015117	144520225	144623591	12
chr8	144635556	144645231	GSDMD	9675	+	NM_001166237	144641505	144645074	14
chr8	144648362	144654928	MROH6	6566	-	NM_001100878	144649408	144654884	14
chr8	144656954	144660521	NAPRT	3567	-	NM_145201	144657007	144660488	13
chr8	144661866	144679845	EEF1D	17979	-	NM_032378	144661961	144672251	10
chr8	144680073	144682485	TIGD5	2412	+	NM_032862	144680073	144682002	1
chr8	144686082	144691784	PYCRL	5702	-	NM_023078	144687869	144691754	6
chr8	144694787	144699732	TSTA3	4945	-	NM_003313	144695079	144698882	11
chr8	144718182	144735900	ZNF623	17718	+	NM_001261843	144732162	144733653	2
chr8	144766621	144777555	ZNF707	10934	+	NM_001288805	144772278	144776700	8
chr8	144779284	144780583	BREA2	1299	+	NR_015445	144780583	144780583	2
chr8	144788863	144790279	CCDC166	1416	-	NM_001162914	144788863	144790279	2
chr8	144790220	144796068	LOC101928160	5848	+	NR_134306	144796068	144796068	6
chr8	144798506	144804633	MAPK15	6127	+	NM_139021	144798547	144804421	14
chr8	144806102	144815914	FAM83H	9812	-	NM_198488	144808090	144812752	5
chr8	144815252	144815323	MIR4664	71	-	NR_039810	144815323	144815323	1
chr8	144816309	144828507	FAM83H-AS1	12198	+	NR_033849	144828507	144828507	4
chr8	144873089	144897549	SCRIB	24460	-	NM_182706	144873332	144897542	37
chr8	144895126	144895212	MIR937	86	-	NR_030633	144895212	144895212	1
chr8	144898513	144911556	PUF60	13043	-	NM_078480	144898689	144911473	12
chr8	144915754	144923146	NRBP2	7392	-	NM_178564	144917831	144923006	18
chr8	144919927	144919988	MIR6845	61	-	NR_106904	144919988	144919988	1
chr8	144939491	144952632	EPPK1	13141	-	NM_031308	144940158	144947421	2
chr8	144989314	145050913	PLEC	61599	-	NM_000445	144990344	145049537	33
chr8	145019358	145019447	MIR661	89	-	NR_030383	145019447	145019447	1
chr8	145051319	145060639	PARP10	9320	-	NM_032789	145051651	145060527	11
chr8	145064225	145067583	GRINA	3358	+	NM_000837	145065391	145067009	7
chr8	145086581	145102015	SPATC1	15434	+	NM_198572	145086683	145101857	5
chr8	145106166	145115606	OPLAH	9440	-	NM_017570	145106226	145114935	28
chr8	145112223	145112283	MIR6846	60	-	NR_106905	145112283	145112283	1
chr8	145133521	145135551	EXOSC4	2030	+	NM_019037	145133631	145135504	3
chr8	145134776	145134845	MIR6847	69	+	NR_106906	145134845	145134845	1
chr8	145137523	145141119	GPAA1	3596	+	NM_003801	145137633	145141028	12
chr8	145149937	145152430	CYC1	2493	+	NM_001916	145150002	145152239	7
chr8	145153535	145159140	SHARPIN	5605	-	NM_030974	145153780	145158656	9
chr8	145159304	145162515	MAF1	3211	+	NM_032272	145160586	145162012	8
chr8	145162594	145171286	WDR97	8692	+	NM_001316309	145162653	145171196	24
chr8	145192671	145195746	HGH1	3075	+	NM_016458	145192738	145194455	6
chr8	145202918	145316843	MROH1	113925	+	NM_032450	145218729	145316643	44
chr8	145317575	145317640	MIR7112	65	-	NR_107057	145317640	145317640	1
chr8	145321460	145323386	SCX	1926	+	NM_001080514	145321516	145323045	2
chr8	145486001	145515120	BOP1	29119	-	NM_015201	145486119	145515052	16
chr8	145515269	145538385	HSF1	23116	+	NM_005526	145515439	145537993	13
chr8	145538245	145550582	DGAT1	12337	-	NM_012079	145540216	145550299	17
chr8	145540908	145540978	MIR6848	70	-	NR_106907	145540978	145540978	1
chr8	145554227	145559943	SCRT1	5716	-	NM_031309	145556846	145559831	2
chr8	145576885	145579269	TMEM249	2384	-	NM_001280561	145577007	145578427	6
chr8	145579087	145582183	FBXL6	3096	-	NM_012162	145579190	145582107	9
chr8	145582216	145584948	SLC52A2	2732	+	NM_001253816	145582953	145584675	5
chr8	145592595	145596648	LOC101928902	4053	-	NR_134307	145596648	145596648	3
chr8	145597703	145618453	ADCK5	20750	+	NM_174922	145597784	145618289	15
chr8	145618445	145634733	CPSF1	16288	-	NM_013291	145618532	145634542	38
chr8	145619363	145619445	MIR939	82	-	NR_030635	145619445	145619445	1
chr8	145625670	145625739	MIR6849	69	-	NR_106908	145625739	145625739	1
chr8	145637797	145642279	SLC39A4	4482	-	NM_130849	145637921	145642173	12
chr8	145648983	145653946	VPS28	4963	-	NM_016208	145649187	145652328	10
chr8	145654162	145669812	TONSL	15650	-	NM_013432	145654525	145669797	26
chr8	145660550	145665276	TONSL-AS1	4726	+	NR_109770	145665276	145665276	6
chr8	145660933	145661002	MIR6893	69	-	NR_106953	145661002	145661002	1
chr8	145675314	145690418	CYHR1	15104	-	NM_138496	145675761	145690284	5
chr8	145691719	145699499	KIFC2	7780	+	NM_145754	145691802	145698833	17
chr8	145699114	145701718	FOXH1	2604	-	NM_003923	145699620	145701139	3
chr8	145722108	145727504	PPP1R16A	5396	+	NM_032902	145722577	145727286	10
chr8	145729464	145732555	GPT	3091	+	NM_005309	145729687	145732383	11
chr8	145734418	145736611	MFSD3	2193	+	NM_138431	145734716	145736547	5
chr8	145736666	145743210	RECQL4	6544	-	NM_004260	145736813	145743168	22
chr8	145743348	145750559	LRRC14	7211	+	NM_001272036	145745109	145746862	5
chr8	145747760	145752416	LRRC24	4656	-	NM_001024678	145747858	145750358	5
chr8	145751602	145754458	C8orf82	2856	-	NM_001001795	145752725	145754300	3
chr8	145754562	145911197	ARHGAP39	156635	-	NM_001308208	145755805	145830999	11
chr8	145946293	145980970	ZNF251	34677	-	NM_138367	145947028	145980113	5
chr8	145997608	146012730	ZNF34	15122	-	NM_030580	145998650	146005625	6
chr8	146015149	146017831	RPL8	2682	-	NM_000973	146015188	146017514	6
chr8	146017315	146017376	MIR6850	61	-	NR_106909	146017376	146017376	1
chr8	146024260	146036139	ZNF517	11879	+	NR_134285	146036139	146036139	4
chr8	146052902	146072893	ZNF7	19991	+	NM_001282796	146054472	146071563	5
chr8	146075550	146078963	COMMD5	3413	-	NM_001081003	146076048	146076723	2
chr8	146102335	146126846	ZNF250	24511	-	NM_021061	146106899	146115734	6
chr8	146155743	146176274	ZNF16	20531	-	NM_001029976	146156123	146171592	4
chr8	146198974	146228285	ZNF252P	29311	-	NR_023392	146228285	146228285	5
chr8	146220250	146224283	TMED10P1	4033	+	NR_002807	146224283	146224283	1
chr8	146228196	146231432	ZNF252P-AS1	3236	+	NR_026974	146231432	146231432	1
chr8	146277823	146281416	C8orf33	3593	+	NM_023080	146277877	146279543	5
chr9	11986	14525	DDX11L5	2539	+	NR_051986	14525	14525	3
chr9	14510	29739	WASH1	15229	-	NM_182905	14806	24999	11
chr9	34393	35864	FAM138C	1471	-	NR_026822	35864	35864	3
chr9	72689	88826	PGM5P3-AS1	16137	+	NR_121190	88826	88826	3
chr9	116230	118417	FOXD4	2187	-	NM_207305	116799	118119	1
chr9	121037	179075	CBWD1	58038	-	NM_001145355	121466	177768	16
chr9	213107	215893	C9orf66	2786	-	NM_152569	214508	215396	1
chr9	214864	465259	DOCK8	250395	+	NM_203447	214976	464219	48
chr9	470293	746106	KANK1	275813	+	NM_001256876	676972	745235	16
chr9	841689	969090	DMRT1	127401	+	NM_021951	841838	968139	5
chr9	976967	991732	DMRT3	14765	+	NM_021240	977001	991005	2
chr9	1048142	1048640	LINC01230	498	+	NR_110643	1048640	1048640	1
chr9	1050345	1057554	DMRT2	7209	+	NM_006557	1051613	1055774	4
chr9	2015218	2193623	SMARCA2	178405	+	NM_003070	2029022	2192739	34
chr9	2535654	2622373	VLDLR-AS1	86719	-	NR_015375	2622373	2622373	4
chr9	2621792	2654485	VLDLR	32693	+	NM_003383	2622189	2653868	19
chr9	2717525	2730037	KCNV2	12512	+	NM_133497	2717739	2729727	2
chr9	2804154	2844130	PUM3	39976	-	NM_014878	2804330	2838507	18
chr9	3181588	3200500	LINC01231	18912	+	NR_121585	3200500	3200500	5
chr9	3218296	3526001	RFX3	307705	-	NM_134428	3225041	3395588	18
chr9	3668085	3691756	RFX3-AS1	23671	+	NR_121586	3691756	3691756	5
chr9	3824127	4300035	GLIS3	475908	-	NM_001042413	3828271	4286425	11
chr9	3898645	3901248	GLIS3-AS1	2603	+	NR_026663	3901248	3901248	2
chr9	4490426	4587469	SLC1A1	97043	+	NM_004170	4490679	4585558	12
chr9	4598315	4666674	SPATA6L	68359	-	NM_001039395	4604179	4666250	11
chr9	4662293	4665272	PLPP6	2979	+	NM_203453	4662375	4663263	1
chr9	4676600	4679480	CDC37L1-AS1	2880	-	NR_121598	4679480	4679480	2
chr9	4679552	4708398	CDC37L1	28846	+	NM_017913	4679767	4706112	7
chr9	4709556	4742043	AK3	32487	-	NM_001199853	4712975	4722566	5
chr9	4792833	4861077	RCL1	68244	+	NM_005772	4793091	4860275	9
chr9	4850296	4850375	MIR101-2	79	+	NR_029836	4850375	4850375	1
chr9	4985244	5128183	JAK2	142939	+	NM_004972	5021987	5126791	25
chr9	5163862	5185618	INSL6	21756	-	NM_007179	5163912	5185602	2
chr9	5231418	5233967	INSL4	2549	+	NM_002195	5231523	5233877	2
chr9	5299865	5304611	RLN2	4746	-	NM_005059	5300402	5304580	3
chr9	5334931	5339873	RLN1	4942	-	NM_006911	5335250	5339746	2
chr9	5357966	5437937	PLGRKT	79971	-	NM_018465	5358238	5431977	6
chr9	5450502	5470567	CD274	20065	+	NR_052005	5470567	5470567	8
chr9	5510544	5571282	PDCD1LG2	60738	+	NM_025239	5522546	5569959	7
chr9	5629118	5776556	RIC1	147438	+	NM_020829	5629309	5774246	26
chr9	5784571	5833081	ERMP1	48510	-	NM_024896	5787143	5833027	15
chr9	5890908	5909822	MLANA	18914	+	NM_005511	5892474	5908708	5
chr9	5919007	6008003	KIAA2026	88996	-	NM_001017969	5919683	6007787	8
chr9	6007825	6007904	MIR4665	79	+	NR_039811	6007904	6007904	1
chr9	6011018	6015640	RANBP6	4622	-	NM_001243203	6014285	6015607	2
chr9	6215148	6257983	IL33	42835	+	NM_001314047	6241694	6256168	8
chr9	6328348	6331900	TPD52L3	3552	+	NM_001001874	6328595	6331019	2
chr9	6413150	6507051	UHRF2	93901	+	NR_046386	6507051	6507051	17
chr9	6532463	6645692	GLDC	113229	-	NM_000170	6533016	6645499	25
chr9	6757640	7175648	KDM4C	418008	+	NM_001304339	6792988	7174637	22
chr9	7796490	7799799	TMEM261	3309	-	NM_033428	7798572	7799734	2
chr9	8314245	10612723	PTPRD	2298478	-	NM_002839	8317873	8733843	46
chr9	8858017	8861727	PTPRD-AS1	3710	+	NR_121599	8861727	8861727	3
chr9	10613205	10620420	PTPRD-AS2	7215	+	NR_110696	10620420	10620420	3
chr9	12693385	12710266	TYRP1	16881	+	NM_000550	12693996	12709182	8
chr9	12699998	12814388	LURAP1L-AS1	114390	-	NR_125775	12814388	12814388	4
chr9	12775011	12823059	LURAP1L	48048	+	NM_203403	12775714	12821759	2
chr9	12972555	12972632	SNORD137	77	-	NR_132976	12972632	12972632	1
chr9	13105702	13279563	MPDZ	173861	-	NM_001261406	13106963	13250314	46
chr9	13406378	13431328	FLJ41200	24950	-	NR_033863	13431328	13431328	3
chr9	13927969	13945606	LINC00583	17637	+	NR_038194	13945606	13945606	3
chr9	14081841	14398982	NFIB	317141	-	NM_001190738	14088307	14398630	9
chr9	14611068	14693480	ZDHHC21	82412	-	NM_178566	14618963	14674338	10
chr9	14719731	14722715	CER1	2984	-	NM_005454	14720087	14722670	2
chr9	14734663	14910993	FREM1	176330	-	NM_144966	14737393	14868975	38
chr9	14993324	15019722	LOC389705	26398	+	NR_003920	15019722	15019722	5
chr9	15170841	15307358	TTC39B	136517	-	NM_152574	15172016	15307321	20
chr9	15422781	15461627	SNAPC3	38846	+	NM_001039697	15422877	15459864	9
chr9	15464064	15511017	PSIP1	46953	-	NM_033222	15465517	15510186	16
chr9	15553096	15971897	CCDC171	418801	+	NM_173550	15564086	15971834	26
chr9	16203932	16276311	C9orf92	72379	-	NR_073471	16276311	16276311	4
chr9	16409500	16870786	BNC2	461286	-	NM_017637	16418986	16870646	7
chr9	17134988	17503921	CNTLN	368933	+	NM_017738	17135063	17502650	26
chr9	17578951	17797126	SH3GL2	218175	+	NM_003026	17579240	17795741	9
chr9	18474078	18910947	ADAMTSL1	436869	+	NM_001040272	18474230	18908546	29
chr9	18573303	18573377	MIR3152	74	+	NR_036107	18573377	18573377	1
chr9	18927657	19049352	SAXO1	121695	-	NM_001287049	18928049	18950778	4
chr9	19049371	19051021	RRAGA	1650	+	NM_006570	19049657	19050599	1
chr9	19053134	19102940	HAUS6	49806	-	NM_001270890	19056340	19102649	17
chr9	19063653	19063784	SCARNA8	131	-	NR_003009	19063784	19063784	1
chr9	19115758	19127604	PLIN2	11846	-	NM_001122	19116245	19126424	8
chr9	19230762	19374266	DENND4C	143504	+	NM_017925	19276172	19372171	32
chr9	19376253	19380235	RPS6	3982	-	NM_001010	19376290	19380193	6
chr9	19408924	19452500	ACER2	43576	+	NM_001010887	19409082	19450634	6
chr9	19507449	19787017	SLC24A2	279568	-	NM_020344	19516150	19786864	10
chr9	20341662	20622542	MLLT3	280880	-	NM_004529	20346440	20622255	11
chr9	20411145	20411236	MIR4473	91	-	NR_039684	20411236	20411236	1
chr9	20502262	20502340	MIR4474	78	-	NR_039685	20502340	20502340	1
chr9	20658307	20995954	FOCAD	337647	+	NM_017794	20715352	20995628	46
chr9	20683300	20684749	FOCAD-AS1	1449	-	NR_121601	20684749	20684749	2
chr9	20716103	20716187	MIR491	84	+	NR_030166	20716187	20716187	1
chr9	21006364	21031635	HACD4	25271	-	NM_001010915	21007035	21031589	7
chr9	21077103	21077962	IFNB1	859	-	NM_002176	21077304	21077868	1
chr9	21140630	21141900	IFNW1	1270	-	NM_002177	21140981	21141569	1
chr9	21165635	21166659	IFNA21	1024	-	NM_002175	21166041	21166611	1
chr9	21186617	21187598	IFNA4	981	-	NM_021068	21186960	21187530	1
chr9	21201467	21202204	IFNA7	737	-	NM_021057	21201594	21202164	1
chr9	21206179	21207142	IFNA10	963	-	NM_002171	21206526	21207096	1
chr9	21216371	21217310	IFNA16	939	-	NM_002173	21216734	21217304	1
chr9	21227241	21228221	IFNA17	980	-	NM_021268	21227602	21228172	1
chr9	21239200	21239978	IFNA14	778	-	NM_002172	21239364	21239934	1
chr9	21277686	21278562	IFNA22P	876	-	NR_036676	21278562	21278562	1
chr9	21304612	21305312	IFNA5	700	-	NM_002169	21304685	21305255	1
chr9	21331017	21335429	KLHL9	4412	-	NM_018847	21333004	21334858	1
chr9	21350316	21350886	IFNA6	570	-	NM_021002	21350316	21350886	1
chr9	21367370	21368075	IFNA13	705	-	NM_006900	21367436	21368009	1
chr9	21384253	21385396	IFNA2	1143	-	NM_000605	21384761	21385328	1
chr9	21409145	21410184	IFNA8	1039	+	NM_002170	21409175	21409745	1
chr9	21440452	21441315	IFNA1	863	+	NM_024013	21440506	21441076	1
chr9	21454266	21559697	MIR31HG	105431	-	NR_027054	21559697	21559697	4
chr9	21480838	21482312	IFNE	1474	-	NM_176891	21481066	21481693	1
chr9	21512113	21512184	MIR31	71	-	NR_029505	21512184	21512184	1
chr9	21802634	21865969	MTAP	63335	+	NM_002451	21802747	21862013	8
chr9	21967137	21967753	CDKN2A-AS1	616	+	NR_024274	21967753	21967753	1
chr9	21967750	21994490	CDKN2A	26740	-	NM_058195	21971001	21994330	3
chr9	21994789	22121093	CDKN2B-AS1	126304	+	NR_003529	22121093	22121093	19
chr9	22002901	22009312	CDKN2B	6411	-	NM_004936	22005985	22008952	2
chr9	22446839	22452472	DMRTA1	5633	+	NM_022160	22447064	22451910	2
chr9	22646198	22824212	LINC01239	178014	+	NR_038977	22824212	22824212	6
chr9	23500688	23672397	LOC101929563	171709	-	NR_121602	23672397	23672397	28
chr9	23690102	23826063	ELAVL2	135961	-	NM_004432	23692554	23762232	7
chr9	24543212	24545674	IZUMO3	2462	-	NM_001271706	24543226	24545647	6
chr9	25676386	25678856	TUSC1	2470	-	NM_001004125	25677680	25678319	1
chr9	25780053	25812966	LINC01241	32913	+	NR_121604	25812966	25812966	6
chr9	26066672	26118406	LOC100506422	51734	+	NM_001004352	26094592	26116853	7
chr9	26840682	26892826	CAAP1	52144	-	NM_001167575	26842298	26887379	6
chr9	26903367	26947468	PLAA	44101	-	NM_001031689	26905508	26947043	14
chr9	26947036	27062931	IFT74	115895	+	NM_001099223	26961965	27062734	20
chr9	26955777	26956305	IFT74-AS1	528	-	NR_121605	26956305	26956305	2
chr9	26993134	27005691	LRRC19	12557	-	NM_022901	26995518	26999692	5
chr9	27109138	27230176	TEK	121038	+	NM_000459	27109588	27229230	23
chr9	27245681	27282791	LINC00032	37110	-	NR_026679	27282791	27282791	17
chr9	27284653	27297137	EQTN	12484	-	NM_020641	27284720	27297053	8
chr9	27325206	27529850	MOB3B	204644	-	NM_024761	27330584	27455548	4
chr9	27524311	27526496	IFNK	2185	+	NM_020124	27524334	27524958	2
chr9	27546543	27573864	C9orf72	27321	-	NM_001256054	27548233	27567118	11
chr9	27948083	29212998	LINGO2	1264915	-	NM_001258282	27948848	27950669	7
chr9	28863623	28863704	MIR876	81	-	NR_030597	28863704	28863704	1
chr9	28888876	28888953	MIR873	77	-	NR_030618	28888953	28888953	1
chr9	30388932	30408452	LINC01242	19520	-	NR_046204	30408452	30408452	3
chr9	32384600	32450832	ACO1	66232	+	NM_001278352	32405504	32450109	22
chr9	32455299	32526322	DDX58	71023	-	NM_014314	32457119	32526164	18
chr9	32540541	32552626	TOPORS	12085	-	NM_005802	32541384	32552434	3
chr9	32552231	32566858	TOPORS-AS1	14627	+	NR_102376	32566858	32566858	3
chr9	32553523	32573182	NDUFB6	19659	-	NM_002493	32553873	32573058	4
chr9	32629451	32635667	TAF1L	6216	-	NM_153809	32630096	32635577	1
chr9	32783496	32789199	TMEM215	5703	+	NM_212558	32784181	32784889	2
chr9	32972603	33001639	APTX	29036	-	NM_175073	32973495	32989889	9
chr9	33025200	33039906	DNAJA1	14706	+	NM_001539	33026482	33038901	9
chr9	33041849	33076714	SMU1	34865	-	NM_018225	33047290	33076606	12
chr9	33110638	33167356	B4GALT1	56718	-	NM_001497	33113451	33167167	6
chr9	33166945	33179981	B4GALT1-AS1	13036	+	NR_108109	33179981	33179981	5
chr9	33240195	33248565	SPINK4	8370	+	NM_014471	33240206	33248469	4
chr9	33252469	33264759	BAG1	12290	-	NM_004323	33255216	33264672	7
chr9	33264876	33282067	CHMP5	17191	+	NM_016410	33265076	33280857	8
chr9	33290417	33371155	NFX1	80738	+	NM_002504	33290570	33369976	24
chr9	33384947	33402517	AQP7	17570	-	NM_001170	33385002	33401260	8
chr9	33441151	33447631	AQP3	6480	-	NM_004925	33442040	33447528	6
chr9	33461350	33473941	NOL6	12591	-	NM_022917	33462661	33473840	26
chr9	33467866	33467933	MIR6851	67	-	NR_106910	33467933	33467933	1
chr9	33504534	33511164	SUGT1P1	6630	-	NR_003667	33511164	33511164	5
chr9	33524410	33573001	ANKRD18B	48591	+	NM_001244752	33524487	33572358	16
chr9	33624222	33625532	ANXA2P2	1310	+	NR_003573	33625532	33625532	1
chr9	33673501	33677418	PTENP1	3917	-	NR_023917	33677418	33677418	1
chr9	33677265	33688008	PTENP1-AS	10743	+	NR_103745	33688008	33688008	4
chr9	33732972	33738414	LINC01251	5442	-	NR_109755	33738414	33738414	2
chr9	33750463	33799229	PRSS3	48766	+	NM_001197097	33794789	33799178	6
chr9	33817181	33920401	UBE2R2	103220	+	NM_017811	33817755	33917235	5
chr9	33921690	34048947	UBAP2	127257	-	NM_018449	33922501	34017146	29
chr9	33934294	33934373	SNORD121B	79	-	NR_102370	33934373	33934373	1
chr9	33952761	33952852	SNORD121A	91	-	NR_003685	33952852	33952852	1
chr9	34086380	34126771	DCAF12	40391	-	NM_015397	34088347	34126429	9
chr9	34179002	34252521	UBAP1	73519	+	NM_001171204	34220912	34251530	8
chr9	34252377	34329198	KIF24	76821	-	NM_194313	34254377	34311344	13
chr9	34329503	34343711	NUDT2	14208	+	NM_001161	34339037	34343438	5
chr9	34366663	34376894	KIAA1161	10231	-	NM_020702	34370796	34372941	2
chr9	34379016	34397849	C9orf24	18833	-	NM_032596	34379643	34397631	7
chr9	34398181	34458568	FAM219A	60387	-	NM_147202	34400961	34458261	6
chr9	34458749	34520987	DNAI1	62238	+	NM_001281428	34459003	34520754	20
chr9	34521039	34523037	ENHO	1998	-	NM_198573	34521462	34521693	2
chr9	34551429	34590138	CNTFR	38709	-	NM_001207011	34552068	34568979	10
chr9	34568009	34583070	CNTFR-AS1	15061	+	NR_024369	34583070	34583070	2
chr9	34610481	34612110	RPP25L	1629	-	NM_148179	34610801	34611293	2
chr9	34613541	34620520	DCTN3	6979	-	NM_001281426	34614075	34620461	7
chr9	34621454	34628011	ARID3C	6557	-	NM_001017363	34621454	34628011	7
chr9	34634718	34637823	SIGMAR1	3105	-	NM_005866	34635628	34637694	4
chr9	34646585	34650595	GALT	4010	+	NM_000155	34646701	34650446	11
chr9	34652181	34661898	IL11RA	9717	+	NM_001142784	34655214	34661495	13
chr9	34661879	34662689	CCL27	810	-	NM_006664	34661940	34662630	3
chr9	34689566	34691274	CCL19	1708	-	NM_006274	34689815	34691136	4
chr9	34709001	34710164	CCL21	1163	-	NM_002989	34709390	34710063	4
chr9	34723049	34729535	FAM205A	6486	-	NM_001141917	34723228	34729424	4
chr9	34830263	34838583	FAM205BP	8320	-	NR_024481	34838583	34838583	4
chr9	34889060	34895775	FAM205C	6715	-	NM_001309427	34889360	34895719	5
chr9	34958191	34982541	PHF24	24350	+	NM_015297	34971295	34978108	8
chr9	34985408	34989376	DNAJB5-AS1	3968	-	NR_109756	34989376	34989376	2
chr9	34989637	34998430	DNAJB5	8793	+	NM_001135004	34989665	34997256	5
chr9	35041091	35045988	C9orf131	4897	+	NM_001040412	35041141	35045866	3
chr9	35056064	35072739	VCP	16675	-	NM_007126	35057113	35072350	17
chr9	35073834	35080013	FANCG	6179	-	NM_004629	35074104	35079521	14
chr9	35088684	35096598	PIGO	7914	-	NM_152850	35089088	35095562	12
chr9	35099772	35103192	STOML2	3420	-	NM_013442	35100031	35103091	10
chr9	35104117	35115969	FAM214B	11852	-	NR_134455	35115969	35115969	10
chr9	35161988	35405332	UNC13B	243344	+	NM_006377	35162280	35404030	39
chr9	35406751	35483026	ATP8B5P	76275	+	NR_003581	35483026	35483026	18
chr9	35489948	35561895	RUSC2	71947	+	NR_052015	35561895	35561895	12
chr9	35561826	35563896	FAM166B	2070	-	NM_001164310	35562003	35563825	6
chr9	35605280	35610038	TESK1	4758	+	NM_006285	35605616	35609739	10
chr9	35608090	35608156	MIR4667	66	+	NR_039813	35608156	35608156	1
chr9	35609975	35618424	CD72	8449	-	NM_001782	35610620	35618300	9
chr9	35649296	35650947	SIT1	1651	-	NM_014450	35649844	35650850	5
chr9	35657747	35658015	RMRP	268	-	NR_003051	35658015	35658015	1
chr9	35658286	35661500	CCDC107	3214	+	NM_001195201	35658376	35660820	6
chr9	35659340	35665278	ARHGEF39	5938	-	NM_032818	35661983	35665166	9
chr9	35673914	35681154	CA9	7240	+	NM_001216	35673956	35681022	11
chr9	35681989	35690053	TPM2	8064	-	NM_213674	35682077	35689814	9
chr9	35697333	35732392	TLN1	35059	-	NM_006289	35697787	35725691	57
chr9	35710672	35710738	MIR6852	66	-	NR_106911	35710738	35710738	1
chr9	35732316	35737005	CREB3	4689	+	NM_006368	35732769	35736723	9
chr9	35732918	35732992	MIR6853	74	+	NR_106912	35732992	35732992	1
chr9	35736862	35749225	GBA2	12363	-	NM_020944	35737165	35748701	17
chr9	35749276	35753264	RGP1	3988	+	NM_001080496	35749752	35752871	9
chr9	35752987	35754274	MSMP	1287	-	NM_001044264	35753096	35754126	3
chr9	35792405	35809728	NPR2	17323	+	NM_003995	35792405	35809442	22
chr9	35807781	35812259	SPAG8	4478	-	NM_172312	35808169	35812144	8
chr9	35812956	35815042	HINT2	2086	-	NM_032593	35813050	35814976	5
chr9	35817013	35828744	FAM221B	11731	-	NR_052026	35828744	35828744	8
chr9	35829221	35854844	TMEM8B	25623	+	NM_001042589	35842435	35853837	14
chr9	35860270	35865515	LINC00950	5245	+	NR_024006	35865515	35865515	1
chr9	35869459	35870398	OR13J1	939	-	NM_001004487	35869459	35870398	1
chr9	35906188	35907138	HRCT1	950	+	NM_001039792	35906284	35906632	1
chr9	35909479	35911617	LINC00961	2138	+	NR_024283	35911617	35911617	2
chr9	35957104	35958151	OR2S2	1047	-	NM_019897	35957135	35958095	1
chr9	36036909	36124452	RECK	87543	+	NM_001316345	36066846	36123042	23
chr9	36136532	36163910	GLIPR2	27378	+	NR_104637	36163910	36163910	7
chr9	36169388	36171331	CCIN	1943	+	NM_005893	36169499	36171266	1
chr9	36190852	36212059	CLTA	21207	+	NM_007096	36191053	36211771	7
chr9	36214438	36277053	GNE	62615	-	NM_001128227	36217361	36276941	12
chr9	36336398	36401195	RNF38	64797	-	NM_194330	36339748	36376037	12
chr9	36572858	36677680	MELK	104822	+	NR_046337	36677680	36677680	18
chr9	36823535	36823596	MIR4475	61	-	NR_039686	36823596	36823596	1
chr9	36833271	37034476	PAX5	201205	-	NR_104000	37034476	37034476	10
chr9	36864250	36864305	MIR4540	55	-	NR_039766	36864305	36864305	1
chr9	36893458	36893528	MIR4476	70	-	NR_039687	36893528	36893528	1
chr9	37079892	37090398	EBLN3	10506	+	NR_036592	37090398	37090398	2
chr9	37120468	37358145	ZCCHC7	237677	+	NM_001289119	37126329	37357265	9
chr9	37422706	37436986	GRHPR	14280	+	NM_012203	37422747	37436779	9
chr9	37438099	37465407	ZBTB5	27308	-	NM_014872	37440514	37442548	2
chr9	37485931	37503694	POLR1E	17763	+	NM_001282766	37489358	37503199	13
chr9	37510888	37576250	FBXO10	65362	-	NM_012166	37512543	37541765	11
chr9	37588411	37592636	TOMM5	4225	-	NM_001001790	37588894	37592529	2
chr9	37651051	37746901	FRMPD1	95850	+	NM_014907	37692638	37746766	16
chr9	37753799	37778969	TRMT10B	25170	+	NM_144964	37761928	37777704	9
chr9	37779710	37785089	EXOSC3	5379	-	NM_016042	37780675	37785041	4
chr9	37800550	37867665	DCAF10	67115	+	NM_001286810	37800624	37861505	7
chr9	37877571	37904350	SLC25A51	26779	-	NR_024872	37904350	37904350	5
chr9	37915894	38069210	SHB	153316	-	NM_003028	37919817	38068642	6
chr9	38392660	38398662	ALDH1B1	6002	+	NM_000692	38395745	38397299	2
chr9	38406524	38424444	IGFBPL1	17920	-	NM_001007563	38411396	38424421	5
chr9	38540563	38545369	FAM95C	4806	-	NR_047651	38545369	38545369	3
chr9	38571360	38620360	ANKRD18A	49000	-	NM_147195	38572041	38620282	16
chr9	38621084	38623277	FAM201A	2193	+	NR_027294	38623277	38623277	2
chr9	39072763	39288300	CNTNAP3	215537	-	NM_033655	39073886	39288061	24
chr9	39355665	39361959	SPATA31A1	6294	+	NM_001085452	39355685	39361806	4
chr9	39443813	39464526	ZNF658B	20713	-	NR_003528	39464526	39464526	5
chr9	40700290	40706537	SPATA31A3	6247	+	NM_001083124	40700319	40706387	4
chr9	40715523	40722679	FAM74A3	7156	+	NR_026801	40722679	40722679	2
chr9	40760699	40789480	ZNF658	28781	-	NR_134255	40789480	40789480	6
chr9	41321106	41327364	SPATA31A5	6258	-	NM_001113541	41321259	41327335	4
chr9	41321109	41327364	SPATA31A7	6255	-	NM_015667	41321259	41327335	4
chr9	41516053	41521999	FAM74A1	5946	+	NR_026803	41521999	41521999	3
chr9	41516053	41521999	FAM74A6	5946	+	NR_110999	41521999	41521999	3
chr9	41948513	41955177	GLIDR	6664	-	NR_126046	41955177	41955177	2
chr9	41958801	42019584	KGFLP2	60783	-	NR_003670	42019584	42019584	3
chr9	42018870	42020413	LOC102724238	1543	+	NR_126048	42020413	42020413	2
chr9	42018874	42020413	LOC554249	1539	+	NR_126049	42020413	42020413	2
chr9	42468588	42474238	FAM95B1	5650	+	NR_026759	42474238	42474238	5
chr9	42493516	42498676	GXYLT1P3	5160	+	NR_121572	42498676	42498676	4
chr9	42718065	42719316	FOXD4L4	1251	+	NM_199244	42718065	42719316	1
chr9	42771707	42782614	LOC101928381	10907	+	NR_121570	42782614	42782614	5
chr9	42844369	42859085	LOC286297	14716	-	NR_046175	42859085	42859085	4
chr9	42858151	42893137	AQP7P3	34986	+	NR_026558	42893137	42893137	4
chr9	43089971	43133510	ANKRD20A3	43539	-	NM_001012419	43091351	43133432	15
chr9	43090424	43133544	ANKRD20A2	43120	-	NM_001012421	43091351	43133432	15
chr9	43140536	43145484	LOC642929	4948	-	NR_027472	43145484	43145484	5
chr9	43608372	43615527	FAM74A7	7155	-	NR_126166	43615527	43615527	2
chr9	43624501	43630730	SPATA31A6	6229	-	NM_001145196	43624654	43630701	4
chr9	43684884	43922473	CNTNAP3B	237589	+	NM_001201380	43685294	43920370	24
chr9	43685195	43921493	CNTNAP3P2	236298	+	NR_111893	43921493	43921493	24
chr9	44181510	44182719	XLOC_007697	1209	-	NR_131213	44182719	44182719	2
chr9	44384584	44391314	LOC101927827	6730	+	NR_121564	44391314	44391314	3
chr9	44401769	44403260	LOC103908605	1491	+	NR_126050	44403260	44403260	2
chr9	44990235	44991492	FAM27C	1257	+	NR_027421	44991492	44991492	2
chr9	45003233	45005290	LOC102723709	2057	-	NR_121606	45005290	45005290	3
chr9	46385603	46387373	FAM27E2	1770	-	NR_103714	46387373	46387373	1
chr9	46687556	46746820	KGFLP1	59264	+	NR_047527	46746820	46746820	4
chr9	46763790	46833319	LINC01189	69529	+	NR_046203	46833319	46833319	5
chr9	65487272	65494386	FAM74A4	7114	-	NR_110998	65494386	65494386	3
chr9	66457288	66469310	LINC01410	12022	+	NR_121647	66469310	66469310	5
chr9	66494268	66503030	PTGER4P2-CDK2AP2P2	8762	+	NR_024496	66503030	66503030	2
chr9	66513679	66553911	LOC403323	40232	-	NR_122076	66553911	66553911	6
chr9	66553199	66555601	LOC728673	2402	+	NR_126047	66555601	66555601	2
chr9	67270214	67289492	AQP7P1	19278	-	NR_002817	67289492	67289492	4
chr9	67784943	67786625	FAM27E3	1682	-	NR_103833	67786625	67786625	2
chr9	67792928	67794189	FAM27B	1261	-	NR_027422	67794189	67794189	2
chr9	67926760	67969840	ANKRD20A1	43080	+	NM_032250	67926872	67968913	15
chr9	68415307	68415388	MIR4477A	81	-	NR_039688	68415388	68415388	1
chr9	68415307	68415388	MIR4477B	81	+	NR_039689	68415388	68415388	1
chr9	68427783	68455368	FRG1JP	27585	-	NR_033907	68455368	68455368	9
chr9	68726540	68748376	FRG1HP	21836	+	NR_034006	68748376	68748376	6
chr9	69002238	69002321	MIR1299	83	-	NR_031629	69002321	69002321	1
chr9	69080243	69147854	PGM5P2	67611	-	NR_002836	69147854	69147854	9
chr9	69174213	69181041	LOC440896	6828	-	NR_015361	69181041	69181041	4
chr9	69199479	69202204	FOXD4L6	2725	-	NM_001085476	69200358	69201612	1
chr9	69204537	69262593	CBWD6	58056	-	NM_001085457	69204962	69262487	15
chr9	69381980	69425109	ANKRD20A4	43129	+	NM_001098805	69382092	69424176	15
chr9	69651360	69664949	LOC100133920	13589	+	NR_024443	69664949	69664949	4
chr9	70175706	70178815	FOXD4L5	3109	-	NM_001126334	70176732	70177983	1
chr9	70432003	70490211	CBWD5	58208	-	NM_001286835	70432428	70457193	17
chr9	70856860	70914951	CBWD3	58091	+	NM_201453	70856947	70914503	15
chr9	70917782	70920000	FOXD4L3	2218	+	NM_199135	70917867	70919121	1
chr9	70970079	70972782	PGM5-AS1	2703	-	NR_121192	70972782	70972782	3
chr9	70971814	71145977	PGM5	174163	+	NM_021965	70972043	71144572	11
chr9	71151497	71155783	TMEM252	4286	-	NM_153237	71152174	71155730	2
chr9	71158456	71161518	LINC01506	3062	-	NR_109769	71161518	71161518	4
chr9	71320329	71624092	PIP5K1B	303763	+	NM_003558	71437530	71623365	16
chr9	71394921	71398795	FAM122A	3874	+	NM_138333	71394954	71395944	1
chr9	71568003	71590757	LOC101927069	22754	-	NR_110647	71590757	71590757	3
chr9	71627448	71629039	PRKACG	1591	-	NM_002732	71627952	71629008	1
chr9	71650478	71715094	FXN	64616	+	NM_001161706	71650698	71714850	5
chr9	71736179	71870124	TJP2	133945	+	NM_001170414	71827472	71869290	22
chr9	71911596	71921972	BANCR	10376	-	NR_047671	71921972	71921972	4
chr9	71939487	72007370	FAM189A2	67883	+	NM_001127608	71951173	72006720	11
chr9	72042448	72287275	APBA1	244827	-	NM_001163	72046242	72132126	13
chr9	72324437	72374876	PTAR1	50439	-	NM_001099666	72333257	72374854	8
chr9	72434320	72435655	C9orf135-AS1	1335	-	NR_038833	72435655	72435655	2
chr9	72435720	72521151	C9orf135	85431	+	NR_131756	72521151	72521151	6
chr9	72658496	72841888	MAMDC2	183392	+	NM_153267	72659113	72840948	14
chr9	72768049	72790804	MAMDC2-AS1	22755	-	NR_040076	72790804	72790804	4
chr9	72830974	72873790	SMC5-AS1	42816	-	NR_039990	72873790	72873790	4
chr9	72873877	72969789	SMC5	95912	+	NM_015110	72873994	72967247	25
chr9	72999512	73029573	KLF9	30061	-	NM_001206	73002691	73028279	2
chr9	73149965	73736514	TRPM3	586549	-	NM_001007471	73150868	73736270	25
chr9	73424890	73425000	MIR204	110	-	NR_029621	73425000	73425000	1
chr9	74298281	74383800	TMEM2	85519	-	NM_013390	74300112	74365289	24
chr9	74477367	74526161	ABHD17B	48794	-	NM_016014	74477496	74489996	5
chr9	74526422	74588371	C9orf85	61949	+	NM_182505	74526650	74587758	4
chr9	74666296	74675521	C9orf57	9225	-	NM_001128618	74667211	74675425	5
chr9	74729510	74867140	GDA	137630	+	NM_001242507	74817496	74863258	14
chr9	74920351	74958126	LINC01504	37775	+	NR_110952	74958126	74958126	5
chr9	74966340	74980163	ZFAND5	13823	-	NM_001102420	74970868	74975694	7
chr9	75136716	75451267	TMC1	314551	+	NM_138691	75263564	75450889	24
chr9	75486644	75489025	LINC01474	2381	-	NR_121181	75489025	75489025	4
chr9	75515577	75568233	ALDH1A1	52656	-	NM_000689	75516123	75567916	13
chr9	75766646	75785310	ANXA1	18664	+	NM_000700	75773451	75785023	13
chr9	76368039	77204569	MIR6130	836530	-	NR_106746	77204569	77204569	8
chr9	76986446	76998446	LOC101927358	12000	+	NR_121182	76998446	76998446	3
chr9	77088350	77113469	RORB-AS1	25119	-	NR_125791	77113469	77113469	5
chr9	77112251	77302117	RORB	189866	+	NM_006914	77112892	77300534	10
chr9	77337410	77503010	TRPM6	165600	-	NM_017662	77339528	77502772	39
chr9	77561498	77567802	C9orf40	6304	-	NM_017998	77562963	77567527	2
chr9	77567880	77612296	C9orf41-AS1	44416	+	NR_121183	77612296	77612296	5
chr9	77597872	77643310	CARNMT1	45438	-	NM_152420	77598682	77643157	8
chr9	77676115	77703133	NMRK1	27018	-	NR_023352	77703133	77703133	10
chr9	77703397	77762114	OSTF1	58717	+	NM_012383	77703608	77761657	10
chr9	78505559	78977255	PCSK5	471696	+	NM_001190482	78506097	78973838	37
chr9	79000432	79009444	RFK	9012	-	NM_018339	79002314	79009087	4
chr9	79013514	79014954	RPSAP9	1440	+	NR_026890	79014954	79014954	1
chr9	79056581	79122332	GCNT1	65751	+	NM_001097634	79117297	79118584	3
chr9	79226291	79521003	PRUNE2	294712	-	NM_015225	79229485	79520879	19
chr9	79379351	79402485	PCA3	23134	+	NR_132312	79402485	79402485	4
chr9	79634570	79635869	FOXB2	1299	+	NM_001013735	79634570	79635869	1
chr9	79791671	79792833	VPS13A-AS1	1162	-	NR_026668	79792833	79792833	2
chr9	79792360	80032399	VPS13A	240039	+	NM_033305	79792620	80030922	72
chr9	80037994	80263232	GNA14	225238	-	NM_004297	80038894	80262709	7
chr9	80062564	80141678	GNA14-AS1	79114	+	NR_121184	80141678	80141678	5
chr9	80331189	80646365	GNAQ	315176	-	NM_002072	80336238	80646151	7
chr9	80850990	80881983	CEP78	30993	+	NM_001098802	80851266	80881678	16
chr9	80911990	80945009	PSAT1	33019	+	NM_058179	80912126	80944002	9
chr9	81750337	81760581	LOC101927450	10244	-	NR_109771	81760581	81760581	5
chr9	82186687	82341796	TLE4	155109	+	NM_001282760	82242336	82340059	21
chr9	82439444	82649470	LINC01507	210026	+	NR_121213	82649470	82649470	3
chr9	84198597	84304450	TLE1	105853	-	NM_005077	84199112	84303155	20
chr9	84304627	84391814	LOC101927502	87187	+	NR_109772	84391814	84391814	4
chr9	84528351	84534842	SPATA31D5P	6491	+	NR_026851	84534842	84534842	4
chr9	84543342	84549913	SPATA31D4	6571	+	NM_001145197	84543428	84547830	4
chr9	84558414	84565009	SPATA31D3	6595	+	NM_207416	84558500	84562922	4
chr9	84603686	84610171	SPATA31D1	6485	+	NM_001001670	84603733	84610116	4
chr9	85594499	85678043	RASEF	83544	-	NM_152573	85597591	85677782	17
chr9	85857904	86153348	FRMD3	295444	-	NM_001244959	85858116	86153146	15
chr9	86237963	86259045	IDNK	21082	+	NR_046422	86259045	86259045	6
chr9	86274877	86323168	UBQLN1	48291	-	NM_013438	86276701	86322594	11
chr9	86354335	86432752	GKAP1	78417	-	NM_025211	86354611	86421432	13
chr9	86451614	86536380	KIF27	84766	-	NM_017576	86451915	86530506	18
chr9	86553226	86571901	C9orf64	18675	-	NM_001317997	86554425	86570469	5
chr9	86582997	86595569	HNRNPK	12572	-	NM_031262	86584264	86593167	17
chr9	86584662	86584772	MIR7-1	110	-	NR_029605	86584772	86584772	1
chr9	86595636	86618987	RMI1	23351	+	NM_024945	86615901	86617779	3
chr9	86678357	86709494	LOC101927575	31137	+	NR_110995	86709494	86709494	9
chr9	86890764	86983413	SLC28A3	92649	-	NM_022127	86893132	86955548	19
chr9	87283372	87641985	NTRK2	358613	+	NM_006180	87285663	87636352	21
chr9	88161453	88356944	AGTPBP1	195491	-	NM_015239	88162023	88327448	26
chr9	88420916	88457794	LOC389765	36878	+	NR_029410	88457794	88457794	9
chr9	88556056	88637217	NAA35	81161	+	NM_024635	88557074	88636875	23
chr9	88641057	88715116	GOLM1	74059	-	NM_177937	88642731	88694235	10
chr9	88742454	88771987	LOC101927623	29533	+	NR_110996	88771987	88771987	5
chr9	88835179	88874572	C9orf153	39393	-	NM_001276367	88836602	88844518	5
chr9	88879462	88897490	ISCA1	18028	-	NM_030940	88880957	88897373	4
chr9	88902647	88969402	ZCCHC6	66755	-	NM_001185059	88903591	88968114	27
chr9	89559276	89562104	GAS1	2828	-	NM_002048	89560656	89561694	1
chr9	89563612	89616948	GAS1RR	53336	+	NR_049794	89616948	89616948	7
chr9	89623365	89657041	LOC440173	33676	-	NR_027471	89657041	89657041	2
chr9	89698800	89700140	LOC494127	1340	-	NR_036691	89700140	89700140	1
chr9	89763558	89774641	C9orf170	11083	+	NM_001001709	89763645	89771685	2
chr9	90112142	90323549	DAPK1	211407	+	NM_001288731	90113992	90322279	26
chr9	90340973	90346384	CTSL	5411	+	NM_145918	90342518	90346022	8
chr9	90387829	90401799	CTSL3P	13970	+	NR_027917	90401799	90401799	5
chr9	90459659	90462339	CTSLP8	2680	+	NR_033405	90462339	90462339	3
chr9	90472957	90473971	LOC392364	1014	-	NR_040117	90473971	90473971	1
chr9	90497771	90503814	SPATA31E1	6043	+	NM_178828	90497806	90503740	4
chr9	90532876	90538572	SPATA31C1	5696	+	NM_001145124	90532905	90538389	4
chr9	90581358	90589695	CDK20	8337	-	NM_001039803	90582376	90589361	8
chr9	90744219	90749900	SPATA31C2	5681	-	NM_001166137	90744546	90749871	4
chr9	91003296	91093622	SPIN1	90326	+	NM_006717	91041454	91090192	6
chr9	91150015	91190704	NXNL2	40689	+	NM_145283	91150349	91186107	3
chr9	91262093	91267075	LOC286238	4982	-	NM_001100111	91262303	91266942	2
chr9	91360750	91360820	MIR4289	70	-	NR_036252	91360820	91360820	1
chr9	91605777	91611057	C9orf47	5280	+	NM_001142413	91605910	91606903	3
chr9	91606323	91620069	S1PR3	13746	+	NM_005226	91616115	91617252	2
chr9	91620685	91793682	SHC3	172997	-	NM_016848	91628361	91793375	12
chr9	91926109	91931618	CKS2	5509	+	NM_001827	91926207	91931340	3
chr9	91927139	91927221	MIR3153	82	+	NR_036108	91927221	91927221	1
chr9	91933387	91974578	SECISBP2	41191	+	NM_024077	91933491	91973739	17
chr9	91975705	92094611	SEMA4D	118906	-	NM_001142287	91977316	92020371	21
chr9	92219926	92221469	GADD45G	1543	+	NM_006705	92220036	92220994	4
chr9	92254697	92334674	UNQ6494	79977	+	NR_024280	92334674	92334674	6
chr9	92731697	92749768	LOC101927847	18071	+	NR_109791	92749768	92749768	3
chr9	92782935	92803781	MIR4290HG	20846	-	NR_038882	92803781	92803781	4
chr9	92785722	92785817	MIR4290	95	-	NR_036253	92785817	92785817	1
chr9	93063177	93195771	LINC01508	132594	-	NR_109795	93195771	93195771	3
chr9	93224713	93345028	LINC01501	120315	-	NR_034157	93345028	93345028	6
chr9	93372113	93405387	DIRAS2	33274	-	NM_017594	93375509	93376109	2
chr9	93563961	93660842	SYK	96881	+	NM_003177	93606180	93657882	14
chr9	93825575	93837414	LOC100129316	11839	-	NR_033912	93837414	93837414	4
chr9	93976096	94124251	AUH	148155	-	NM_001306190	93976629	94124171	9
chr9	94171326	94186908	NFIL3	15582	-	NM_001290000	94171627	94173016	2
chr9	94398532	94398643	MIR3910-1	111	+	NR_037472	94398643	94398643	1
chr9	94398548	94398627	MIR3910-2	79	-	NR_037489	94398627	94398627	1
chr9	94484877	94712444	ROR2	227567	-	NM_004560	94485943	94712245	9
chr9	94793415	94877756	SPTLC1	84341	-	NM_006415	94794746	94877652	15
chr9	94895115	94900911	LOC100128076	5796	+	NR_015444	94900911	94900911	13
chr9	94903748	94921890	LINC00475	18142	+	NR_027341	94921890	94921890	4
chr9	94972489	95056038	IARS	83549	-	NM_002161	94973088	95051701	34
chr9	95054739	95054829	MIR3651	90	-	NR_037424	95054829	95054829	1
chr9	95054742	95054875	SNORA84	133	-	NR_003704	95054875	95054875	1
chr9	95059639	95087876	NOL8	28237	-	NM_001256394	95060117	95084026	18
chr9	95087749	95377437	CENPP	289688	+	NM_001012267	95088280	95375431	8
chr9	95146248	95166937	OGN	20689	-	NM_014057	95147901	95165689	7
chr9	95176526	95186836	OMD	10310	-	NM_005014	95177433	95179840	3
chr9	95218488	95244844	ASPN	26356	-	NM_017680	95219569	95237179	8
chr9	95255828	95298374	ECM2	42546	-	NM_001197296	95256364	95285148	10
chr9	95290265	95290340	MIR4670	75	-	NR_039817	95290340	95290340	1
chr9	95375465	95432547	IPPK	57082	-	NM_022755	95378113	95432270	13
chr9	95380331	95382817	LOC100128361	2486	+	NR_036505	95382817	95382817	1
chr9	95473644	95527083	BICD2	53439	-	NM_015250	95475737	95527026	8
chr9	95571892	95600739	ANKRD19P	28847	+	NR_026868	95600739	95600739	10
chr9	95607312	95640320	ZNF484	33008	-	NM_001261460	95608509	95618507	6
chr9	95644848	95651837	LOC642943	6989	+	NR_111003	95651837	95651837	4
chr9	95709600	95798518	FGD3	88918	+	NM_001083536	95738538	95797871	18
chr9	95770396	95777226	LOC101927954	6830	-	NR_121565	95777226	95777226	3
chr9	95820969	95847418	SUSD3	26449	+	NM_001287005	95831381	95847029	6
chr9	95858404	95875577	CARD19	17173	+	NR_134467	95875577	95875577	7
chr9	95883770	95896570	NINJ1	12800	-	NM_004148	95887189	95896499	4
chr9	95947211	96082854	WNK2	135643	+	NM_006648	95947211	96082674	29
chr9	96080480	96108696	C9orf129	28216	-	NM_001098808	96080679	96098235	5
chr9	96208781	96215874	FAM120AOS	7093	-	NM_198841	96209892	96214991	3
chr9	96213977	96328397	FAM120A	114420	+	NM_001286722	96214197	96326822	18
chr9	96338908	96441869	PHF2	102961	+	NM_005392	96339055	96439958	22
chr9	96581638	96581703	MIR4291	65	+	NR_036254	96581703	96581703	1
chr9	96713908	96717608	BARX1	3700	-	NM_021570	96714445	96717428	4
chr9	96793075	96872138	PTPDC1	79063	+	NM_177995	96827021	96870226	10
chr9	96938238	96938318	MIRLET7A1	80	+	NR_029476	96938318	96938318	1
chr9	96938628	96938715	MIRLET7F1	87	+	NR_029483	96938715	96938715	1
chr9	96938851	96966848	MIRLET7DHG	27997	-	NR_046163	96966848	96966848	4
chr9	96941115	96941202	MIRLET7D	87	+	NR_029481	96941202	96941202	1
chr9	97021547	97064111	ZNF169	42564	+	NM_001301275	97062413	97063652	5
chr9	97080477	97090926	NUTM2F	10449	-	NM_017561	97080746	97090905	7
chr9	97094757	97123230	LOC100132077	28473	+	NR_033937	97123230	97123230	3
chr9	97136832	97223202	MFSD14B	86370	+	NM_032558	97137101	97221694	12
chr9	97317326	97330411	PCAT7	13085	+	NR_121569	97330411	97330411	3
chr9	97320995	97356114	FBP2	35119	-	NM_003837	97321219	97356008	7
chr9	97365420	97402531	FBP1	37111	-	NM_001127628	97365662	97401592	8
chr9	97488950	97849500	C9orf3	360550	+	NM_032823	97522065	97844997	15
chr9	97572243	97572339	MIR2278	96	+	NR_031755	97572339	97572339	1
chr9	97827631	97827728	MIR6081	97	+	NR_106729	97827728	97827728	1
chr9	97847489	97847586	MIR23B	97	+	NR_029664	97847586	97847586	1
chr9	97847726	97847823	MIR27B	97	+	NR_029665	97847823	97847823	1
chr9	97848295	97848376	MIR3074	81	-	NR_036109	97848376	97848376	1
chr9	97848302	97848370	MIR24-1	68	+	NR_029496	97848370	97848370	1
chr9	97861335	98079991	FANCC	218656	-	NM_000136	97863988	98011573	15
chr9	98205263	98279247	PTCH1	73984	-	NM_001083603	98209193	98279102	24
chr9	98225890	98232301	LOC100507346	6411	+	NR_038982	98232301	98232301	4
chr9	98568369	98638259	LINC00476	69890	-	NR_023390	98638259	98638259	3
chr9	98637899	98780735	ERCC6L2	142836	+	NM_020207	98638287	98775485	19
chr9	98782013	98784037	LINC00092	2024	-	NR_024129	98784037	98784037	2
chr9	98828120	98864194	LOC158435	36074	+	NR_033838	98864194	98864194	9
chr9	98868942	98878693	LOC158434	9751	-	NR_132344	98878693	98878693	3
chr9	98997588	99064434	HSD17B3	66846	-	NM_000197	98997741	99064386	11
chr9	99075718	99145992	SLC35D2	70274	-	NR_104627	99145992	99145992	13
chr9	99148224	99180669	ZNF367	32445	-	NM_153695	99150518	99180314	5
chr9	99212436	99253618	HABP4	41182	+	NM_014282	99212561	99252320	8
chr9	99262394	99382112	CDC14B	119718	-	NM_033331	99266034	99381660	14
chr9	99403532	99417599	AAED1	14067	-	NM_153698	99404040	99417563	6
chr9	99488102	99489749	LOC441455	1647	+	NR_026792	99489749	99489749	1
chr9	99516830	99540411	ZNF510	23581	-	NM_014930	99521059	99538351	6
chr9	99579272	99616389	ZNF782	37117	-	NM_001001662	99580204	99614243	6
chr9	99631181	99634510	LOC100132781	3329	+	NR_038890	99634510	99634510	2
chr9	99671356	99672737	LOC441454	1381	+	NR_028350	99672737	99672737	1
chr9	99691285	99704572	NUTM2G	13287	+	NM_001045477	99691306	99701878	7
chr9	99708326	99775862	MFSD14C	67536	-	NR_002894	99775862	99775862	5
chr9	99791958	99801925	CTSV	9967	-	NM_001201575	99795230	99800325	8
chr9	99837952	99844227	GAS2L1P2	6275	-	NR_002942	99844227	99844227	3
chr9	100000707	100059596	LOC100499484	58889	+	NR_036526	100059596	100059596	16
chr9	100000707	100139577	LOC100499484-C9ORF174	138870	+	NR_036528	100139577	100139577	51
chr9	100069909	100139577	CCDC180	69668	+	NM_020893	100070037	100139176	37
chr9	100125835	100125963	MIR1302-8	128	-	NR_031637	100125963	100125963	1
chr9	100153118	100158973	LOC286359	5855	-	NR_026847	100158973	100158973	6
chr9	100174301	100258405	TDRD7	84104	+	NM_014290	100190747	100258165	17
chr9	100263461	100364025	TMOD1	100564	+	NM_001166116	100286470	100361980	10
chr9	100362361	100395962	TSTD2	33601	-	NM_139246	100364750	100389844	10
chr9	100395704	100436029	NCBP1	40325	+	NM_002486	100396163	100433481	23
chr9	100437190	100459691	XPA	22501	-	NR_027302	100459691	100459691	7
chr9	100615536	100618997	FOXE1	3461	+	NM_004473	100616196	100617318	1
chr9	100666770	100684852	TRMO	18082	-	NM_016481	100667014	100684775	5
chr9	100689072	100707197	HEMGN	18125	-	NM_018437	100689665	100700418	5
chr9	100745488	100778224	ANP32B	32736	+	NM_006401	100745837	100777713	7
chr9	100818958	100845365	NANS	26407	+	NM_018946	100819090	100845337	6
chr9	100846634	100881635	TRIM14	35001	-	NM_033219	100849751	100881470	7
chr9	100883256	100954956	CORO2A	71700	-	NM_052820	100887055	100919942	12
chr9	100961279	101018003	TBC1D2	56724	-	NM_018421	100961662	101017823	13
chr9	100991430	100991499	MIR6854	69	-	NR_106913	100991499	100991499	1
chr9	101050363	101471479	GABBR2	421116	-	NM_005458	101052865	101471019	19
chr9	101494290	101558824	ANKS6	64534	-	NM_173551	101498800	101558773	15
chr9	101569980	101612363	GALNT12	42383	+	NM_024642	101569980	101611374	10
chr9	101705994	101833074	COL15A1	127080	+	NM_001855	101706343	101832168	42
chr9	101867370	101916473	TGFBR1	49103	+	NM_004612	101867487	101911587	9
chr9	101978706	101984246	ALG2	5540	-	NR_024532	101984246	101984246	3
chr9	101984569	101992901	SEC61B	8332	+	NM_006808	101984645	101992706	4
chr9	102117621	102137539	NAMA	19918	-	NR_102270	102137539	102137539	10
chr9	102348067	102582171	LOC101928438	234104	-	NR_109802	102582171	102582171	7
chr9	102584136	102629173	NR4A3	45037	+	NM_173200	102589052	102626149	9
chr9	102648599	102668883	STX17-AS1	20284	-	NR_038853	102668883	102668883	3
chr9	102668914	102736818	STX17	67904	+	NM_017919	102677521	102730955	8
chr9	102741462	102861334	ERP44	119872	-	NM_015051	102744893	102861122	12
chr9	102861501	103063426	INVS	201925	+	NM_183245	102866803	103062956	18
chr9	103064356	103115259	TEX10	50903	-	NM_017746	103064472	103111645	15
chr9	103189494	103214016	MSANTD3	24522	+	NM_001198807	103204220	103207512	4
chr9	103204187	103339918	MSANTD3-TMEFF1	135731	+	NM_001198812	103204220	103338882	10
chr9	103235519	103339918	TMEFF1	104399	+	NM_003692	103235826	103338882	10
chr9	103340360	103350669	MURC	10309	+	NM_001018116	103340425	103348733	2
chr9	103791030	104087417	PLPPR1	296387	+	NM_207299	103947776	104086339	8
chr9	104122698	104147287	BAAT	24589	-	NM_001701	104124709	104133686	4
chr9	104152248	104160919	MRPL50	8671	-	NM_019051	104152747	104160874	2
chr9	104161135	104172942	ZNF189	11807	+	NM_001278240	104161438	104170229	4
chr9	104182841	104198062	ALDOB	15221	-	NM_000035	104184090	104193169	9
chr9	104230720	104243788	TMEM246-AS1	13068	+	NR_121573	104243788	104243788	4
chr9	104235439	104249503	TMEM246	14064	-	NM_001303107	104238162	104239374	3
chr9	104296130	104325626	RNF20	29496	+	NM_019592	104297705	104324704	20
chr9	104331633	104500862	GRIN3A	169229	-	NM_133445	104335455	104500261	9
chr9	104353896	104357283	PPP3R2	3387	-	NM_147180	104356690	104357212	1
chr9	105281918	105419791	LINC00587	137873	+	NR_103830	105419791	105419791	5
chr9	105757592	105780770	CYLC2	23178	+	NM_001340	105757662	105767960	8
chr9	105902809	106087315	LINC01492	184506	-	NR_121578	106087315	106087315	10
chr9	106761989	106762763	LOC101928523	774	+	NR_109803	106762763	106762763	2
chr9	106842304	106854755	SMC2-AS1	12451	-	NR_121580	106854755	106854755	3
chr9	106856540	106903700	SMC2	47160	+	NM_006444	106857665	106901596	25
chr9	107266543	107267503	OR13F1	960	+	NM_001004485	107266543	107267503	1
chr9	107288533	107289490	OR13C4	957	-	NM_001001919	107288533	107289490	1
chr9	107298050	107299094	OR13C3	1044	-	NM_001001961	107298050	107299094	1
chr9	107331448	107332411	OR13C8	963	+	NM_001004483	107331448	107332411	1
chr9	107360737	107361694	OR13C5	957	-	NM_001004482	107360737	107361694	1
chr9	107366951	107367908	OR13C2	957	-	NM_001004481	107366951	107367908	1
chr9	107379528	107380485	OR13C9	957	-	NM_001001956	107379528	107380485	1
chr9	107456702	107457743	OR13D1	1041	+	NM_001004484	107456702	107457743	1
chr9	107509968	107522403	NIPSNAP3A	12435	+	NM_015469	107510073	107521619	6
chr9	107526021	107540045	NIPSNAP3B	14024	+	NM_018376	107526521	107535354	6
chr9	107543283	107690527	ABCA1	147244	-	NM_005502	107546595	107665960	50
chr9	108006893	108159628	SLC44A1	152735	+	NM_001286730	108007149	108152193	16
chr9	108210314	108314714	FSD1L	104400	+	NM_001145313	108210501	108308764	14
chr9	108320410	108403399	FKTN	82989	+	NM_001198963	108337313	108402404	12
chr9	108424737	108425385	TAL2	648	+	NM_005421	108424777	108425104	1
chr9	108456805	108538892	TMEM38B	82087	+	NM_018112	108456941	108536361	6
chr9	109363208	109363303	MIR8081	95	+	NR_107048	109363303	109363303	1
chr9	109378338	109442081	LINC01505	63743	+	NR_104145	109442081	109442081	7
chr9	109625377	109773796	ZNF462	148419	+	NM_021224	109685664	109773311	13
chr9	109653504	109848716	MIR548Q	195212	-	NR_031752	109848716	109848716	4
chr9	109737113	109865269	LOC340512	128156	-	NR_126029	109865269	109865269	5
chr9	110045516	110094475	RAD23B	48959	+	NM_002874	110045910	110091937	10
chr9	110182564	110228866	LINC01509	46302	-	NR_121581	110228866	110228866	8
chr9	110247132	110252001	KLF4	4869	-	NM_004235	110248031	110251453	5
chr9	111616868	111618275	ACTL7B	1407	-	NM_006686	111616962	111618210	1
chr9	111624507	111626035	ACTL7A	1528	+	NM_006687	111624602	111625910	1
chr9	111629799	111696608	IKBKAP	66809	-	NM_003640	111631394	111693426	37
chr9	111696672	111703237	FAM206A	6565	+	NM_017832	111696766	111701966	6
chr9	111704848	111775874	CTNNAL1	71026	-	NM_003798	111705048	111775722	19
chr9	111777414	111882225	TMEM245	104811	-	NM_032012	111782739	111882193	18
chr9	111808508	111808578	MIR32	70	-	NR_029506	111808578	111808578	1
chr9	111899580	111929571	FRRS1L	29991	-	NM_014334	111899734	111929571	5
chr9	111934253	112083244	EPB41L4B	148991	-	NM_019114	111936833	112082726	26
chr9	112137973	112260593	PTPN3	122620	-	NM_002829	112141835	112225714	26
chr9	112273754	112273825	MIR3927	71	-	NR_037493	112273825	112273825	1
chr9	112403067	112713756	PALM2	310689	+	NM_001037293	112403141	112705705	7
chr9	112542576	112934791	PALM2-AKAP2	392215	+	NM_007203	112542768	112930777	11
chr9	112810877	112934791	AKAP2	123914	+	NM_001198656	112810979	112930777	5
chr9	112961845	112970413	C9orf152	8568	-	NM_001012993	112963227	112969859	2
chr9	113006091	113018920	TXN	12829	-	NM_003329	113006436	113018715	5
chr9	113065866	113100164	TXNDC8	34298	-	NM_001003936	113065961	113100076	6
chr9	113127528	113342160	SVEP1	214632	-	NM_153366	113128818	113341823	48
chr9	113431050	113563278	MUSK	132228	+	NM_005592	113431184	113563268	14
chr9	113636053	113800365	LPAR1	164312	-	NM_057159	113637700	113734397	5
chr9	114033435	114033494	MIR7702	59	-	NR_106989	114033494	114033494	1
chr9	114089762	114090713	OR2K2	951	-	NM_205859	114089762	114090713	1
chr9	114122972	114247025	KIAA0368	124053	-	NM_001080398	114124309	114247025	51
chr9	114287438	114340124	ZNF483	52686	+	NM_001007169	114289675	114338694	6
chr9	114312001	114362135	PTGR1	50134	-	NM_001146109	114312052	114359702	10
chr9	114365110	114375833	LRRC37A5P	10723	-	NR_034087	114375833	114375833	3
chr9	114393631	114416631	DNAJC25	23000	+	NR_037148	114416631	114416631	5
chr9	114393631	114432526	DNAJC25-GNG10	38895	+	NM_004125	114393687	114429220	3
chr9	114423850	114432526	GNG10	8676	+	NM_001198664	114423914	114429220	3
chr9	114448798	114557288	C9orf84	108490	-	NR_109816	114557288	114557288	27
chr9	114659045	114697654	UGCG	38609	+	NM_003358	114659495	114695277	9
chr9	114694379	114694449	MIR4668	70	+	NR_039814	114694449	114694449	1
chr9	114758831	115112545	MIR3134	353714	-	NR_036085	115112545	115112545	4
chr9	114803060	114937577	SUSD1	134517	-	NM_001282640	114804180	114937515	18
chr9	114979994	115095944	PTBP3	115950	-	NM_001163790	114986130	115095757	15
chr9	115142188	115234685	HSDL2	92497	+	NM_032303	115142443	115232824	11
chr9	115249247	115427591	KIAA1958	178344	+	NM_001287036	115336360	115422349	5
chr9	115448790	115480387	INIP	31597	-	NM_021218	115449817	115478765	5
chr9	115513133	115637267	SNX30	124134	+	NM_001012994	115513281	115631123	9
chr9	115641199	115653193	SLC46A2	11994	-	NM_033051	115642041	115652961	4
chr9	115759399	115774472	ZNF883	15073	-	NM_001101338	115759399	115760539	5
chr9	115804094	115819071	ZFP37	14977	-	NM_001282518	115805004	115818968	4
chr9	115867002	115873957	FAM225B	6955	-	NR_024376	115873957	115873957	3
chr9	115875175	115882126	FAM225A	6951	+	NR_024366	115882126	115882126	3
chr9	115913237	115926422	SLC31A2	13185	+	NM_001860	115913354	115925197	4
chr9	115927799	115983641	FKBP15	55842	-	NM_015258	115928357	115983523	28
chr9	115983807	116026772	SLC31A1	42965	+	NM_001859	116018428	116022753	5
chr9	116029289	116037869	CDC26	8580	-	NM_139286	116029542	116034787	4
chr9	116037913	116055185	PRPF4	17272	+	NM_004697	116038023	116053940	14
chr9	116059372	116061320	RNF183	1948	-	NM_145051	116059885	116060464	2
chr9	116077930	116102620	WDR31	24690	-	NM_001012361	116079028	116094302	11
chr9	116111811	116133513	BSPRY	21702	+	NM_017688	116111859	116132422	6
chr9	116135695	116139289	HDHD3	3594	-	NM_001304509	116135878	116136634	3
chr9	116148591	116163618	ALAD	15027	-	NM_000031	116150579	116155839	12
chr9	116169517	116173029	POLE3	3512	-	NM_017443	116171090	116172573	5
chr9	116172923	116191964	C9orf43	19041	+	NM_001278629	116175773	116191666	14
chr9	116207008	116360023	RGS3	153015	+	NM_144488	116222536	116359233	26
chr9	116638561	116818875	ZNF618	180314	+	NM_133374	116638660	116812447	14
chr9	116822407	116840752	AMBP	18345	-	NM_001633	116822518	116840489	10
chr9	116853917	116861337	KIF12	7420	-	NM_138424	116854140	116859982	16
chr9	116917824	117074796	COL27A1	156972	+	NM_032888	116918230	117072975	61
chr9	116971713	116971809	MIR455	96	+	NR_030255	116971809	116971809	1
chr9	117085302	117088759	ORM1	3457	+	NM_000607	117085413	117088637	6
chr9	117092068	117095536	ORM2	3468	+	NM_000608	117092184	117095414	6
chr9	117098406	117156685	AKNA	58279	-	NM_030767	117099333	117143613	22
chr9	117164359	117267736	DFNB31	103377	-	NM_001173425	117165033	117267081	12
chr9	117349993	117361152	ATP6V1G1	11159	+	NM_004888	117350118	117360023	3
chr9	117373705	117408703	C9orf91	34998	+	NM_153045	117379475	117405593	9
chr9	117428713	117444369	LOC100505478	15656	-	NM_001199233	117428922	117434003	5
chr9	117546914	117568408	TNFSF15	21494	-	NM_005118	117552731	117568292	4
chr9	117655622	117692875	TNFSF8	37253	-	NM_001252290	117656358	117692583	5
chr9	117781853	117880536	TNC	98683	-	NM_002160	117783435	117853297	28
chr9	117881818	117900688	LOC101928748	18870	-	NR_110950	117900688	117900688	6
chr9	117904096	118164923	DEC1	260827	+	NM_017418	118138981	118164404	8
chr9	118501948	118506518	LOC101928775	4570	-	NR_109805	118506518	118506518	3
chr9	118650543	118687377	LINC00474	36834	-	NR_024032	118687377	118687377	3
chr9	118916070	119164600	PAPPA	248530	+	NM_002581	118916451	119158895	22
chr9	119160436	119162885	PAPPA-AS1	2449	-	NR_103711	119162885	119162885	1
chr9	119187503	120177317	ASTN2	989814	-	NM_014010	119188129	120177216	22
chr9	119266561	119324572	ASTN2-AS1	58011	+	NR_033973	119324572	119324572	12
chr9	119449580	119463579	TRIM32	13999	+	NM_001099679	119460021	119461983	2
chr9	119943344	119943480	SNORA70C	136	-	NR_003708	119943480	119943480	1
chr9	120410883	120419304	LOC101928797	8421	+	NR_109806	120419304	120419304	6
chr9	120466452	120479769	TLR4	13317	+	NM_003266	120470867	120476926	4
chr9	121928907	122131739	BRINP1	202832	-	NM_014618	121929361	122075633	8
chr9	122697337	122700110	LINC01613	2773	+	NR_132393	122700110	122700110	1
chr9	123007256	123007328	MIR147A	72	-	NR_029604	123007328	123007328	1
chr9	123151146	123342448	CDK5RAP2	191302	-	NR_073556	123342448	123342448	39
chr9	123363195	123476765	MEGF9	113570	-	NM_001080497	123367467	123476636	6
chr9	123519253	123555740	FBXW2	36487	-	NM_012164	123526836	123550536	8
chr9	123555774	123561009	LOC100288842	5235	+	NR_027442	123561009	123561009	2
chr9	123578331	123605299	PSMD5	26968	-	NM_005047	123580183	123605187	10
chr9	123605319	123616651	PSMD5-AS1	11332	+	NR_024408	123616651	123616651	4
chr9	123617928	123657174	PHF19	39246	-	NM_001286840	123620221	123657107	15
chr9	123664670	123691451	TRAF1	26781	-	NM_001190945	123667297	123688353	9
chr9	123714613	123837452	C5	122839	-	NM_001317163	123715016	123837114	41
chr9	123850573	123939886	CNTRL	89313	+	NM_007018	123850604	123939464	42
chr9	123940414	123964365	RAB14	23951	-	NM_016322	123943673	123955690	8
chr9	124030379	124095120	GSN	64741	+	NM_001127666	124062380	124094881	19
chr9	124043045	124047808	GSN-AS1	4763	-	NR_103560	124047808	124047808	1
chr9	124101265	124132582	STOM	31317	-	NR_073037	124132582	124132582	8
chr9	124217318	124262306	GGTA1P	44988	-	NR_003191	124262306	124262306	7
chr9	124329380	124547809	DAB2IP	218429	+	NM_032552	124329467	124545824	17
chr9	124584203	124855885	TTLL11	271682	-	NM_001139442	124584865	124855697	9
chr9	124882360	124882446	MIR4478	86	-	NR_039690	124882446	124882446	1
chr9	124906337	124922098	NDUFA8	15761	-	NM_014222	124906519	124921956	4
chr9	124922186	124962367	MORN5	40181	+	NM_198469	124922251	124962210	5
chr9	124964855	124991091	LHX6	26236	-	NM_014368	124967038	124991019	10
chr9	125001833	125027143	RBM18	25310	-	NR_027126	125027143	125027143	7
chr9	125026881	125085742	MRRF	58861	+	NM_138777	125033170	125084896	7
chr9	125132808	125157982	PTGS1	25174	+	NM_001271368	125134094	125154823	12
chr9	125239236	125240205	OR1J1	969	-	NM_001004451	125239236	125240205	1
chr9	125273080	125274022	OR1J2	942	+	NM_054107	125273080	125274022	1
chr9	125281419	125282361	OR1J4	942	+	NM_001004452	125281419	125282361	1
chr9	125288636	125289572	OR1N1	936	-	NM_012363	125288636	125289572	1
chr9	125315448	125316441	OR1N2	993	+	NM_001004457	125315448	125316441	1
chr9	125329826	125330756	OR1L8	930	-	NM_001004454	125329826	125330756	1
chr9	125377016	125377961	OR1Q1	945	+	NM_012364	125377016	125377961	1
chr9	125390857	125391814	OR1B1	957	-	NM_001004450	125390857	125391814	1
chr9	125423994	125424927	OR1L1	933	+	NM_001005236	125423994	125424927	1
chr9	125437408	125438383	OR1L3	975	+	NM_001005234	125437408	125438383	1
chr9	125486268	125487204	OR1L4	936	+	NM_001005235	125486268	125487204	1
chr9	125512126	125513062	OR1L6	936	+	NM_001004453	125512126	125513062	1
chr9	125551211	125552174	OR5C1	963	+	NM_001001923	125551211	125552174	1
chr9	125562401	125563352	OR1K1	951	+	NM_080859	125562401	125563352	1
chr9	125580375	125590935	PDCL	10560	-	NM_005388	125582363	125589066	4
chr9	125611731	125667562	RC3H2	55831	-	NM_001100588	125611905	125659788	21
chr9	125642491	125642598	SNORD90	107	-	NR_003071	125642598	125642598	1
chr9	125670334	125675607	ZBTB6	5273	-	NM_006626	125673076	125674351	2
chr9	125680307	125693830	ZBTB26	13523	-	NM_020924	125680887	125682213	2
chr9	125703287	125867147	RABGAP1	163860	+	NM_012197	125719338	125865492	26
chr9	125795921	125797944	GPR21	2023	+	NM_005294	125796845	125797895	2
chr9	125871772	125877756	MIR600HG	5984	-	NR_026677	125877756	125877756	1
chr9	125873824	125873922	MIR600	98	-	NR_030331	125873922	125873922	1
chr9	125883907	126030855	STRBP	146948	-	NM_001171137	125887875	125941467	19
chr9	126118445	126141034	CRB2	22589	+	NM_173689	126118539	126139341	13
chr9	126141932	126692417	DENND1A	550485	-	NM_020946	126143710	126692184	22
chr9	126164803	126164882	MIR601	79	-	NR_030332	126164882	126164882	1
chr9	126247807	126247901	MIR7150	94	-	NR_106972	126247901	126247901	1
chr9	126773888	126795442	LHX2	21554	+	NM_004789	126774627	126794986	5
chr9	127019884	127114719	NEK6	94835	+	NM_001166167	127019975	127113226	10
chr9	127115743	127177752	PSMB7	62009	-	NM_002799	127115876	127177704	8
chr9	127115751	127121463	LOC100129034	5712	+	NR_027406	127121463	127121463	1
chr9	127243514	127269699	NR5A1	26185	-	NM_004959	127245036	127265674	7
chr9	127279553	127533589	NR6A1	254036	-	NM_033334	127284983	127533398	10
chr9	127420714	127460907	MIR181A2HG	40193	+	NR_038975	127460907	127460907	2
chr9	127454720	127454830	MIR181A2	110	+	NR_029611	127454830	127454830	1
chr9	127455988	127456077	MIR181B2	89	+	NR_029782	127456077	127456077	1
chr9	127539436	127577170	OLFML2A	37734	+	NM_182487	127539549	127572691	8
chr9	127615695	127620170	WDR38	4475	+	NM_001276374	127615810	127619909	9
chr9	127620157	127624240	RPL35	4083	-	NM_007209	127620196	127624191	4
chr9	127624396	127640012	ARPC5L	15616	+	NM_030978	127631569	127639219	6
chr9	127640572	127703386	GOLGA1	62814	-	NM_002077	127642808	127700990	23
chr9	127704887	127905838	SCAI	200951	-	NM_173690	127715085	127905716	19
chr9	127908851	127952218	PPP6C	43367	-	NM_001123355	127911951	127951997	8
chr9	127962820	127996438	RABEPK	33618	+	NM_001174152	127965292	127996259	9
chr9	127997126	128003666	HSPA5	6540	-	NM_005347	127998870	128003405	8
chr9	128024072	128127290	GAPVD1	103218	+	NM_001282680	128061200	128125025	28
chr9	128199672	128469513	MAPKAP1	269841	-	NM_001006617	128201165	128434853	12
chr9	128506033	128508208	LOC51145	2175	-	NR_122032	128508208	128508208	2
chr9	128509616	128729655	PBX3	220039	+	NM_006195	128509732	128728202	9
chr9	129032402	129038194	LOC101929116	5792	-	NR_121584	129038194	129038194	3
chr9	129089122	129269320	MVB12B	180198	+	NM_033446	129089208	129265542	10
chr9	129170053	129172783	NRON	2730	-	NR_045006	129172783	129172783	1
chr9	129376721	129463311	LMX1B	86590	+	NM_001174147	129376728	129458730	8
chr9	129567284	129600487	ZBTB43	33203	+	NM_014007	129594788	129596192	3
chr9	129622943	129648156	ZBTB34	25213	+	NM_001099270	129641690	129643193	2
chr9	129677052	129985445	RALGPS1	308393	+	NM_014636	129724568	129981048	19
chr9	129849627	129885044	ANGPTL2	35417	-	NM_012098	129851217	129871010	5
chr9	130025940	130155828	GARNL3	129888	+	NM_001286779	130026270	130155533	29
chr9	130159416	130170170	SLC2A8	10754	+	NM_014580	130159509	130169528	10
chr9	130186652	130207651	ZNF79	20999	+	NM_001286697	130191166	130207476	6
chr9	130209952	130213711	RPL12	3759	-	NM_000976	130209999	130213596	7
chr9	130210780	130210916	SNORA65	136	-	NR_002449	130210916	130210916	1
chr9	130213764	130265780	LRSAM1	52016	+	NM_001005373	130216806	130265178	26
chr9	130267616	130341286	FAM129B	73670	-	NM_001035534	130269123	130341216	14
chr9	130374485	130454995	STXBP1	80510	+	NM_003165	130374682	130446756	20
chr9	130452965	130453074	MIR3911	109	-	NR_037473	130453074	130453074	1
chr9	130469270	130476303	CFAP157	7033	+	NM_001012502	130469310	130476184	9
chr9	130476226	130477936	PTRH1	1710	-	NM_001002913	130476378	130477918	5
chr9	130478342	130493879	TTC16	15537	+	NM_001317037	130478424	130493684	14
chr9	130493802	130497628	TOR2A	3826	-	NM_001085347	130494312	130497549	5
chr9	130500595	130541048	SH2D3C	40453	-	NM_170600	130501024	130540906	12
chr9	130548111	130548202	MIR3960	91	+	NR_039767	130548202	130548202	1
chr9	130548196	130548286	MIR2861	90	+	NR_036055	130548286	130548286	1
chr9	130548304	130553052	CDK9	4748	+	NM_001261	130548427	130551822	7
chr9	130565136	130576360	FPGS	11224	+	NM_004957	130565203	130575883	15
chr9	130577290	130617052	ENG	39762	-	NM_001114753	130577960	130616634	15
chr9	130628758	130640022	AK1	11264	-	NM_000476	130630286	130636896	7
chr9	130631693	130631774	MIR4672	81	-	NR_039819	130631774	130631774	1
chr9	130647599	130667627	ST6GALNAC6	20028	-	NR_104629	130667627	130667627	6
chr9	130670164	130679305	ST6GALNAC4	9141	-	NM_175039	130670670	130678698	6
chr9	130683807	130693076	PIP5KL1	9269	-	NM_001135219	130684125	130693031	10
chr9	130697373	130700763	DPM2	3390	-	NM_003863	130698000	130700099	4
chr9	130702860	130742812	FAM102A	39952	-	NM_001035254	130705470	130742416	11
chr9	130823511	130829599	NAIF1	6088	-	NM_197956	130825706	130829380	2
chr9	130830478	130871537	SLC25A25	41059	+	NM_001006641	130830598	130869723	10
chr9	130873449	130881013	SLC25A25-AS1	7564	-	NR_033374	130881013	130881013	5
chr9	130882971	130890741	PTGES2	7770	-	NM_198938	130883423	130886093	8
chr9	130890807	130892913	PTGES2-AS1	2106	+	NR_024425	130892913	130892913	1
chr9	130911708	130915734	LCN2	4026	+	NM_005564	130911804	130915398	7
chr9	130922538	130926207	C9orf16	3669	+	NM_024112	130922686	130925894	2
chr9	130928343	130966662	CIZ1	38319	-	NM_001131015	130928475	130953136	18
chr9	130965633	131017527	DNM1	51894	+	NM_001288737	130965749	131015401	22
chr9	131006999	131007109	MIR199B	110	-	NR_029619	131007109	131007109	1
chr9	131007225	131007309	MIR3154	84	-	NR_036110	131007309	131007309	1
chr9	131018107	131038268	GOLGA2	20161	-	NM_004486	131019345	131038255	26
chr9	131038424	131051268	SWI5	12844	+	NM_001040011	131038424	131050995	5
chr9	131071395	131084697	TRUB2	13302	-	NM_015679	131071828	131084687	8
chr9	131084786	131096351	COQ4	11565	+	NM_016035	131085137	131095924	7
chr9	131102838	131123749	SLC27A4	20911	+	NM_005094	131105411	131122770	13
chr9	131114325	131424415	MIR1268A	310090	+	NR_031672	131424415	131424415	3
chr9	131133597	131154295	URM1	20698	+	NR_049743	131154295	131154295	5
chr9	131154896	131154993	MIR219A2	97	-	NR_029837	131154993	131154993	1
chr9	131154899	131154987	MIR219B	88	+	NR_039815	131154987	131154987	1
chr9	131181438	131199630	CERCAM	18192	+	NM_001286760	131185183	131198184	13
chr9	131218284	131263571	ODF2	45287	+	NM_002540	131222837	131262534	23
chr9	131266970	131304580	GLE1	37610	+	NM_001003722	131267084	131303449	16
chr9	131314836	131395944	SPTAN1	81108	+	NM_001130438	131329019	131395613	57
chr9	131395939	131419129	WDR34	23190	-	NM_052844	131396022	131419005	9
chr9	131445933	131458675	SET	12742	+	NM_001122821	131446174	131456943	8
chr9	131464782	131483199	PKN3	18417	+	NM_001317926	131465194	131482761	22
chr9	131483148	131486408	ZDHHC12	3260	-	NM_032799	131483459	131486372	5
chr9	131486740	131495522	LOC100506100	8782	+	NR_046240	131495522	131495522	2
chr9	131492066	131534213	ZER1	42147	-	NM_006336	131493615	131517844	16
chr9	131549485	131572711	TBC1D13	23226	+	NM_018201	131549632	131570158	12
chr9	131580778	131584955	ENDOG	4177	+	NM_004435	131580963	131584889	3
chr9	131581929	131592100	C9orf114	10171	-	NM_016390	131585043	131592059	12
chr9	131595220	131644354	CCBL1	49134	-	NM_001287390	131595862	131609807	15
chr9	131644390	131680317	LRRC8A	35927	+	NM_019594	131669443	131678650	4
chr9	131683173	131704320	PHYHD1	21147	+	NM_001100876	131684602	131703992	13
chr9	131707808	131710012	DOLK	2204	-	NM_014908	131707965	131709582	1
chr9	131709971	131769375	NUP188	59404	+	NM_015354	131709998	131768957	44
chr9	131770071	131790632	SH3GLB2	20561	-	NM_001287045	131770962	131790433	13
chr9	131799252	131834351	FAM73B	35099	+	NM_032809	131802873	131832732	16
chr9	131843382	131852717	DOLPP1	9335	+	NM_020438	131843410	131851286	8
chr9	131857072	131873070	CRAT	15998	-	NM_001257363	131857675	131870320	15
chr9	131873227	131911225	PPP2R4	37998	+	NM_021131	131873879	131909743	11
chr9	131937830	131940540	IER5L	2710	-	NM_203434	131939116	131940331	1
chr9	132044694	132047998	LOC101929331	3304	+	NR_121587	132047998	132047998	3
chr9	132083294	132084882	C9orf106	1588	+	NM_001012715	132084092	132084791	2
chr9	132099201	132109756	LINC01503	10555	+	NR_120686	132109756	132109756	4
chr9	132250938	132275965	LINC00963	25027	+	NR_038955	132275965	132275965	5
chr9	132371162	132398410	NTMT1	27248	+	NM_001286796	132394982	132397743	4
chr9	132374503	132383055	C9orf50	8552	-	NM_199350	132374625	132382853	7
chr9	132396882	132404448	ASB6	7566	-	NM_017873	132400068	132404278	6
chr9	132427919	132484951	PRRX2	57032	+	NM_016307	132428146	132484631	4
chr9	132475172	132480985	PRRX2-AS1	5813	-	NR_132102	132480985	132480985	2
chr9	132500614	132515344	PTGES	14730	-	NM_004878	132501889	132515291	3
chr9	132565421	132573568	TOR1B	8147	+	NM_014506	132565491	132571862	5
chr9	132575220	132586441	TOR1A	11221	-	NM_000113	132576250	132586364	5
chr9	132589563	132597572	C9orf78	8009	-	NM_016520	132590439	132597500	9
chr9	132597695	132644117	USP20	46422	+	NM_001110303	132614834	132642552	26
chr9	132631883	132631950	MIR6855	67	+	NR_106914	132631950	132631950	1
chr9	132649465	132805473	FNBP1	156008	-	NM_015033	132652817	132805254	17
chr9	132815984	132902448	GPR107	86464	+	NM_001136557	132816211	132897400	20
chr9	132934856	132999583	NCS1	64727	+	NM_014286	132934942	132988766	8
chr9	133028157	133309510	HMCN2	281353	+	NM_001291815	133028157	133309080	87
chr9	133320093	133376661	ASS1	56568	+	NM_000050	133327615	133376408	16
chr9	133452736	133454881	LOC100272217	2145	-	NR_027440	133454881	133454881	1
chr9	133454959	133513739	FUBP3	58780	+	NM_003934	133455067	133512409	19
chr9	133501683	133501750	MIR6856	67	+	NR_106915	133501750	133501750	1
chr9	133539980	133558384	PRDM12	18404	+	NM_021619	133540040	133557056	5
chr9	133569146	133580281	EXOSC2	11135	+	NM_014285	133569178	133579161	9
chr9	133589267	133763062	ABL1	173795	+	NM_007313	133589706	133761070	11
chr9	133768814	133772199	QRFP	3385	-	NM_198180	133768814	133769225	3
chr9	133777824	133814455	FIBCD1	36631	-	NM_001145106	133779450	133813994	8
chr9	133884503	133968446	LAMC3	83943	+	NM_006059	133884601	133967174	28
chr9	133971862	133998539	AIF1L	26677	+	NM_001185095	133972016	133995709	7
chr9	134000947	134110057	NUP214	109110	+	NM_005085	134001091	134108874	36
chr9	134133464	134151906	FAM78A	18442	-	NM_033387	134136208	134151566	2
chr9	134165080	134184649	PLPP7	19569	+	NM_032728	134165384	134183674	2
chr9	134305476	134375575	PRRC2B	70099	+	NM_013318	134305531	134371261	31
chr9	134361051	134361137	SNORD62A	86	+	NR_002914	134361137	134361137	1
chr9	134361051	134361137	SNORD62B	86	+	NR_003050	134361137	134361137	1
chr9	134378288	134399193	POMT1	20905	+	NM_001077365	134379605	134398493	20
chr9	134399182	134406662	UCK1	7480	-	NM_031432	134400426	134406561	7
chr9	134452156	134615331	RAPGEF1	163175	-	NM_001304275	134454883	134615217	24
chr9	134735496	134955274	MED27	219778	-	NM_004269	134735924	134955231	8
chr9	135037333	135118220	NTNG2	80887	+	NM_032536	135042218	135117498	8
chr9	135136826	135230372	SETX	93546	-	NM_015046	135139625	135224815	26
chr9	135250936	135282238	TTF1	31302	-	NM_007344	135251301	135278208	11
chr9	135285582	135448706	CFAP77	163124	+	NM_207417	135285658	135447897	7
chr9	135457992	135465640	BARHL1	7648	+	NM_020064	135458184	135464909	3
chr9	135469675	135545788	DDX31	76113	-	NM_022779	135470252	135545636	20
chr9	135545421	135570342	GTF3C4	24921	+	NR_133925	135570342	135570342	6
chr9	135600964	135754198	AK8	153234	-	NM_001317959	135601074	135702733	15
chr9	135753706	135765419	C9orf9	11713	+	NM_001316898	135759334	135763998	4
chr9	135766734	135820020	TSC1	53286	-	NM_001162426	135771621	135804259	23
chr9	135820931	135867074	GFI1B	46143	+	NM_004188	135862065	135866437	11
chr9	135821093	135821158	MIR548AW	65	+	NR_049862	135821158	135821158	1
chr9	135906061	135933890	GTF3C5	27829	+	NM_001122823	135906398	135933367	12
chr9	135927382	135927446	MIR6877	64	+	NR_106937	135927446	135927446	1
chr9	135937364	135947250	CEL	9886	+	NM_001807	135937380	135947151	11
chr9	135957925	135962478	CELP	4553	+	NR_001275	135962478	135962478	5
chr9	135973106	136024607	RALGDS	51501	-	NM_001042368	135973973	136024367	18
chr9	136028334	136039332	GBGT1	10998	-	NM_021996	136028963	136037799	7
chr9	136080665	136084637	OBP2B	3972	-	NR_110242	136084637	136084637	8
chr9	136130562	136150630	ABO	20068	-	NM_020469	136131052	136150605	7
chr9	136197542	136203047	SURF6	5505	-	NM_006753	136198704	136202969	5
chr9	136207750	136215011	MED22	7261	-	NM_133640	136208354	136213517	5
chr9	136215068	136218280	RPL7A	3212	+	NM_000972	136215098	136218221	8
chr9	136216250	136216325	SNORD24	75	+	NR_002447	136216325	136216325	1
chr9	136216948	136217019	SNORD36B	71	+	NR_000017	136217019	136217019	1
chr9	136217310	136217382	SNORD36A	72	+	NR_002448	136217382	136217382	1
chr9	136217700	136217767	SNORD36C	67	+	NR_000016	136217767	136217767	1
chr9	136218659	136223361	SURF1	4702	-	NM_003172	136218767	136223329	9
chr9	136223420	136228041	SURF2	4621	+	NM_001278928	136223468	136228015	6
chr9	136228324	136244820	SURF4	16496	-	NM_001280788	136230368	136244723	6
chr9	136243283	136271220	STKLD1	27937	+	NM_153710	136243344	136270545	18
chr9	136271181	136283292	REXO4	12111	-	NM_001279351	136272076	136280077	8
chr9	136279458	136324525	ADAMTS13	45067	+	NR_024514	136324525	136324525	18
chr9	136325086	136335909	CACFD1	10823	+	NM_001242369	136325188	136333833	6
chr9	136336215	136344276	SLC2A6	8061	-	NM_017585	136337142	136344181	10
chr9	136379707	136390068	TMEM8C	10361	-	NM_001080483	136379757	136389966	5
chr9	136397285	136440641	ADAMTSL2	43356	+	NM_001145320	136401834	136439986	19
chr9	136443536	136445368	FAM163B	1832	-	NM_001080515	136444143	136445345	2
chr9	136501484	136524466	DBH	22982	+	NM_000787	136501493	136523569	12
chr9	136519708	136522530	DBH-AS1	2822	-	NR_102735	136522530	136522530	2
chr9	136528683	136605077	SARDH	76394	-	NM_007101	136529010	136599295	21
chr9	136627015	136857446	VAV2	230431	-	NM_001134398	136629183	136857400	30
chr9	136890560	136896719	LINC00094	6159	+	NR_015427	136896719	136896719	3
chr9	136895445	136933141	BRD3	37696	-	NM_007371	136898711	136918599	12
chr9	137001209	137025094	WDR5	23885	+	NM_017588	137004999	137023115	14
chr9	137029561	137029686	RNU6ATAC	125	-	NR_023344	137029686	137029686	1
chr9	137218308	137332432	RXRA	114124	+	NM_002957	137218477	137328460	10
chr9	137271256	137271318	MIR4669	62	+	NR_039816	137271318	137271318	1
chr9	137533650	137736688	COL5A1	203038	+	NM_001278074	137534033	137734149	66
chr9	137711260	137764464	LOC101448202	53204	-	NR_103451	137764464	137764464	2
chr9	137741020	137742490	MIR3689A	1470	-	NR_037460	137742490	137742490	2
chr9	137741143	137741215	MIR3689C	72	-	NR_039691	137741215	137741215	1
chr9	137741454	137741528	MIR3689D1	74	-	NR_039693	137741528	137741528	1
chr9	137741970	137742118	MIR3689B	148	-	NR_037469	137742118	137742118	1
chr9	137742122	137742202	MIR3689D2	80	-	NR_039694	137742202	137742202	1
chr9	137742415	137742487	MIR3689E	72	-	NR_039695	137742487	137742487	1
chr9	137742587	137742653	MIR3689F	66	-	NR_039696	137742653	137742653	1
chr9	137772657	137779366	FCN2	6709	+	NM_004108	137772667	137779261	8
chr9	137801430	137809806	FCN1	8376	-	NM_002003	137801643	137809717	9
chr9	137967088	138013030	OLFM1	45942	+	NM_014279	137967552	138012024	6
chr9	138073454	138079152	LOC401557	5698	+	NR_046107	138079152	138079152	3
chr9	138235094	138238404	C9orf62	3310	+	NM_173520	138235244	138236253	3
chr9	138354564	138364095	PPP1R26-AS1	9531	-	NR_038969	138364095	138364095	3
chr9	138371647	138380739	PPP1R26	9092	+	NM_014811	138376356	138379986	4
chr9	138387025	138391761	C9orf116	4736	-	NM_144654	138387358	138391697	3
chr9	138392476	138396519	MRPS2	4043	+	NR_051968	138396519	138396519	5
chr9	138395118	138398293	LOC101928525	3175	-	NR_121579	138398293	138398293	3
chr9	138413283	138418386	LCN1	5103	+	NM_002297	138413343	138417003	7
chr9	138437984	138441815	OBP2A	3831	+	NM_014582	138438026	138441176	7
chr9	138453601	138458622	PAEP	5021	+	NM_002571	138453647	138457647	7
chr9	138466770	138478958	LINC01502	12188	+	NR_034016	138478958	138478958	6
chr9	138515501	138531386	GLT6D1	15885	-	NM_182974	138515942	138531033	5
chr9	138555167	138557755	LCN9	2588	+	NM_001001676	138555167	138557755	6
chr9	138585254	138591374	SOHLH1	6120	-	NM_001101677	138585442	138591313	8
chr9	138594030	138684993	KCNT1	90963	+	NM_020822	138594104	138684007	31
chr9	138700332	138799005	CAMSAP1	98673	-	NM_015447	138703154	138799005	17
chr9	138824814	138853226	UBAC1	28412	-	NM_016172	138825245	138853008	10
chr9	138898382	138987131	NACC2	88749	-	NM_144653	138903361	138942367	6
chr9	139006426	139010731	C9orf69	4305	-	NM_152833	139008326	139008746	2
chr9	139088095	139096955	LHX3	8860	-	NM_178138	139089170	139096858	6
chr9	139098181	139137687	QSOX2	39506	-	NM_181701	139100573	139137649	12
chr9	139216997	139221779	DKFZP434A062	4782	-	NR_026964	139221779	139221779	1
chr9	139221931	139254057	GPSM1	32126	+	NM_001145638	139222151	139252672	14
chr9	139256351	139258263	DNLZ	1912	-	NM_001080849	139256463	139258166	3
chr9	139258407	139268133	CARD9	9726	-	NM_052814	139258576	139266530	13
chr9	139270028	139292889	SNAPC4	22861	-	NM_003086	139270807	139292880	23
chr9	139296373	139305054	SDCCAG3	8681	-	NM_001039707	139297239	139304849	10
chr9	139305024	139318213	PMPCA	13189	+	NM_001282946	139306965	139317716	13
chr9	139323066	139334256	INPP5E	11190	-	NM_019892	139324126	139333871	10
chr9	139334547	139378211	SEC16A	43664	-	NM_001276418	139336206	139372067	29
chr9	139377946	139380519	C9orf163	2573	+	NM_152571	139378900	139379512	1
chr9	139388895	139440238	NOTCH1	51343	-	NM_017617	139390522	139440238	34
chr9	139414019	139414078	MIR4673	59	-	NR_039820	139414078	139414078	1
chr9	139440624	139440711	MIR4674	87	-	NR_039821	139440711	139440711	1
chr9	139442293	139444196	NALT1	1903	+	NR_121577	139444196	139444196	3
chr9	139553307	139567130	EGFL7	13823	+	NR_046367	139567130	139567130	10
chr9	139565053	139565138	MIR126	85	+	NR_029695	139565138	139565138	1
chr9	139567594	139581911	AGPAT2	14317	-	NM_006412	139568203	139581809	6
chr9	139607023	139619170	FAM69B	12147	+	NM_152421	139607117	139618226	5
chr9	139619045	139622636	SNHG7	3591	-	NR_024543	139622636	139622636	5
chr9	139620555	139620689	SNORA17B	134	-	NR_002975	139620689	139620689	1
chr9	139621198	139621331	SNORA17A	133	-	NR_002958	139621331	139621331	1
chr9	139632618	139637411	LCN10	4793	-	NM_001001712	139633976	139637355	6
chr9	139638468	139642980	LCN6	4512	-	NM_198946	139639113	139642935	7
chr9	139640612	139644363	LOC100128593	3751	+	NR_033913	139644363	139644363	3
chr9	139641344	139641422	MIR6722	78	-	NR_106780	139641422	139641422	1
chr9	139648839	139652731	LCN8	3892	-	NM_178469	139648949	139652382	7
chr9	139654085	139658965	LCN15	4880	-	NM_203347	139656270	139658940	7
chr9	139685776	139687769	TMEM141	1993	+	NM_032928	139685822	139687284	5
chr9	139690789	139702193	CCDC183	11404	+	NM_001039374	139690849	139702142	14
chr9	139698378	139703300	CCDC183-AS1	4922	-	NR_024580	139703300	139703300	5
chr9	139702373	139735639	RABL6	33266	+	NM_001173988	139702648	139734974	15
chr9	139725408	139725475	MIR4292	67	+	NR_036251	139725475	139725475	1
chr9	139738866	139741797	C9orf172	2931	+	NM_001080482	139738866	139741797	1
chr9	139743267	139745495	PHPT1	2228	+	NM_001287343	139743882	139745241	4
chr9	139746818	139755251	MAMDC4	8433	+	NM_206920	139746868	139755055	27
chr9	139756565	139760788	EDF1	4223	-	NM_001281299	139756735	139760710	5
chr9	139780964	139821067	TRAF2	40103	+	NM_021138	139793192	139820353	11
chr9	139781184	139781255	MIR4479	71	+	NR_039697	139781255	139781255	1
chr9	139834884	139839206	FBXW5	4322	-	NM_018998	139835379	139838535	9
chr9	139839697	139841426	C8G	1729	+	NM_000606	139839772	139841233	7
chr9	139846767	139849949	LCN12	3182	+	NM_178536	139846779	139849851	6
chr9	139871955	139876194	PTGDS	4239	+	NM_000954	139872030	139875307	7
chr9	139877444	139880210	LCNL1	2766	+	NM_207510	139878038	139879463	3
chr9	139886869	139888428	C9orf142	1559	+	NM_183241	139886895	139888257	7
chr9	139889059	139891024	CLIC3	1965	-	NM_004669	139889132	139890995	6
chr9	139901685	139923374	ABCA2	21689	-	NM_212533	139902380	139923324	49
chr9	139921915	139931234	C9orf139	9319	+	NM_207511	139927515	139929506	3
chr9	139924625	139927292	FUT7	2667	-	NM_004479	139925161	139926443	2
chr9	139933908	139940676	NPDC1	6768	-	NM_015392	139934223	139940441	9
chr9	139942550	139948503	ENTPD2	5953	-	NM_203468	139943108	139948449	9
chr9	139956578	139965028	SAPCD2	8450	-	NM_178448	139959110	139964912	6
chr9	139971952	139978990	UAP1L1	7038	+	NM_207309	139971984	139977181	9
chr9	139979397	139981269	MAN1B1-AS1	1872	-	NR_027447	139981269	139981269	1
chr9	139981378	140003639	MAN1B1	22261	+	NR_045721	140003639	140003639	14
chr9	140004991	140009195	DPP7	4204	-	NM_013379	140005099	140009165	13
chr9	140033608	140063214	GRIN1	29606	+	NM_001185090	140033938	140062294	21
chr9	140063211	140064491	LRRC26	1280	-	NM_001013653	140063305	140064395	2
chr9	140063637	140063722	MIR3621	85	-	NR_037416	140063722	140063722	1
chr9	140065379	140066498	TMEM210	1119	-	NM_001282477	140065426	140066479	4
chr9	140069235	140083057	ANAPC2	13822	-	NM_013366	140069393	140082984	13
chr9	140083053	140084822	SSNA1	1769	+	NM_003731	140083178	140084366	3
chr9	140086068	140095163	TPRN	9095	-	NM_001128228	140086563	140095163	4
chr9	140098534	140100090	TMEM203	1556	-	NM_053045	140099455	140099866	1
chr9	140100118	140113813	NDOR1	13695	+	NM_014434	140100229	140110868	14
chr9	140114698	140115775	RNF208	1077	-	NM_031297	140114878	140115664	1
chr9	140119086	140120763	CYSRT1	1677	+	NM_199001	140119573	140120508	2
chr9	140122017	140124090	RNF224	2073	+	NM_001190228	140122787	140123538	3
chr9	140125208	140131006	SLC34A3	5798	+	NM_001177316	140126154	140130868	13
chr9	140135710	140138159	TUBB4B	2449	+	NM_006088	140135812	140138008	4
chr9	140138034	140142244	FAM166A	4210	-	NM_001001710	140138151	140142167	7
chr9	140144670	140147949	C9orf173-AS1	3279	-	NR_038389	140147949	140147949	4
chr9	140145712	140147935	C9orf173	2223	+	NR_046340	140147935	140147935	6
chr9	140149751	140168000	NELFB	18249	+	NM_015456	140149817	140167380	13
chr9	140172279	140177093	TOR4A	4814	+	NM_017723	140173141	140174413	2
chr9	140194082	140196703	NRARP	2621	-	NM_001004354	140196035	140196380	1
chr9	140201345	140317714	EXD3	116369	-	NM_017820	140201401	140289809	22
chr9	140317846	140328858	NOXA1	11012	+	NM_006647	140317981	140328812	14
chr9	140328815	140335901	ENTPD8	7086	-	NM_001033113	140329365	140332737	10
chr9	140342022	140353786	NSMF	11764	-	NM_001130969	140343845	140353554	16
chr9	140344477	140344538	MIR7114	61	-	NR_106964	140344538	140344538	1
chr9	140354403	140445021	PNPLA7	90618	-	NM_001098537	140354844	140444649	35
chr9	140446308	140447007	MRPL41	699	+	NM_032477	140446533	140446947	2
chr9	140449358	140473387	DPH7	24029	-	NM_138778	140449690	140473229	9
chr9	140476530	140484937	ZMYND19	8407	-	NM_138462	140476994	140484715	6
chr9	140500091	140509812	ARRDC1	9721	+	NM_152285	140500169	140509590	8
chr9	140509783	140513347	ARRDC1-AS1	3564	-	NR_122035	140513347	140513347	3
chr9	140513443	140730578	EHMT1	217135	+	NM_024757	140513480	140729405	27
chr9	140657473	140659224	EHMT1-IT1	1751	+	NR_024341	140659224	140659224	1
chr9	140732870	140732968	MIR602	98	+	NR_030333	140732968	140732968	1
chr9	140762376	140787022	LOC100133077	24646	-	NR_121583	140787022	140787022	4
chr9	140772240	141019076	CACNA1B	246836	+	NM_000718	140772385	141016451	46
chr9	140838081	140841512	LOC105376331	3431	-	NR_132977	140841512	140841512	3
chr9	140934954	140939523	LOC101928786	4569	-	NR_121582	140939523	140939523	3
chr9	141044564	141071885	TUBBP5	27321	+	NR_027156	141071885	141071885	5
chr9	141106636	141134172	FAM157B	27536	+	NM_001145249	141106636	141124256	7
chr10	92827	95178	TUBB8	2351	-	NM_177987	92996	95178	4
chr10	180404	300577	ZMYND11	120173	+	NM_006624	225952	298410	15
chr10	320129	735608	DIP2C	415479	-	NM_014974	323264	735518	37
chr10	687628	687718	MIR5699	90	-	NR_049884	687718	687718	1
chr10	696016	711109	PRR26	15093	+	NR_027152	711109	711109	3
chr10	852853	977645	LARP4B	124792	-	NM_015155	858865	931661	18
chr10	978965	988683	LOC101927762	9718	+	NR_120629	988683	988683	3
chr10	1034348	1063708	GTPBP4	29360	+	NM_012341	1034419	1063167	17
chr10	1064846	1071799	IDI2	6953	-	NM_033261	1065456	1070663	5
chr10	1068576	1090141	IDI2-AS1	21565	+	NR_027709	1090141	1090141	5
chr10	1085359	1102656	IDI1	17297	-	NM_001317955	1087126	1090083	6
chr10	1102775	1178237	WDR37	75462	+	NM_014023	1118095	1175284	14
chr10	1205707	1210612	LINC00200	4905	+	NR_015376	1210612	1210612	3
chr10	1223252	1779670	ADARB2	556418	-	NM_018702	1229132	1779344	10
chr10	1568824	1599179	ADARB2-AS1	30355	+	NR_033387	1599179	1599179	2
chr10	2047666	2056542	LINC00700	8876	-	NR_040253	2056542	2056542	3
chr10	2118212	2118283	MIR6072	71	-	NR_106720	2118283	2118283	1
chr10	2342512	2357268	LINC00701	14756	-	NR_038884	2357268	2357268	3
chr10	3109711	3178997	PFKP	69286	+	NM_002627	3109787	3178771	22
chr10	3176351	3176517	SNORD142	166	+	NR_132758	3176517	3176517	1
chr10	3179918	3215033	PITRM1	35115	-	NM_014889	3180222	3214964	27
chr10	3183792	3190821	PITRM1-AS1	7029	+	NR_038284	3190821	3190821	4
chr10	3360886	3792955	LOC105376360	432069	+	NR_131187	3792955	3792955	2
chr10	3818187	3827473	KLF6	9286	-	NM_001160124	3821730	3827206	4
chr10	4033351	4033451	MIR6078	100	+	NR_106726	4033451	4033451	1
chr10	4093917	4131205	LOC101927964	37288	+	NR_120632	4131205	4131205	4
chr10	4249067	4286104	LINC00702	37037	-	NR_108040	4286104	4286104	3
chr10	4426437	4452804	LINC00703	26367	+	NR_108054	4452804	4452804	3
chr10	4692376	4720262	LINC00704	27886	-	NR_024475	4720262	4720262	4
chr10	4698347	4704606	LINC00705	6259	+	NR_015425	4704606	4704606	3
chr10	4868368	4890251	AKR1E2	21883	+	NM_001040177	4868516	4889722	10
chr10	4913858	4958465	AKR1C6P	44607	-	NR_026743	4958465	4958465	11
chr10	5005453	5020158	AKR1C1	14705	+	NM_001353	5005636	5019934	9
chr10	5029967	5060225	AKR1C2	30258	-	NM_001354	5032187	5046027	11
chr10	5090957	5149878	AKR1C3	58921	+	NM_001253908	5091003	5149695	9
chr10	5196654	5227150	AKR1C8P	30496	-	NR_027916	5227150	5227150	8
chr10	5238797	5260910	AKR1C4	22113	+	NM_001818	5238830	5260723	9
chr10	5406975	5416169	UCN3	9194	+	NM_053049	5415683	5416169	2
chr10	5435060	5446793	TUBAL3	11733	-	NM_001171864	5435479	5446755	4
chr10	5454513	5501019	NET1	46506	+	NM_001047160	5454655	5498957	12
chr10	5540657	5541533	CALML5	876	-	NM_017422	5540960	5541401	1
chr10	5556206	5568209	CALML3-AS1	12003	-	NR_120496	5568209	5568209	4
chr10	5566851	5568231	CALML3	1380	+	NM_005185	5567048	5567498	1
chr10	5680819	5708558	ASB13	27739	-	NR_037164	5708558	5708558	7
chr10	5726800	5805703	FAM208B	78903	+	NM_017782	5762605	5804995	21
chr10	5807185	5855512	GDI2	48327	-	NM_001494	5807968	5855221	11
chr10	5903688	5931860	ANKRD16	28172	-	NM_019046	5920092	5931317	8
chr10	5931534	5979558	FBXO18	48024	+	NM_001258452	5948064	5979243	22
chr10	5994333	6020150	IL15RA	25817	-	NM_001243539	5995057	6008282	7
chr10	6052656	6104333	IL2RA	51677	-	NM_000417	6054834	6104114	8
chr10	6130948	6159422	RBM17	28474	+	NM_032905	6139028	6157519	12
chr10	6186840	6277507	PFKFB3	90667	+	NM_001145443	6186960	6274905	15
chr10	6194158	6194240	MIR3155A	82	+	NR_036111	6194240	6194240	1
chr10	6194169	6194225	MIR3155B	56	-	NR_039698	6194225	6194225	1
chr10	6368506	6377943	LOC399715	9437	+	NR_040079	6377943	6377943	6
chr10	6469104	6622263	PRKCQ	153159	-	NM_001282644	6470168	6556991	18
chr10	6622386	6627323	PRKCQ-AS1	4937	+	NR_036502	6627323	6627323	3
chr10	6660677	6681743	LOC101928150	21066	+	NR_120634	6681743	6681743	6
chr10	6816264	6821142	LINC00706	4878	-	NR_108074	6821142	6821142	2
chr10	6821559	6884868	LINC00707	63309	+	NR_038291	6884868	6884868	5
chr10	7200585	7453448	SFMBT2	252863	-	NM_001029880	7205731	7423860	21
chr10	7228641	7228746	SNORD129	105	-	NR_132972	7228746	7228746	1
chr10	7601231	7708961	ITIH5	107730	-	NM_030569	7605044	7708855	15
chr10	7745235	7791483	ITIH2	46248	+	NM_002216	7745397	7791297	21
chr10	7792924	7829990	KIN	37066	-	NR_045609	7829990	7829990	14
chr10	7830092	7849762	ATP5C1	19670	+	NM_001001973	7830170	7848943	10
chr10	7860466	8057016	TAF3	196550	+	NM_031923	7860672	8056714	7
chr10	8092412	8095447	GATA3-AS1	3035	-	NR_024256	8095447	8095447	2
chr10	8096666	8117164	GATA3	20498	+	NM_002051	8097618	8115986	6
chr10	8301294	8310268	LINC00708	8974	-	NR_108058	8310268	8310268	5
chr10	8939951	8956559	LOC105755953	16608	+	NR_131944	8956559	8956559	4
chr10	9239328	9337556	LOC101928272	98228	-	NR_120635	9337556	9337556	5
chr10	9317575	9329019	LINC00709	11444	+	NR_108039	9329019	9329019	2
chr10	10100684	10105465	LOC101928298	4781	+	NR_120636	10105465	10105465	4
chr10	10461500	10504312	LOC101928322	42812	-	NR_120637	10504312	10504312	4
chr10	10826401	10836877	SFTA1P	10476	-	NR_027082	10836877	10836877	4
chr10	10976902	10994126	LINC00710	17224	-	NR_015413	10994126	10994126	6
chr10	11047258	11378672	CELF2	331414	+	NM_001025077	11047350	11371016	14
chr10	11113505	11147451	CELF2-AS2	33946	-	NR_046108	11147451	11147451	7
chr10	11358795	11386673	CELF2-AS1	27878	-	NR_126062	11386673	11386673	3
chr10	11502508	11653788	USP6NL	151280	-	NM_014688	11504439	11639633	15
chr10	11784355	11806065	ECHDC3	21710	+	NM_024693	11784575	11805543	5
chr10	11865396	11914276	PROSER2	48880	+	NM_153256	11894076	11912405	4
chr10	11891606	11936709	PROSER2-AS1	45103	-	NR_038222	11936709	11936709	6
chr10	11962020	12085169	UPF2	123149	-	NM_080599	11963296	12077422	22
chr10	12110915	12165227	DHTKD1	54312	+	NM_018706	12111032	12162887	17
chr10	12171639	12211957	SEC61A2	40318	+	NR_024577	12211957	12211957	14
chr10	12172758	12172815	MIR548AK	57	-	NR_039699	12172815	12172815	1
chr10	12209572	12238143	NUDT5	28571	-	NM_014142	12209700	12228290	10
chr10	12237960	12292589	CDC123	54629	+	NM_006023	12238244	12292336	13
chr10	12391541	12877545	CAMK1D	486004	+	NM_153498	12391817	12870886	11
chr10	12620751	12620822	MIR4480	71	+	NR_039700	12620822	12620822	1
chr10	12695136	12695196	MIR4481	60	-	NR_039701	12695196	12695196	1
chr10	12938624	13141773	CCDC3	203149	-	NM_001282658	12940415	13040511	7
chr10	13142081	13180276	OPTN	38195	+	NM_001008213	13151122	13178866	16
chr10	13203553	13253104	MCM10	49551	+	NM_182751	13206202	13251310	20
chr10	13263765	13276328	UCMA	12563	-	NM_145314	13264102	13276258	5
chr10	13319795	13342130	PHYH	22335	-	NM_006214	13320300	13342042	9
chr10	13359437	13390298	SEPHS1	30861	-	NM_012247	13361141	13386950	9
chr10	13480483	13544976	BEND7	64493	-	NM_152751	13481171	13542069	9
chr10	13628938	13672868	PRPF18	43930	+	NM_003675	13629086	13672340	10
chr10	13685705	14372866	FRMD4A	687161	-	NM_018027	13693904	14372101	25
chr10	14116282	14129878	LOC101928453	13596	+	NR_120638	14129878	14129878	3
chr10	14425198	14425276	MIR4293	78	-	NR_036181	14425276	14425276	1
chr10	14478574	14478660	MIR1265	86	+	NR_031668	14478660	14478660	1
chr10	14560555	14816896	FAM107B	256341	-	NM_001282695	14563188	14572458	6
chr10	14861250	14879983	CDNF	18733	-	NM_001029954	14861978	14879945	4
chr10	14880158	14913740	HSPA14	33582	+	NM_016299	14880401	14913605	14
chr10	14920781	14946304	SUV39H2	25523	+	NM_001193424	14920887	14944511	6
chr10	14946609	14996431	DCLRE1C	49822	-	NR_110297	14996431	14996431	17
chr10	15001437	15014850	MEIG1	13413	+	NM_001080836	15008467	15014640	3
chr10	15085894	15115851	OLAH	29957	+	NM_018324	15089287	15115228	9
chr10	15117473	15130775	ACBD7	13302	-	NM_001039844	15120528	15130727	4
chr10	15137383	15139318	C10orf111	1935	-	NM_153244	15138355	15138823	2
chr10	15139178	15146256	RPP38	7078	+	NM_183005	15145313	15146165	3
chr10	15147770	15210695	NMT2	62925	-	NM_004808	15151193	15210611	12
chr10	15196720	15197346	PPIAP30	626	-	NR_036506	15197346	15197346	1
chr10	15253643	15413058	FAM171A1	159415	-	NM_001010924	15254913	15413051	8
chr10	15555947	15762334	ITGA8	206387	-	NM_003638	15559156	15761770	30
chr10	15820174	15902519	FAM188A	82345	-	NM_024948	15820990	15902298	15
chr10	16478941	16555744	PTER	76803	+	NM_001001484	16526383	16553255	6
chr10	16555741	16564004	C1QL3	8263	-	NM_001010908	16556526	16563064	2
chr10	16632616	16859453	RSU1	226837	-	NM_012425	16635392	16859080	9
chr10	16865964	17171816	CUBN	305852	-	NM_001081	16866973	17171764	67
chr10	17184981	17244070	TRDMT1	59089	-	NM_004412	17191038	17243633	11
chr10	17256237	17271984	VIM-AS1	15747	-	NR_108061	17271984	17271984	3
chr10	17270257	17279592	VIM	9335	+	NM_003380	17271421	17279270	10
chr10	17362675	17496254	ST8SIA6	133579	-	NM_001004470	17362876	17496254	8
chr10	17428934	17450285	ST8SIA6-AS1	21351	+	NR_034129	17450285	17450285	3
chr10	17631957	17659373	HACD1	27416	-	NM_014241	17632362	17659338	7
chr10	17683282	17685917	STAM-AS1	2635	-	NR_110370	17685917	17685917	1
chr10	17686123	17758821	STAM	72698	+	NM_003473	17686338	17756779	14
chr10	17851341	18200091	MRC1	348750	+	NM_002438	17851464	18199394	30
chr10	17887106	17887193	MIR511	87	+	NR_030167	17887193	17887193	1
chr10	18041226	18089854	TMEM236	48628	+	NM_001098844	18041261	18085490	4
chr10	18240767	18332221	SLC39A12	91454	+	NM_001282733	18242205	18331762	13
chr10	18290714	18299491	SLC39A12-AS1	8777	-	NR_038419	18299491	18299491	5
chr10	18429605	18830688	CACNB2	401083	+	NM_201593	18429665	18828653	14
chr10	18834135	18940566	NSUN6	106431	-	NM_182543	18834861	18940132	11
chr10	18948312	18966940	ARL5B	18628	+	NM_178815	18948566	18964145	6
chr10	19337699	20023407	MALRD1	685708	+	NM_001142308	19337867	20023166	40
chr10	19999263	20017479	LOC101928834	18216	-	NR_120646	20017479	20017479	5
chr10	20105371	20578784	PLXDC2	473413	+	NM_032812	20106008	20568748	14
chr10	20840898	20840975	MIR4675	77	+	NR_039822	20840975	20840975	1
chr10	21068902	21463116	NEBL	394214	-	NM_001173484	21074811	21462762	7
chr10	21414691	21435488	C10orf113	20797	-	NM_001177483	21415014	21435437	2
chr10	21462918	21463852	NEBL-AS1	934	+	NR_046283	21463852	21463852	2
chr10	21783420	21786213	CASC10	2793	-	NM_001010911	21784528	21785743	2
chr10	21785490	21785570	MIR1915	80	-	NR_031736	21785570	21785570	1
chr10	21802408	21814611	SKIDA1	12203	-	NM_207371	21804024	21806751	4
chr10	21823100	22032559	MLLT10	209459	+	NM_004641	21823573	22029163	24
chr10	22045476	22292650	DNAJC1	247174	-	NM_022365	22045615	22292363	12
chr10	22497742	22498912	EBLN1	1170	-	NM_001199938	22497811	22498912	1
chr10	22541000	22547477	LOC100130992	6477	+	NR_038921	22547477	22547477	1
chr10	22605311	22609246	COMMD3	3935	+	NM_012071	22605346	22608927	8
chr10	22605311	22620414	COMMD3-BMI1	15103	+	NM_001204062	22605346	22618471	14
chr10	22610138	22620414	BMI1	10276	+	NM_005180	22615378	22618471	10
chr10	22634373	22706539	SPAG6	72166	+	NM_001253854	22649750	22705617	14
chr10	22724353	22726858	LOC100499489	2505	-	NR_036533	22726858	22726858	1
chr10	22823765	23003503	PIP4K2A	179738	-	NM_005028	22826129	23003255	10
chr10	23216952	23327452	ARMC3	110500	+	NM_001282745	23220925	23326408	19
chr10	23384426	23410942	MSRB2	26516	+	NM_012228	23384537	23409791	5
chr10	23481459	23483181	PTF1A	1722	+	NM_178161	23481459	23482835	2
chr10	23492744	23528721	LINC01552	35977	-	NR_103721	23528721	23528721	4
chr10	23605519	23633772	C10orf67	28253	-	NM_153714	23607838	23633706	5
chr10	23682333	23682396	MIR1254-2	63	+	NR_039606	23682396	23682396	1
chr10	23728197	23731310	OTUD1	3113	+	NM_001145373	23728386	23729832	1
chr10	23983674	24836777	KIAA1217	853103	+	NM_001098500	24508724	24835253	19
chr10	24564613	24564710	MIR603	97	+	NR_030334	24564710	24564710	1
chr10	24872537	25012597	ARHGAP21	140060	-	NM_020824	24873340	25010828	26
chr10	25137535	25241573	PRTFDC1	104038	-	NM_020200	25138772	25241504	9
chr10	25270907	25351208	ENKUR	80301	-	NM_001270383	25273298	25350077	6
chr10	25305507	25315593	THNSL1	10086	+	NM_024838	25312152	25314384	3
chr10	25401986	25450162	LINC01516	48176	+	NR_120649	25450162	25450162	8
chr10	25447000	25465205	GPR158-AS1	18205	-	NR_027333	25465205	25465205	2
chr10	25464289	25891157	GPR158	426868	+	NM_020752	25464349	25888203	11
chr10	25940640	26021864	LINC00836	81224	+	NR_108067	26021864	26021864	5
chr10	26213306	26222639	LOC101929073	9333	-	NR_120650	26222639	26222639	4
chr10	26223001	26501465	MYO3A	278464	+	NM_017433	26241039	26500892	35
chr10	26505235	26593491	GAD2	88256	+	NM_000818	26505738	26589890	17
chr10	26727265	26856732	APBB1IP	129467	+	NM_019043	26781255	26856417	15
chr10	26878793	26883251	LINC00264	4458	+	NR_026793	26883251	26883251	4
chr10	26932036	26942383	LINC00202-2	10347	+	NR_026794	26942383	26942383	5
chr10	26986594	27035726	PDSS1	49132	+	NM_014317	26986640	27035402	12
chr10	27035524	27150016	ABI1	114492	-	NM_001178116	27037498	27149792	12
chr10	27220134	27230930	LINC00202-1	10796	-	NR_026795	27230930	27230930	5
chr10	27293044	27389427	ANKRD26	96383	-	NM_014915	27294518	27389255	34
chr10	27399039	27443349	YME1L1	44310	-	NM_139312	27400905	27443139	20
chr10	27443752	27475848	MASTL	32096	+	NM_001172303	27444355	27475465	12
chr10	27484142	27531068	ACBD5	46926	-	NM_001042473	27486358	27529323	13
chr10	27534781	27541235	LRRC37A6P	6454	-	NR_003525	27541235	27541235	1
chr10	27687116	27703297	PTCHD3	16181	-	NM_001034842	27687222	27703179	4
chr10	27793102	27831166	RAB18	38064	+	NM_001256410	27793298	27826980	8
chr10	27961802	28034778	MKX	72976	-	NM_001242702	27964157	28032344	7
chr10	28033543	28056728	MKX-AS1	23185	+	NR_121652	28056728	28056728	2
chr10	28101092	28287979	ARMC4	186887	-	NM_018076	28101440	28284071	20
chr10	28339922	28571067	MPP7	231145	-	NM_173496	28342993	28527533	19
chr10	28362165	28362307	SNORD130	142	-	NR_132973	28362307	28362307	1
chr10	28578186	28578279	MIR8086	93	-	NR_107053	28578279	28578279	1
chr10	28808845	28821283	WAC-AS1	12438	-	NR_033805	28821283	28821283	3
chr10	28821516	28912041	WAC	90525	+	NM_100264	28824547	28908535	14
chr10	28835324	28835346	MIR5586	22	+	NR_049851	28835346	28835346	1
chr10	28966423	28971868	BAMBI	5445	+	NM_012342	28966826	28971330	3
chr10	29032578	29097148	LINC01517	64570	+	NR_120652	29097148	29097148	4
chr10	29078239	29084979	LINC00837	6740	-	NR_038374	29084979	29084979	3
chr10	29135336	29170826	C10orf126	35490	+	NM_001278522	29136169	29169375	5
chr10	29577989	29600158	LYZL1	22169	+	NM_032517	29578046	29599988	5
chr10	29698462	29776785	SVIL-AS1	78323	+	NR_110927	29776785	29776785	3
chr10	29746276	30024730	SVIL	278454	-	NM_003174	29747175	29843987	36
chr10	29833932	29834026	MIR604	94	-	NR_030335	29834026	29834026	1
chr10	29891192	29891275	MIR938	83	-	NR_030634	29891275	29891275	1
chr10	30301728	30348488	KIAA1462	46760	-	NM_020848	30306811	30336741	4
chr10	30500780	30521619	LOC101929279	20839	+	NR_120653	30521619	30521619	3
chr10	30598729	30638267	MTPAP	39538	-	NM_018109	30602537	30638204	9
chr10	30653255	30660836	GOLGA2P6	7581	-	NR_120609	30660836	30660836	12
chr10	30657525	30657594	MIR7162	69	-	NR_106985	30657594	30657594	1
chr10	30722949	30750762	MAP3K8	27813	+	NM_005204	30727867	30749765	9
chr10	30900707	30918647	LYZL2	17940	-	NM_183058	30900883	30918634	5
chr10	30981202	31005942	SVILP1	24740	+	NR_036438	31005942	31005942	10
chr10	31133564	31320866	ZNF438	187302	-	NM_001143770	31133889	31146615	9
chr10	31605456	31608024	ZEB1-AS1	2568	-	NR_024284	31608024	31608024	2
chr10	31608100	31818742	ZEB1	210642	+	NM_001174096	31608163	31816192	9
chr10	32094325	32217804	ARHGAP12	123479	-	NM_018287	32096585	32197783	20
chr10	32297937	32345371	KIF5B	47434	-	NM_004521	32304456	32344901	26
chr10	32556643	32667726	EPC1	111083	-	NM_001282391	32557990	32667421	14
chr10	32636291	32663416	LOC102031319	27125	+	NR_104163	32663416	32663416	2
chr10	32723296	32734984	LOC101929431	11688	-	NR_120660	32734984	32734984	3
chr10	32856650	33171792	CCDC7	315142	+	NM_024688	32873189	33165321	23
chr10	33189245	33247293	ITGB1	58048	-	NM_002211	33190497	33224486	16
chr10	33190261	33190400	SNORA86	139	-	NR_132768	33190400	33190400	1
chr10	33466418	33623833	NRP1	157415	-	NM_003873	33469003	33623310	17
chr10	34048640	34061608	LINC00838	12968	-	NR_038932	34061608	34061608	3
chr10	34398487	35104253	PARD3	705766	-	NM_001184785	34400096	35103923	25
chr10	35104695	35105350	PARD3-AS1	655	+	NR_108043	35105350	35105350	2
chr10	35297478	35379570	CUL2	82092	-	NM_001198777	35299238	35360245	21
chr10	35368525	35368608	MIR3611	83	-	NR_037405	35368608	35368608	1
chr10	35415768	35501886	CREM	86118	+	NM_183013	35426763	35500326	8
chr10	35535908	35861598	CCNY	325690	+	NM_181698	35772339	35858098	12
chr10	35894337	35897863	GJD4	3526	+	NM_153368	35894495	35897554	2
chr10	35927176	35930362	FZD8	3186	-	NM_031866	35928272	35930357	1
chr10	35930099	35930180	MIR4683	81	-	NR_039831	35930180	35930180	1
chr10	36067229	36089848	PCAT5	22619	+	NR_110138	36089848	36089848	3
chr10	37414784	37521495	ANKRD30A	106711	+	NM_052997	37414883	37520397	36
chr10	37598113	37635956	LINC00993	37843	+	NR_104061	37635956	37635956	5
chr10	37890365	37891859	MTRNR2L7	1494	-	NM_001190489	37890897	37890972	1
chr10	38065453	38146564	ZNF248	81111	-	NM_001267607	38065464	38145238	7
chr10	38082865	38084103	ZNF33BP1	1238	-	NR_051997	38084103	38084103	1
chr10	38238794	38265453	ZNF25	26659	-	NM_145011	38241054	38260650	6
chr10	38299577	38348995	ZNF33A	49418	+	NM_001278176	38306273	38345488	6
chr10	38383263	38412278	ZNF37A	29015	+	NM_001007094	38385545	38407765	8
chr10	38464598	38503273	LOC100129055	38675	+	NR_024524	38503273	38503273	7
chr10	38645307	38667433	HSD17B7P2	22126	+	NR_003086	38667433	38667433	8
chr10	38671997	38691780	SEPT7P9	19783	-	NR_027269	38691780	38691780	4
chr10	38717073	38741081	LINC00999	24008	+	NR_024497	38741081	38741081	8
chr10	38989726	38991371	ACTR3BP5	1645	+	NR_045000	38991371	38991371	1
chr10	42827313	42863493	LOC441666	36180	-	NR_024380	42863493	42863493	3
chr10	42903621	42967688	CCNYL2	64067	-	NR_103829	42967688	42967688	9
chr10	42970938	42990785	LINC00839	19847	+	NR_026827	42990785	42990785	5
chr10	43008960	43048318	ZNF37BP	39358	-	NR_026777	43048318	43048318	8
chr10	43069630	43134285	ZNF33B	64655	-	NR_130951	43134285	43134285	4
chr10	43168460	43187207	LINC01518	18747	-	NR_120659	43187207	43187207	5
chr10	43277953	43330385	BMS1	52432	+	NM_014753	43279842	43326544	23
chr10	43474464	43476955	LINC01264	2491	-	NR_126352	43476955	43476955	3
chr10	43493010	43493129	MIR5100	119	+	NR_049836	43493129	43493129	1
chr10	43572516	43625797	RET	53281	+	NM_020975	43572706	43623717	20
chr10	43633892	43680754	CSGALNACT2	46862	+	NM_018590	43650597	43678990	8
chr10	43689980	43762367	RASGEF1A	72387	-	NM_145313	43691691	43701564	13
chr10	43867091	43871783	FXYD4	4692	+	NM_001184963	43869194	43871614	9
chr10	43881064	43904696	HNRNPF	23632	-	NM_001098204	43882084	43883332	4
chr10	43932573	43978007	ZNF487	45434	+	NR_026693	43978007	43978007	4
chr10	44051792	44070066	ZNF239	18274	-	NM_001099284	44052150	44053527	3
chr10	44101854	44113352	ZNF485	11498	+	NM_145312	44102498	44112817	5
chr10	44124264	44170147	ZNF32-AS3	45883	+	NR_038867	44170147	44170147	5
chr10	44139306	44144326	ZNF32	5020	-	NM_006973	44139497	44141581	3
chr10	44139319	44140495	ZNF32-AS1	1176	+	NR_047557	44140495	44140495	2
chr10	44141389	44143467	ZNF32-AS2	2078	+	NR_047558	44143467	44143467	3
chr10	44282859	44285865	HNRNPA3P1	3006	-	NR_002726	44285865	44285865	1
chr10	44340753	44346070	LINC00619	5317	+	NR_033923	44346070	44346070	3
chr10	44354858	44390881	LINC00840	36023	+	NR_038268	44390881	44390881	5
chr10	44404751	44465355	LINC00841	60604	+	NR_033846	44465355	44465355	8
chr10	44788197	44790097	C10orf142	1900	+	NM_001258000	44788208	44789391	3
chr10	44865600	44880545	CXCL12	14945	-	NM_000609	44868775	44880453	4
chr10	45306471	45455137	TMEM72-AS1	148666	-	NR_033842	45455137	45455137	8
chr10	45406763	45432458	TMEM72	25695	+	NM_001123376	45406960	45430582	5
chr10	45455218	45490172	RASSF4	34954	+	NM_032023	45465650	45488777	11
chr10	45471708	45474330	C10orf10	2622	-	NM_007021	45472839	45473478	2
chr10	45489379	45496358	C10orf25	6979	-	NR_126421	45496358	45496358	4
chr10	45496272	45500777	ZNF22	4505	+	NM_006963	45498816	45499491	2
chr10	45594923	45650044	RSU1P2	55121	-	NR_024472	45650044	45650044	9
chr10	45650109	45681489	ANKRD30BP3	31380	+	NR_033891	45681489	45681489	8
chr10	45659461	45659536	MIR3156-1	75	+	NR_036112	45659536	45659536	1
chr10	45798101	45811056	OR13A1	12955	-	NM_001004297	45798883	45799870	4
chr10	45869623	45941567	ALOX5	71944	+	NM_001256153	45869727	45941135	14
chr10	45940015	45948569	LOC102724323	8554	-	NR_120674	45948569	45948569	3
chr10	45950032	46090354	MARCH8	140322	-	NM_145021	45953686	46028659	7
chr10	46110948	46168261	ZFAND4	57313	-	NM_001282906	46111883	46148469	11
chr10	46222647	46288412	FAM21C	65765	+	NM_015262	46222765	46287848	30
chr10	46321039	46349325	AGAP4	28286	-	NM_001291379	46321362	46342137	10
chr10	46737612	46762892	BMS1P5	25280	-	NR_003611	46762892	46762892	9
chr10	46897640	46939145	FAM35BP	41505	+	NR_027632	46939145	46939145	7
chr10	46955443	46970601	SYT15	15158	-	NM_181519	46959968	46970448	9
chr10	46993545	47000568	GPRIN2	7023	+	NM_014696	46998880	47000257	3
chr10	47083533	47088320	NPY4R	4787	+	NM_005972	47086783	47087911	3
chr10	47086724	47088173	CH17-360D5.1	1449	+	NM_001278795	47086783	47087911	1
chr10	47096453	47151400	LINC00842	54947	-	NR_033957	47151400	47151400	4
chr10	47133294	47133836	HNRNPA1P33	542	-	NR_003277	47133836	47133836	1
chr10	47177203	47181688	FAM25C	4485	-	NM_001137548	47177259	47181662	3
chr10	47177221	47181688	FAM25G	4467	-	NM_001137549	47177259	47181662	3
chr10	47379719	47421238	FAM35DP	41519	+	NR_027634	47421238	47421238	7
chr10	47590260	47640844	ANTXRLP1	50584	-	NR_103827	47640844	47640844	5
chr10	47658232	47701443	ANTXRL	43211	+	NM_001278688	47658498	47701320	17
chr10	47740303	47744822	FAM25BP	4519	+	NR_104039	47744822	47744822	3
chr10	47746849	47763040	ANXA8L1	16191	+	NM_001098845	47747111	47762187	12
chr10	48155942	48158691	CTSLP2	2749	+	NR_033407	48158691	48158691	4
chr10	48185838	48203780	BMS1P6	17942	+	NR_024495	48203780	48203780	9
chr10	48215723	48237508	AGAP9	21785	+	NM_001190810	48215835	48237210	8
chr10	48255203	48271368	ANXA8	16165	+	NM_001271702	48255428	48270515	12
chr10	48355088	48373866	ZNF488	18778	+	NM_153034	48370532	48371555	2
chr10	48381486	48390991	RBP3	9505	-	NM_002900	48381904	48390877	4
chr10	48413091	48416872	GDF2	3781	-	NM_016204	48413577	48416693	2
chr10	48425787	48439138	GDF10	13351	-	NM_004962	48426569	48438710	3
chr10	48737041	48827924	PTPN20	90883	-	NM_001042363	48738620	48792783	10
chr10	48844035	48862688	FRMPD2B	18653	-	NR_033172	48862688	48862688	6
chr10	48952591	48980339	GLUD1P7	27748	+	NR_111968	48980339	48980339	6
chr10	49218158	49239658	AGAP12P	21500	-	NR_029396	49239658	49239658	8
chr10	49364601	49482941	FRMPD2	118340	-	NM_001018071	49365364	49482610	29
chr10	49514681	49647402	MAPK8	132721	+	NM_001278547	49609703	49643072	12
chr10	49654067	49864310	ARHGAP22	210243	-	NR_045675	49864310	49864310	11
chr10	49893517	50191001	WDFY4	297484	+	NM_020945	49917777	50190620	62
chr10	50117528	50122280	LRRC18	4752	-	NM_001006939	50118281	50122200	2
chr10	50193556	50193632	MIR4294	76	-	NR_036182	50193632	50193632	1
chr10	50222289	50323577	VSTM4	101288	-	NM_001031746	50227694	50323530	8
chr10	50329883	50359592	FAM170B-AS1	29709	+	NR_038973	50359592	50359592	6
chr10	50339200	50342065	FAM170B	2865	-	NM_001164484	50339657	50341963	2
chr10	50362768	50396445	C10orf128	33677	-	NM_001288743	50364235	50396381	7
chr10	50504327	50506938	C10orf71-AS1	2611	-	NR_108038	50506938	50506938	2
chr10	50507186	50535537	C10orf71	28351	+	NM_001135196	50530590	50534898	3
chr10	50574160	50604062	DRGX	29902	-	NM_001276451	50574160	50603486	7
chr10	50662525	50747169	ERCC6	84644	-	NM_000124	50666860	50741010	21
chr10	50723150	50732327	PGBD3	9177	-	NM_170753	50723378	50725160	2
chr10	50723150	50747584	ERCC6-PGBD3	24434	-	NM_001277059	50723378	50741010	6
chr10	50817140	50873150	CHAT	56010	+	NM_020984	50824615	50873092	15
chr10	50818346	50820766	SLC18A3	2420	+	NM_003055	50818786	50820385	1
chr10	50887683	50916956	C10orf53	29273	+	NM_182554	50887743	50916663	3
chr10	50942686	50970425	OGDHL	27739	-	NM_018245	50943273	50966638	23
chr10	51026320	51371371	PARG	345051	-	NM_003631	51027385	51371070	18
chr10	51253907	51371344	PARGP1	117437	-	NR_029388	51371344	51371344	13
chr10	51371378	51734610	TIMM23B	363232	+	NR_110767	51734610	51734610	8
chr10	51464143	51486327	AGAP7P	22184	-	NR_126580	51486327	51486327	7
chr10	51549552	51562518	MSMB	12966	+	NM_002443	51549584	51562400	4
chr10	51565107	51590734	NCOA4	25627	+	NM_001145260	51568356	51586675	12
chr10	51592080	51623386	TIMM23	31306	-	NR_073029	51623386	51623386	8
chr10	51748077	51770259	AGAP6	22182	+	NM_001077665	51748475	51769946	8
chr10	51780941	51827563	FAM21EP	46622	-	NR_038275	51827563	51827563	7
chr10	51827647	51893269	FAM21A	65622	+	NM_001005751	51827765	51892705	31
chr10	51946999	52008370	ASAH2	61371	-	NM_019893	51947074	52008370	20
chr10	52065344	52383737	SGMS1	318393	-	NM_147156	52066901	52103874	11
chr10	52384710	52391396	SGMS1-AS1	6686	+	NR_126411	52391396	52391396	4
chr10	52499687	52514569	ASAH2B	14882	+	NM_001079516	52502684	52514500	6
chr10	52559168	52645435	A1CF	86267	-	NM_001198819	52566488	52610547	15
chr10	52750910	54058110	PRKG1	1307200	+	NM_001098512	52751138	54053660	18
chr10	52822338	52828312	LOC102724719	5974	-	NR_120678	52828312	52828312	2
chr10	53059332	53059415	MIR605	83	+	NR_030336	53059415	53059415	1
chr10	53455245	53459355	CSTF2T	4110	-	NM_015235	53457458	53459309	1
chr10	54056607	54073888	PRKG1-AS1	17281	-	NR_038277	54073888	54073888	6
chr10	54074040	54077417	DKK1	3377	+	NM_012242	54074194	54076567	4
chr10	54210636	54230293	LINC01468	19657	-	NR_120641	54230293	54230293	4
chr10	54525139	54531460	MBL2	6321	-	NM_000242	54527896	54531395	4
chr10	55562532	56561051	PCDH15	998519	-	NM_001142771	55566338	56424022	35
chr10	57358749	57360487	MTRNR2L5	1738	+	NM_001190478	57359659	57359734	1
chr10	58117198	58121034	ZWINT	3836	-	NM_007057	58118178	58120997	9
chr10	59064238	59064319	MIR3924	81	-	NR_037490	59064319	59064319	1
chr10	59951277	60027694	IPMK	76417	-	NM_152230	59955836	60027371	6
chr10	60028861	60049019	CISD1	20158	+	NM_018464	60029033	60047410	3
chr10	60094738	60130513	UBE2D1	35775	+	NM_003338	60094961	60128525	7
chr10	60144902	60158990	TFAM	14088	+	NR_073073	60158990	60158990	8
chr10	60272903	60591197	BICC1	318294	+	NM_001080512	60272903	60588651	21
chr10	60474774	60477293	FAM133CP	2519	+	NR_027508	60477293	60477293	1
chr10	60759277	60761377	LINC00844	2100	+	NR_108046	60761377	60761377	2
chr10	60933722	60936224	CCEPR	2502	-	NR_131782	60936224	60936224	1
chr10	60936347	61007534	PHYHIPL	71187	+	NM_032439	60936613	61005351	5
chr10	61005888	61122661	FAM13C	116773	-	NM_001143773	61007373	61112104	15
chr10	61410521	61469649	SLC16A9	59128	-	NM_194298	61412529	61444049	6
chr10	61496747	61513203	MRLN	16456	-	NM_001304732	61496817	61496958	4
chr10	61548505	61666414	CCDC6	117909	-	NM_005436	61552674	61666182	9
chr10	61717974	61720671	LINC01553	2697	-	NR_024340	61720671	61720671	2
chr10	61786055	62493284	ANK3	707229	-	NM_001204403	61802448	62493077	44
chr10	62538211	62554610	CDK1	16399	+	NM_001786	62539923	62553733	8
chr10	62629197	62761198	RHOBTB1	132001	-	NR_024555	62761198	62761198	12
chr10	62776032	62786175	LINC00845	10143	+	NR_108052	62786175	62786175	2
chr10	63166400	63213208	TMEM26	46808	-	NM_178505	63170079	63212839	6
chr10	63212396	63253189	TMEM26-AS1	40793	+	NR_120643	63253189	63253189	6
chr10	63422718	63526091	C10orf107	103373	+	NM_173554	63441000	63525771	7
chr10	63661012	63856707	ARID5B	195695	+	NM_032199	63661468	63852789	10
chr10	63736060	63736088	MIR548AV	28	+	NR_049858	63736088	63736088	1
chr10	63952844	64028622	RTKN2	75778	-	NM_145307	63957666	64028369	12
chr10	64099346	64134886	LOC283045	35540	-	NR_104162	64134886	64134886	4
chr10	64133915	64431771	ZNF365	297856	+	NM_199451	64135952	64430061	8
chr10	64564515	64568239	ADO	3724	+	NM_032804	64564819	64565632	1
chr10	64571755	64578927	EGR2	7172	-	NM_001136178	64572966	64575789	4
chr10	64893006	64914791	NRBF2	21785	+	NM_030759	64893230	64913978	4
chr10	64926980	65225761	JMJD1C	298781	-	NM_032776	64927804	65225422	26
chr10	65132716	65132808	MIR1296	92	-	NR_031566	65132808	65132808	1
chr10	65190334	65190962	LOC105378330	628	+	NR_134312	65190962	65190962	2
chr10	65224988	65226322	JMJD1C-AS1	1334	+	NR_027182	65226322	65226322	1
chr10	65281122	65384883	REEP3	103761	+	NM_001001330	65281305	65380629	8
chr10	66585284	66586634	ANXA2P3	1350	+	NR_001446	66586634	66586634	1
chr10	66660893	66684276	LOC101928887	23383	-	NR_134456	66684276	66684276	2
chr10	67331182	67526299	LINC01515	195117	+	NR_120647	67526299	67526299	6
chr10	67672275	69455949	CTNNA3	1783674	-	NM_013266	67680087	69407271	18
chr10	68653867	68771911	LOC101928961	118044	-	NR_111911	68771911	68771911	7
chr10	68685791	68861309	LRRTM3	175518	+	NM_178011	68686341	68857554	3
chr10	69163108	69163168	MIR7151	60	-	NR_106973	69163168	69163168	1
chr10	69556426	69597937	DNAJC12	41511	-	NM_021800	69556873	69597769	5
chr10	69644426	69678147	SIRT1	33721	+	NM_012238	69644479	69676350	9
chr10	69681655	69835103	HERC4	153448	-	NM_022079	69682687	69832865	26
chr10	69769703	69770640	POU5F1P5	937	-	NR_131184	69770640	69770640	1
chr10	69865873	69971773	MYPN	105900	+	NM_001256267	69881195	69970212	21
chr10	69990351	69991870	ATOH7	1519	-	NM_145178	69990975	69991434	1
chr10	70042416	70092684	PBLD	50268	-	NM_022129	70043933	70066601	10
chr10	70091767	70102953	HNRNPH3	11186	+	NM_012207	70096978	70101811	10
chr10	70100863	70167051	RUFY2	66188	-	NR_103476	70167051	70167051	19
chr10	70173820	70231878	DNA2	58058	-	NR_102264	70231878	70231878	22
chr10	70242089	70287280	SLC25A16	45191	-	NM_152707	70243188	70287132	9
chr10	70320116	70454239	TET1	134123	+	NM_030625	70332095	70451571	12
chr10	70480900	70552134	CCAR1	71234	+	NM_018237	70482261	70551023	25
chr10	70514928	70514995	SNORD98	67	+	NR_003076	70514995	70514995	1
chr10	70519074	70519171	MIR1254-1	97	+	NR_031655	70519171	70519171	1
chr10	70587293	70655209	STOX1	67916	+	NM_001130161	70587380	70652492	5
chr10	70661033	70706603	DDX50	45570	+	NM_024045	70661140	70706386	15
chr10	70715878	70744825	DDX21	28947	+	NM_004728	70715981	70742568	15
chr10	70748476	70776739	KIAA1279	28263	+	NM_015634	70748588	70776172	7
chr10	70847827	70864567	SRGN	16740	+	NM_002727	70847913	70863876	3
chr10	70883907	70932616	VPS26A	48709	+	NM_004896	70884033	70931025	9
chr10	70939959	70968854	SUPV3L1	28895	+	NM_001301683	70946242	70968791	16
chr10	70975088	70992246	LOC101928994	17158	-	NR_120648	70992246	70992246	5
chr10	70980058	71027315	HKDC1	47257	+	NM_025130	70980191	71026513	18
chr10	71029755	71161637	HK1	131882	+	NM_033500	71060590	71160891	22
chr10	71163957	71176674	TACR2	12717	-	NM_001057	71164581	71176079	5
chr10	71211225	71267423	TSPAN15	56198	+	NM_012339	71211350	71266734	8
chr10	71331790	71333210	NEUROG3	1420	-	NM_020999	71332154	71332799	2
chr10	71390002	71393355	C10orf35	3353	+	NM_145306	71391499	71392815	4
chr10	71561643	71718904	COL13A1	157261	+	NM_001130103	71562179	71718457	40
chr10	71812356	71872040	H2AFY2	59684	+	NM_018649	71835414	71871439	9
chr10	71872022	71892690	AIFM2	20668	-	NM_001198696	71873933	71883840	9
chr10	71897736	71906496	TYSND1	8760	-	NM_173555	71899679	71906342	4
chr10	71909960	71930285	SAR1A	20325	-	NM_001142648	71912231	71921671	8
chr10	71962585	71993190	PPA1	30605	-	NM_021129	71962910	71993083	11
chr10	72014712	72043450	NPFFR1	28738	-	NM_022146	72014712	72043432	4
chr10	72058725	72142406	LRRC20	83681	-	NM_001278212	72061109	72136289	5
chr10	72163860	72188374	EIF4EBP2	24514	+	NM_004096	72164157	72181503	3
chr10	72191691	72201465	NODAL	9774	-	NM_018055	72192691	72201423	3
chr10	72238563	72328206	PALD1	89643	+	NM_014431	72285707	72326489	20
chr10	72357103	72362531	PRF1	5428	-	NM_005041	72357808	72360658	3
chr10	72432558	72522195	ADAMTS14	89637	+	NM_139155	72432558	72520609	22
chr10	72530994	72545157	TBATA	14163	-	NM_152710	72531131	72543135	11
chr10	72575703	72640932	SGPL1	65229	+	NM_003901	72576609	72637092	15
chr10	72643264	72648543	PCBD1	5279	-	NM_000281	72643706	72648290	4
chr10	72698809	72715398	LOC105378349	16589	+	NR_134313	72715398	72715398	3
chr10	72972291	73062635	UNC5B	90344	+	NM_170744	72972742	73059034	17
chr10	72976980	72977985	UNC5B-AS1	1005	-	NR_038453	72977985	72977985	2
chr10	73079009	73123147	SLC29A3	44138	+	NM_018344	73079066	73122365	6
chr10	73156690	73575704	CDH23	419014	+	NM_022124	73199588	73575035	68
chr10	73267909	73271677	LOC102723377	3768	-	NR_120672	73271677	73271677	3
chr10	73471457	73497581	C10orf105	26124	-	NM_001168390	73475692	73476094	2
chr10	73507313	73533337	C10orf54	26024	-	NM_022153	73511009	73533196	7
chr10	73550503	73550557	MIR7152	54	+	NR_106974	73550557	73550557	1
chr10	73576054	73611082	PSAP	35028	-	NM_001042465	73577197	73610978	15
chr10	73724119	73773322	CHST3	49203	+	NM_004273	73765600	73768229	3
chr10	73818791	73848790	SPOCK2	29999	-	NM_014767	73822517	73848086	12
chr10	73855789	73976892	ASCC1	121103	-	NR_045564	73976892	73976892	10
chr10	73975757	73995618	ANAPC16	19861	+	NM_001242546	73983672	73992874	5
chr10	74033676	74035797	DDIT4	2121	+	NM_019058	74033974	74034946	3
chr10	74092587	74114907	DNAJB12	22320	-	NM_017626	74095567	74114757	9
chr10	74127083	74385949	MICU1	258866	-	NM_006077	74127952	74326551	12
chr10	74451888	74647452	MCU	195564	+	NR_073062	74647452	74647452	10
chr10	74480786	74480858	MIR4676	72	+	NR_039823	74480858	74480858	1
chr10	74653313	74692794	OIT3	39481	+	NM_152635	74653556	74692282	9
chr10	74694937	74714510	PLA2G12B	19573	-	NM_032562	74695374	74714443	4
chr10	74766979	74856732	P4HA1	89753	-	NM_001142595	74767979	74834641	16
chr10	74870132	74891586	NUDT13	21454	+	NM_001283016	74883991	74890661	10
chr10	74894281	74927853	ECD	33572	-	NM_001135752	74894340	74923695	15
chr10	74927876	75001939	FAM149B1	74063	+	NM_173348	74928097	75000777	14
chr10	75001713	75007089	DNAJC9	5376	-	NM_015190	75003157	75006947	5
chr10	75007124	75036742	DNAJC9-AS1	29618	+	NR_038373	75036742	75036742	4
chr10	75008600	75012451	MRPS16	3851	-	NM_016065	75010609	75012240	3
chr10	75013515	75118617	CFAP70	105102	-	NM_145170	75013732	75114554	28
chr10	75135188	75173841	ANXA7	38653	-	NM_004034	75135852	75160614	14
chr10	75183336	75193319	MSS51	9983	-	NM_001024593	75184310	75188042	7
chr10	75196185	75255782	PPP3CB	59597	-	NM_001142353	75197999	75255647	14
chr10	75255509	75267067	PPP3CB-AS1	11558	+	NR_132103	75267067	75267067	5
chr10	75257295	75335433	USP54	78138	-	NM_152586	75258386	75335416	22
chr10	75391369	75401515	MYOZ1	10146	-	NM_021245	75391687	75399775	6
chr10	75404638	75415863	SYNPO2L	11225	-	NM_001114133	75406475	75415680	4
chr10	75434032	75457554	AGAP5	23522	-	NM_001144000	75434356	75457513	8
chr10	75458908	75490272	BMS1P4	31364	-	NR_026592	75490272	75490272	12
chr10	75490319	75491529	GLUD1P3	1210	+	NR_048575	75491529	75491529	2
chr10	75504130	75531933	SEC24C	27803	+	NM_004922	75506590	75530853	24
chr10	75532048	75535976	FUT11	3928	+	NM_001284194	75532091	75535273	3
chr10	75541807	75543406	CHCHD1	1599	+	NM_203298	75541833	75542945	3
chr10	75545381	75561556	ZSWIM8	16175	+	NM_001242488	75545636	75561534	26
chr10	75556271	75561157	ZSWIM8-AS1	4886	-	NR_038357	75561157	75561157	4
chr10	75561668	75571589	NDST2	9921	-	NM_003635	75562208	75568146	15
chr10	75572258	75634349	CAMK2G	62091	-	NM_172171	75574772	75634219	21
chr10	75669726	75682535	C10orf55	12809	-	NM_001001791	75671442	75672002	5
chr10	75670861	75677258	PLAU	6397	+	NM_002658	75671313	75676323	11
chr10	75757871	75879914	VCL	122043	+	NM_014000	75757965	75877927	22
chr10	75880014	75910826	AP3M1	30812	-	NM_207012	75883567	75898137	10
chr10	75910942	76469061	ADK	558119	+	NM_006721	75911036	76468203	11
chr10	76266255	76289082	LOC102723439	22827	-	NR_120673	76289082	76289082	5
chr10	76586170	76792380	KAT6B	206210	+	NM_001256469	76602615	76790804	18
chr10	76797593	76818272	DUPD1	20679	-	NM_001003892	76797593	76818272	3
chr10	76854189	76868970	DUSP13	14781	-	NM_001007271	76865426	76868915	8
chr10	76871392	76941881	SAMD8	70489	+	NM_001174156	76910286	76936450	6
chr10	76969911	76991207	VDAC2	21296	+	NM_001184823	76970916	76990747	10
chr10	76993728	76995770	COMTD1	2042	-	NM_144589	76993830	76995686	7
chr10	77039483	77161652	ZNF503	122169	-	NR_120651	77161652	77161652	4
chr10	77056140	77121436	ZNF503-AS1	65296	+	NR_038226	77121436	77121436	4
chr10	77161285	77168740	ZNF503-AS2	7455	+	NR_024421	77168740	77168740	2
chr10	77168914	77171082	LOC101929234	2168	+	NR_110304	77171082	77171082	3
chr10	77191403	78317133	C10orf11	1125730	+	NM_001305581	77191482	78317046	7
chr10	77312215	77312311	MIR606	96	+	NR_030337	77312311	77312311	1
chr10	77472212	77503606	LOC105378367	31394	+	NR_132791	77503606	77503606	3
chr10	78629358	79397577	KCNMA1	768219	-	NM_001014797	78637626	79397400	29
chr10	78647801	78738351	KCNMA1-AS1	90550	+	NR_120655	78738351	78738351	4
chr10	78900588	78909858	KCNMA1-AS2	9270	+	NR_120654	78909858	78909858	3
chr10	79110629	79136371	KCNMA1-AS3	25742	+	NR_126365	79136371	79136371	6
chr10	79550548	79686348	DLG5	135800	-	NM_004747	79552197	79686278	32
chr10	79686569	79689583	DLG5-AS1	3014	+	NR_024585	79689583	79689583	1
chr10	79734906	79789298	POLR3A	54392	-	NM_007055	79737235	79789165	31
chr10	79793517	79816571	RPS24	23054	+	NM_001142285	79793659	79814768	5
chr10	80008381	80012402	LINC00856	4021	+	NR_038985	80012402	80012402	2
chr10	80027084	80039970	LINC00595	12886	+	NR_073447	80039970	80039970	3
chr10	80703082	80827205	ZMIZ1-AS1	124123	-	NR_024431	80827205	80827205	10
chr10	80828791	81076285	ZMIZ1	247494	+	NM_020338	80961389	81072506	25
chr10	81107219	81115089	PPIF	7870	+	NM_005729	81107304	81113598	6
chr10	81142082	81205383	ZCCHC24	63301	-	NM_153367	81146100	81205196	4
chr10	81272356	81276192	EIF5AL1	3836	+	NM_001099692	81272405	81272870	1
chr10	81315607	81320163	SFTPA2	4556	-	NM_001098668	81316964	81319239	6
chr10	81370694	81375199	SFTPA1	4505	+	NM_001164646	81371581	81373869	6
chr10	81388513	81422941	LOC105378385	34428	-	NR_134315	81422941	81422941	4
chr10	81442730	81448650	BEND3P3	5920	+	NR_027512	81448650	81448650	1
chr10	81451255	81586350	NUTM2B-AS1	135095	-	NR_120613	81586350	81586350	7
chr10	81462982	81472513	NUTM2B	9531	+	NM_001278495	81463365	81472241	7
chr10	81585657	81587358	LOC642361	1701	+	NR_029407	81587358	81587358	1
chr10	81664653	81691557	BMS1P21	26904	+	NR_033857	81691557	81691557	6
chr10	81679933	81682875	MBL1P	2942	+	NR_002724	81682875	81682875	3
chr10	81697495	81708861	SFTPD	11366	-	NM_003019	81697607	81706415	8
chr10	81805988	81838949	TMEM254-AS1	32961	-	NR_027428	81838949	81838949	6
chr10	81838401	81852307	TMEM254	13906	+	NM_001270370	81838455	81850168	6
chr10	81892257	81904784	PLAC9	12527	+	NM_001012973	81892518	81904666	4
chr10	81914879	81965433	ANXA11	50554	-	NM_001278407	81915608	81932617	17
chr10	81967465	81979413	LINC00857	11948	+	NR_038464	81979413	81979413	2
chr10	82031575	82049434	MAT1A	17859	-	NM_000429	82033536	82049179	9
chr10	82095860	82116514	DYDC1	20654	-	NM_138812	82095911	82112357	8
chr10	82104500	82127829	DYDC2	23329	+	NR_070308	82127829	82127829	6
chr10	82167584	82192753	FAM213A	25169	+	NM_001243779	82180223	82191855	6
chr10	82214037	82282391	TSPAN14	68354	+	NM_030927	82248989	82277732	9
chr10	82289352	82295698	LOC101929574	6346	-	NR_120661	82295698	82295698	2
chr10	82291005	82292879	LOC102723703	1874	+	NR_120662	82292879	82292879	2
chr10	82297657	82406316	SH2D4B	108659	+	NM_207372	82298087	82403837	7
chr10	83635069	84746935	NRG3	1111866	+	NM_001165972	83635096	84745361	9
chr10	83988769	83992676	NRG3-AS1	3907	-	NR_120666	83992676	83992676	4
chr10	85432161	85436845	LOC105378397	4684	-	NR_134317	85436845	85436845	5
chr10	85899184	85913311	GHITM	14127	+	NM_014394	85901256	85912104	9
chr10	85933553	85945050	C10orf99	11497	+	NM_207373	85933607	85944522	3
chr10	85954390	85979376	CDHR1	24986	+	NM_001171971	85954516	85979032	17
chr10	85980248	85985345	LRIT2	5097	-	NM_001284223	85981675	85985276	4
chr10	85991275	86001217	LRIT1	9942	-	NM_015613	85991682	86001195	4
chr10	86004808	86018944	RGR	14136	+	NM_002921	86004846	86018395	7
chr10	86039735	86054415	LINC00858	14680	+	NR_038220	86054415	86054415	6
chr10	86088344	86278277	CCSER2	189933	+	NM_018999	86130808	86273299	11
chr10	86953176	86958694	LINC01519	5518	-	NR_120667	86958694	86958694	4
chr10	87191698	87192528	LOC101929646	830	-	NR_120669	87192528	87192528	2
chr10	87192618	87208713	LOC101929662	16095	+	NR_120670	87208713	87208713	3
chr10	87209348	87251758	LINC01520	42410	+	NR_120671	87251758	87251758	6
chr10	87337487	87366972	GRID1-AS1	29485	+	NR_038986	87366972	87366972	3
chr10	87359311	88126250	GRID1	766939	-	NM_017551	87362029	88126149	16
chr10	88024450	88024545	MIR346	95	-	NR_029907	88024545	88024545	1
chr10	88195012	88281541	WAPL	86529	-	NM_015045	88197299	88277826	19
chr10	88414313	88426216	OPN4	11903	+	NM_001030015	88414540	88425508	11
chr10	88428205	88495824	LDB3	67619	+	NM_001171610	88428448	88492733	14
chr10	88516395	88684945	BMPR1A	168550	+	NM_004329	88635775	88683476	13
chr10	88695297	88717425	MMRN2	22128	-	NM_024756	88696499	88717298	7
chr10	88718287	88723017	SNCG	4730	+	NM_003087	88718454	88722742	5
chr10	88728187	88730666	ADIRF	2479	+	NM_006829	88728301	88730339	3
chr10	88730497	88769960	AGAP11	39463	+	NM_133447	88761479	88769662	12
chr10	88780045	88784487	FAM25A	4442	+	NM_001146157	88780081	88784431	3
chr10	88809958	88854776	GLUD1	44818	-	NM_005271	88811507	88854526	13
chr10	88854952	88951222	FAM35A	96270	+	NM_019054	88911111	88950440	9
chr10	88985204	88994733	NUTM2A	9529	+	NM_001099338	88985587	88994465	7
chr10	88998423	89102315	NUTM2A-AS1	103892	-	NR_024397	89102315	89102315	6
chr10	89102167	89103331	LOC439994	1164	+	NR_029408	89103331	89103331	1
chr10	89117476	89130452	NUTM2D	12976	+	NR_075100	89130452	89130452	7
chr10	89156330	89167457	LINC00864	11127	-	NR_046091	89167457	89167457	3
chr10	89263637	89263711	MIR4678	74	+	NR_039825	89263711	89263711	1
chr10	89264222	89313218	MINPP1	48996	+	NM_004897	89264672	89312235	5
chr10	89419475	89507462	PAPSS2	87987	+	NM_001015880	89419738	89505727	13
chr10	89512874	89577917	ATAD1	65043	-	NM_032810	89514443	89574356	10
chr10	89578069	89605369	CFL1P1	27300	+	NR_028492	89605369	89605369	4
chr10	89618917	89623194	KLLN	4277	-	NM_001126049	89621707	89622244	1
chr10	89623194	89731687	PTEN	108493	+	NM_001304717	89623706	89725229	10
chr10	90033620	90343082	RNLS	309462	-	NM_018363	90034717	90342947	7
chr10	90346518	90366733	LIPJ	20215	+	NM_001010939	90350444	90366664	11
chr10	90424145	90438572	LIPF	14427	+	NM_001198830	90425297	90438438	11
chr10	90484300	90512513	LIPK	28213	+	NM_001080518	90484300	90512513	9
chr10	90521162	90537999	LIPN	16837	+	NM_001102469	90521162	90537999	9
chr10	90562486	90580303	LIPM	17817	+	NM_001128215	90562653	90580258	9
chr10	90579658	90611732	ANKRD22	32074	-	NM_144590	90582697	90611364	6
chr10	90639943	90683259	STAMBPL1	43316	+	NM_020799	90661465	90682981	11
chr10	90692440	90699731	ACTA2-AS1	7291	+	NR_125373	90699731	90699731	5
chr10	90694830	90751147	ACTA2	56317	-	NM_001141945	90694979	90708687	9
chr10	90750287	90775542	FAS	25255	+	NM_000043	90750633	90774207	9
chr10	90751180	90752732	FAS-AS1	1552	-	NR_028371	90752732	90752732	1
chr10	90823091	90823168	MIR4679-2	77	-	NR_039827	90823168	90823168	1
chr10	90823092	90823167	MIR4679-1	75	+	NR_039826	90823167	90823167	1
chr10	90965693	90967071	CH25H	1378	-	NM_003956	90966230	90967049	1
chr10	90973325	91011796	LIPA	38471	-	NM_000235	90974584	91007405	10
chr10	91061705	91069033	IFIT2	7328	+	NM_001547	91061880	91067132	2
chr10	91087575	91100725	IFIT3	13150	+	NM_001289758	91098568	91099885	3
chr10	91137812	91144962	IFIT1B	7150	+	NM_001010987	91137892	91144495	2
chr10	91152302	91166244	IFIT1	13942	+	NM_001270930	91162125	91163469	3
chr10	91174324	91180759	IFIT5	6435	+	NM_012420	91174555	91178405	2
chr10	91190050	91295313	SLC16A12	105263	-	NM_213606	91192820	91222335	8
chr10	91215747	91227908	SLC16A12-AS1	12161	+	NR_120614	91227908	91227908	3
chr10	91339253	91405329	PANK1	66076	-	NM_148977	91344162	91405059	7
chr10	91352503	91352584	MIR107	81	-	NR_029524	91352584	91352584	1
chr10	91451056	91457685	FLJ37201	6629	-	NR_026835	91457685	91457685	2
chr10	91461346	91534700	KIF20B	73354	+	NM_016195	91465051	91533805	33
chr10	91589249	91600618	LINC00865	11369	+	NR_038382	91600618	91600618	4
chr10	91675245	91717130	LINC01375	41885	-	NR_110655	91717130	91717130	4
chr10	92162277	92300562	LOC101926942	138285	-	NR_110657	92300562	92300562	7
chr10	92500575	92617671	HTR7	117096	-	NM_019859	92502238	92617428	4
chr10	92631708	92668312	RPP30	36604	+	NM_001104546	92631743	92663019	14
chr10	92671856	92681032	ANKRD1	9176	-	NM_014391	92672622	92680784	9
chr10	92707056	92751889	XLOC_008559	44833	+	NR_131214	92751889	92751889	6
chr10	92792922	92801012	LOC105378430	8090	+	NR_134319	92801012	92801012	3
chr10	92805564	92821916	LINC00502	16352	+	NR_047467	92821916	92821916	4
chr10	92911760	92912837	NUDT9P1	1077	-	NR_002779	92912837	92912837	1
chr10	92922768	93044088	PCGF5	121320	+	NM_001257101	92982628	93038073	10
chr10	93066718	93371217	HECTD2-AS1	304499	-	NR_024467	93371217	93371217	5
chr10	93170041	93274585	HECTD2	104544	+	NM_001284274	93170195	93272141	22
chr10	93388196	93392858	PPP1R3C	4662	-	NM_005398	93389683	93392726	2
chr10	93542595	93558048	TNKS2-AS1	15453	-	NR_108071	93558048	93558048	2
chr10	93558150	93625232	TNKS2	67082	+	NM_025235	93558447	93622756	27
chr10	93666344	93669258	FGFBP3	2914	-	NM_152429	93667949	93668726	2
chr10	93683735	93790080	BTAF1	106345	+	NM_003972	93683833	93788690	38
chr10	93808396	94050875	CPEB3	242479	-	NM_014912	93811968	94000107	10
chr10	94050919	94113721	MARCH5	62802	+	NM_017824	94051251	94110964	6
chr10	94178417	94179363	MARK2P9	946	+	NR_038243	94179363	94179363	1
chr10	94211440	94333852	IDE	122412	-	NM_004969	94214200	94333776	25
chr10	94352824	94415152	KIF11	62328	+	NM_004523	94353132	94413553	22
chr10	94449680	94455408	HHEX	5728	+	NM_002729	94449743	94454525	4
chr10	94594469	94819251	EXOC6	224782	+	NM_001013848	94594495	94818112	22
chr10	94821020	94828454	CYP26C1	7434	+	NM_183374	94821020	94828454	6
chr10	94833231	94837641	CYP26A1	4410	+	NM_057157	94834082	94837061	7
chr10	95066185	95242074	MYOF	175889	-	NM_013451	95066719	95241951	54
chr10	95256368	95288849	CEP55	32481	+	NM_001127182	95259808	95287910	9
chr10	95326421	95349829	FFAR4	23408	+	NM_181745	95326477	95347366	4
chr10	95351592	95360993	RBP4	9401	-	NM_006744	95351831	95360785	6
chr10	95372344	95425429	PDE6C	53085	+	NM_006204	95372482	95425175	22
chr10	95427639	95462329	FRA10AC1	34690	-	NM_145246	95429582	95459863	14
chr10	95517565	95557931	LGI1	40366	+	NM_001308275	95517901	95557543	8
chr10	95653729	95662491	SLC35G1	8762	+	NM_153226	95653790	95661247	3
chr10	95717896	95721672	PIPSL	3776	-	NR_002319	95721672	95721672	1
chr10	95753745	96088148	PLCE1	334403	+	NM_001288989	95790803	96084837	33
chr10	95841706	95868551	PLCE1-AS2	26845	-	NR_120616	95868551	95868551	8
chr10	96039046	96046827	PLCE1-AS1	7781	-	NR_033969	96046827	96046827	4
chr10	96092982	96122733	NOC3L	29751	-	NM_022451	96093933	96122595	21
chr10	96162185	96296089	TBC1D12	133904	+	NM_015188	96162370	96292853	13
chr10	96305523	96361856	HELLS	56333	+	NM_001289067	96305678	96361379	23
chr10	96443250	96495947	CYP2C18	52697	+	NM_000772	96443576	96495201	9
chr10	96522437	96612962	CYP2C19	90525	+	NM_000769	96522462	96612671	9
chr10	96698414	96749148	CYP2C9	50734	+	NM_000771	96698439	96748785	9
chr10	96796528	96829254	CYP2C8	32726	-	NM_001198855	96796884	96827406	10
chr10	96953956	96988686	ACSM6	34730	+	NM_207321	96954242	96988541	11
chr10	96997324	97050905	PDLIM1	53581	-	NM_020992	96997681	97050672	7
chr10	97071529	97321177	SORBS1	249648	-	NM_001290294	97074815	97200892	32
chr10	97365685	97416567	ALDH18A1	50882	-	NM_002860	97366518	97413134	18
chr10	97423152	97453900	TCTN3	30748	-	NM_015631	97423823	97453656	14
chr10	97471535	97637023	ENTPD1	165488	+	NM_001098175	97471713	97626140	10
chr10	97512962	97849992	ENTPD1-AS1	337030	-	NR_038444	97849992	97849992	6
chr10	97667721	97698415	C10orf131	30694	+	NM_001130446	97673182	97697966	8
chr10	97759847	97792441	CC2D2B	32594	+	NM_001159747	97763984	97791765	12
chr10	97803158	97820625	CCNJ	17467	+	NM_001134376	97804150	97817998	6
chr10	97824071	97824156	MIR3157	85	-	NR_036113	97824156	97824156	1
chr10	97889471	97923517	ZNF518A	34046	+	NM_001278524	97916079	97920530	7
chr10	97951454	98031333	BLNK	79879	-	NM_013314	97951728	98031155	17
chr10	98064084	98098321	DNTT	34237	+	NM_004088	98064254	98097981	11
chr10	98102974	98119122	OPALIN	16148	-	NM_001040103	98105697	98113212	7
chr10	98124362	98273683	TLL2	149321	-	NM_012465	98127844	98273442	21
chr10	98277866	98346809	TM9SF3	68943	-	NM_020123	98282019	98346592	15
chr10	98353068	98480279	PIK3AP1	127211	-	NM_152309	98355333	98480151	17
chr10	98588425	98588521	MIR607	96	-	NR_030338	98588521	98588521	1
chr10	98592016	98724198	LCOR	132182	+	NM_001170766	98708814	98718175	9
chr10	98741040	98745585	C10orf12	4545	+	NM_015652	98741147	98744891	1
chr10	98757794	98945683	SLIT1	187889	-	NM_003061	98760868	98945431	37
chr10	98862512	98863504	SLIT1-AS1	992	+	NR_038330	98863504	98863504	3
chr10	98912798	99052430	ARHGAP19-SLIT1	139632	-	NR_037909	99052430	99052430	15
chr10	98981929	99052430	ARHGAP19	70501	-	NM_032900	98985878	99052384	12
chr10	99079021	99081672	FRAT1	2651	+	NM_005479	99079210	99080050	1
chr10	99092253	99094458	FRAT2	2205	-	NM_012083	99093627	99094329	1
chr10	99116457	99161127	RRP12	44670	-	NM_015179	99116850	99160988	34
chr10	99185881	99193201	PGAM1	7320	+	NM_002629	99186064	99192281	4
chr10	99195665	99205768	EXOSC1	10103	-	NM_016046	99196201	99205742	8
chr10	99205887	99217127	ZDHHC16	11240	+	NM_198046	99211432	99216648	12
chr10	99218080	99258551	MMS19	40471	-	NM_001289405	99218448	99258141	32
chr10	99258638	99330967	UBTD1	72329	+	NM_024954	99258960	99330280	3
chr10	99332197	99343641	ANKRD2	11444	+	NM_020349	99332464	99343482	9
chr10	99344101	99372555	HOGA1	28454	+	NM_138413	99344460	99371416	7
chr10	99349449	99350691	C10orf62	1242	+	NM_001009997	99349654	99350326	1
chr10	99354974	99354995	MIR5692C2	21	+	NR_049868	99354995	99354995	1
chr10	99374309	99393913	MORN4	19604	-	NM_001098831	99376019	99379410	5
chr10	99400442	99436189	PI4K2A	35747	+	NM_018425	99400499	99433499	9
chr10	99437180	99447015	AVPI1	9835	-	NM_021732	99437625	99439662	3
chr10	99473464	99477909	MARVELD1	4445	+	NM_031484	99473633	99474155	2
chr10	99496877	99520664	ZFYVE27	23787	+	NM_144588	99498234	99519057	13
chr10	99526507	99531756	SFRP5	5249	-	NM_003015	99527270	99531590	3
chr10	99588234	99609555	LINC00866	21321	-	NR_108035	99609555	99609555	3
chr10	99609994	99631335	GOLGA7B	21341	+	NM_001010917	99610060	99625457	5
chr10	99624756	99790585	CRTAC1	165829	-	NM_018058	99625304	99790229	15
chr10	99894380	100004654	R3HCC1L	110274	+	NM_001256619	99967871	100003915	11
chr10	100007442	100028007	LOXL4	20565	-	NM_032211	100008677	100022776	15
chr10	100143321	100174978	PYROXD2	31657	-	NM_032709	100143554	100174892	16
chr10	100154974	100155064	MIR1287	90	-	NR_031619	100155064	100155064	1
chr10	100175954	100206720	HPS1	30766	-	NM_000195	100177320	100202997	20
chr10	100191048	100191117	MIR4685	69	-	NR_039833	100191117	100191117	1
chr10	100206077	100213562	LOC101927278	7485	+	NR_134452	100213562	100213562	4
chr10	100216833	100995632	HPSE2	778799	-	NM_001166246	100221542	100995559	13
chr10	100684255	100684325	MIR6507	70	-	NR_106762	100684325	100684325	1
chr10	101088855	101154087	CNNM1	65232	+	NM_020348	101089144	101151273	11
chr10	101156626	101190530	GOT1	33904	-	NM_002079	101157303	101190322	9
chr10	101286106	101290934	LINC01475	4828	-	NR_120618	101290934	101290934	5
chr10	101292689	101296280	NKX2-3	3591	+	NM_145285	101292888	101295478	2
chr10	101370274	101380221	SLC25A28	9947	-	NM_031212	101370605	101380092	4
chr10	101419262	101471002	ENTPD7	51740	+	NM_020354	101419713	101464440	13
chr10	101468504	101492423	COX15	23919	-	NM_004376	101473170	101491806	9
chr10	101491957	101515894	CUTC	23937	+	NM_015960	101492105	101515496	9
chr10	101542354	101611949	ABCC2	69595	+	NM_000392	101542601	101611388	32
chr10	101635333	101769676	DNMBP	134343	-	NM_015221	101636907	101731881	17
chr10	101686965	101718755	DNMBP-AS1	31790	+	NR_024130	101718755	101718755	5
chr10	101802064	101841642	CPN1	39578	-	NM_001308	101802183	101841382	9
chr10	101909846	101945814	ERLIN1	35968	-	NM_001100626	101911887	101945383	12
chr10	101948123	101989344	CHUK	41221	-	NM_001278	101949354	101989289	21
chr10	101992052	102027438	CWF19L1	35386	-	NM_018294	101992983	102027350	14
chr10	101996912	101997059	SNORA12	147	-	NR_002954	101997059	101997059	1
chr10	102033034	102046469	BLOC1S2	13435	-	NM_001282436	102035218	102042693	6
chr10	102047902	102090243	PKD2L1	42341	-	NM_001253837	102048152	102089697	16
chr10	102106771	102124588	SCD	17817	+	NM_005063	102107261	102120690	6
chr10	102133332	102148111	OLMALINC	14779	+	NR_026762	102148111	102148111	3
chr10	102222811	102243399	WNT8B	20588	+	NM_003393	102222925	102242573	6
chr10	102246402	102279595	SEC31B	33193	-	NM_015490	102247372	102276709	26
chr10	102283485	102289680	NDUFB8	6195	-	NM_005004	102283593	102289608	5
chr10	102295640	102313681	HIF1AN	18041	+	NM_017902	102295715	102307894	8
chr10	102495465	102589698	PAX2	94233	+	NM_001304569	102495465	102587376	11
chr10	102672325	102724891	SLF2	52566	+	NM_018121	102672867	102721669	20
chr10	102732285	102745373	SEMA4G	13088	+	NM_017893	102732669	102743888	14
chr10	102734741	102734841	MIR608	100	+	NR_030339	102734841	102734841	1
chr10	102737578	102747272	MRPL43	9694	-	NM_176792	102739009	102747200	5
chr10	102747292	102754158	C10orf2	6866	+	NM_021830	102747967	102753267	5
chr10	102756863	102767593	LZTS2	10730	+	NM_032429	102762295	102766925	5
chr10	102767439	102790914	PDZD7	23475	-	NM_001195263	102768223	102789976	17
chr10	102790995	102800998	SFXN3	10003	+	NM_030971	102792230	102799342	12
chr10	102820998	102825351	KAZALD1	4353	+	NM_030929	102822349	102824677	5
chr10	102849077	102890903	TLX1NB	41826	-	NR_130723	102890903	102890903	3
chr10	102891060	102897546	TLX1	6486	+	NM_005521	102891298	102896670	3
chr10	102936078	102953904	LINC01514	17826	+	NR_120620	102953904	102953904	6
chr10	102986732	102988717	LBX1	1985	-	NM_006562	102987026	102988572	2
chr10	102989350	102998616	LBX1-AS1	9266	+	NR_029380	102998616	102998616	3
chr10	103012577	103023307	LOC101927419	10730	-	NR_120621	103023307	103023307	3
chr10	103113789	103317078	BTRC	203289	+	NM_033637	103113937	103310617	15
chr10	103338638	103348027	POLL	9389	-	NM_001174084	103339209	103347117	9
chr10	103348088	103369410	DPCD	21322	+	NM_015448	103348093	103369228	6
chr10	103361173	103361254	MIR3158-1	81	+	NR_036114	103361254	103361254	1
chr10	103361173	103361254	MIR3158-2	81	-	NR_036115	103361254	103361254	1
chr10	103370420	103454743	FBXW4	84323	-	NM_022039	103371047	103454397	9
chr10	103529886	103540126	FGF8	10240	-	NM_001206389	103530085	103534513	5
chr10	103541081	103543170	NPM3	2089	-	NM_006993	103541492	103543147	6
chr10	103544199	103578222	MGEA5	34023	-	NM_012215	103546207	103577779	16
chr10	103578824	103588646	KCNIP2-AS1	9822	+	NR_045118	103588646	103588646	3
chr10	103585730	103603677	KCNIP2	17947	-	NM_014591	103587109	103603325	10
chr10	103605355	103815932	C10orf76	210577	-	NM_024541	103607284	103799871	26
chr10	103825123	103827795	HPS6	2672	+	NM_024747	103825231	103827559	1
chr10	103867324	103880210	LDB1	12886	-	NM_001113407	103867849	103879867	11
chr10	103892750	103910090	PPRC1	17340	+	NM_015062	103892825	103909786	14
chr10	103911932	103923628	NOLC1	11696	+	NM_001284389	103912167	103922026	13
chr10	103986034	103989344	ELOVL3	3310	+	NM_152310	103986305	103989009	4
chr10	103989945	104001231	PITX3	11286	-	NM_005029	103990270	103991837	4
chr10	104005254	104142656	GBF1	137402	+	NM_001199378	104018695	104142093	40
chr10	104153866	104162286	NFKB2	8420	+	NM_001288724	104155716	104162133	23
chr10	104162373	104179691	PSD	17318	-	NM_001270965	104162956	104176795	18
chr10	104179570	104182893	FBXL15	3323	+	NM_024326	104180886	104182750	4
chr10	104183001	104192423	CUEDC2	9422	-	NM_024040	104183182	104184945	9
chr10	104196268	104196341	MIR146B	73	+	NR_030169	104196341	104196341	1
chr10	104209573	104216050	RPARP-AS1	6477	+	NR_038937	104216050	104216050	5
chr10	104209593	104211300	C10orf95	1707	-	NM_024886	104210213	104211225	2
chr10	104221169	104236802	MFSD13A	15633	+	NM_024789	104228786	104235741	10
chr10	104238985	104262512	ACTR1A	23527	-	NM_005736	104240619	104262404	11
chr10	104263718	104393214	SUFU	129496	+	NM_016169	104263909	104389912	12
chr10	104404251	104418076	TRIM8	13825	+	NM_030912	104404374	104417111	6
chr10	104433483	104474190	ARL3	40707	-	NM_004311	104436650	104474032	6
chr10	104474297	104498946	SFXN2	24649	+	NM_178858	104486393	104497519	12
chr10	104503726	104576021	WBP1L	72295	+	NM_001083913	104503810	104573088	4
chr10	104590287	104597290	CYP17A1	7003	-	NM_000102	104590458	104597118	8
chr10	104613966	104624718	BORCS7	10752	+	NM_144591	104614043	104622681	6
chr10	104613966	104661655	BORCS7-ASMT	47689	+	NR_037644	104661655	104661655	15
chr10	104629209	104661655	AS3MT	32446	+	NM_020682	104629349	104660457	11
chr10	104678074	104838344	CNNM2	160270	+	NM_017649	104678237	104836937	8
chr10	104847773	104953063	NT5C2	105290	-	NM_012229	104849428	104934715	19
chr10	105005643	105007773	RPEL1	2130	+	NM_001143909	105005753	105006440	1
chr10	105036919	105050108	INA	13189	+	NM_032727	105036968	105048426	3
chr10	105062552	105110891	PCGF6	48339	-	NM_001011663	105063661	105110823	10
chr10	105127723	105148822	TAF5	21099	+	NM_006951	105127746	105147980	11
chr10	105148808	105156270	USMG5	7462	-	NM_001206427	105151950	105152214	5
chr10	105154009	105154158	MIR1307	149	-	NR_031707	105154158	105154158	1
chr10	105156411	105206019	PDCD11	49608	+	NM_014976	105158183	105205306	36
chr10	105206542	105212162	CALHM2	5620	-	NM_015916	105206908	105209698	4
chr10	105213143	105218648	CALHM1	5505	-	NM_001001412	105215018	105218508	2
chr10	105232560	105238997	CALHM3	6437	-	NM_001129742	105232969	105238789	3
chr10	105239359	105277199	NEURL1-AS1	37840	-	NR_120675	105277199	105277199	4
chr10	105253734	105352309	NEURL1	98575	+	NM_004210	105254144	105350129	6
chr10	105353783	105615164	SH3PXD2A	261381	-	NM_014631	105361572	105615024	14
chr10	105506536	105515167	SH3PXD2A-AS1	8631	+	NR_038940	105515167	105515167	3
chr10	105637317	105678045	OBFC1	40728	-	NM_024928	105642441	105677352	10
chr10	105726942	105788991	SLK	62049	+	NM_014720	105727503	105785478	19
chr10	105791045	105845638	COL17A1	54593	-	NM_000494	105791992	105840431	56
chr10	105807846	105807944	MIR936	98	-	NR_030760	105807944	105807944	1
chr10	105881815	105886143	SFR1	4328	+	NM_145247	105882748	105885462	4
chr10	105889645	105992120	CFAP43	102475	-	NM_025145	105889896	105992004	38
chr10	105978546	105978641	MIR609	95	-	NR_030340	105978641	105978641	1
chr10	106013951	106027222	GSTO1	13271	+	NM_001191003	106014970	106027163	6
chr10	106028093	106028163	MIR4482	70	-	NR_039702	106028163	106028163	1
chr10	106028630	106059176	GSTO2	30546	+	NM_183239	106034673	106059042	7
chr10	106069453	106098251	ITPRIP	28798	-	NM_001272013	106074165	106075809	2
chr10	106083121	106086503	LOC101927472	3382	+	NR_120622	106086503	106086503	3
chr10	106111058	106113333	CFAP58-AS1	2275	-	NR_108036	106113333	106113333	2
chr10	106113521	106214848	CFAP58	101327	+	NM_001008723	106113655	106214288	18
chr10	106234697	106240033	LOC101927523	5336	-	NR_120624	106240033	106240033	3
chr10	106400858	107025000	SORCS3	624142	+	NM_014978	106401085	107023132	27
chr10	106424365	106425974	SORCS3-AS1	1609	-	NR_104028	106425974	106425974	2
chr10	107433367	107580091	LOC101927549	146724	-	NR_120625	107580091	107580091	4
chr10	107899922	107948480	LOC105378470	48558	+	NR_134330	107948480	107948480	5
chr10	108333420	108924466	SORCS1	591046	-	NM_001206572	108337305	108924284	27
chr10	109631334	109829051	LINC01435	197717	-	NR_125760	109829051	109829051	5
chr10	111624523	111683311	XPNPEP1	58788	-	NM_020383	111624941	111683191	21
chr10	111705316	111768139	ADD3-AS1	62823	-	NR_038943	111768139	111768139	5
chr10	111765725	111895323	ADD3	129598	+	NM_019903	111860411	111893376	14
chr10	111967362	112047123	MXI1	79761	+	NM_130439	111967566	112044745	6
chr10	112052797	112064707	SMNDC1	11910	-	NM_005871	112053907	112063345	6
chr10	112257624	112271302	DUSP5	13678	+	NM_004419	112257879	112270184	4
chr10	112327448	112364392	SMC3	36944	+	NM_005445	112327574	112364060	29
chr10	112404154	112599229	RBM20	195075	+	NM_001134363	112404212	112595736	14
chr10	112628647	112630662	PDCD4-AS1	2015	-	NR_026932	112630662	112630662	1
chr10	112631552	112659764	PDCD4	28212	+	NM_145341	112636501	112657846	13
chr10	112657847	112657913	MIR4680	66	+	NR_039828	112657913	112657913	1
chr10	112658487	112679124	BBIP1	20637	-	NM_001195304	112660241	112677915	5
chr10	112679300	112773425	SHOC2	94125	+	NM_007373	112724116	112771576	9
chr10	112696360	112697013	RPL13AP6	653	-	NR_026715	112697013	112697013	1
chr10	112836789	112840662	ADRA2A	3873	+	NM_000681	112837754	112839152	1
chr10	113909621	113943537	GPAM	33916	-	NM_001244949	113913307	113941542	22
chr10	114043413	114064792	TECTB	21379	+	NM_058222	114043492	114063070	10
chr10	114059369	114059446	MIR6715B	77	-	NR_106772	114059446	114059446	1
chr10	114059369	114059448	MIR6715A	79	+	NR_106771	114059448	114059448	1
chr10	114067935	114116353	GUCY2GP	48418	-	NR_028134	114116353	114116353	19
chr10	114133915	114188138	ACSL5	54223	+	NM_203379	114154704	114187116	21
chr10	114190047	114206717	ZDHHC6	16670	-	NM_022494	114190561	114205194	11
chr10	114206755	114578504	VTI1A	371749	+	NM_145206	114207131	114575142	8
chr10	114393928	114394013	MIR4295	85	+	NR_036177	114394013	114394013	1
chr10	114583254	114587491	LOC103344931	4237	+	NR_120684	114587491	114587491	1
chr10	114710008	114927436	TCF7L2	217428	+	NM_001198525	114710515	114920420	15
chr10	114805113	114805335	SNORA87	222	+	NR_132769	114805335	114805335	1
chr10	115310589	115349360	HABP2	38771	+	NM_001177660	115327256	115348128	13
chr10	115348582	115423829	NRAP	75247	-	NM_001261463	115348733	115423641	42
chr10	115438920	115490668	CASP7	51748	+	NM_033340	115457252	115489183	8
chr10	115511212	115542192	PLEKHS1	30980	+	NM_001193434	115527143	115540540	13
chr10	115537751	115537813	MIR4483	62	-	NR_039703	115537813	115537813	1
chr10	115594482	115614163	DCLRE1A	19681	-	NM_001271816	115594910	115612941	10
chr10	115614390	115672265	NHLRC2	57875	+	NM_198514	115614631	115668295	11
chr10	115803805	115806667	ADRB1	2862	+	NM_000684	115803891	115805325	1
chr10	115881973	115934364	CCDC186	52391	-	NM_018017	115884901	115923027	16
chr10	115933863	115933938	MIR2110	75	-	NR_031747	115933938	115933938	1
chr10	115939028	115992063	TDRD1	53035	+	NM_198795	115947590	115991276	26
chr10	115999012	116054259	VWA2	55247	+	NM_001272046	116008472	116050996	14
chr10	116054582	116164537	AFAP1L2	109955	-	NM_001287824	116055800	116164214	20
chr10	116190868	116444414	ABLIM1	253546	-	NM_001003408	116196018	116444112	23
chr10	116524546	116539662	LOC101927692	15116	+	NR_120628	116539662	116539662	3
chr10	116581502	116659586	FAM160B1	78084	+	NM_001135051	116581837	116659273	17
chr10	116697951	116737439	TRUB1	39488	+	NM_139169	116698012	116735138	8
chr10	116754415	116756352	LOC102724589	1937	+	NR_120677	116756352	116756352	3
chr10	116853123	117708509	ATRNL1	855386	+	NM_207303	116853509	117704290	29
chr10	117816441	118033126	GFRA1	216685	-	NM_005264	117823908	118031541	11
chr10	118083939	118139541	CCDC172	55602	+	NM_198515	118084523	118138870	9
chr10	118187423	118237468	PNLIPRP3	50045	+	NM_001011709	118187524	118236665	12
chr10	118305427	118327367	PNLIP	21940	+	NM_000936	118305604	118327310	13
chr10	118350470	118368687	PNLIPRP1	18217	+	NM_006229	118350641	118368628	13
chr10	118380464	118404654	PNLIPRP2	24190	+	NM_005396	118380487	118404608	13
chr10	118423206	118429481	C10orf82	6275	-	NM_144661	118423680	118427823	5
chr10	118430702	118502085	HSPA12A	71383	-	NM_025015	118434291	118501980	12
chr10	118609022	118642112	ENO4	33090	+	NM_001242699	118609077	118641180	14
chr10	118659822	118886097	SHTN1	226275	-	NM_001258300	118660047	118719733	18
chr10	118888031	118897812	VAX1	9781	-	NM_199131	118891719	118897567	4
chr10	118913031	118928566	MIR3663HG	15535	-	NR_121651	118928566	118928566	3
chr10	118927188	118927285	MIR3663	97	-	NR_037436	118927285	118927285	1
chr10	118956999	118969810	KCNK18	12811	+	NM_181840	118956999	118969810	3
chr10	119000583	119038941	SLC18A2	38358	+	NM_003054	119001204	119036777	16
chr10	119039999	119134978	PDZD8	94979	-	NM_173791	119042778	119134738	5
chr10	119243803	119304579	EMX2OS	60776	-	NR_002791	119304579	119304579	4
chr10	119301955	119309057	EMX2	7102	+	NM_004098	119302778	119307743	3
chr10	119764426	119806114	RAB11FIP2	41688	-	NM_014904	119768508	119805674	5
chr10	119806331	119969665	CASC2	163334	+	NR_026939	119969665	119969665	5
chr10	120068571	120101839	FAM204A	33268	-	NM_022063	120070368	120095927	9
chr10	120116619	120118715	LINC00867	2096	+	NR_108045	120118715	120118715	3
chr10	120352915	120355160	PRLHR	2245	-	NM_004248	120353643	120354756	2
chr10	120440493	120514758	CACUL1	74265	-	NM_153810	120445639	120514274	9
chr10	120789227	120793244	NANOS1	4017	+	NM_199461	120789313	120790192	1
chr10	120794540	120840334	EIF3A	45794	-	NM_003750	120795550	120840188	22
chr10	120819524	120819650	SNORA19	126	-	NR_002917	120819650	120819650	1
chr10	120863576	120897496	FAM45A	33920	+	NM_001303111	120864996	120896159	10
chr10	120863628	120897376	FAM45BP	33748	+	NR_027141	120897376	120897376	9
chr10	120900424	120925204	SFXN4	24780	-	NM_213649	120900753	120925159	14
chr10	120927210	120938377	PRDX3	11167	-	NM_006793	120927991	120938302	7
chr10	120967196	121215131	GRK5	247935	+	NM_005308	120967429	121214579	16
chr10	121137483	121137555	MIR4681	72	+	NR_039829	121137555	121137555	1
chr10	121259338	121302222	RGS10	42884	-	NM_001005339	121259624	121302150	5
chr10	121332977	121356541	TIAL1	23564	-	NM_001033925	121335176	121355977	12
chr10	121410881	121437329	BAG3	26448	+	NM_004281	121411187	121436794	4
chr10	121485558	121588662	INPP5F	103104	+	NM_014937	121485774	121587292	20
chr10	121588915	121633140	MCMBP	44225	-	NM_001256379	121590985	121612616	16
chr10	121652084	121704170	SEC23IP	52086	+	NM_007190	121652294	121693279	19
chr10	121718024	121718104	MIR4682	80	+	NR_039830	121718104	121718104	1
chr10	122216465	122349367	PLPP4	132902	+	NM_001030059	122216817	122349014	7
chr10	122344590	122806858	MIR5694	462268	+	NR_049879	122806858	122806858	5
chr10	122357460	122359635	LINC01561	2175	+	NR_103717	122359635	122359635	1
chr10	122521323	122610691	WDR11-AS1	89368	-	NR_033850	122610691	122610691	3
chr10	122610686	122669038	WDR11	58352	+	NM_018117	122610932	122668225	29
chr10	123237843	123357972	FGFR2	120129	-	NM_000141	123239370	123353331	18
chr10	123499935	123688316	ATE1	188381	-	NM_001288736	123503194	123687946	12
chr10	123687826	123711480	ATE1-AS1	23654	+	NR_120495	123711480	123711480	2
chr10	123716602	123734743	NSMCE4A	18141	-	NM_001167865	123718850	123734680	11
chr10	123748688	124014060	TACC2	265372	+	NM_206862	123781496	124013571	23
chr10	124030820	124097676	BTBD16	66856	+	NM_144587	124034596	124097600	16
chr10	124134093	124191871	PLEKHA1	57778	+	NM_001001974	124152716	124189454	12
chr10	124176480	124176583	MIR3941	103	+	NR_037506	124176583	124176583	1
chr10	124214178	124216868	ARMS2	2690	+	NM_001099667	124214243	124216449	2
chr10	124221040	124274424	HTRA1	53384	+	NM_002775	124221168	124273875	9
chr10	124320180	124403252	DMBT1	83072	+	NM_007329	124320286	124402914	53
chr10	124457224	124459338	C10orf120	2114	-	NM_001010912	124457248	124459306	3
chr10	124516209	124557161	DMBT1P1	40952	+	NR_003570	124557161	124557161	28
chr10	124591670	124605691	CUZD1	14021	-	NM_022034	124591793	124605359	9
chr10	124591670	124639157	FAM24B-CUZD1	47487	-	NR_037915	124639157	124639157	11
chr10	124608609	124639157	FAM24B	30548	-	NM_001204364	124608762	124610031	4
chr10	124639148	124658230	LOC399815	19082	+	NR_027282	124658230	124658230	6
chr10	124670216	124672627	FAM24A	2411	+	NM_001029888	124671150	124672470	3
chr10	124690418	124713919	C10orf88	23501	-	NM_024942	124691942	124713694	6
chr10	124739555	124749907	PSTK	10352	+	NM_153336	124739995	124747019	7
chr10	124750321	124768366	IKZF5	18045	-	NR_073479	124768366	124768366	6
chr10	124768428	124817806	ACADSB	49378	+	NM_001609	124768545	124813281	11
chr10	124895566	124897247	HMX3	1681	+	NM_001105574	124895566	124897247	2
chr10	124907637	124910188	HMX2	2551	+	NM_005519	124907894	124909639	2
chr10	124913759	124924886	BUB3	11127	+	NM_004725	124914433	124923351	8
chr10	125425870	125456913	GPR26	31043	+	NM_153442	125425923	125447676	3
chr10	125505151	125651500	CPXM2	146349	-	NM_198148	125506279	125651175	14
chr10	125767181	125853123	CHST15	85942	-	NM_001270764	125769664	125805728	8
chr10	126085871	126107545	OAT	21674	-	NM_000274	126086510	126100740	10
chr10	126135997	126138550	NKX1-2	2553	-	NM_001146340	126135997	126138512	2
chr10	126150340	126302710	LHPP	152370	+	NM_022126	126150431	126301929	7
chr10	126307862	126432930	FAM53B	125068	-	NM_014661	126311810	126395282	5
chr10	126392596	126403329	FAM53B-AS1	10733	+	NR_120630	126403329	126403329	3
chr10	126446399	126480510	METTL10	34111	-	NM_212554	126449071	126480402	7
chr10	126490353	126525239	FAM175B	34886	+	NM_032182	126490398	126523540	9
chr10	126630691	126676005	ZRANB1	45314	+	NM_017580	126631062	126673561	9
chr10	126676417	126849624	CTBP2	173207	-	NM_001083914	126678086	126727623	11
chr10	126721351	126721439	MIR4296	88	-	NR_036178	126721439	126721439	1
chr10	127262939	127267014	TEX36-AS1	4075	+	NR_023362	127267014	127267014	5
chr10	127344262	127371713	TEX36	27451	-	NM_001128202	127344468	127371558	4
chr10	127371811	127398246	LOC283038	26435	+	NR_033848	127398246	127398246	5
chr10	127393858	127408062	FLJ37035	14204	-	NR_033847	127408062	127408062	5
chr10	127408083	127452712	EDRF1	44629	+	NR_110859	127452712	127452712	26
chr10	127433295	127440629	EDRF1-AS1	7334	-	NR_120633	127440629	127440629	5
chr10	127455026	127464390	MMP21	9364	-	NM_147191	127455230	127464390	7
chr10	127477146	127511837	UROS	34691	-	NM_000375	127477436	127505068	10
chr10	127508308	127508391	MIR4484	83	+	NR_039704	127508391	127508391	1
chr10	127512103	127542264	BCCIP	30161	+	NM_016567	127512126	127541812	8
chr10	127524908	127569884	DHX32	44976	-	NM_018180	127525255	127569393	11
chr10	127585107	127698161	FANK1	113054	+	NM_145235	127585211	127698007	11
chr10	127660756	127661842	FANK1-AS1	1086	-	NR_102707	127661842	127661842	4
chr10	127700953	128077127	ADAM12	376174	-	NM_003474	127705847	128076714	23
chr10	128102437	128110448	LINC00601	8011	-	NR_073453	128110448	128110448	4
chr10	128113573	128210010	C10orf90	96437	-	NM_001004298	128114432	128209889	9
chr10	128593977	129250781	DOCK1	656804	+	NM_001380	128594086	129249691	52
chr10	128933689	128994422	FAM196A	60733	-	NM_001039762	128936100	128974659	6
chr10	129347612	129350935	NPS	3323	+	NM_001030013	129347632	129350903	3
chr10	129535537	129539450	FOXI2	3913	+	NM_207426	129535537	129537229	2
chr10	129676113	129691211	CLRN3	15098	-	NM_152311	129676412	129691048	3
chr10	129705324	129884119	PTPRE	178795	+	NM_001316676	129763259	129881170	22
chr10	129894924	129924468	MKI67	29544	-	NM_002417	129897453	129923931	15
chr10	130084213	130115990	LINC01163	31777	+	NR_120619	130115990	130115990	6
chr10	131265447	131565884	MGMT	300437	+	NM_002412	131265479	131565261	5
chr10	131633495	131762091	EBF3	128596	-	NM_001005463	131636192	131762032	16
chr10	131641562	131641638	MIR4297	76	-	NR_036179	131641638	131641638	1
chr10	131862161	131909081	LINC00959	46920	-	NR_034125	131909081	131909081	8
chr10	131904272	131907101	CTAGE7P	2829	+	NR_044994	131907101	131907101	1
chr10	131934638	131978646	GLRX3	44008	+	NM_001199868	131934684	131977656	12
chr10	132760850	132760931	MIR378C	81	-	NR_036180	132760931	132760931	1
chr10	132890654	133109984	TCERG1L	219330	-	NM_174937	132891424	133109898	12
chr10	132893480	132894040	TCERG1L-AS1	560	+	NR_120623	132894040	132894040	2
chr10	133604733	133622535	LINC01164	17802	-	NR_038365	133622535	133622535	5
chr10	133747954	133773338	PPP2R2D	25384	+	NM_001291310	133757489	133769467	7
chr10	133781186	133795517	BNIP3	14331	-	NM_004052	133782027	133795505	6
chr10	133918312	133998313	JAKMIP3	80001	+	NM_001105521	133918312	133980537	24
chr10	134000413	134019280	DPYSL4	18867	+	NM_006426	134000567	134018434	14
chr10	134020995	134121477	STK32C	100482	-	NM_173575	134021513	134121337	12
chr10	134145613	134195010	LRRC27	49397	+	NM_030626	134147028	134188746	11
chr10	134210701	134231358	PWWP2B	20657	+	NM_138499	134210730	134219777	3
chr10	134258713	134261825	C10orf91	3112	+	NM_173541	134258753	134261565	3
chr10	134351352	134596984	INPP5A	245632	+	NM_005539	134351600	134595445	16
chr10	134598319	134599537	NKX6-2	1218	-	NM_177400	134598419	134599452	3
chr10	134621895	134756089	CFAP46	134194	-	NM_001200049	134621924	134755988	58
chr10	134757470	134778793	LINC01166	21323	-	NR_120627	134778793	134778793	2
chr10	134774843	134775741	LINC01167	898	-	NR_125763	134775741	134775741	2
chr10	134779037	134790001	LINC01168	10964	+	NR_046231	134790001	134790001	3
chr10	134898752	134900201	ADGRA1-AS1	1449	-	NR_111905	134900201	134900201	3
chr10	134901507	134945179	ADGRA1	43672	+	NM_001083909	134902413	134943015	7
chr10	134973970	135039916	KNDC1	65946	+	NM_152643	134973971	135038394	30
chr10	135043777	135045062	UTF1	1285	+	NM_003577	135043792	135044946	2
chr10	135051407	135055434	VENTX	4027	+	NM_014468	135051418	135053810	3
chr10	135059982	135061389	MIR202HG	1407	-	NR_108078	135061389	135061389	3
chr10	135061014	135061124	MIR202	110	-	NR_030170	135061124	135061124	1
chr10	135075919	135090407	ADAM8	14488	-	NM_001109	135076659	135090321	23
chr10	135092133	135125841	TUBGCP2	33708	-	NR_046330	135125841	135125841	18
chr10	135122392	135126666	ZNF511	4274	+	NM_145806	135122447	135126370	6
chr10	135138927	135150475	CALY	11548	-	NM_015722	135139330	135142493	6
chr10	135160843	135166187	PRAP1	5344	+	NM_001145201	135160921	135165944	5
chr10	135168657	135171529	FUOM	2872	-	NM_001301828	135168873	135170709	6
chr10	135175986	135186908	ECHS1	10922	-	NM_004092	135176371	135186837	8
chr10	135185059	135185167	MIR3944	108	-	NR_037509	135185167	135185167	1
chr10	135192740	135205200	PAOX	12460	+	NM_152911	135192820	135204959	7
chr10	135207620	135234174	MTG1	26554	+	NM_138384	135207724	135233669	11
chr10	135234169	135238121	SPRN	3952	-	NM_001012508	135236729	135237185	2
chr10	135267431	135281949	SCART1	14518	+	NR_002934	135281949	135281949	10
chr10	135340866	135352620	CYP2E1	11754	+	NM_000773	135340899	135352468	9
chr10	135367403	135382876	SYCE1	15473	-	NM_130784	135367793	135373622	14
chr10	135380437	135383462	SPRNP1	3025	-	NR_033789	135383462	135383462	2
chr10	135438602	135440299	FRG2B	1697	-	NM_001080998	135438602	135440246	4
chr11	126986	131920	LINC01001	4934	-	NR_028326	131920	131920	3
chr11	193079	194500	SCGB1C2	1421	+	NM_001097610	193099	194450	3
chr11	193079	194573	SCGB1C1	1494	+	NM_145651	193099	194450	3
chr11	196760	200258	ODF3	3498	+	NM_053280	197304	200033	7
chr11	202923	207422	BET1L	4499	-	NM_001098787	205301	207321	4
chr11	207510	215175	RIC8A	7665	+	NM_021932	208854	214350	10
chr11	209335	209406	MIR6743	71	+	NR_106801	209406	209406	1
chr11	215029	236362	SIRT3	21333	-	NM_001017524	216697	233389	7
chr11	236807	252984	PSMD13	16177	+	NM_002817	237049	252600	13
chr11	278569	285388	NLRP6	6819	+	NM_138329	278569	285304	8
chr11	289137	295688	ATHL1	6551	+	NM_025092	289816	294749	14
chr11	298200	299526	IFITM5	1326	-	NM_001025295	298500	299490	2
chr11	308106	309410	IFITM2	1304	+	NM_006435	308192	309165	2
chr11	313990	315272	IFITM1	1282	+	NM_003641	314170	315113	2
chr11	319672	320914	IFITM3	1242	-	NR_049759	320914	320914	2
chr11	369794	382117	B4GALNT4	12323	+	NM_178537	369803	381792	20
chr11	392598	404908	PKP3	12310	+	NM_001303029	392627	404569	14
chr11	405715	417397	SIGIRR	11682	-	NM_001135053	405895	409874	10
chr11	417929	442011	ANO9	24082	-	NM_001012302	418370	441926	23
chr11	450279	491387	PTDSS2	41108	+	NM_030783	450455	490582	12
chr11	494511	507283	RNH1	12772	-	NM_203387	494690	502162	11
chr11	532241	535550	HRAS	3309	-	NM_176795	533295	534322	6
chr11	537521	554916	LRRC56	17395	+	NM_198075	540684	554276	14
chr11	554849	560779	LMNTD2	5930	-	NM_173573	554979	560716	14
chr11	560970	564025	RASSF7	3055	+	NM_001143993	561768	563380	4
chr11	565656	568457	MIR210HG	2801	-	NR_038262	568457	568457	2
chr11	568088	568198	MIR210	110	-	NR_029623	568198	568198	1
chr11	573807	575885	LOC143666	2078	-	NR_026967	575885	575885	1
chr11	576445	612222	PHRF1	35777	+	NM_020901	581512	611777	18
chr11	612554	615999	IRF7	3445	-	NM_001572	612644	615364	11
chr11	616564	625067	CDHR5	8503	-	NM_021924	617350	624902	15
chr11	626312	627173	SCT	861	-	NM_021920	626430	627143	4
chr11	637304	640705	DRD4	3401	+	NM_000797	637304	640603	4
chr11	644219	695754	DEAF1	51535	-	NM_021008	644549	695047	12
chr11	695590	705028	TMEM80	9438	+	NM_001276274	695608	704646	6
chr11	706119	727727	EPS8L2	21608	+	NM_022772	709407	726981	21
chr11	747431	765024	TALDO1	17593	+	NM_006755	747481	764845	8
chr11	767222	777487	PDDC1	10265	-	NM_182612	770896	777462	8
chr11	777577	784284	LOC171391	6707	+	NR_126342	784284	784284	4
chr11	787109	790126	CEND1	3017	-	NM_016564	788126	788576	2
chr11	790474	798269	SLC25A22	7795	-	NM_001191061	791914	795006	10
chr11	797510	799185	PANO1	1675	+	NM_001293167	797625	798273	1
chr11	799178	805250	PIDD1	6072	-	NM_145886	799306	804388	16
chr11	809935	812876	RPLP2	2941	+	NM_001004	810234	812836	5
chr11	811680	811814	SNORA52	134	+	NR_002585	811814	811814	1
chr11	818900	825571	PNPLA2	6671	+	NM_020376	819718	824862	10
chr11	828259	831991	CRACR2B	3732	+	NM_001286606	828607	831709	9
chr11	832951	838835	CD151	5884	+	NM_004357	836069	838192	9
chr11	839720	842529	POLR2L	2809	-	NM_021128	840371	842508	2
chr11	842823	867116	TSPAN4	24293	+	NM_003271	850304	866630	9
chr11	867858	915058	CHID1	47200	-	NM_001142675	869857	904816	13
chr11	925808	1012245	AP2A2	86437	+	NM_001242837	926021	1010625	22
chr11	1012823	1036706	MUC6	23883	-	NM_005961	1013455	1036655	33
chr11	1074874	1104416	MUC2	29542	+	NM_002457	1074901	1104263	50
chr11	1151579	1222366	MUC5AC	70787	+	NM_001304359	1151626	1221928	35
chr11	1244294	1283406	MUC5B	39112	+	NM_002458	1244353	1282838	49
chr11	1277834	1277900	MIR6744	66	+	NR_106802	1277900	1277900	1
chr11	1295597	1330892	TOLLIP	35295	-	NM_019009	1298268	1330728	6
chr11	1330937	1331937	TOLLIP-AS1	1000	+	NR_029409	1331937	1331937	1
chr11	1411128	1483919	BRSK2	72791	+	NR_046331	1483919	1483919	21
chr11	1490677	1508009	MOB2	17332	-	NM_001172223	1491401	1507786	5
chr11	1575280	1593150	DUSP8	17870	-	NM_004420	1577747	1587056	7
chr11	1593970	1620414	KRTAP5-AS1	26444	+	NR_021489	1620414	1620414	2
chr11	1605571	1606513	KRTAP5-1	942	-	NM_001005922	1605642	1606479	1
chr11	1618406	1619524	KRTAP5-2	1118	-	NM_001004325	1618946	1619480	1
chr11	1628794	1629693	KRTAP5-3	899	-	NM_001012708	1628898	1629615	1
chr11	1642187	1643368	KRTAP5-4	1181	-	NM_001012709	1642636	1643323	1
chr11	1651032	1652159	KRTAP5-5	1127	+	NM_001001480	1651070	1651784	1
chr11	1686828	1689086	FAM99A	2258	+	NR_026643	1689086	1689086	3
chr11	1704499	1706859	FAM99B	2360	-	NR_026642	1706859	1706859	3
chr11	1718424	1718985	KRTAP5-6	561	+	NM_001012416	1718475	1718865	1
chr11	1753639	1771824	IFITM10	18185	-	NM_001170820	1756509	1771672	3
chr11	1773981	1785222	CTSD	11241	-	NM_001909	1774732	1785089	9
chr11	1855539	1858751	SYT8	3212	+	NM_138567	1855801	1858661	9
chr11	1860232	1862910	TNNI2	2678	+	NM_003282	1860926	1862781	7
chr11	1874199	1913493	LSP1	39294	+	NM_002339	1874374	1908793	11
chr11	1880693	1880766	MIR4298	73	-	NR_036185	1880766	1880766	1
chr11	1901274	1901377	MIR7847	103	+	NR_107001	1901377	1901377	1
chr11	1917988	1929589	LINC01150	11601	+	NR_120534	1929589	1929589	4
chr11	1940798	1959936	TNNT3	19138	+	NM_006757	1944104	1959722	16
chr11	1968501	1977839	MRPL23	9338	+	NM_021134	1968592	1977650	5
chr11	1970560	1970706	SNORD131	146	+	NR_132974	1970706	1970706	1
chr11	2004438	2011150	MRPL23-AS1	6712	-	NR_024471	2011150	2011150	4
chr11	2012325	2014699	LINC01219	2374	+	NR_126400	2014699	2014699	3
chr11	2013637	2017524	HOTS	3887	+	NM_001293171	2016426	2016882	1
chr11	2016405	2022696	H19	6291	-	NR_131224	2022696	2022696	5
chr11	2017988	2018061	MIR675	73	-	NR_030533	2018061	2018061	1
chr11	2150341	2170833	IGF2	20492	-	NM_001007139	2154216	2156753	5
chr11	2150341	2182439	INS-IGF2	32098	-	NR_003512	2182439	2182439	7
chr11	2155363	2155439	MIR483	76	-	NR_030158	2155439	2155439	1
chr11	2161741	2169896	IGF2-AS	8155	+	NR_028043	2169896	2169896	3
chr11	2181008	2182439	INS	1431	-	NM_000207	2181081	2182201	3
chr11	2185158	2193035	TH	7877	-	NM_199293	2185462	2193016	14
chr11	2194292	2194368	MIR4686	76	+	NR_039834	2194368	2194368	1
chr11	2289727	2292182	ASCL2	2455	-	NM_005170	2290980	2291562	2
chr11	2317506	2323143	C11orf21	5637	-	NM_001142946	2320685	2323091	5
chr11	2323242	2339430	TSPAN32	16188	+	NM_139022	2323379	2339154	10
chr11	2349978	2399222	CD81-AS1	49244	-	NR_108080	2399222	2399222	3
chr11	2397406	2418649	CD81	21243	+	NM_001297649	2415356	2418096	8
chr11	2421717	2425108	TSSC4	3391	+	NM_001297660	2423863	2424853	4
chr11	2425745	2444275	TRPM5	18530	-	NM_014555	2426166	2444266	24
chr11	2466220	2870340	KCNQ1	404120	+	NM_000218	2466328	2869233	16
chr11	2629557	2721228	KCNQ1OT1	91671	-	NR_002728	2721228	2721228	1
chr11	2861364	2882799	KCNQ1-AS1	21435	-	NR_130721	2882799	2882799	3
chr11	2891262	2893336	KCNQ1DN	2074	+	NR_024627	2893336	2893336	2
chr11	2904447	2906995	CDKN1C	2548	-	NM_001122631	2905233	2906686	4
chr11	2908574	2925175	SLC22A18AS	16601	-	NM_007105	2909409	2920931	4
chr11	2920950	2946476	SLC22A18	25526	+	NM_183233	2924575	2946427	11
chr11	2949502	2950650	PHLDA2	1148	-	NM_003311	2950135	2950594	2
chr11	2965659	3013607	NAP1L4	47948	-	NM_005969	2970488	3000450	16
chr11	2985000	2985123	SNORA54	123	-	NR_002982	2985123	2985123	1
chr11	3022151	3078681	CARS	56530	-	NR_036542	3078681	3078681	23
chr11	3108345	3186582	OSBPL5	78237	-	NM_020896	3109434	3150378	22
chr11	3239173	3240043	MRGPRG	870	-	NM_001164377	3239173	3240043	1
chr11	3239561	3244361	MRGPRG-AS1	4800	+	NR_027138	3244361	3244361	2
chr11	3249040	3253616	MRGPRE	4576	-	NM_001039165	3249090	3250029	2
chr11	3379156	3400452	ZNF195	21296	-	NR_046381	3400452	3400452	7
chr11	3402190	3430378	TSSC2	28188	+	NR_024248	3430378	3430378	11
chr11	3411936	3413145	OR7E12P	1209	-	NR_044999	3413145	3413145	1
chr11	3529209	3593217	LOC101927708	64008	-	NR_126335	3593217	3593217	3
chr11	3647689	3658789	TRPC2	11100	+	NR_002720	3658789	3658789	7
chr11	3659735	3663546	ART5	3811	-	NM_001079536	3659967	3663092	5
chr11	3666360	3685646	ART1	19286	+	NM_004314	3680443	3685419	5
chr11	3686816	3692614	CHRNA10	5798	-	NM_001303035	3687336	3688738	5
chr11	3696239	3819022	NUP98	122783	-	NM_016320	3697388	3803347	33
chr11	3818953	3847601	PGAP2	28648	+	NM_001256235	3832520	3846688	8
chr11	3848207	3862213	RHOG	14006	-	NM_001665	3848792	3849368	2
chr11	3876932	4114440	STIM1	237508	+	NM_001277962	3877500	4112556	13
chr11	3877291	3877371	MIR4687	80	+	NR_039835	3877371	3877371	1
chr11	4115923	4160106	RRM1	44183	+	NM_001033	4116242	4159613	19
chr11	4208381	4223883	LOC100506082	15502	+	NR_047550	4223883	4223883	2
chr11	4388492	4389616	OR52B4	1124	-	NM_001005161	4388580	4389525	1
chr11	4406126	4414926	TRIM21	8800	-	NM_003141	4406514	4411639	7
chr11	4470524	4471591	OR52K2	1067	+	NM_001005172	4470569	4471514	1
chr11	4510108	4511138	OR52K1	1030	+	NM_001005171	4510130	4511075	1
chr11	4566420	4567374	OR52M1	954	+	NM_001004137	4566420	4567374	1
chr11	4592652	4599050	C11orf40	6398	-	NM_144663	4592652	4599050	4
chr11	4608020	4609135	OR52I2	1115	+	NM_001005170	4608042	4609095	1
chr11	4615268	4616243	OR52I1	975	+	NM_001005169	4615268	4616243	1
chr11	4619901	4629489	TRIM68	9588	-	NM_018073	4621505	4626734	7
chr11	4660944	4662068	OR51D1	1124	+	NM_001004751	4661020	4661995	1
chr11	4665155	4676716	OR51E1	11561	+	NM_152430	4673756	4674713	2
chr11	4701400	4719076	OR51E2	17676	-	NM_030774	4702978	4703941	2
chr11	4790208	4791147	OR51F1	939	-	NM_001004752	4790208	4791147	1
chr11	4824662	4825610	OR52R1	948	-	NM_001005177	4824662	4825610	1
chr11	4842615	4843644	OR51F2	1029	+	NM_001004753	4842615	4843644	1
chr11	4869466	4870438	OR51S1	972	-	NM_001004758	4869466	4870438	1
chr11	4903048	4904113	OR51T1	1065	+	NM_001004759	4903048	4904113	1
chr11	4928599	4929538	OR51A7	939	+	NM_001004749	4928599	4929538	1
chr11	4935948	4936893	OR51G2	945	-	NM_001005238	4935948	4936893	1
chr11	4944603	4945569	OR51G1	966	-	NM_001005237	4944603	4945569	1
chr11	4967388	4968330	OR51A4	942	-	NM_001005329	4967388	4968330	1
chr11	4976001	4976943	OR51A2	942	-	NM_001004748	4976001	4976943	1
chr11	5009423	5013659	MMP26	4236	+	NM_021801	5009441	5013472	6
chr11	5020212	5021160	OR51L1	948	+	NM_001004755	5020212	5021160	1
chr11	5067755	5068691	OR52J3	936	+	NM_001001916	5067755	5068691	1
chr11	5079879	5080857	OR52E2	978	-	NM_001005164	5079879	5080857	1
chr11	5152921	5153872	OR52A5	951	-	NM_001005160	5152921	5153872	1
chr11	5172660	5173599	OR52A1	939	-	NM_012375	5172660	5173599	1
chr11	5220964	5221930	OR51V1	966	-	NM_001004760	5220964	5221930	1
chr11	5246695	5248301	HBB	1606	-	NM_000518	5246827	5248251	3
chr11	5254058	5255858	HBD	1800	-	NM_000519	5254193	5255663	3
chr11	5263184	5264822	HBBP1	1638	-	NR_001589	5264822	5264822	3
chr11	5265783	5266776	BGLT3	993	-	NR_121648	5266776	5266776	1
chr11	5269501	5271087	HBG1	1586	-	NM_000559	5269588	5271034	3
chr11	5274420	5276011	HBG2	1591	-	NM_000184	5274506	5275958	3
chr11	5289579	5291373	HBE1	1794	-	NM_005330	5289698	5291120	3
chr11	5322243	5323176	OR51B4	933	-	NM_033179	5322243	5323176	1
chr11	5344527	5345582	OR51B2	1055	-	NM_033180	5344588	5345527	1
chr11	5362112	5526882	OR51B5	164770	-	NR_038321	5526882	5526882	5
chr11	5372737	5373676	OR51B6	939	+	NM_001004750	5372737	5373676	1
chr11	5410606	5411664	OR51M1	1058	+	NM_001004756	5410628	5411609	1
chr11	5443340	5444436	OR51Q1	1096	+	NM_001004757	5443430	5444384	1
chr11	5461771	5462783	OR51I1	1012	-	NM_001005288	5461799	5462744	1
chr11	5474637	5475707	OR51I2	1070	+	NM_001004754	5474718	5475657	1
chr11	5509914	5510978	OR52D1	1064	+	NM_001005163	5509936	5510893	1
chr11	5528529	5531153	UBQLN3	2624	-	NM_017481	5528820	5530788	2
chr11	5535622	5537956	UBQLNL	2334	-	NM_145053	5536243	5537671	1
chr11	5539539	5543015	OLFM5P	3476	-	NR_133006	5543015	5543015	3
chr11	5565790	5566753	OR52H1	963	-	NM_001005289	5565790	5566753	1
chr11	5602106	5603114	OR52B6	1008	+	NM_001005162	5602106	5603114	1
chr11	5617330	5634188	TRIM6	16858	+	NM_058166	5624542	5632572	8
chr11	5617864	5665625	TRIM6-TRIM34	47761	+	NM_001003819	5618127	5664939	14
chr11	5641173	5665625	TRIM34	24452	+	NM_001003827	5653561	5664939	8
chr11	5684424	5706339	TRIM5	21915	-	NM_033034	5686038	5701407	8
chr11	5710816	5732093	TRIM22	21277	+	NM_001199573	5717462	5730878	8
chr11	5757677	5758768	OR56B1	1091	+	NM_001005180	5757746	5758721	1
chr11	5775922	5776959	OR52N4	1037	+	NM_001005175	5775970	5776936	1
chr11	5798863	5799897	OR52N5	1034	-	NM_001001922	5798889	5799864	1
chr11	5809083	5810046	OR52N1	963	-	NM_001001913	5809083	5810046	1
chr11	5841565	5842531	OR52N2	966	+	NM_001005174	5841565	5842531	1
chr11	5862185	5863127	OR52E6	942	-	NM_001005167	5862185	5863127	1
chr11	5877978	5878932	OR52E8	954	-	NM_001005168	5877978	5878932	1
chr11	5905522	5906461	OR52E4	939	+	NM_001005165	5905522	5906461	1
chr11	5968576	5969524	OR56A3	948	+	NM_001003443	5968576	5969524	1
chr11	5988782	5989724	OR56A5	942	-	NM_001146033	5988782	5989724	1
chr11	6007121	6008215	OR52L1	1094	-	NM_001005173	6007170	6008160	1
chr11	6023280	6024378	OR56A4	1098	-	NM_001005179	6023280	6024378	1
chr11	6047900	6048971	OR56A1	1071	-	NM_001001917	6047977	6048934	1
chr11	6128913	6130065	OR56B4	1152	+	NM_001005181	6129008	6129968	1
chr11	6190584	6191556	OR52B2	972	-	NM_001004052	6190584	6191556	1
chr11	6220453	6221416	OR52W1	963	+	NM_001005178	6220453	6221416	1
chr11	6226797	6232365	C11orf42	5568	+	NM_173525	6226845	6232272	3
chr11	6232563	6255941	FAM160A2	23378	-	NM_001098794	6232735	6245746	12
chr11	6260321	6265707	CNGA4	5386	+	NM_001037329	6260436	6265639	6
chr11	6280903	6293357	CCKBR	12454	+	NM_176875	6281158	6292773	5
chr11	6340175	6341740	PRKCDBP	1565	-	NM_145040	6340392	6341706	2
chr11	6411643	6416228	SMPD1	4585	+	NM_000543	6411828	6415837	6
chr11	6416353	6440702	APBB1	24349	-	NM_145689	6416763	6432577	14
chr11	6452267	6462254	HPX	9987	-	NM_000613	6452440	6462193	10
chr11	6469842	6495689	TRIM3	25847	-	NM_001248006	6470257	6486925	12
chr11	6495912	6502709	ARFIP2	6797	-	NM_012402	6498342	6501651	8
chr11	6502676	6505911	TIMM10B	3235	+	NM_012192	6502746	6503451	3
chr11	6518525	6593254	DNHD1	74729	+	NM_144666	6519445	6593216	43
chr11	6621143	6624880	RRP8	3737	-	NM_015324	6621375	6624732	7
chr11	6624937	6632105	ILK	7168	+	NM_004517	6625501	6631842	13
chr11	6632047	6633475	TAF10	1428	-	NM_006284	6632152	6633420	5
chr11	6633996	6640692	TPP1	6696	-	NM_000391	6635776	6640631	13
chr11	6642554	6677080	DCHS1	34526	-	NM_003737	6643009	6662844	21
chr11	6701615	6704632	MRPL17	3017	-	NM_022061	6703348	6704527	3
chr11	6734380	6743110	GVINP1	8730	-	NR_003945	6743110	6743110	1
chr11	6789237	6790188	OR2AG2	951	-	NM_001004490	6789237	6790188	1
chr11	6806247	6807245	OR2AG1	998	+	NM_001004489	6806268	6807219	1
chr11	6815755	6817139	OR6A2	1384	-	NM_003696	6815955	6816939	1
chr11	6866913	6867867	OR10A5	954	+	NM_178168	6866913	6867867	1
chr11	6890985	6891897	OR10A2	912	+	NM_001004460	6890985	6891897	1
chr11	6897855	6898850	OR10A4	995	+	NM_207186	6897878	6898826	1
chr11	6912804	6913731	OR2D2	927	-	NM_003700	6912804	6913731	1
chr11	6942232	6943225	OR2D3	993	+	NM_001004684	6942232	6943225	1
chr11	6947653	6979278	ZNF215	31625	+	NM_013250	6953503	6977762	7
chr11	7020548	7041586	ZNF214	21038	-	NM_013249	7021092	7024066	3
chr11	7041699	7092757	NLRP14	51058	+	NM_176822	7059817	7092539	12
chr11	7110164	7112379	RBMXL2	2215	+	NM_014469	7110351	7111530	1
chr11	7255996	7256068	MIR302E	72	+	NR_031683	7256068	7256068	1
chr11	7273180	7490276	SYT9	217096	+	NM_175733	7273417	7488031	7
chr11	7458867	7487066	LOC100506258	28199	-	NR_103855	7487066	7487066	5
chr11	7506599	7532606	OLFML1	26007	+	NM_198474	7507106	7531419	3
chr11	7534995	7674996	PPFIBP2	140001	+	NM_003621	7570706	7674449	24
chr11	7686325	7695474	CYB5R2	9149	-	NM_001302826	7686604	7694056	9
chr11	7711154	7727941	OVCH2	16787	-	NM_198185	7711185	7727941	16
chr11	7817520	7818489	OR5P2	969	-	NM_153444	7817520	7818489	1
chr11	7846583	7847519	OR5P3	936	-	NM_153445	7846583	7847519	1
chr11	7870597	7871118	OR5E1P	521	+	NR_027711	7871118	7871118	1
chr11	7872297	7927502	LOC283299	55205	-	NR_036678	7927502	7927502	8
chr11	7949264	7950209	OR10A6	945	-	NM_001004461	7949264	7950209	1
chr11	7960122	7961067	OR10A3	945	-	NM_001003745	7960122	7961067	1
chr11	7981155	7985059	NLRP10	3904	-	NM_176821	7981190	7985042	2
chr11	8008866	8017719	EIF3F	8853	+	NM_003754	8008899	8017569	8
chr11	8032824	8038056	CASC23	5232	-	NR_125366	8038056	8038056	3
chr11	8060179	8127654	TUB	67475	+	NM_003320	8060420	8123166	13
chr11	8081584	8090920	TUB-AS1	9336	+	NR_120537	8090920	8090920	4
chr11	8127596	8190590	RIC3	62994	-	NR_045405	8190590	8190590	7
chr11	8245850	8290182	LMO1	44332	-	NM_001270428	8246162	8289995	4
chr11	8413412	8615836	STK33	202424	-	NM_001289058	8414056	8496329	14
chr11	8633583	8680383	TRIM66	46800	-	NM_014818	8639490	8673355	20
chr11	8703994	8711419	RPL27A	7425	+	NM_000990	8704360	8707353	5
chr11	8705773	8705903	SNORA3A	130	+	NR_002580	8705903	8705903	1
chr11	8706985	8707116	SNORA3B	131	+	NR_002977	8707116	8707116	1
chr11	8714898	8932498	ST5	217600	-	NM_005418	8715642	8772247	23
chr11	8790324	8831823	LOC102724784	41499	+	NR_120590	8831823	8831823	5
chr11	8932700	8941626	AKIP1	8926	+	NM_020642	8932996	8941027	6
chr11	8941622	8954553	C11orf16	12931	-	NM_020643	8942862	8953855	7
chr11	8959118	8964580	ASCL3	5462	-	NM_020646	8959162	8959708	2
chr11	8968747	8986558	TMEM9B	17811	-	NM_001286095	8969866	8977820	5
chr11	8986221	8997830	TMEM9B-AS1	11609	+	NR_073431	8997830	8997830	5
chr11	9002122	9025596	NRIP3	23474	-	NM_020645	9005091	9025482	7
chr11	9041046	9113150	SCUBE2	72104	-	NM_020974	9042591	9113075	22
chr11	9111858	9111926	MIR5691	68	-	NR_049874	9111926	9111926	1
chr11	9115909	9117737	KRT8P41	1828	+	NR_027713	9117737	9117737	1
chr11	9160374	9286873	DENND5A	126499	-	NM_001243254	9161321	9286616	23
chr11	9302200	9336315	TMEM41B	34115	-	NR_028491	9336315	9336315	8
chr11	9406168	9469674	IPO7	63506	+	NM_006391	9406310	9466741	25
chr11	9450312	9450501	SNORA23	189	+	NR_002962	9450501	9450501	1
chr11	9481102	9482245	LOC644656	1143	-	NR_036539	9482245	9482245	1
chr11	9482511	9550071	ZNF143	67560	+	NM_001282656	9492855	9549160	16
chr11	9595227	9611313	WEE1	16086	+	NM_003390	9595480	9610149	11
chr11	9685623	9774538	SWAP70	88915	+	NM_015055	9685726	9771517	12
chr11	9776316	9781080	LOC440028	4764	-	NR_033972	9781080	9781080	3
chr11	9779839	9832866	SBF2-AS1	53027	+	NR_036485	9832866	9832866	3
chr11	9800213	10315754	SBF2	515541	-	NM_030962	9801964	10315616	40
chr11	9860688	9950808	LOC101928008	90120	+	NR_120539	9950808	9950808	3
chr11	10326526	10328949	ADM	2423	+	NM_001124	10327247	10328188	4
chr11	10329859	10452220	CAND1.11	122361	+	NR_103765	10452220	10452220	4
chr11	10471867	10529126	AMPD3	57259	+	NM_001172431	10503660	10527431	14
chr11	10529433	10530723	MTRNR2L8	1290	-	NM_001190702	10529698	10529773	1
chr11	10529816	10529873	MIR4485	57	-	NR_039705	10529873	10529873	1
chr11	10533224	10562774	RNF141	29550	-	NM_016422	10536462	10555705	6
chr11	10562782	10621479	MRVI1-AS1	58697	+	NR_046374	10621479	10621479	5
chr11	10579412	10590365	LYVE1	10953	-	NM_006691	10580657	10590079	6
chr11	10594637	10715535	MRVI1	120898	-	NM_130385	10597878	10715149	21
chr11	10772533	10801302	CTR9	28769	+	NM_014633	10772959	10800652	25
chr11	10818592	10830582	EIF4G2	11990	-	NM_001418	10819362	10828842	22
chr11	10823013	10823155	SNORD97	142	-	NR_004403	10823155	10823155	1
chr11	10830843	10844478	LOC101928053	13635	+	NR_120540	10844478	10844478	3
chr11	10874250	10879620	ZBED5	5370	-	NM_001143667	10874410	10876492	3
chr11	10879763	10900823	ZBED5-AS1	21060	+	NR_034137	10900823	10900823	3
chr11	11292420	11643561	GALNT18	351141	-	NM_198516	11292690	11643140	11
chr11	11373488	11374904	CSNK2A3	1416	-	NM_001256686	11373490	11374666	1
chr11	11678197	11678269	MIR4299	72	-	NR_036184	11678269	11678269	1
chr11	11804681	11804769	MIR8070	88	-	NR_107037	11804769	11804769	1
chr11	11862969	11980872	USP47	117903	+	NM_001282659	11863732	11977722	28
chr11	11984542	12030917	DKK3	46375	-	NM_013253	11986010	12030129	8
chr11	12132122	12285337	MICAL2	153215	+	NM_014632	12183702	12284067	28
chr11	12185229	12185314	MIR6124	85	+	NR_106739	12185314	12185314	1
chr11	12308446	12380691	MICALCL	72245	+	NM_032867	12313715	12380026	9
chr11	12399025	12556903	PARVA	157878	+	NM_018222	12399074	12549472	13
chr11	12695968	12966284	TEAD1	270316	+	NM_021961	12785779	12958769	13
chr11	13001080	13011095	LINC00958	10015	-	NR_038904	13011095	13011095	2
chr11	13030969	13033653	RASSF10	2684	+	NM_001080521	13031123	13032647	1
chr11	13299273	13408812	ARNTL	109539	+	NM_001297719	13375855	13408303	20
chr11	13409542	13484844	BTBD10	75302	-	NM_032320	13410377	13466671	9
chr11	13513591	13517722	PTH	4131	-	NM_001316352	13513951	13517679	3
chr11	13690205	13753893	FAR1	63688	+	NM_032228	13716312	13750321	12
chr11	13984183	14289679	SPON1	305496	+	NM_006108	13984451	14287233	16
chr11	14299465	14386052	RRAS2	86587	-	NM_001177314	14300882	14385939	6
chr11	14479048	14521441	COPB1	42393	-	NM_001144061	14479369	14520474	22
chr11	14526421	14665180	PSMA1	138759	-	NM_148976	14526737	14632532	11
chr11	14665268	14893604	PDE3B	228336	+	NM_000922	14665621	14891206	16
chr11	14899555	14913751	CYP2R1	14196	-	NM_024514	14899667	14913751	5
chr11	14988214	14993832	CALCA	5618	-	NR_125898	14993832	14993832	6
chr11	15095145	15100177	CALCB	5032	+	NM_000728	15096264	15098991	5
chr11	15133969	15268756	INSC	134787	+	NM_001031853	15134015	15267586	13
chr11	15665430	15726914	LOC102724957	61484	+	NM_001293172	15665475	15726827	3
chr11	15987994	16497935	SOX6	509941	-	NM_033326	15994354	16362794	16
chr11	15991078	15991167	MIR6073	89	-	NR_106721	15991167	15991167	1
chr11	16760147	16779901	C11orf58	19754	+	NM_014267	16760325	16776651	5
chr11	16809206	17035963	PLEKHA7	226757	-	NM_175058	16810633	17035948	23
chr11	17073432	17074591	OR7E14P	1159	+	NR_045002	17074591	17074591	1
chr11	17095938	17099220	RPS13	3282	-	NM_001017	17095979	17099188	6
chr11	17108123	17191354	PIK3C2A	83231	-	NM_002645	17111284	17191288	32
chr11	17298285	17353070	NUCB2	54785	+	NM_005013	17316870	17352966	14
chr11	17353588	17371520	LOC105376575	17932	+	NR_132751	17371520	17371520	3
chr11	17373308	17398868	NCR3LG1	25560	+	NM_001202439	17373516	17394059	5
chr11	17406795	17410878	KCNJ11	4083	-	NM_001166290	17408465	17409377	2
chr11	17414431	17498392	ABCC8	83961	-	NM_000352	17414537	17498323	39
chr11	17515441	17565963	USH1C	50522	-	NM_153676	17515878	17565854	27
chr11	17568919	17667491	OTOG	98572	+	NM_001292063	17568919	17667491	56
chr11	17716813	17718486	LOC102723330	1673	-	NR_132279	17718486	17718486	2
chr11	17741109	17743678	MYOD1	2569	+	NM_002478	17741329	17743055	3
chr11	17757494	17804602	KCNC1	47108	+	NM_001112741	17757549	17803281	4
chr11	17809595	18034709	SERGEF	225114	-	NR_104040	18034709	18034709	12
chr11	18042083	18062335	TPH1	20252	-	NM_004179	18042537	18062309	10
chr11	18101889	18127638	SAAL1	25749	-	NM_138421	18101945	18127588	12
chr11	18134018	18137679	SAA3P	3661	-	NR_026576	18137679	18137679	3
chr11	18142501	18160027	MRGPRX3	17526	+	NM_054031	18158749	18159718	3
chr11	18194383	18195827	MRGPRX4	1444	+	NM_054032	18194803	18195772	1
chr11	18230684	18235111	LOC494141	4427	+	NR_026564	18235111	18235111	3
chr11	18252901	18258384	SAA4	5483	-	NM_006512	18253048	18257473	4
chr11	18252901	18270221	SAA2-SAA4	17320	-	NM_001199744	18253048	18269558	6
chr11	18259779	18270221	SAA2	10442	-	NM_001127380	18261494	18269558	4
chr11	18287807	18291523	SAA1	3716	+	NM_001178006	18288434	18291402	5
chr11	18300216	18343721	HPS5	43505	-	NM_181507	18301428	18339405	23
chr11	18343815	18388590	GTF2H1	44775	+	NM_001142307	18354621	18387416	16
chr11	18415935	18429765	LDHA	13830	+	NM_005566	18418389	18428828	8
chr11	18433852	18472793	LDHC	38941	+	NM_017448	18434264	18472674	8
chr11	18477373	18501147	LDHAL6A	23774	+	NM_001144071	18478227	18500417	8
chr11	18501857	18548503	TSG101	46646	-	NM_006292	18502092	18548363	10
chr11	18552949	18610293	UEVLD	57344	-	NM_001040697	18553866	18610201	12
chr11	18621350	18631802	SPTY2D1-AS1	10452	+	NR_038360	18631802	18631802	5
chr11	18627947	18656020	SPTY2D1	28073	-	NM_194285	18631407	18655804	6
chr11	18720281	18726332	TMEM86A	6051	+	NM_153347	18720433	18723556	3
chr11	18725851	18747777	IGSF22	21926	-	NM_173588	18726014	18745783	23
chr11	18749474	18814268	PTPN5	64794	-	NM_001278236	18750480	18793505	15
chr11	18955359	18956549	MRGPRX1	1190	-	NM_147199	18955362	18956331	1
chr11	19076002	19082228	MRGPRX2	6226	-	NM_054030	19076956	19077949	2
chr11	19138691	19197967	ZDHHC13	59276	+	NM_019028	19138796	19197507	17
chr11	19203576	19232118	CSRP3	28542	-	NM_003476	19204216	19213995	7
chr11	19245609	19263202	E2F8	17593	-	NM_001256372	19246204	19261668	13
chr11	19372270	20143147	NAV2	770877	+	NM_001111018	19372499	20139804	38
chr11	19524219	19528776	NAV2-AS5	4557	-	NR_049725	19528776	19528776	3
chr11	19532439	19545625	NAV2-AS4	13186	-	NR_033989	19545625	19545625	4
chr11	19596856	19596919	MIR4486	63	+	NR_039706	19596919	19596919	1
chr11	19732479	19736218	LOC100126784	3739	-	NR_015384	19736218	19736218	1
chr11	19781549	19781629	MIR4694	80	-	NR_039843	19781629	19781629	1
chr11	20065320	20070849	NAV2-AS2	5529	-	NR_046672	20070849	20070849	2
chr11	20177759	20181870	DBX1	4111	-	NM_001029865	20177759	20181870	4
chr11	20385230	20405329	HTATIP2	20099	+	NM_006410	20385783	20404751	6
chr11	20409075	20530879	PRMT3	121804	+	NM_005788	20409292	20529959	16
chr11	20620945	20676610	SLC6A5	55665	+	NM_004211	20621218	20676414	16
chr11	20691096	21597229	NELL1	906133	+	NM_001288713	20691269	21596568	21
chr11	22214721	22304913	ANO5	90192	+	NM_213599	22215038	22301311	22
chr11	22359666	22401046	SLC17A6	41380	+	NM_020346	22360079	22399286	12
chr11	22467217	22513565	LINC01495	46348	-	NR_120583	22513565	22513565	4
chr11	22644078	22647387	FANCF	3309	-	NM_022725	22646231	22647356	1
chr11	22688159	22834547	GAS2	146388	+	NM_001143830	22696415	22833562	8
chr11	22843597	22851382	SVIP	7785	-	NM_148893	22844664	22851294	4
chr11	22868467	22881972	CCDC179	13505	-	NM_001195637	22869055	22881967	4
chr11	23440650	23440736	MIR8054	86	-	NR_107021	23440736	23440736	1
chr11	24518515	25104186	LUZP2	585671	+	NM_001252008	24759773	25100204	12
chr11	26210669	26684836	ANO3	474167	+	NM_001313726	26210723	26681991	28
chr11	26307131	26309554	LOC105376599	2423	-	NR_132968	26309554	26309554	3
chr11	26580578	26593815	MUC15	13237	-	NM_001135091	26582611	26588641	5
chr11	26688565	26743574	SLC5A12	55009	-	NM_178498	26692648	26743261	15
chr11	27015627	27018632	FIBIN	3005	+	NM_203371	27016073	27016709	1
chr11	27062508	27149354	BBOX1	86846	+	NM_003986	27076977	27149000	9
chr11	27068732	27240315	BBOX1-AS1	171583	-	NR_125768	27240315	27240315	4
chr11	27360060	27384795	CCDC34	24735	-	NM_030771	27360367	27384741	6
chr11	27387507	27494334	LGR4	106827	-	NM_018490	27389413	27493849	18
chr11	27493277	27503980	LOC105376671	10703	+	NR_131170	27503980	27503980	4
chr11	27515964	27528326	LIN7C	12362	-	NM_018362	27520195	27528299	5
chr11	27528398	27719718	BDNF-AS	191320	+	NR_033312	27719718	27719718	9
chr11	27536516	27536594	MIR8087	78	-	NR_107054	27536594	27536594	1
chr11	27639172	27656174	LINC00678	17002	-	NR_102708	27656174	27656174	4
chr11	27676441	27743605	BDNF	67164	-	NM_170731	27679367	27742961	2
chr11	28042162	28129746	KIF18A	87584	-	NM_031217	28042746	28119494	17
chr11	28078361	28078457	MIR610	96	+	NR_030341	28078457	28078457	1
chr11	28129797	28355054	METTL15	225257	+	NM_152636	28134881	28349685	8
chr11	28499027	28499095	MIR8068	68	-	NR_107035	28499095	28499095	1
chr11	30001667	30003940	LINC01616	2273	-	NR_132652	30003940	30003940	1
chr11	30031287	30038577	KCNA4	7290	-	NM_002233	30032263	30034225	2
chr11	30252562	30256824	FSHB	4262	+	NM_000510	30253449	30255347	3
chr11	30344645	30359770	ARL14EP	15125	+	NM_152316	30352495	30358342	4
chr11	30406039	30607930	MPPED2	201891	-	NM_001145399	30410435	30601920	7
chr11	30885149	31014233	DCDC5	129084	-	NM_020869	30900130	30974027	20
chr11	31284170	31391357	DCDC1	107187	-	NM_181807	31284609	31349827	9
chr11	31391376	31454382	DNAJC24	63006	+	NM_181706	31392295	31451948	5
chr11	31453945	31531175	IMMP1L	77230	-	NM_144981	31454046	31484823	7
chr11	31531275	31806073	ELP4	274798	+	NM_001288726	31531331	31804977	12
chr11	31806339	31839509	PAX6	33170	-	NM_001258462	31811481	31827959	14
chr11	31838113	31908587	DKFZp686K1684	70474	+	NR_033971	31908587	31908587	3
chr11	31848113	31850850	PAUPAR	2737	+	NR_117094	31850850	31850850	1
chr11	32057524	32062864	LOC100506675	5340	-	NR_120526	32062864	32062864	3
chr11	32112476	32127272	RCN1	14796	+	NM_002901	32112742	32126018	6
chr11	32165287	32165458	SNORA88	171	-	NR_132770	32165458	32165458	1
chr11	32409321	32457081	WT1	47760	-	NM_024424	32410603	32456891	10
chr11	32457063	32480315	WT1-AS	23252	+	NR_120548	32480315	32480315	5
chr11	32605312	32624419	EIF3M	19107	+	NM_006360	32605433	32623945	11
chr11	32623625	32816204	CCDC73	192579	-	NM_001008391	32624356	32781789	18
chr11	32851480	32879669	PRRG4	28189	+	NM_024081	32852075	32875073	6
chr11	32914723	33001814	QSER1	87091	+	NM_001076786	32949572	32998020	13
chr11	33037409	33055128	DEPDC7	17719	+	NM_001077242	33037501	33055001	9
chr11	33060962	33095109	TCP11L1	34147	+	NM_018393	33065319	33094222	10
chr11	33097695	33101000	LINC00294	3305	+	NR_015451	33101000	33101000	1
chr11	33106129	33183037	CSTF3	76908	-	NM_001326	33106632	33182871	21
chr11	33183202	33213142	CSTF3-AS1	29940	+	NR_034027	33213142	33213142	4
chr11	33278217	33378568	HIPK3	100351	+	NM_001278163	33307960	33375114	16
chr11	33563876	33695646	KIAA1549L	131770	+	NM_012194	33564000	33689700	20
chr11	33719653	33722286	C11orf91	2633	-	NM_001166692	33719974	33722286	2
chr11	33724555	33758025	CD59	33470	-	NM_203330	33731671	33743991	6
chr11	33762489	33796071	FBXO3	33582	-	NM_012175	33763453	33796043	11
chr11	33796244	33797216	FBXO3-AS1	972	+	NR_120550	33797216	33797216	3
chr11	33880122	33913836	LMO2	33714	-	NM_005574	33880901	33891262	6
chr11	34073229	34124157	CAPRIN1	50928	+	NM_005898	34073967	34120914	19
chr11	34127110	34168458	NAT10	41348	+	NM_024662	34129772	34167739	29
chr11	34172533	34379555	ABTB2	207022	-	NM_145804	34173933	34379130	17
chr11	34460471	34493607	CAT	33136	+	NM_001752	34460560	34492980	13
chr11	34500341	34535347	ELF5	35006	-	NM_001422	34501764	34527296	7
chr11	34642587	34684834	EHF	42247	+	NM_012153	34664177	34680478	9
chr11	34903842	34937958	APIP	34116	-	NM_015957	34904263	34937831	7
chr11	34937676	35017675	PDHX	79999	+	NM_003477	34938202	35016719	11
chr11	34963383	34963467	MIR1343	84	+	NR_039836	34963467	34963467	1
chr11	35154196	35159579	LOC100507144	5383	-	NR_120528	35159579	35159579	3
chr11	35160416	35253949	CD44	93533	+	NM_000610	35160850	35250880	18
chr11	35272751	35441610	SLC1A2	168859	-	NM_001252652	35282440	35339053	12
chr11	35453375	35551848	PAMR1	98473	-	NM_001282675	35453903	35515773	13
chr11	35639734	35642421	FJX1	2687	+	NM_014344	35640184	35641498	1
chr11	35684299	35832603	TRIM44	148304	+	NM_017583	35684659	35827935	5
chr11	35965530	36253686	LDLRAD3	288156	+	NM_174902	35965648	36250947	6
chr11	36031647	36031754	MIR3973	107	+	NR_039769	36031754	36031754	1
chr11	36293841	36310999	COMMD9	17158	-	NM_001307937	36296181	36308394	7
chr11	36317724	36486754	PRR5L	169030	+	NM_001160167	36422671	36484286	9
chr11	36505316	36531863	TRAF6	26547	-	NM_145803	36511387	36523065	8
chr11	36589562	36601310	RAG1	11748	+	NM_000448	36594854	36597986	2
chr11	36613492	36619829	RAG2	6337	-	NM_001243786	36614134	36615718	3
chr11	36616042	36680841	C11orf74	64799	+	NM_001276723	36631653	36680736	6
chr11	38639813	38667906	LOC103312105	28093	-	NR_120555	38667906	38667906	5
chr11	38670407	38676799	LINC01493	6392	+	NR_120553	38676799	38676799	3
chr11	40135750	41481186	LRRC4C	1345436	-	NM_001258419	40135919	40137842	7
chr11	41736117	41857992	LINC01499	121875	+	NR_120584	41857992	41857992	6
chr11	42209292	42275240	LOC100507205	65948	-	NR_038309	42275240	42275240	6
chr11	43283053	43290919	HNRNPKP3	7866	-	NR_033868	43290919	43290919	2
chr11	43333504	43366080	API5	32576	+	NR_024625	43366080	43366080	15
chr11	43380434	43516483	TTC17	136049	+	NM_018259	43380504	43515454	24
chr11	43581205	43581303	MIR670	98	+	NR_031577	43581303	43581303	1
chr11	43590855	43591950	MIR670HG	1095	+	NR_131246	43591950	43591950	2
chr11	43602943	43603033	MIR129-2	90	+	NR_029697	43603033	43603033	1
chr11	43702142	43878169	HSD17B12	176027	+	NM_016142	43702377	43876798	11
chr11	43902356	43941825	ALKBH3	39469	+	NM_139178	43904202	43941560	10
chr11	43918852	43921424	SEC14L1P1	2572	+	NR_026952	43921424	43921424	1
chr11	43930838	43942494	ALKBH3-AS1	11656	-	NR_038907	43942494	43942494	6
chr11	43964105	43965433	C11orf96	1328	+	NM_001145033	43964454	43964823	1
chr11	44069530	44081527	ACCSL	11997	+	NM_001031854	44069586	44081470	14
chr11	44087728	44105569	ACCS	17841	+	NM_001127219	44089177	44105342	15
chr11	44117098	44266980	EXT2	149882	+	NM_001178083	44129262	44265837	15
chr11	44282277	44331716	ALX4	49439	-	NM_021926	44286403	44331612	4
chr11	44587140	44641315	CD82	54175	+	NM_002231	44616212	44640676	10
chr11	44785975	44953977	TSPAN18	168002	+	NM_130783	44927967	44950729	9
chr11	44953898	44972857	TP53I11	18959	-	NM_001258322	44956434	44959886	8
chr11	44995452	44999578	LOC221122	4126	+	NR_026681	44999578	44999578	4
chr11	45115563	45246639	PRDM11	131076	+	NR_046338	45246639	45246639	8
chr11	45261852	45307884	SYT13	46032	-	NM_001247987	45265602	45275932	8
chr11	45376921	45378208	LOC101928812	1287	+	NR_120557	45378208	45378208	2
chr11	45392947	45410059	LOC399886	17112	+	NR_122071	45410059	45410059	5
chr11	45669238	45687206	CHST1	17968	-	NM_003654	45671237	45672473	4
chr11	45713253	45713326	MIR7154	73	-	NR_106976	45713326	45713326	1
chr11	45743857	45746106	LOC100507384	2249	+	NR_047569	45746106	45746106	3
chr11	45792982	45793909	DKFZp779M0652	927	+	NR_027134	45793909	45793909	2
chr11	45825622	45834567	SLC35C1	8945	+	NM_001145266	45827391	45832886	3
chr11	45868668	45904799	CRY2	36131	+	NM_001127457	45868800	45893782	12
chr11	45907046	45928016	MAPK8IP1	20970	+	NM_005456	45907371	45927272	12
chr11	45928085	45928833	C11orf94	748	-	NM_001080446	45928119	45928796	3
chr11	45931219	45939674	PEX16	8455	-	NM_004813	45931804	45939362	11
chr11	45943171	45950647	GYLTL1B	7476	+	NM_001300722	45944433	45950396	15
chr11	45950869	46142985	PHF21A	192116	-	NM_001101802	45955518	46105770	18
chr11	46193505	46198656	LOC101928894	5151	+	NR_120565	46198656	46198656	3
chr11	46299188	46342972	CREB3L1	43784	+	NM_052854	46299662	46342296	12
chr11	46354454	46402104	DGKZ	47650	+	NM_201532	46354825	46401497	31
chr11	46397951	46398034	MIR4688	83	+	NR_039837	46398034	46398034	1
chr11	46402333	46405387	MDK	3054	+	NM_001270550	46403607	46405044	5
chr11	46406341	46408158	CHRM4	1817	-	NM_000741	46406667	46408107	1
chr11	46417961	46615619	AMBRA1	197658	-	NM_001267782	46418999	46569930	20
chr11	46473354	46473439	MIR3160-1	85	-	NR_036117	46473439	46473439	1
chr11	46473356	46473437	MIR3160-2	81	+	NR_036118	46473437	46473437	1
chr11	46624855	46638777	HARBI1	13922	-	NM_173811	46625079	46637787	3
chr11	46638825	46697568	ATG13	58743	+	NM_001142673	46665841	46693882	18
chr11	46698624	46722215	ARHGAP1	23591	-	NM_004308	46700586	46717657	13
chr11	46722316	46727466	ZNF408	5150	+	NM_024741	46722597	46727413	5
chr11	46740715	46761058	F2	20343	+	NM_000506	46740785	46760958	14
chr11	46765083	46867859	CKAP5	102776	-	NM_001008938	46765572	46842782	44
chr11	46774674	46774742	MIR5582	68	-	NR_049846	46774742	46774742	1
chr11	46783938	46784049	SNORD67	111	-	NR_003056	46784049	46784049	1
chr11	46867961	46895967	LRP4-AS1	28006	+	NR_038909	46895967	46895967	3
chr11	46878267	46940173	LRP4	61906	-	NM_002334	46880533	46939930	38
chr11	46958239	47185931	C11orf49	227692	+	NM_001003678	46958356	47185803	9
chr11	47185848	47198676	ARFGAP2	12828	-	NM_032389	47187032	47198404	16
chr11	47199072	47208010	PACSIN3	8938	-	NM_016223	47199481	47204278	11
chr11	47201161	47201288	MIR6745	127	-	NR_106803	47201288	47201288	1
chr11	47236492	47260769	DDB2	24277	+	NM_000107	47236687	47260400	10
chr11	47260852	47270398	ACP2	9546	-	NM_001610	47261666	47270340	11
chr11	47269850	47290584	NR1H3	20734	+	NM_001251935	47270354	47290247	10
chr11	47290926	47351582	MADD	60656	+	NM_130470	47295465	47350701	33
chr11	47292207	47293661	LOC101928943	1454	-	NR_120569	47293661	47293661	3
chr11	47352956	47374253	MYBPC3	21297	-	NM_000256	47353421	47374198	34
chr11	47376408	47400127	SPI1	23719	-	NM_001080547	47376777	47399904	5
chr11	47422520	47422593	MIR4487	73	+	NR_039707	47422593	47422593	1
chr11	47430045	47438051	SLC39A13	8006	+	NM_001128225	47431645	47436914	10
chr11	47440319	47448024	PSMC3	7705	-	NM_002804	47440385	47447830	12
chr11	47459307	47470730	RAPSN	11423	-	NM_005055	47459525	47470516	8
chr11	47487488	47574792	CELF1	87304	-	NM_006560	47493781	47510566	14
chr11	47586981	47595013	PTPMT1	8032	+	NM_175732	47587174	47593181	4
chr11	47593748	47600567	KBTBD4	6819	-	NM_018095	47594481	47600503	4
chr11	47600561	47606115	NDUFS3	5554	+	NM_004551	47600643	47606033	7
chr11	47608229	47610746	FAM180B	2517	+	NM_001164379	47608320	47609986	3
chr11	47611215	47615961	C1QTNF4	4746	-	NM_031909	47611372	47612362	2
chr11	47638857	47664206	MTCH2	25349	-	NM_001317231	47640351	47664017	13
chr11	47681142	47736928	AGBL2	55786	-	NM_024783	47681724	47736202	19
chr11	47738068	47788993	FNBP4	50925	-	NM_015308	47738973	47788840	17
chr11	47799669	47870057	NUP160	70388	-	NM_015231	47800656	47869972	36
chr11	48002109	48192394	PTPRJ	190285	+	NM_002843	48002464	48188914	25
chr11	48118333	48118410	MIR3161	77	+	NR_036119	48118410	48118410	1
chr11	48238361	48239291	OR4B1	930	+	NM_001005470	48238361	48239291	1
chr11	48266655	48267567	OR4X2	912	+	NM_001004727	48266655	48267567	1
chr11	48285412	48286330	OR4X1	918	+	NM_001004726	48285412	48286330	1
chr11	48327774	48328704	OR4S1	930	+	NM_001004725	48327774	48328704	1
chr11	48346492	48347482	OR4C3	990	+	NM_001004702	48346492	48347482	1
chr11	48366899	48373999	OR4C45	7100	-	NM_001005513	48366899	48373999	2
chr11	48510344	48511274	OR4A47	930	+	NM_001005512	48510344	48511274	1
chr11	49053151	49059529	TRIM49B	6378	+	NM_001206626	49053151	49059529	6
chr11	49075265	49080664	TRIM64C	5399	-	NM_001206631	49075265	49080664	6
chr11	49168186	49230222	FOLH1	62036	-	NM_001193471	49168307	49228402	20
chr11	49580079	49831969	LOC440040	251890	+	NR_027044	49831969	49831969	7
chr11	49973942	49974971	OR4C13	1029	+	NM_001001955	49973974	49974904	1
chr11	50003008	50004071	OR4C12	1063	-	NM_001005270	50003107	50004037	1
chr11	50238998	50257633	LOC441601	18635	-	NR_003034	50257633	50257633	6
chr11	50368317	50379802	LOC646813	11485	+	NR_024504	50379802	50379802	6
chr11	51411377	51412448	OR4A5	1071	-	NM_001005272	51411447	51412395	1
chr11	51515281	51516211	OR4C46	930	+	NM_001004703	51515281	51516211	1
chr11	55029657	55038595	TRIM48	8938	+	NM_024114	55029743	55036814	6
chr11	55061178	55065708	TRIM51HP	4530	-	NR_038174	55065708	55065708	5
chr11	55110676	55111663	OR4A16	987	+	NM_001005274	55110676	55111663	1
chr11	55135359	55136394	OR4A15	1035	+	NM_001005275	55135359	55136394	1
chr11	55321782	55322895	OR4C15	1113	+	NM_001001920	55321782	55322895	1
chr11	55339603	55340536	OR4C16	933	+	NM_001004701	55339603	55340536	1
chr11	55370829	55371874	OR4C11	1045	-	NM_001004700	55370916	55371849	1
chr11	55405833	55406772	OR4P4	939	+	NM_001004124	55405833	55406772	1
chr11	55418379	55419315	OR4S2	936	+	NM_001004059	55418379	55419315	1
chr11	55432642	55433572	OR4C6	930	+	NM_001004704	55432642	55433572	1
chr11	55540913	55541858	OR5D13	945	+	NM_001001967	55540913	55541858	1
chr11	55563031	55563976	OR5D14	945	+	NM_001004735	55563031	55563976	1
chr11	55578942	55579878	OR5L1	936	+	NM_001004738	55578942	55579878	1
chr11	55587105	55588047	OR5D18	942	+	NM_001001952	55587105	55588047	1
chr11	55594694	55595630	OR5L2	936	+	NM_001004739	55594694	55595630	1
chr11	55606227	55607214	OR5D16	987	+	NM_001005496	55606227	55607214	1
chr11	55650772	55659284	TRIM51	8512	+	NM_032681	55652904	55659108	7
chr11	55681125	55682058	OR5W2	933	-	NM_001001960	55681125	55682058	1
chr11	55702931	55703876	OR5I1	945	-	NM_006637	55702931	55703876	1
chr11	55735033	55735939	OR10AG1	906	-	NM_001005491	55735033	55735939	1
chr11	55746178	55753881	OR7E5P	7703	-	NR_027688	55753881	55753881	4
chr11	55761156	55762101	OR5F1	945	-	NM_003697	55761156	55762101	1
chr11	55797894	55798869	OR5AS1	975	+	NM_001001921	55797894	55798869	1
chr11	55860783	55861716	OR8I2	933	+	NM_001003750	55860783	55861716	1
chr11	55872518	55873457	OR8H2	939	+	NM_001005200	55872518	55873457	1
chr11	55889848	55890787	OR8H3	939	+	NM_001005201	55889848	55890787	1
chr11	55904246	55905194	OR8J3	948	-	NM_001004064	55904246	55905194	1
chr11	55926869	55927793	OR8K5	924	-	NM_001004058	55926869	55927793	1
chr11	55944093	55945032	OR5J2	939	+	NM_001005492	55944093	55945032	1
chr11	55999581	56000661	OR5T2	1080	-	NM_001004746	55999581	56000661	1
chr11	56019675	56020698	OR5T3	1023	+	NM_001004747	56019675	56020698	1
chr11	56043114	56044095	OR5T1	981	+	NM_001004745	56043114	56044095	1
chr11	56057602	56058538	OR8H1	936	-	NM_001005199	56057602	56058538	1
chr11	56085782	56086721	OR8K3	939	+	NM_001005202	56085782	56086721	1
chr11	56113514	56114474	OR8K1	960	+	NM_001002907	56113514	56114474	1
chr11	56127690	56128764	OR8J1	1074	+	NM_001005205	56127722	56128673	1
chr11	56143099	56143975	OR8U8	876	+	NM_001013356	56143099	56143975	2
chr11	56143099	56144029	OR8U1	930	+	NM_001005204	56143099	56144029	1
chr11	56184733	56185708	OR5R1	975	-	NM_001004744	56184733	56185708	1
chr11	56229944	56230877	OR5M9	933	-	NM_001004743	56229944	56230877	1
chr11	56236963	56238014	OR5M3	1051	-	NM_001004742	56237049	56237973	1
chr11	56257910	56258846	OR5M8	936	-	NM_001005282	56257910	56258846	1
chr11	56309815	56310733	OR5M11	918	-	NM_001005245	56309815	56310733	1
chr11	56344249	56345197	OR5M10	948	-	NM_001004741	56344249	56345197	1
chr11	56380030	56380978	OR5M1	948	-	NM_001004740	56380030	56380978	1
chr11	56408964	56409915	OR5AP2	951	-	NM_001002925	56408964	56409915	1
chr11	56431161	56432094	OR5AR1	933	+	NM_001004730	56431161	56432094	1
chr11	56467863	56468781	OR9G1	918	+	NM_001005213	56467863	56468781	1
chr11	56467863	56468781	OR9G9	918	+	NM_001013358	56467863	56468781	1
chr11	56510303	56511287	OR9G4	984	-	NM_001005284	56510303	56511287	1
chr11	56511348	56511457	MIR6128	109	+	NR_106743	56511457	56511457	1
chr11	56615953	56645554	LOC101927120	29601	+	NR_110136	56645554	56645554	4
chr11	56756388	56757318	OR5AK2	930	+	NM_001005323	56756388	56757318	1
chr11	56805008	56805935	OR5AK4P	927	+	NR_036445	56805935	56805935	1
chr11	56949220	56959188	LRRC55	9968	+	NM_001005210	56949367	56954954	2
chr11	57001051	57004927	APLNR	3876	-	NR_027991	57004927	57004927	2
chr11	57067102	57092413	TNKS1BP1	25311	-	NM_033396	57068013	57089359	12
chr11	57093458	57103351	SSRP1	9893	-	NM_003146	57093880	57102595	17
chr11	57105840	57137549	P2RX3	31709	+	NM_002559	57106024	57137470	12
chr11	57144241	57148623	PRG3	4382	-	NM_006093	57144322	57148181	6
chr11	57154259	57158130	PRG2	3871	-	NM_002728	57154947	57157417	6
chr11	57174426	57195053	SLC43A3	20627	-	NM_017611	57175264	57193645	14
chr11	57228009	57245012	RTN4RL2	17003	+	NM_178570	57228338	57244384	3
chr11	57252003	57283192	SLC43A1	31189	-	NM_003627	57252568	57281584	15
chr11	57295935	57298232	TIMM10	2297	-	NM_012456	57296189	57297662	3
chr11	57310113	57317747	SMTNL1	7634	+	NM_001105565	57310115	57317585	7
chr11	57319127	57335803	UBE2L6	16676	-	NM_198183	57319830	57322021	4
chr11	57365026	57382326	SERPING1	17300	+	NM_000062	57365743	57382054	8
chr11	57408670	57408759	MIR130A	89	+	NR_029673	57408759	57408759	1
chr11	57412559	57417417	YPEL4	4858	-	NM_145008	57413453	57414580	5
chr11	57425215	57429337	CLP1	4122	+	NM_006831	57426948	57428908	3
chr11	57435473	57468659	ZDHHC5	33186	+	NM_015457	57440562	57467503	12
chr11	57471180	57479795	MED19	8615	-	NM_001317078	57471509	57479702	5
chr11	57479994	57508445	TMX2	28451	+	NM_015959	57480090	57507717	8
chr11	57479994	57586652	TMX2-CTNND1	106658	+	NR_037646	57586652	57586652	21
chr11	57508721	57510883	C11orf31	2162	+	NM_170746	57509067	57509689	4
chr11	57510985	57519253	BTBD18	8268	-	NM_001145101	57511605	57518660	3
chr11	57529233	57586652	CTNND1	57419	+	NM_001085458	57558950	57583780	21
chr11	57791352	57949038	OR9Q1	157686	+	NM_001005212	57946916	57947849	3
chr11	57798424	57799378	OR6Q1	954	+	NM_001005186	57798424	57799378	1
chr11	57885971	57886916	OR9I1	945	-	NM_001005211	57885971	57886916	1
chr11	57957905	57958990	OR9Q2	1085	+	NM_001005283	57957962	57958907	1
chr11	57970675	57971653	OR1S2	978	-	NM_001004459	57970675	57971653	1
chr11	57982216	57983194	OR1S1	978	+	NM_001004458	57982216	57983194	1
chr11	57995353	57996390	OR10Q1	1037	-	NM_001004471	57995387	57996347	1
chr11	58034263	58035732	OR10W1	1469	-	NM_207374	58034412	58035330	1
chr11	58125597	58126542	OR5B17	945	-	NM_001005489	58125597	58126542	1
chr11	58169937	58170882	OR5B3	945	-	NM_001005469	58169937	58170882	1
chr11	58189737	58190786	OR5B2	1049	-	NM_001005566	58189804	58190734	1
chr11	58206592	58207646	OR5B12	1054	-	NM_001004733	58206679	58207624	1
chr11	58274648	58275578	OR5B21	930	-	NM_001005218	58274648	58275578	1
chr11	58294343	58345712	LPXN	51369	-	NM_001143995	58294926	58345519	9
chr11	58346586	58389023	ZFP91	42437	+	NM_001197051	58346754	58385179	11
chr11	58346586	58393205	ZFP91-CNTF	46619	+	NR_024091	58393205	58393205	13
chr11	58390145	58393205	CNTF	3060	+	NM_000614	58390225	58391995	2
chr11	58476229	58499447	GLYAT	23218	-	NM_201648	58477238	58491969	6
chr11	58601539	58611997	GLYATL2	10458	-	NM_145016	58601901	58607085	6
chr11	58695101	58724547	GLYATL1	29446	+	NM_001220494	58714560	58723500	8
chr11	58701115	58825925	LOC283194	124810	-	NR_033853	58825925	58825925	6
chr11	58874657	58894888	FAM111B	20231	+	NM_198947	58877098	58893775	4
chr11	58901445	58910281	LOC101927204	8836	-	NR_110184	58910281	58910281	4
chr11	58910218	58922511	FAM111A	12293	+	NM_001312909	58916345	58920977	6
chr11	58938902	58976060	DTX4	37158	+	NM_001300727	58949318	58972382	9
chr11	58975982	58980494	MPEG1	4512	-	NM_001039396	58978187	58980338	1
chr11	59131931	59132867	OR5AN1	936	+	NM_001004729	59131931	59132867	1
chr11	59189451	59190426	OR5A2	975	-	NM_001001954	59189451	59190426	1
chr11	59210641	59211589	OR5A1	948	+	NM_001004728	59210641	59211589	1
chr11	59224433	59225378	OR4D6	945	+	NM_001004708	59224433	59225378	1
chr11	59244902	59245838	OR4D10	936	+	NM_001004705	59244902	59245838	1
chr11	59271048	59271984	OR4D11	936	+	NM_001004706	59271048	59271984	1
chr11	59282385	59283330	OR4D9	945	+	NM_001004711	59282385	59283330	1
chr11	59341870	59383617	OSBP	41747	-	NM_002556	59344049	59383137	14
chr11	59362549	59362631	MIR3162	82	-	NR_036120	59362631	59362631	1
chr11	59404191	59436511	PATL1	32320	-	NM_152716	59405862	59436368	19
chr11	59480388	59481318	OR10V1	930	-	NM_001005324	59480388	59481318	1
chr11	59516284	59517054	OR10V2P	770	+	NR_045005	59517054	59517054	1
chr11	59522531	59573355	STX3	50824	+	NM_004177	59523078	59564839	11
chr11	59573607	59578345	MRPL16	4738	-	NM_017840	59573819	59578131	4
chr11	59596745	59612974	GIF	16229	-	NM_005142	59596956	59612926	9
chr11	59620280	59634041	TCN1	13761	-	NM_001062	59620447	59633943	9
chr11	59710351	59763318	OOSP1	52967	+	NR_130719	59763318	59763318	9
chr11	59807747	59815516	OOSP2	7769	+	NM_173801	59807932	59814546	4
chr11	59824100	59838588	MS4A3	14488	+	NM_006138	59828633	59837706	7
chr11	59856136	59865940	MS4A2	9804	+	NM_000139	59856238	59863129	7
chr11	59939079	59952139	MS4A6A	13060	-	NM_152852	59939630	59949200	8
chr11	60048013	60076445	MS4A4A	28432	+	NM_024021	60059713	60075651	8
chr11	60073143	60073172	MIR6503	29	-	NR_106758	60073172	60073172	1
chr11	60102354	60108441	MS4A6E	6087	+	NM_139249	60102368	60107428	4
chr11	60145957	60163426	MS4A7	17469	+	NM_021201	60150614	60161334	7
chr11	60163486	60185228	MS4A14	21742	+	NR_049734	60185228	60185228	7
chr11	60197061	60215265	MS4A5	18204	+	NM_023945	60197147	60215232	5
chr11	60223281	60238225	MS4A1	14944	+	NM_152866	60229847	60235941	8
chr11	60260250	60274901	MS4A12	14651	+	NM_017716	60264791	60274597	7
chr11	60282885	60310191	MS4A13	27306	+	NM_001012417	60285556	60310048	7
chr11	60383223	60454621	LINC00301	71398	+	NR_026946	60454621	60454621	7
chr11	60467046	60483285	MS4A8	16239	+	NM_031457	60468333	60482887	7
chr11	60491481	60511686	MS4A18	20205	+	NM_001310141	60496788	60511467	6
chr11	60524339	60544204	MS4A15	19865	+	NR_103481	60544204	60544204	8
chr11	60552820	60568778	MS4A10	15958	+	NM_206893	60557808	60567382	8
chr11	60609428	60618561	CCDC86	9133	+	NM_024098	60609597	60617798	4
chr11	60618397	60623444	PTGDR2	5047	-	NM_004778	60620007	60621195	2
chr11	60635014	60643164	ZP1	8150	+	NM_207341	60635034	60643129	12
chr11	60658019	60674061	PRPF19	16042	-	NM_014502	60658637	60673854	16
chr11	60681370	60690915	TMEM109	9545	+	NM_024092	60687165	60689637	4
chr11	60691912	60704631	TMEM132A	12719	+	NM_178031	60692105	60704379	11
chr11	60704554	60719257	SLC15A3	14703	-	NM_016582	60704690	60719023	8
chr11	60739112	60787848	CD6	48736	+	NM_006725	60739337	60786790	13
chr11	60869929	60895323	CD5	25394	+	NM_014207	60870032	60893311	11
chr11	60897727	60928916	VPS37C	31189	-	NM_017966	60899291	60906301	5
chr11	60970984	60980341	PGA3	9357	+	NM_001079807	60971036	60980174	9
chr11	60989820	60999167	PGA4	9347	+	NM_001079808	60989872	60999003	9
chr11	61008647	61018915	PGA5	10268	+	NM_014224	61008698	61018753	9
chr11	61025757	61062788	VWCE	37031	-	NM_152718	61026146	61062509	20
chr11	61066918	61100684	DDB1	33766	-	NM_001923	61067607	61100440	27
chr11	61100653	61116231	TKFC	15578	+	NM_015533	61102200	61113975	18
chr11	61116219	61129755	CYB561A3	13536	-	NM_001161454	61117870	61124710	8
chr11	61129472	61136975	TMEM138	7503	+	NR_028473	61136975	61136975	6
chr11	61159831	61166335	TMEM216	6504	+	NM_001173991	61160103	61165748	5
chr11	61170119	61197464	CPSF7	27345	-	NM_001136040	61178414	61196707	10
chr11	61197596	61214239	SDHAF2	16643	+	NM_017841	61197618	61213543	4
chr11	61248584	61258400	PPP1R32	9816	+	NM_145017	61249281	61258042	14
chr11	61276067	61276129	MIR4488	62	+	NR_039708	61276129	61276129	1
chr11	61276271	61278490	LRRC10B	2219	+	NM_001145077	61276470	61277349	1
chr11	61281187	61348344	SYT7	67157	-	NM_001300773	61286098	61348292	10
chr11	61355965	61375018	LOC101927495	19053	+	NR_110189	61375018	61375018	4
chr11	61382507	61406921	RPLP0P2	24414	+	NR_002775	61406921	61406921	5
chr11	61447904	61514474	DAGLA	66570	+	NM_006133	61487627	61511961	20
chr11	61520108	61555990	MYRF	35882	+	NM_001127392	61520216	61553615	27
chr11	61521500	61525136	DKFZP434K028	3636	-	NR_026882	61525136	61525136	4
chr11	61556601	61560085	TMEM258	3484	-	NM_014206	61557266	61560030	4
chr11	61559966	61560033	MIR611	67	-	NR_030342	61560033	61560033	1
chr11	61560108	61564714	FEN1	4606	+	NM_004111	61562833	61563976	2
chr11	61567096	61584529	FADS1	17433	-	NM_013402	61569882	61584401	12
chr11	61582632	61582712	MIR1908	80	-	NR_031729	61582712	61582712	1
chr11	61583674	61634826	FADS2	51152	+	NM_001281501	61583757	61633161	12
chr11	61640994	61659017	FADS3	18023	-	NM_021727	61641285	61658853	12
chr11	61645687	61645750	MIR6746	63	-	NR_106804	61645750	61645750	1
chr11	61664767	61687741	RAB3IL1	22974	-	NM_001271686	61665749	61687664	9
chr11	61717355	61731935	BEST1	14580	+	NM_004183	61719278	61731594	11
chr11	61731756	61735132	FTH1	3376	-	NM_002032	61732198	61734897	4
chr11	61891444	61920635	INCENP	29191	+	NM_001040694	61895633	61919448	19
chr11	61957709	61961009	SCGB1D1	3300	+	NM_006552	61957756	61960900	3
chr11	61976139	61981411	SCGB2A1	5272	+	NM_002407	61976203	61981242	3
chr11	62009723	62012280	SCGB1D2	2557	+	NM_006551	62009779	62012171	3
chr11	62037626	62040629	SCGB2A2	3003	+	NM_002411	62037688	62040467	3
chr11	62063753	62066536	SCGB1D4	2783	-	NM_206998	62063881	62066482	3
chr11	62104773	62160887	ASRGL1	56114	+	NM_001083926	62105449	62159756	7
chr11	62186506	62190678	SCGB1A1	4172	+	NM_003357	62186567	62190563	3
chr11	62201013	62314332	AHNAK	113319	-	NM_024060	62201355	62303570	6
chr11	62327072	62341460	EEF1G	14388	-	NM_001404	62327150	62341314	10
chr11	62327634	62327778	MIR3654	144	-	NR_037427	62327778	62327778	2
chr11	62334482	62334543	MIR6747	61	-	NR_106805	62334543	62334543	1
chr11	62342516	62359109	TUT1	16593	-	NM_022830	62342565	62359071	9
chr11	62360674	62369312	MTA2	8638	-	NM_004739	62361346	62368922	18
chr11	62369690	62380237	EML3	10547	-	NM_153265	62369946	62379929	22
chr11	62380212	62382592	ROM1	2380	+	NM_000327	62380753	62382311	3
chr11	62382767	62389647	B3GAT3	6880	-	NM_001288721	62383172	62388587	6
chr11	62392297	62414198	GANAB	21901	-	NM_198335	62393286	62414071	25
chr11	62414319	62420774	INTS5	6455	-	NM_030628	62414491	62420721	2
chr11	62430288	62432688	C11orf98	2400	-	NM_001286086	62430521	62432641	4
chr11	62430288	62439241	LBHD1	8953	-	NM_024099	62430600	62437503	7
chr11	62432778	62434923	METTL12	2145	+	NM_001043229	62433351	62434523	3
chr11	62432893	62433042	SNORA57	149	+	NR_004390	62433042	62433042	1
chr11	62439125	62441162	UQCC3	2037	+	NM_001085372	62439217	62439586	2
chr11	62443969	62446589	UBXN1	2620	-	NM_001286077	62444061	62446395	9
chr11	62453873	62457371	LRRN4CL	3498	-	NM_203422	62455263	62455980	2
chr11	62457733	62477091	BSCL2	19358	-	NR_037949	62477091	62477091	12
chr11	62457733	62494856	HNRNPUL2-BSCL2	37123	-	NR_037946	62494856	62494856	24
chr11	62475065	62476678	GNG3	1613	+	NM_012202	62475767	62476278	3
chr11	62480096	62494857	HNRNPUL2	14761	-	NM_001079559	62482770	62494628	14
chr11	62495951	62506108	TTC9C	10157	+	NM_173810	62496320	62505854	3
chr11	62518434	62521656	ZBTB3	3222	-	NM_024784	62519561	62521534	2
chr11	62529010	62534187	POLR2G	5177	+	NM_002696	62529120	62533979	8
chr11	62538774	62554813	TAF6L	16039	+	NM_006473	62543255	62554768	11
chr11	62554873	62557872	TMEM179B	2999	+	NM_199337	62554903	62557519	5
chr11	62557286	62557357	MIR6748	71	+	NR_106806	62557357	62557357	1
chr11	62557786	62559486	TMEM223	1700	-	NM_001080501	62558094	62559466	2
chr11	62559597	62572964	NXF1	13367	-	NM_006362	62559947	62572828	21
chr11	62560173	62560243	MIR6514	70	-	NR_106769	62560243	62560243	1
chr11	62574331	62599563	STX5	25232	-	NM_003164	62574940	62598715	11
chr11	62600376	62607628	WDR74	7252	-	NM_018093	62600423	62607042	12
chr11	62619459	62623360	SNHG1	3901	-	NR_003098	62623360	62623360	11
chr11	62620381	62620507	SNORD22	126	-	NR_000008	62620507	62620507	1
chr11	62620797	62620865	SNORD31	68	-	NR_002560	62620865	62620865	1
chr11	62621134	62621204	SNORD30	70	-	NR_002561	62621204	62621204	1
chr11	62621375	62621440	SNORD29	65	-	NR_002559	62621440	62621440	1
chr11	62622092	62622167	SNORD28	75	-	NR_002562	62622167	62622167	1
chr11	62622483	62622555	SNORD27	72	-	NR_002563	62622555	62622555	1
chr11	62622763	62622838	SNORD26	75	-	NR_002564	62622838	62622838	1
chr11	62623036	62623103	SNORD25	67	-	NR_002565	62623103	62623103	1
chr11	62623483	62656355	SLC3A2	32872	+	NM_002394	62623741	62656165	12
chr11	62676150	62689012	CHRM1	12862	-	NM_000738	62677189	62678572	2
chr11	62744068	62752495	SLC22A6	8427	-	NM_153278	62744265	62752162	10
chr11	62760295	62783317	SLC22A8	23022	-	NM_001184732	62760708	62782430	11
chr11	62847411	62911693	SLC22A24	64282	-	NM_001136506	62847411	62911251	10
chr11	62931295	62997124	SLC22A25	65829	-	NM_199352	62931295	62997124	9
chr11	63057429	63079246	SLC22A10	21817	+	NM_001039752	63057637	63078506	10
chr11	63137260	63177712	SLC22A9	40452	+	NM_080866	63137528	63177334	10
chr11	63228875	63258680	HRASLS5	29805	-	NM_001146728	63231002	63258506	6
chr11	63273523	63284246	LGALS12	10723	+	NM_033101	63273864	63283865	9
chr11	63304272	63313930	RARRES3	9658	+	NM_004585	63304340	63313728	4
chr11	63320241	63330855	HRASLS2	10614	-	NM_017878	63320435	63330796	4
chr11	63341943	63381941	PLA2G16	39998	-	NM_001128203	63342416	63381486	5
chr11	63391553	63439446	ATL3	47893	-	NM_001290048	63396790	63426716	13
chr11	63448921	63527363	RTN3	78442	+	NM_001265589	63449108	63525673	9
chr11	63527363	63536113	C11orf95	8750	-	NM_001144936	63530889	63536094	5
chr11	63580845	63595190	C11orf84	14345	+	NM_138471	63581158	63594611	6
chr11	63606399	63678492	MARK2	72093	+	NM_001039469	63606978	63676709	19
chr11	63678692	63684316	RCOR2	5624	-	NM_173587	63679336	63683928	12
chr11	63706441	63724791	NAA40	18350	+	NM_024771	63706568	63721951	8
chr11	63742078	63744015	COX8A	1937	+	NM_004074	63742152	63743792	2
chr11	63753324	63765892	OTUB1	12568	+	NM_017670	63753928	63765018	7
chr11	63766029	63933585	MACROD1	167556	-	NM_014067	63766339	63933466	11
chr11	63871361	63886645	FLRT1	15284	+	NM_013280	63883739	63885764	2
chr11	63952743	63972020	STIP1	19277	+	NM_001282652	63953296	63971598	14
chr11	63974151	63991363	FERMT3	17212	+	NM_178443	63974836	63990964	15
chr11	63991270	63993726	TRPT1	2456	-	NM_001160390	63991347	63993332	8
chr11	63993729	63997488	NUDT22	3759	+	NM_001128612	63994124	63997462	6
chr11	63997752	64001753	DNAJC4	4001	+	NM_005528	63998326	64001656	7
chr11	64002055	64006736	VEGFB	4681	+	NM_003377	64002305	64005105	7
chr11	64008412	64011607	FKBP2	3195	+	NM_004470	64009859	64011501	6
chr11	64011950	64014413	PPP1R14B	2463	-	NM_138689	64012225	64014145	4
chr11	64018994	64036924	PLCB3	17930	+	NM_001316314	64019121	64035028	32
chr11	64037299	64052176	BAD	14877	-	NM_032989	64037680	64051840	4
chr11	64051810	64056972	GPR137	5162	+	NM_001170726	64051838	64056837	9
chr11	64058773	64067500	KCNK4	8727	+	NR_133660	64067500	64067500	6
chr11	64059193	64072241	KCNK4-TEX40	13048	+	NR_133662	64072241	64072241	11
chr11	64067862	64072239	TEX40	4377	+	NM_001039496	64067882	64072118	5
chr11	64072999	64084212	ESRRA	11213	+	NM_004451	64074651	64083438	7
chr11	64083963	64085556	TRMT112	1593	-	NM_016404	64084332	64084998	4
chr11	64085559	64089295	PRDX5	3736	+	NM_012094	64085687	64089163	6
chr11	64107689	64125006	CCDC88B	17317	+	NM_032251	64107738	64124566	27
chr11	64109320	64109376	MIR7155	56	-	NR_106977	64109376	64109376	1
chr11	64126624	64139687	RPS6KA4	13063	+	NM_001006944	64126707	64138952	17
chr11	64136073	64136175	MIR1237	102	+	NR_031602	64136175	64136175	1
chr11	64216528	64219128	LOC100996455	2600	+	NR_073177	64219128	64219128	2
chr11	64323072	64340347	SLC22A11	17275	+	NM_018484	64323471	64338514	10
chr11	64358281	64369825	SLC22A12	11544	+	NM_153378	64361108	64369023	10
chr11	64373645	64490660	NRXN2	117015	-	NM_015080	64374667	64481171	23
chr11	64494382	64512928	RASGRP2	18546	-	NM_153819	64494773	64510338	17
chr11	64513860	64528187	PYGM	14327	-	NM_005609	64514130	64527370	20
chr11	64532075	64546316	SF1	14241	-	NM_201995	64532860	64545864	14
chr11	64556572	64570726	MAP4K2	14154	-	NM_004579	64557008	64570621	32
chr11	64570985	64578766	MEN1	7781	-	NM_130804	64571805	64577581	11
chr11	64591661	64612041	CDC42BPG	20380	-	NM_017525	64591944	64612041	37
chr11	64620198	64647185	EHD1	26987	-	NM_001282444	64621804	64645936	7
chr11	64655929	64660921	MIR194-2HG	4992	-	NR_133639	64660921	64660921	3
chr11	64658608	64658718	MIR192	110	-	NR_029578	64658718	64658718	1
chr11	64658826	64658911	MIR194-2	85	-	NR_029829	64658911	64658911	1
chr11	64662003	64684722	ATG2A	22719	-	NM_015104	64662444	64684607	41
chr11	64665834	64665909	MIR6750	75	-	NR_106808	64665909	64665909	1
chr11	64669858	64669927	MIR6749	69	-	NR_106807	64669927	64669927	1
chr11	64692142	64701950	PPP2R5B	9808	+	NM_006244	64693206	64701316	14
chr11	64701942	64703360	GPHA2	1418	-	NM_130769	64702244	64702932	4
chr11	64705701	64739563	C11orf85	33862	-	NM_001037225	64707134	64726877	11
chr11	64755416	64764517	BATF2	9101	-	NM_138456	64756600	64764386	3
chr11	64781584	64789657	ARL2	8073	+	NM_001667	64781679	64789327	5
chr11	64781584	64808044	ARL2-SNX15	26460	+	NR_037650	64808044	64808044	11
chr11	64785976	64786042	MIR6879	66	+	NR_106939	64786042	64786042	1
chr11	64794879	64808044	SNX15	13165	+	NM_013306	64795009	64807264	8
chr11	64808375	64812300	SAC3D1	3925	+	NM_013299	64808764	64812199	2
chr11	64812294	64826009	NAALADL1	13715	-	NM_005468	64812742	64825993	18
chr11	64844926	64851615	CDCA5	6689	-	NM_080668	64846578	64851450	6
chr11	64851693	64855874	ZFPL1	4181	+	NM_006782	64852170	64855586	8
chr11	64855843	64856581	TMEM262	738	-	NM_001282448	64855926	64856503	3
chr11	64863586	64879332	VPS51	15746	+	NR_073519	64879332	64879332	10
chr11	64879325	64883707	TM7SF2	4382	+	NM_003273	64879487	64883525	10
chr11	64883874	64885210	ZNHIT2	1336	-	NM_014205	64883913	64885125	1
chr11	64888098	64889672	FAU	1574	-	NM_001997	64888152	64889285	5
chr11	64889654	64894841	MRPL49	5187	+	NR_037567	64894841	64894841	4
chr11	64894750	64902003	SYVN1	7253	-	NM_172230	64895853	64901072	16
chr11	64897387	64897450	MIR6751	63	-	NR_106809	64897450	64897450	1
chr11	64937706	64940688	SPDYC	2982	+	NM_001008778	64937706	64940688	7
chr11	64948685	64979477	CAPN1	30792	+	NM_001198868	64950172	64978757	22
chr11	64981310	65010228	SLC22A20	28918	+	NR_033396	65010228	65010228	10
chr11	65029322	65066156	POLA2	36834	+	NM_002689	65029763	65064740	18
chr11	65082288	65089900	CDC42EP2	7612	+	NM_006779	65088369	65089002	2
chr11	65101224	65120451	DPF2	19227	+	NM_006268	65101357	65119230	11
chr11	65122281	65125082	TIGD3	2801	+	NM_145719	65123279	65124695	2
chr11	65142662	65151172	SLC25A45	8510	-	NM_001278251	65143877	65147364	10
chr11	65154040	65180995	FRMD8	26955	+	NM_031904	65154507	65178831	11
chr11	65190268	65213009	NEAT1	22741	+	NR_131012	65213009	65213009	1
chr11	65211928	65212028	MIR612	100	+	NR_030343	65212028	65212028	1
chr11	65265232	65273983	MALAT1	8751	+	NR_002819	65273983	65273983	1
chr11	65292547	65306182	SCYL1	13635	+	NM_020680	65292624	65306037	18
chr11	65306029	65325699	LTBP3	19670	-	NM_001130144	65306550	65325430	28
chr11	65336690	65337884	SSSCA1-AS1	1194	-	NR_038923	65337884	65337884	1
chr11	65337929	65339359	SSSCA1	1430	+	NM_006396	65337962	65339205	4
chr11	65339819	65341669	FAM89B	1850	+	NM_001098784	65340140	65340997	2
chr11	65343508	65360116	EHBP1L1	16608	+	NM_001099409	65343773	65359773	19
chr11	65360325	65363467	KCNK7	3142	-	NM_033348	65360813	65363243	4
chr11	65365225	65381720	MAP3K11	16495	-	NM_002419	65365761	65381227	10
chr11	65383782	65404910	PCNXL3	21128	+	NM_032223	65383782	65404449	35
chr11	65403780	65403840	MIR4690	60	+	NR_039839	65403840	65403840	1
chr11	65405577	65418391	SIPA1	12814	+	NM_006747	65408392	65418186	16
chr11	65416662	65416724	MIR4489	62	+	NR_039709	65416724	65416724	1
chr11	65421066	65430443	RELA	9377	-	NM_001243985	65421848	65430303	12
chr11	65479472	65487077	KAT5	7605	+	NM_006388	65479738	65486652	14
chr11	65485143	65488409	RNASEH2C	3266	-	NM_032193	65487253	65488229	4
chr11	65541368	65548062	AP5B1	6694	-	NM_138368	65545326	65548062	2
chr11	65554504	65564690	OVOL1	10186	+	NM_004561	65554844	65562812	4
chr11	65556471	65558339	OVOL1-AS1	1868	-	NR_108085	65558339	65558339	2
chr11	65601409	65621172	SNX32	19763	+	NM_152760	65601536	65620806	13
chr11	65622284	65625804	CFL1	3520	-	NM_005507	65622806	65625570	4
chr11	65627871	65633914	MUS81	6043	+	NM_025128	65628224	65633523	16
chr11	65633911	65640405	EFEMP2	6494	-	NR_037718	65640405	65640405	12
chr11	65647283	65651212	CTSW	3929	+	NM_001335	65647325	65651089	10
chr11	65651210	65656010	FIBP	4800	-	NM_198897	65651444	65655889	10
chr11	65657874	65659106	CCDC85B	1232	+	NM_006848	65658254	65658863	1
chr11	65659606	65667997	FOSL1	8391	-	NM_005438	65660356	65667810	4
chr11	65684282	65686531	C11orf68	2249	-	NM_001135635	65684929	65686502	2
chr11	65686727	65689048	DRAP1	2321	+	NM_006442	65686972	65688906	7
chr11	65713114	65727434	TSGA10IP	14320	+	NM_152762	65713146	65727411	8
chr11	65729159	65747607	SART1	18448	+	NM_005146	65729251	65746501	20
chr11	65764015	65769637	EIF1AD	5622	-	NM_032325	65766069	65767860	6
chr11	65769549	65771617	BANF1	2068	+	NM_001143985	65770721	65771243	3
chr11	65779461	65780976	CST6	1515	+	NM_001323	65779515	65780871	3
chr11	65784222	65793988	CATSPER1	9766	-	NM_053054	65784360	65793850	12
chr11	65808235	65816651	GAL3ST3	8416	-	NM_033036	65809977	65812886	3
chr11	65819815	65836382	SF3B2	16567	+	NM_006842	65819855	65836216	22
chr11	65837823	66012218	PACS1	174395	+	NM_018026	65837957	66010751	24
chr11	66024764	66035331	KLC2	10567	+	NM_001134775	66026065	66034427	16
chr11	66036055	66044963	RAB1B	8908	+	NM_030981	66036150	66043709	6
chr11	66045671	66051685	CNIH2	6014	+	NM_182553	66045927	66051068	6
chr11	66052050	66056638	YIF1A	4588	-	NM_020470	66052107	66056456	8
chr11	66059372	66064135	TMEM151A	4763	+	NM_153266	66059484	66063124	2
chr11	66081957	66084515	CD248	2558	-	NM_020404	66082224	66084498	1
chr11	66099541	66104000	RIN1	4459	-	NM_004292	66099746	66103873	10
chr11	66104803	66112582	BRMS1	7779	-	NM_001024957	66105138	66109705	10
chr11	66112842	66115161	B4GAT1	2319	-	NM_006876	66113519	66115016	2
chr11	66129991	66139947	SLC29A2	9956	-	NM_001300868	66130906	66139062	14
chr11	66188474	66194177	NPAS4	5703	+	NM_178864	66188650	66193460	8
chr11	66202545	66206319	MRPL11	3774	-	NM_170739	66204307	66206225	6
chr11	66233797	66244808	PELI3	11011	+	NM_001243135	66235599	66243638	7
chr11	66240960	66247720	LOC101928069	6760	-	NR_120586	66247720	66247720	4
chr11	66247483	66277130	DPP3	29647	+	NM_130443	66249671	66276722	18
chr11	66278118	66301084	BBS1	22966	+	NM_024649	66278130	66299508	17
chr11	66306734	66313671	ZDHHC24	6937	-	NM_207340	66306999	66313474	3
chr11	66313865	66330800	ACTN3	16935	+	NM_001258371	66313981	66330664	21
chr11	66330934	66336047	CTSF	5113	-	NM_003793	66331403	66335957	13
chr11	66357639	66360554	CCDC87	2915	-	NM_018219	66357936	66360486	1
chr11	66360689	66373490	CCS	12801	+	NM_005125	66360732	66373326	8
chr11	66384052	66397397	RBM14	13345	+	NM_006328	66384191	66394139	3
chr11	66384052	66413944	RBM14-RBM4	29892	+	NM_001198845	66384191	66411603	3
chr11	66406087	66435858	RBM4	29771	+	NM_001198844	66407182	66433436	3
chr11	66432464	66445392	RBM4B	12928	-	NM_031492	66436094	66444550	4
chr11	66452719	66488870	SPTBN2	36151	-	NM_006946	66453341	66488711	37
chr11	66512206	66610987	C11orf80	98781	+	NM_024650	66512213	66610705	17
chr11	66610882	66614003	RCE1	3121	+	NM_001032279	66611450	66613566	8
chr11	66615996	66725847	PC	109851	-	NM_001040716	66616369	66639630	23
chr11	66624875	66627946	LRFN4	3071	+	NM_024036	66625215	66627666	2
chr11	66742753	66744479	C11orf86	1726	+	NM_001136485	66742833	66743722	2
chr11	66790189	66818334	SYT12	28145	+	NM_001177880	66797615	66816228	8
chr11	66813113	66813179	MIR6860	66	+	NR_106920	66813179	66813179	1
chr11	66824288	66839488	RHOD	15200	+	NM_014578	66824373	66839073	5
chr11	66886739	67025550	KDM2A	138811	+	NR_027473	67025550	67025550	21
chr11	67033904	67054029	ADRBK1	20125	+	NM_001619	67034170	67052921	21
chr11	67056761	67069955	ANKRD13D	13194	+	NM_207354	67056931	67069803	15
chr11	67070918	67080078	SSH3	9160	+	NM_017857	67071096	67079358	14
chr11	67085309	67159158	LOC100130987	73849	+	NR_024469	67159158	67159158	4
chr11	67118235	67121067	POLD4	2832	-	NR_046413	67121067	67121067	4
chr11	67131638	67141648	CLCF1	10010	-	NM_001166212	67132606	67135083	3
chr11	67159422	67165883	RAD9A	6461	+	NM_004584	67159515	67165030	11
chr11	67165651	67169376	PPP1CA	3725	-	NM_002708	67166005	67169253	7
chr11	67171383	67177561	TBC1D10C	6178	+	NM_198517	67171673	67177225	10
chr11	67183148	67193078	CARNS1	9930	+	NM_001166222	67183670	67192072	10
chr11	67195934	67202879	RPS6KB2	6945	+	NM_003952	67196016	67202640	15
chr11	67202980	67205153	PTPRCAP	2173	-	NM_005608	67203203	67205090	2
chr11	67205517	67211292	CORO1B	5775	-	NM_001018070	67205846	67210099	12
chr11	67218771	67220200	GPR152	1429	-	NM_206997	67218782	67220195	1
chr11	67219885	67229246	CABP4	9361	+	NM_001300896	67223607	67226130	7
chr11	67231818	67236748	TMEM134	4930	-	NM_001078651	67232084	67236663	7
chr11	67250499	67258579	AIP	8080	+	NM_003977	67250629	67258464	6
chr11	67257715	67257786	MIR6752	71	+	NR_106810	67257786	67257786	1
chr11	67259238	67272843	PITPNM1	13605	-	NM_004910	67259503	67271651	24
chr11	67273960	67276199	CDK2AP2	2239	-	NM_005851	67274415	67275553	4
chr11	67286417	67290899	CABP2	4482	-	NM_016366	67286609	67290797	7
chr11	67351065	67354124	GSTP1	3059	+	NM_000852	67351314	67354048	7
chr11	67370350	67374177	C11orf72	3827	-	NR_130935	67374177	67374177	3
chr11	67374322	67380012	NDUFV1	5690	+	NM_007103	67374475	67379929	10
chr11	67380994	67383135	DOC2GP	2141	-	NR_033791	67383135	67383135	5
chr11	67395408	67397408	NUDT8	2000	-	NM_181843	67395775	67397382	3
chr11	67398773	67407031	TBX10	8258	-	NM_005995	67399075	67406943	8
chr11	67410025	67418130	ACY3	8105	-	NM_080658	67410194	67414514	8
chr11	67429632	67448685	ALDH3B2	19053	-	NM_001031615	67430685	67434406	10
chr11	67559237	67572807	FAM86C2P	13570	-	NR_024249	67572807	67572807	4
chr11	67758570	67771595	UNC93B1	13025	-	NM_030930	67759016	67771513	11
chr11	67776016	67796749	ALDH3B1	20733	+	NM_001161473	67782767	67795406	10
chr11	67798083	67804114	NDUFS8	6031	+	NM_002496	67799618	67804060	7
chr11	67800330	67800389	MIR7113	59	+	NR_106963	67800389	67800389	1
chr11	67801363	67801448	MIR4691	85	+	NR_039840	67801448	67801448	1
chr11	67806461	67818366	TCIRG1	11905	+	NM_006019	67808738	67818286	20
chr11	67812260	67812424	MIR6753	164	+	NR_106811	67812424	67812424	1
chr11	67820325	67888858	CHKA	68533	-	NM_001277	67821454	67888644	12
chr11	67922329	67981239	KMT5B	58910	-	NM_001300908	67925154	67939109	11
chr11	68028802	68039469	C11orf24	10667	-	NM_001300913	68029112	68031235	5
chr11	68080076	68216743	LRP5	136667	+	NM_002335	68080182	68216538	23
chr11	68228185	68382801	PPP6R3	154616	+	NM_001164160	68305132	68380585	25
chr11	68451942	68458643	GAL	6701	+	NM_015973	68452391	68458455	6
chr11	68474907	68518988	MTL5	44081	-	NM_004923	68475775	68518128	10
chr11	68522087	68609399	CPT1A	87312	-	NM_001031847	68522283	68582942	19
chr11	68658745	68671303	MRPL21	12558	-	NM_181515	68658798	68664123	7
chr11	68671318	68708069	IGHMBP2	36751	+	NM_002180	68671420	68707199	15
chr11	68747489	68748455	MRGPRD	966	-	NM_198923	68747489	68748455	1
chr11	68771861	68780850	MRGPRF	8989	-	NM_001098515	68772745	68777369	3
chr11	68779821	68785916	MRGPRF-AS1	6095	+	NR_120541	68785916	68785916	6
chr11	68816349	68858072	TPCN2	41723	+	NM_139075	68816465	68855421	25
chr11	68850643	68850726	MIR3164	83	+	NR_036122	68850726	68850726	1
chr11	68914695	68939030	LOC338694	24335	-	NR_104161	68939030	68939030	3
chr11	69061604	69064754	MYEOV	3150	+	NM_001300923	69063091	69063859	3
chr11	69300328	69308311	LINC01488	7983	+	NR_120542	69308311	69308311	6
chr11	69455872	69469242	CCND1	13370	+	NM_053056	69456081	69466050	5
chr11	69480331	69490165	ORAOV1	9834	-	NM_153451	69482286	69490007	5
chr11	69513005	69519106	FGF19	6101	-	NM_005117	69514029	69518644	3
chr11	69587796	69590171	FGF4	2375	-	NM_002007	69588076	69589852	3
chr11	69624735	69634192	FGF3	9457	-	NM_005247	69625072	69633701	3
chr11	69902335	69911477	LOC101928443	9142	-	NR_120529	69911477	69911477	2
chr11	69918539	69921454	ANO1-AS2	2915	-	NR_103835	69921454	69921454	3
chr11	69924407	70035652	ANO1	111245	+	NM_018043	69924712	70034110	26
chr11	70049268	70053508	FADD	4240	+	NM_003824	70049565	70052579	2
chr11	70116805	70230607	PPFIA1	113802	+	NR_045286	70230607	70230607	29
chr11	70130060	70130176	MIR548K	116	+	NR_031624	70130176	70130176	1
chr11	70244611	70282690	CTTN	38079	+	NM_001184740	70253403	70282514	19
chr11	70313960	70935842	SHANK2	621882	-	NM_012309	70318973	70858372	23
chr11	70477198	70481595	SHANK2-AS1	4397	+	NR_046567	70481595	70481595	3
chr11	70708894	70711220	SHANK2-AS3	2326	+	NR_073536	70711220	70711220	3
chr11	70718374	70718473	MIR3664	99	-	NR_037437	70718473	70718473	1
chr11	71116791	71134400	FLJ42102	17609	-	NR_038862	71134400	71134400	3
chr11	71145456	71159477	DHCR7	14021	-	NM_001163817	71146420	71155998	9
chr11	71164216	71212581	NADSYN1	48365	+	NM_018161	71164342	71212398	21
chr11	71184548	71184614	MIR6754	66	+	NR_106812	71184614	71184614	1
chr11	71238312	71239210	KRTAP5-7	898	+	NM_001012503	71238346	71238844	1
chr11	71249070	71250253	KRTAP5-8	1183	+	NM_021046	71249101	71249665	1
chr11	71259465	71260653	KRTAP5-9	1188	+	NM_005553	71259703	71260213	1
chr11	71276608	71277666	KRTAP5-10	1058	+	NM_001012710	71276633	71277242	1
chr11	71292900	71293921	KRTAP5-11	1021	-	NM_001005405	71293412	71293883	1
chr11	71498556	71512280	FAM86C1	13724	+	NM_018172	71498582	71510693	5
chr11	71505408	71524905	ALG1L9P	19497	-	NR_073386	71524905	71524905	4
chr11	71525090	71532593	ZNF705E	7503	-	NM_001278713	71527557	71532522	5
chr11	71544245	71548608	DEFB108B	4363	+	NM_001002035	71544245	71548608	2
chr11	71576554	71639493	LOC100133315	62939	-	NR_029192	71639493	71639493	7
chr11	71589498	71595607	LOC100129216	6109	+	NM_001242853	71589498	71595607	2
chr11	71639767	71708643	RNF121	68876	+	NR_024148	71708643	71708643	9
chr11	71709957	71713850	IL18BP	3893	+	NM_173044	71711030	71712942	6
chr11	71713909	71791739	NUMA1	77830	-	NM_006185	71714572	71746989	27
chr11	71725336	71731956	LOC100128494	6620	+	NR_104178	71731956	71731956	4
chr11	71783273	71783348	MIR3165	75	-	NR_036123	71783348	71783348	1
chr11	71791376	71821828	LRTOMT	30452	+	NM_001145310	71806108	71819971	9
chr11	71808337	71814433	LAMTOR1	6096	-	NM_017907	71808867	71814270	5
chr11	71820632	71823822	ANAPC15	3190	-	NM_001278489	71820926	71822322	6
chr11	71846770	71850934	FOLR3	4164	+	NM_000804	71846998	71850875	5
chr11	71900601	71907367	FOLR1	6766	+	NM_016724	71903217	71907221	6
chr11	71927818	71932994	FOLR2	5176	+	NM_000803	71929628	71932806	5
chr11	71935881	71950188	INPPL1	14307	+	NM_001567	71936028	71949397	28
chr11	71950120	71955220	PHOX2A	5100	-	NM_005169	71950792	71955048	3
chr11	72003469	72145728	CLPB	142259	-	NM_001258394	72004410	72145276	18
chr11	72281699	72284266	LINC01537	2567	+	NR_126364	72284266	72284266	2
chr11	72287183	72385497	PDE2A	98314	-	NM_002599	72288427	72385251	31
chr11	72326106	72326174	MIR139	68	-	NR_029603	72326174	72326174	1
chr11	72396113	72463434	ARAP1	67321	-	NM_001040118	72396708	72438173	35
chr11	72465773	72504750	STARD10	38977	-	NM_006645	72465941	72492226	7
chr11	72494574	72494637	MIR4692	63	+	NR_039841	72494637	72494637	1
chr11	72525450	72540680	ATG16L2	15230	+	NM_033388	72525490	72540435	18
chr11	72547789	72853143	FCHSD2	305354	-	NM_014824	72549835	72852922	20
chr11	72590964	72604767	MIR4459	13803	+	NR_039664	72604767	72604767	3
chr11	72929342	72953472	P2RY2	24130	+	NM_176072	72945204	72946338	3
chr11	72975549	73009670	P2RY6	34121	+	NM_176796	73007563	73008550	4
chr11	73019662	73080425	ARHGEF17	60763	+	NM_014786	73019683	73078825	21
chr11	73087404	73108519	RELT	21115	+	NM_152222	73100181	73106536	11
chr11	73111522	73309234	FAM168A	197712	-	NM_001286050	73118575	73179519	9
chr11	73357222	73373864	PLEKHB1	16642	+	NM_021200	73357653	73372647	8
chr11	73386682	73472201	RAB6A	85519	-	NM_198896	73388942	73471680	8
chr11	73498916	73575656	MRPL48	76740	+	NM_016055	73499016	73575415	8
chr11	73583712	73587890	COA4	4178	-	NM_016565	73584159	73584423	2
chr11	73587743	73638781	PAAF1	51038	+	NM_001267806	73610253	73638407	12
chr11	73661363	73681332	DNAJB13	19969	+	NM_153614	73662114	73681159	8
chr11	73685715	73693889	UCP2	8174	-	NM_003355	73686051	73689423	8
chr11	73711325	73720282	UCP3	8957	-	NM_003356	73712456	73718087	7
chr11	73723758	73882064	C2CD3	158306	-	NM_001286577	73724429	73881837	33
chr11	73882107	73965748	PPME1	83641	+	NM_001271593	73882466	73964555	14
chr11	73977693	74022721	P4HA3	45028	-	NM_182904	73978292	74022656	13
chr11	74022406	74035750	LOC101928580	13344	+	NR_120556	74035750	74035750	7
chr11	74041356	74109510	PGM2L1	68154	-	NM_173582	74047696	74109206	14
chr11	74165885	74178600	KCNE3	12715	-	NM_005472	74168296	74168608	3
chr11	74202922	74204755	LIPT2	1833	-	NM_001144869	74203179	74204748	2
chr11	74303574	74354105	POLD3	50531	+	NM_006591	74303703	74351811	12
chr11	74407472	74442430	CHRDL2	34958	-	NM_015424	74407542	74441933	12
chr11	74431312	74431382	MIR4696	70	-	NR_039845	74431382	74431382	1
chr11	74459912	74553458	RNF169	93546	+	NM_001098638	74459925	74547775	6
chr11	74551954	74660232	XRRA1	108278	-	NM_182969	74554244	74651923	19
chr11	74660291	74690076	SPCS2	29785	+	NM_014752	74660330	74688088	5
chr11	74699949	74718743	NEU3	18794	+	NM_006656	74700105	74717537	3
chr11	74799795	74800758	OR2AT4	963	-	NM_001005285	74799795	74800758	1
chr11	74862031	74917445	SLCO2B1	55414	+	NM_007256	74862426	74915625	14
chr11	74951949	74954749	TPBGL	2800	+	NM_001195528	74952094	74953243	1
chr11	74971165	75062875	ARRB1	91710	-	NM_004041	74977206	75062651	16
chr11	75046135	75046230	MIR326	95	-	NR_029891	75046230	75046230	1
chr11	75110534	75133345	RPS3	22811	+	NM_001256802	75110591	75115909	7
chr11	75111434	75111582	SNORD15A	148	+	NR_000005	75111582	75111582	1
chr11	75115464	75115610	SNORD15B	146	+	NR_000025	75115610	75115610	1
chr11	75133437	75141674	KLHL35	8237	-	NM_001039548	75133623	75141674	6
chr11	75145684	75236599	GDPD5	90915	-	NM_030792	75146551	75188780	17
chr11	75273100	75283849	SERPINH1	10749	+	NM_001207014	75277394	75283128	6
chr11	75297962	75379479	MAP6	81517	-	NM_033063	75298103	75379414	4
chr11	75428933	75442331	MOGAT2	13398	+	NM_025098	75428933	75442331	6
chr11	75469499	75479692	LOC283214	10193	-	NR_046090	75479692	75479692	4
chr11	75479777	75512581	DGAT2	32804	+	NM_032564	75480036	75511553	8
chr11	75526211	75855282	UVRAG	329071	+	NM_003369	75526452	75852457	15
chr11	75897369	75917574	WNT11	20205	-	NM_004626	75898108	75917451	5
chr11	76061000	76092009	PRKRIR	31009	-	NR_130898	76092009	76092009	6
chr11	76092356	76125665	LOC100506127	33309	+	NR_130990	76125665	76125665	4
chr11	76156068	76263943	EMSY	107875	+	NM_001300942	76157982	76261190	22
chr11	76368567	76381791	LRRC32	13224	-	NM_001128922	76370647	76376998	3
chr11	76391209	76432833	GUCY2EP	41624	-	NR_024042	76432833	76432833	21
chr11	76493356	76509198	TSKU	15842	+	NM_001258210	76506660	76507722	2
chr11	76493624	76494106	LOC101928837	482	-	NR_120561	76494106	76494106	2
chr11	76571916	76737841	ACER3	165925	+	NM_018367	76572020	76731371	11
chr11	76745384	76753005	B3GNT6	7621	+	NM_138706	76750595	76751753	4
chr11	76777991	76837198	CAPN5	59207	+	NM_004055	76795932	76834916	13
chr11	76813885	76814377	OMP	492	+	NM_006189	76813885	76814377	1
chr11	76839309	76926286	MYO7A	86977	+	NM_000260	76841680	76925741	49
chr11	76927602	76998463	GDPD4	70861	-	NM_182833	76928321	76996182	16
chr11	77033059	77185108	PAK1	152049	-	NM_001128620	77034343	77103565	16
chr11	77282133	77286707	LOC646029	4574	+	NR_130930	77286707	77286707	3
chr11	77300679	77321401	AQP11	20722	+	NM_173039	77301037	77320422	3
chr11	77327195	77348851	CLNS1A	21656	-	NM_001293	77330672	77348759	7
chr11	77377273	77531880	RSF1	154607	-	NM_016578	77377961	77531760	16
chr11	77532159	77611831	AAMDC	79672	+	NM_001316958	77553542	77611647	7
chr11	77589765	77705717	INTS4	115952	-	NM_033547	77589994	77705689	23
chr11	77726760	77757237	KCTD14	30477	-	NM_001282406	77727638	77728316	3
chr11	77726760	77791265	NDUFC2-KCTD14	64505	-	NM_001203260	77749709	77790790	4
chr11	77774906	77779403	THRSP	4497	+	NM_003251	77774927	77775368	2
chr11	77779392	77791265	NDUFC2	11873	-	NM_004549	77781032	77790790	3
chr11	77811987	77850699	ALG8	38712	-	NM_001007027	77813939	77850634	14
chr11	77850838	77885023	KCTD21-AS1	34185	+	NR_102280	77885023	77885023	4
chr11	77882289	77899675	KCTD21	17386	-	NM_001029859	77884817	77885600	2
chr11	77899857	77925757	USP35	25900	+	NM_020798	77907291	77924859	11
chr11	77926335	78128868	GAB2	202533	-	NM_080491	77930317	78128766	10
chr11	78135028	78140882	LOC101928865	5854	-	NR_120564	78140882	78140882	4
chr11	78147006	78285909	NARS2	138903	-	NM_024678	78147715	78285533	14
chr11	78244221	78269611	LOC101928896	25390	+	NR_120566	78269611	78269611	4
chr11	78364327	79151695	TENM4	787368	-	NM_001098816	78369102	78780989	34
chr11	79113065	79113153	MIR708	88	-	NR_030598	79113153	79113153	1
chr11	79133212	79133270	MIR5579	58	-	NR_049841	79133270	79133270	1
chr11	80462243	80473846	LOC101928944	11603	-	NR_120570	80473846	80473846	3
chr11	81590892	82114955	MIR4300HG	524063	-	NR_120571	82114955	82114955	8
chr11	81601782	81601878	MIR4300	96	-	NR_036186	81601878	81601878	1
chr11	82443045	82444906	FAM181B	1861	-	NM_175885	82443490	82444771	1
chr11	82535408	82611557	PRCP	76149	-	NM_199418	82535947	82611444	10
chr11	82612736	82645699	DDIAS	32963	+	NM_145018	82625780	82645377	6
chr11	82684174	82782965	RAB30	98791	-	NM_014488	82693206	82708358	6
chr11	82752505	82752640	SNORA70E	135	-	NR_033347	82752640	82752640	1
chr11	82783107	82784754	RAB30-AS1	1647	+	NR_038903	82784754	82784754	3
chr11	82868136	82896835	PCF11	28699	+	NM_015885	82868481	82895936	16
chr11	82896562	82898526	PCF11-AS1	1964	-	NR_133914	82898526	82898526	1
chr11	82904780	82967141	ANKRD42	62361	+	NM_001300973	82905712	82966976	12
chr11	82970134	82997450	CCDC90B	27316	-	NM_021825	82972952	82997015	9
chr11	83166055	85338314	DLG2	2172259	-	NM_001142699	83170860	85309740	28
chr11	85339616	85347583	TMEM126B	7967	+	NM_001193538	85342739	85347273	6
chr11	85358962	85367597	TMEM126A	8635	+	NM_032273	85361299	85367545	5
chr11	85368607	85376182	CREBZF	7575	-	NR_028026	85376182	85376182	5
chr11	85394886	85397320	CCDC89	2434	-	NM_152723	85396048	85397173	1
chr11	85405264	85522202	SYTL2	116938	-	NM_001289608	85406237	85459423	19
chr11	85566143	85631063	CCDC83	64920	+	NM_173556	85576166	85630553	12
chr11	85668213	85780923	PICALM	112710	-	NM_001206947	85670088	85742630	19
chr11	85955425	85989852	EED	34427	+	NM_001308007	85956271	85989567	13
chr11	85989374	85989440	MIR6755	66	+	NR_106813	85989440	85989440	1
chr11	86013252	86056985	C11orf73	43733	+	NM_016401	86013490	86056680	5
chr11	86085777	86134151	CCDC81	48374	+	NM_001156474	86086205	86133757	15
chr11	86152149	86383678	ME3	231529	-	NM_001161586	86152320	86382986	15
chr11	86511281	86663945	PRSS23	152664	+	NR_120591	86663945	86663945	5
chr11	86567972	86568996	OR7E2P	1024	-	NR_045004	86568996	86568996	1
chr11	86656716	86666440	FZD4	9724	-	NM_012193	86662183	86666127	2
chr11	86666662	86711989	LOC100506368	45327	+	NR_038905	86711989	86711989	3
chr11	86748885	87039876	TMEM135	290991	+	NM_022918	86749087	87032375	15
chr11	87846414	87908635	RAB38	62221	-	NM_022337	87847155	87908552	3
chr11	87909669	87909761	MIR3166	92	+	NR_036124	87909761	87909761	1
chr11	88026759	88070941	CTSC	44182	-	NM_001814	88027173	88070840	7
chr11	88237743	88257222	GRM5-AS1	19479	+	NR_049724	88257222	88257222	6
chr11	88237743	88796846	GRM5	559103	-	NM_000842	88241759	88781040	9
chr11	88911039	89028927	TYR	117888	+	NM_000372	88911121	89028534	5
chr11	89057521	89322779	NOX4	265258	-	NM_001143837	89059923	89223706	21
chr11	89392464	89431886	FOLH1B	39422	+	NM_153696	89402576	89431767	14
chr11	89443466	89451040	TRIM77	7574	+	NM_001146162	89443466	89451040	6
chr11	89530822	89541743	TRIM49	10921	-	NM_020358	89531297	89537637	8
chr11	89575164	89584136	TRIM53AP	8972	+	NR_028346	89584136	89584136	7
chr11	89603605	89609185	TRIM64B	5580	-	NM_001164397	89603788	89609185	6
chr11	89644578	89653576	TRIM49D2	8998	-	NM_001105522	89644754	89650878	7
chr11	89644639	89650878	TRIM49D1	6239	-	NM_001206627	89644754	89650878	6
chr11	89701671	89707240	TRIM64	5569	+	NM_001136486	89701671	89707057	6
chr11	89764273	89775193	TRIM49C	10920	+	NM_001195234	89768379	89774718	8
chr11	89819117	89820299	UBTFL1	1182	+	NM_001143975	89819117	89820299	1
chr11	89867817	89925779	NAALAD2	57962	+	NM_005467	89867926	89924915	19
chr11	89933596	89956532	CHORDC1	22936	-	NM_012124	89935572	89956122	11
chr11	89984399	90648220	DISC1FP1	663821	+	NR_104190	90648220	90648220	7
chr11	90288941	90289025	MIR4490	84	-	NR_039711	90289025	90289025	1
chr11	90602288	90602370	MIR1261	82	-	NR_031663	90602370	90602370	1
chr11	92085261	92629635	FAT3	544374	+	NM_001008781	92085278	92624279	25
chr11	92702788	92715948	MTNR1B	13160	+	NM_005959	92702891	92715478	2
chr11	92877336	92931141	SLC36A4	53805	-	NM_152313	92881702	92930998	11
chr11	93063882	93171636	CCDC67	107754	+	NM_181645	93065425	93170885	14
chr11	93211638	93276546	SMCO4	64908	-	NM_020179	93212175	93212355	3
chr11	93394815	93463522	CEP295	68707	+	NM_033395	93399873	93463435	30
chr11	93454679	93455032	SCARNA9	353	+	NR_002569	93455032	93455032	1
chr11	93463680	93463812	SNORA25	132	-	NR_003028	93463812	93463812	1
chr11	93464144	93464265	SNORA32	121	-	NR_003032	93464265	93464265	1
chr11	93464668	93464739	SNORD6	71	-	NR_003036	93464739	93464739	1
chr11	93465169	93465299	SNORA1	130	-	NR_003026	93465299	93465299	1
chr11	93465526	93465665	SNORA8	139	-	NR_002920	93465665	93465665	1
chr11	93466393	93466466	SNORD5	73	-	NR_003033	93466466	93466466	1
chr11	93466631	93466763	SNORA18	132	-	NR_002959	93466763	93466763	1
chr11	93466839	93466930	MIR1304	91	-	NR_031639	93466930	93466930	1
chr11	93468275	93468402	SNORA40	127	-	NR_002973	93468402	93468402	1
chr11	93469095	93474703	TAF1D	5608	-	NM_024116	93469326	93472470	6
chr11	93474759	93496268	C11orf54	21509	+	NM_001286067	93480559	93494854	10
chr11	93517404	93546496	MED17	29092	+	NM_004268	93517679	93545230	12
chr11	93553734	93583668	VSTM5	29934	-	NM_001144871	93553734	93583668	4
chr11	93754377	93847374	HEPHL1	92997	+	NM_001098672	93754534	93845060	20
chr11	93862093	93915137	PANX1	53044	+	NM_015368	93862478	93914035	5
chr11	94038802	94040858	IZUMO1R	2056	+	NM_001199206	94038802	94040858	4
chr11	94110476	94134585	GPR83	24109	-	NM_016540	94113314	94134413	4
chr11	94150468	94227040	MRE11A	76572	-	NM_005591	94153290	94225967	20
chr11	94199660	94199746	MIR548L	86	-	NR_031630	94199746	94199746	1
chr11	94227152	94232744	ANKRD49	5592	+	NM_017704	94229859	94231698	3
chr11	94245694	94265289	C11orf97	19595	+	NM_001190462	94245694	94265066	4
chr11	94277016	94283064	FUT4	6048	+	NM_002033	94277299	94278892	1
chr11	94300473	94354587	PIWIL4	54114	+	NM_152431	94300684	94354158	20
chr11	94501507	94609918	AMOTL1	108411	+	NM_130847	94501677	94603960	13
chr11	94695786	94706776	CWC15	10990	-	NM_016403	94696549	94705349	7
chr11	94706844	94732676	KDM4D	25832	+	NM_018039	94730536	94732108	3
chr11	94758421	94760760	KDM4E	2339	+	NM_001161630	94758721	94760242	1
chr11	94800040	94804387	SRSF8	4347	+	NR_103726	94804387	94804387	2
chr11	94822973	94865815	ENDOD1	42842	+	NM_015036	94823091	94862743	2
chr11	94883702	94892312	LOC101929295	8610	+	NR_110303	94892312	94892312	3
chr11	94898676	94965705	SESN3	67029	-	NM_001271594	94906418	94924675	9
chr11	94963349	94967568	LOC100129203	4219	+	NR_110295	94967568	94967568	6
chr11	95502105	95522954	FAM76B	20849	-	NM_144664	95504724	95522642	10
chr11	95523624	95565857	CEP57	42233	+	NM_001243776	95528705	95564420	12
chr11	95566043	95657371	MTMR2	91328	-	NM_001243571	95568453	95598810	18
chr11	95709756	96076344	MAML2	366588	-	NM_032427	95712111	96075059	5
chr11	96074601	96074690	MIR1260B	89	+	NR_036125	96074690	96074690	1
chr11	96085928	96123083	CCDC82	37155	-	NM_024725	96086809	96117911	10
chr11	96123157	96126727	JRKL	3570	+	NM_001261833	96123813	96125388	2
chr11	96176445	96240041	JRKL-AS1	63596	-	NR_047481	96240041	96240041	5
chr11	98891705	100229616	CNTN5	1337911	+	NM_014361	99426945	100226951	25
chr11	100554891	100558686	LOC100128386	3795	-	NR_133571	100558686	100558686	2
chr11	100558406	100861656	ARHGAP42	303250	+	NM_152432	100558409	100859532	24
chr11	100862810	100864666	TMEM133	1856	+	NM_032021	100863039	100863429	1
chr11	100900354	101000544	PGR	100190	-	NM_000926	100909846	100999801	8
chr11	100999807	101030001	LOC101054525	30194	+	NR_073144	101030001	101030001	5
chr11	101322294	101454659	TRPC6	132365	-	NM_004621	101323685	101454234	13
chr11	101390550	101390636	MIR3920	86	-	NR_037485	101390636	101390636	1
chr11	101761404	101787253	ANGPTL5	25849	-	NM_178127	101762009	101778640	9
chr11	101785745	101871796	CEP126	86051	+	NM_020802	101786015	101868374	11
chr11	101918168	101955291	C11orf70	37123	+	NM_032930	101918201	101953930	7
chr11	101981191	102104154	YAP1	122963	+	NM_001282101	101981579	102100671	9
chr11	102188180	102210135	BIRC3	21955	+	NM_182962	102195240	102207833	10
chr11	102217912	102249401	BIRC2	31489	+	NM_001166	102220585	102248914	9
chr11	102267055	102323775	TMEM123	56720	-	NM_052932	102269597	102323354	5
chr11	102391238	102401478	MMP7	10240	-	NM_002423	102391506	102401431	6
chr11	102447565	102496063	MMP20	48498	-	NM_004771	102448056	102496050	10
chr11	102562414	102576468	MMP27	14054	-	NM_022122	102562496	102576445	10
chr11	102582525	102595685	MMP8	13160	-	NM_001304442	102584078	102593754	11
chr11	102641232	102651359	MMP10	10127	-	NM_002425	102641523	102651322	10
chr11	102654406	102707497	WTAPP1	53091	+	NR_038390	102707497	102707497	8
chr11	102660640	102668966	MMP1	8326	-	NM_001145938	102661142	102668138	10
chr11	102706527	102714420	MMP3	7893	-	NM_002422	102706856	102714277	10
chr11	102733463	102745764	MMP12	12301	-	NM_002426	102733830	102745667	10
chr11	102813720	102826463	MMP13	12743	-	NM_002427	102814994	102826434	10
chr11	102921412	102962944	DCUN1D5	41532	-	NM_032299	102933087	102962601	8
chr11	102980159	103350591	DYNC2H1	370432	+	NM_001080463	102980303	103349981	90
chr11	103720633	103720708	MIR4693	75	+	NR_039842	103720708	103720708	1
chr11	103777913	104035027	PDGFD	257114	-	NM_025208	103780421	104034655	7
chr11	103907307	103909922	DDI1	2615	+	NM_001001711	103907550	103908741	1
chr11	104123318	104123379	MIR7641-1	61	+	NR_106987	104123379	104123379	1
chr11	104439216	104480030	LOC102723895	40814	-	NR_120585	104480030	104480030	4
chr11	104756444	104769397	CASP12	12953	-	NR_034070	104769397	104769397	9
chr11	104772275	104788902	LOC643733	16627	-	NR_034079	104788902	104788902	5
chr11	104813593	104839325	CASP4	25732	-	NM_001225	104815479	104839252	9
chr11	104864966	104893895	CASP5	28929	-	NM_001136112	104866470	104893863	10
chr11	104896236	104905884	CASP1	9648	-	NM_033292	104896984	104905840	10
chr11	104912052	104916051	CARD16	3999	-	NM_052889	104914252	104916024	4
chr11	104933328	104942257	CASP1P2	8929	-	NR_131905	104942257	104942257	5
chr11	104963195	104972158	CARD17	8963	-	NM_001007232	104970089	104972141	4
chr11	105008447	105010461	CARD18	2014	-	NM_021571	105009539	105010453	3
chr11	105480799	105852819	GRIA4	372020	+	NM_000829	105481724	105850466	17
chr11	105878628	105892954	MSANTD4	14326	-	NM_032424	105880261	105881644	3
chr11	105921824	105948465	KBTBD3	26641	-	NM_198439	105923576	105929824	4
chr11	105948291	105969419	AASDHPPT	21128	+	NM_015423	105948437	105967634	6
chr11	106122133	106135632	LOC101928535	13499	+	NR_120551	106135632	106135632	5
chr11	106544737	106889171	GUCY1A2	344434	-	NM_001256424	106558274	106888781	9
chr11	107197071	107328572	CWF19L2	131501	-	NM_152434	107197635	107328542	18
chr11	107373452	107436461	ALKBH8	63009	-	NM_001301010	107375383	107436358	12
chr11	107461816	107537505	ELMOD1	75689	+	NM_001308018	107501143	107535923	13
chr11	107462470	107463949	LOC643923	1479	+	NR_028328	107463949	107463949	3
chr11	107578100	107582787	SLN	4687	-	NM_003063	107578560	107578656	2
chr11	107661716	107729914	SLC35F2	68198	-	NM_017515	107663340	107729493	8
chr11	107799200	107834208	RAB39A	35008	+	NM_017516	107799294	107833098	2
chr11	107879407	107978488	CUL5	99081	+	NM_003478	107880074	107975111	19
chr11	107992257	108018891	ACAT1	26634	+	NM_000019	107992333	108018117	12
chr11	108028118	108093365	NPAT	65247	-	NM_002519	108029668	108093263	18
chr11	108093558	108239826	ATM	146268	+	NM_000051	108098351	108236235	63
chr11	108253726	108338258	C11orf65	84532	-	NM_152587	108253747	108332286	9
chr11	108342832	108369159	KDELC2	26327	-	NM_153705	108345553	108369093	8
chr11	108376157	108464465	EXPH5	88308	-	NM_001308019	108380263	108464460	7
chr11	108535751	108811657	DDX10	275906	+	NM_004398	108535880	108811150	18
chr11	109292845	109299893	C11orf87	7048	+	NM_207645	109294359	109294953	2
chr11	109964086	110042566	ZC3H12C	78480	+	NM_033390	109964137	110036462	6
chr11	110045604	110167437	RDX	121833	-	NM_001260493	110070336	110150417	16
chr11	110300660	110335608	FDX1	34948	+	NM_004109	110300844	110333192	4
chr11	110447758	110583912	ARHGAP20	136154	-	NM_001258416	110450093	110561721	16
chr11	111126706	111157129	C11orf53	30423	+	NM_198498	111152158	111156779	4
chr11	111164113	111175773	COLCA1	11660	-	NM_001302644	111166828	111167203	2
chr11	111169270	111179460	COLCA2	10190	+	NM_001271458	111169306	111179162	5
chr11	111218481	111218547	MIR4491	66	+	NR_039712	111218547	111218547	1
chr11	111222980	111250157	POU2AF1	27177	-	NM_006235	111224985	111249902	5
chr11	111284966	111288911	LOC100132078	3945	-	NR_046085	111288911	111288911	4
chr11	111338255	111383079	BTG4	44824	-	NM_017589	111338396	111369501	6
chr11	111383662	111383746	MIR34B	84	+	NR_029839	111383746	111383746	1
chr11	111384163	111384240	MIR34C	77	+	NR_029840	111384240	111384240	1
chr11	111385509	111407756	C11orf88	22247	+	NM_207430	111385509	111407552	7
chr11	111411232	111432470	LAYN	21238	+	NM_001258390	111411568	111431183	8
chr11	111473114	111597641	SIK2	124527	+	NM_015191	111473287	111594853	15
chr11	111597631	111637169	PPP2R1B	39538	-	NM_181699	111597688	111637085	16
chr11	111652918	111742305	ALG9	89387	-	NM_001077690	111657120	111742206	16
chr11	111744779	111750181	FDXACB1	5402	-	NM_138378	111745645	111749856	5
chr11	111749947	111754797	C11orf1	4850	+	NM_022761	111750284	111754604	4
chr11	111779343	111783937	CRYAB	4594	-	NM_001885	111779487	111782448	4
chr11	111783459	111784817	HSPB2	1358	+	NM_001541	111783553	111784619	2
chr11	111783459	111797595	HSPB2-C11orf52	14136	+	NR_037651	111797595	111797595	5
chr11	111789600	111797595	C11orf52	7995	+	NM_080659	111789696	111796923	4
chr11	111807926	111893374	DIXDC1	85448	+	NM_001037954	111808223	111889760	20
chr11	111895537	111935002	DLAT	39465	+	NM_001931	111896196	111933259	14
chr11	111934733	111944895	PIH1D2	10162	-	NM_001082619	111934891	111943898	6
chr11	111944967	111955874	C11orf57	10907	+	NM_001082970	111946298	111953696	6
chr11	111955538	111957522	TIMM8B	1984	-	NR_028383	111957522	111957522	3
chr11	111957547	111966525	SDHD	8978	+	NM_001276506	111957631	111963921	5
chr11	112013973	112034840	IL18	20867	-	NM_001562	112014318	112025776	6
chr11	112038094	112043279	TEX12	5185	+	NM_031275	112039991	112042639	5
chr11	112046207	112089649	BCO2	43442	+	NM_031938	112046324	112088597	12
chr11	112097087	112104695	PTS	7608	+	NM_000317	112097166	112104278	6
chr11	112118875	112131583	PLET1	12708	-	NM_001145024	112119521	112131312	4
chr11	112130987	112132119	LOC100132686	1132	+	NR_133566	112132119	112132119	1
chr11	112141471	112233257	LOC283140	91786	+	NR_126004	112233257	112233257	4
chr11	112352954	112412639	LOC101928823	59685	+	NR_120559	112412639	112412639	3
chr11	112404944	112426525	LOC387810	21581	-	NR_104155	112426525	112426525	4
chr11	112830002	112834182	LOC101928847	4180	-	NR_120563	112834182	112834182	3
chr11	112831968	113149158	NCAM1	317190	+	NM_001242607	112832333	113146109	21
chr11	113140253	113144623	NCAM1-AS1	4370	-	NR_034101	113144623	113144623	3
chr11	113185250	113237114	TTC12	51864	+	NM_017868	113186979	113237022	22
chr11	113258512	113271140	ANKK1	12628	+	NM_178510	113258606	113270989	8
chr11	113280316	113346001	DRD2	65685	-	NM_000795	113281448	113295373	8
chr11	113320744	113320810	MIR4301	66	-	NR_036183	113320810	113320810	1
chr11	113558267	113577095	TMPRSS5	18828	-	NM_001288751	113558981	113570762	13
chr11	113603904	113644485	ZW10	40581	-	NM_004724	113604415	113644388	16
chr11	113650517	113651207	CLDN25	690	+	NM_001101389	113650517	113651207	1
chr11	113668596	113746292	USP28	77696	-	NM_020886	113669961	113746223	25
chr11	113775517	113817283	HTR3B	41766	+	NM_006028	113775655	113816859	9
chr11	113845796	113861034	HTR3A	15238	+	NM_000869	113846029	113860485	9
chr11	113930430	114121397	ZBTB16	190967	+	NM_006006	113934022	114121277	7
chr11	114166534	114183238	NNMT	16704	+	NM_006169	114167278	114183199	3
chr11	114231356	114250761	LOC101928940	19405	-	NR_120567	114250761	114250761	3
chr11	114262169	114271272	C11orf71	9103	-	NM_019021	114262286	114271053	2
chr11	114271250	114281332	RBM7	10082	+	NM_016090	114271393	114278529	5
chr11	114310107	114321000	REXO2	10893	+	NM_015523	114310250	114320697	7
chr11	114392436	114430617	NXPE1	38181	-	NM_152315	114392689	114401303	6
chr11	114441312	114466484	NXPE4	25172	-	NM_001077639	114441659	114465481	6
chr11	114549199	114577652	NXPE2	28453	+	NM_182495	114549297	114577652	6
chr11	115044344	115375241	CADM1	330897	-	NM_001301043	115047193	115375112	12
chr11	115626050	115630918	LINC00900	4868	-	NR_034148	115630918	115630918	3
chr11	116618885	116643714	BUD13	24829	-	NM_001159736	116619197	116643680	10
chr11	116648904	116658754	ZPR1	9850	-	NM_003904	116649640	116658706	14
chr11	116660085	116663136	APOA5	3051	-	NM_052968	116660843	116662576	4
chr11	116691417	116694011	APOA4	2594	-	NM_000482	116691582	116693907	3
chr11	116700623	116703787	APOC3	3164	+	NM_000040	116701298	116703600	4
chr11	116706466	116708666	APOA1	2200	-	NM_000039	116706523	116708103	4
chr11	116706832	116726445	APOA1-AS	19613	+	NR_126362	116726445	116726445	2
chr11	116714117	116969131	SIK3	255014	-	NM_001281748	116717111	116798073	25
chr11	117014999	117048889	PAFAH1B2	33890	+	NR_110269	117048889	117048889	8
chr11	117049938	117068161	SIDT2	18223	+	NM_001040455	117049979	117066782	26
chr11	117066328	117072630	LOC100652768	6302	-	NR_045215	117072630	117072630	8
chr11	117070039	117075508	TAGLN	5469	+	NM_003186	117073729	117075075	5
chr11	117075786	117103241	PCSK7	27455	-	NM_004716	117076712	117100560	17
chr11	117103340	117156404	RNF214	53064	+	NM_207343	117104988	117155867	15
chr11	117156401	117186972	BACE1	30571	-	NM_012104	117160281	117186511	9
chr11	117162061	117162886	BACE1-AS	825	+	NR_037803	117162886	117162886	1
chr11	117192493	117283982	CEP164	91489	+	NM_001271933	117209302	117282884	32
chr11	117298487	117667976	DSCAML1	369489	-	NM_020693	117299043	117667974	33
chr11	117690789	117698807	FXYD2	8018	-	NM_021603	117691386	117698728	6
chr11	117690789	117747746	FXYD6-FXYD2	56957	-	NM_001204268	117691386	117713491	11
chr11	117707690	117748201	FXYD6	40511	-	NM_001164831	117710516	117713491	8
chr11	117771355	117800168	TMPRSS13	28813	-	NM_001077263	117772953	117800022	13
chr11	117857105	117872199	IL10RA	15094	+	NR_026691	117872199	117872199	8
chr11	117886486	117957508	TMPRSS4-AS1	71022	-	NR_038318	117957508	117957508	4
chr11	117947726	117990556	TMPRSS4	42830	+	NM_001083947	117948017	117988628	13
chr11	118004091	118023630	SCN4B	19539	-	NM_174934	118007741	118023388	5
chr11	118033518	118047337	SCN2B	13819	-	NM_004588	118037601	118047146	4
chr11	118064441	118095809	JAML	31368	-	NM_001098526	118065039	118085581	10
chr11	118097404	118123083	MPZL3	25679	-	NM_198275	118100608	118123009	6
chr11	118124130	118135251	MPZL2	11121	-	NM_005797	118127964	118134868	6
chr11	118175294	118186890	CD3E	11596	+	NM_000733	118175667	118186257	9
chr11	118209788	118213459	CD3D	3671	-	NM_000732	118209876	118213322	5
chr11	118215058	118224497	CD3G	9439	+	NM_000073	118215138	118223184	7
chr11	118230295	118269926	UBE4A	39631	+	NM_004788	118235795	118267155	20
chr11	118251934	118289530	LOC100131626	37596	-	NR_046370	118289530	118289530	4
chr11	118272103	118280562	ATP5L	8459	+	NR_033759	118280562	118280562	4
chr11	118307204	118397539	KMT2A	90335	+	NM_005933	118307227	118392887	36
chr11	118382632	118401490	LOC101929089	18858	-	NR_120574	118401490	118401490	3
chr11	118398209	118401740	TTC36	3531	+	NM_001080441	118398209	118401631	3
chr11	118401802	118417313	TMEM25	15511	+	NM_001144037	118402516	118416862	9
chr11	118415242	118436791	IFT46	21549	-	NM_020153	118415630	118430544	13
chr11	118443101	118473747	ARCN1	30646	+	NM_001655	118443262	118471429	10
chr11	118477212	118528748	PHLDB1	51536	+	NM_015157	118484551	118527533	24
chr11	118514717	118514797	MIR6716	80	+	NR_106773	118514797	118514797	1
chr11	118528941	118550381	TREH	21440	-	NM_007180	118528998	118550336	15
chr11	118618472	118661972	DDX6	43500	-	NM_004397	118625420	118656960	14
chr11	118754474	118766980	CXCR5	12506	+	NM_001716	118754650	118765372	2
chr11	118766850	118781613	BCL9L	14763	-	NM_182557	118769123	118780648	8
chr11	118781416	118781496	MIR4492	80	+	NR_039713	118781496	118781496	1
chr11	118827007	118829269	UPK2	2262	+	NM_006760	118827060	118828943	5
chr11	118842416	118851995	FOXR1	9579	+	NM_181721	118842641	118851946	6
chr11	118868842	118886502	CCDC84	17660	+	NR_104051	118886502	118886502	11
chr11	118873670	118874303	RPL23AP64	633	-	NR_003040	118874303	118874303	1
chr11	118886421	118889057	RPS25	2636	-	NM_001028	118886554	118888994	5
chr11	118889240	118894385	TRAPPC4	5145	+	NM_016146	118889505	118894109	5
chr11	118889653	118889722	MIR3656	69	+	NR_037429	118889722	118889722	1
chr11	118895060	118901616	SLC37A4	6556	-	NM_001164278	118895619	118900079	12
chr11	118914895	118927957	HYOU1	13062	-	NM_006389	118916304	118926872	26
chr11	118938462	118952688	VPS11	14226	+	NM_021729	118938534	118952333	16
chr11	118955586	118964259	HMBS	8673	+	NM_000190	118955743	118963993	14
chr11	118964584	118966177	H2AFX	1593	-	NM_002105	118965672	118966104	1
chr11	118967212	118972785	DPAGT1	5573	-	NM_001382	118967707	118972365	9
chr11	118978059	118987834	C2CD2L	9775	+	NM_001290474	118978451	118986966	14
chr11	118992232	119005765	HINFP	13533	+	NM_015517	118997654	119005208	11
chr11	119019749	119033374	ABCG4	13625	+	NM_022169	119020675	119031816	15
chr11	119039042	119054726	NLRX1	15684	+	NM_001282358	119042112	119054148	10
chr11	119056165	119060932	PDZD3	4767	+	NM_024791	119056203	119060201	11
chr11	119060962	119066584	CCDC153	5622	-	NM_001145018	119061008	119066197	7
chr11	119076985	119178859	CBL	101874	+	NM_005188	119077127	119170491	16
chr11	119179233	119187840	MCAM	8607	-	NM_006500	119180595	119187811	16
chr11	119183659	119183722	MIR6756	63	-	NR_106814	119183722	119183722	1
chr11	119205209	119208024	RNF26	2815	+	NM_032015	119205832	119207134	1
chr11	119209643	119217383	C1QTNF5	7740	-	NM_015645	119210040	119211107	15
chr11	119209643	119217383	MFRP	7740	-	NM_031433	119212257	119217223	15
chr11	119225924	119252436	USP2	26512	-	NM_004205	119227544	119244190	13
chr11	119252487	119369944	USP2-AS1	117457	+	NR_034160	119369944	119369944	4
chr11	119288650	119295695	THY1	7045	-	NM_001311162	119290117	119291615	4
chr11	119508807	119599435	PVRL1	90628	-	NM_203285	119508807	119599263	8
chr11	119600292	119610333	LOC102724301	10041	+	NR_120587	119610333	119610333	4
chr11	119981993	120008863	TRIM29	26870	-	NM_012101	119983121	120008739	9
chr11	120081746	120100650	OAF	18904	+	NM_178507	120081987	120099851	4
chr11	120107348	120190653	POU2F3	83305	+	NM_001244682	120107382	120189101	13
chr11	120120467	120136641	LOC649133	16174	-	NR_038829	120136641	120136641	8
chr11	120195837	120204388	TMEM136	8551	+	NM_001198674	120198150	120201224	4
chr11	120207617	120360645	ARHGEF12	153028	+	NM_015313	120207952	120355786	41
chr11	120382454	120859513	GRIK4	477059	+	NM_014619	120531027	120856969	21
chr11	120682053	120689824	LOC105369532	7771	-	NR_133008	120689824	120689824	3
chr11	120738641	120765506	LOC101929227	26865	-	NR_132790	120765506	120765506	2
chr11	120811263	120828748	LOC101929208	17485	-	NR_133004	120828748	120828748	3
chr11	120894802	120960354	TBCEL	65552	+	NM_001130047	120916399	120957805	8
chr11	120973374	121061515	TECTA	88141	+	NM_005422	120973374	121061515	23
chr11	121163387	121184119	SC5D	20732	+	NM_006918	121174084	121178221	5
chr11	121322911	121504471	SORL1	181560	+	NM_003105	121323040	121500272	48
chr11	121959810	122073770	MIR100HG	113960	-	NR_024430	122073770	122073770	4
chr11	121970464	121970552	MIR125B1	88	-	NR_029671	121970552	121970552	1
chr11	121986061	121986923	BLID	862	-	NM_001001786	121986303	121986630	1
chr11	122017229	122017301	MIRLET7A2	72	-	NR_029477	122017301	122017301	1
chr11	122022936	122023016	MIR100	80	-	NR_029515	122023016	122023016	1
chr11	122526397	122685187	UBASH3B	158790	+	NM_032873	122526757	122680594	14
chr11	122709205	122743347	CRTAM	34142	+	NM_019604	122709254	122742107	10
chr11	122753235	122830430	C11orf63	77195	+	NM_024806	122756557	122830153	9
chr11	122848356	122852379	BSX	4023	-	NM_001098169	122848356	122852379	3
chr11	122888273	122890319	LOC341056	2046	+	NR_027288	122890319	122890319	1
chr11	122928199	122933043	HSPA8	4844	-	NM_006597	122928441	122932032	9
chr11	122942713	123066013	CLMP	123300	-	NM_024769	122944181	123065648	7
chr11	123252147	123252220	MIR4493	73	-	NR_039714	123252220	123252220	1
chr11	123396343	123498479	GRAMD1B	102136	+	NM_001286563	123396856	123493303	21
chr11	123499894	123525315	SCN3B	25421	-	NM_001040151	123504850	123524509	7
chr11	123594634	123612391	ZNF202	17757	-	NM_003455	123596704	123601596	9
chr11	123624287	123625226	OR6X1	939	-	NM_001005188	123624287	123625226	1
chr11	123676115	123677057	OR6M1	942	-	NM_001005325	123676115	123677057	1
chr11	123753632	123756349	TMEM225	2717	-	NM_001013743	123753844	123756132	4
chr11	123777138	123778083	OR8D4	945	+	NM_001005197	123777138	123778083	1
chr11	123810323	123811280	OR4D5	957	+	NM_001001965	123810323	123811280	1
chr11	123813573	123814545	OR6T1	972	-	NM_001005187	123813573	123814545	1
chr11	123847402	123848398	OR10S1	996	-	NM_001004474	123847402	123848398	1
chr11	123886281	123887217	OR10G4	936	+	NM_001004462	123886281	123887217	1
chr11	123893719	123894655	OR10G9	936	+	NM_001001953	123893719	123894655	1
chr11	123900329	123901265	OR10G8	936	+	NM_001004464	123900329	123901265	1
chr11	123908772	123909708	OR10G7	936	-	NM_001004463	123908772	123909708	1
chr11	123986110	124017618	VWA5A	31508	+	NM_001130142	123988218	124016652	19
chr11	124095343	124096368	OR8G2	1025	+	NM_001291438	124095397	124096312	1
chr11	124120422	124135756	OR8G1	15334	+	NM_001002905	124120422	124135756	2
chr11	124134722	124135763	OR8G5	1041	+	NM_001005198	124134722	124135763	1
chr11	124179735	124180662	OR8D1	927	-	NM_001002917	124179735	124180662	1
chr11	124189157	124190093	OR8D2	936	-	NM_001002918	124189157	124190093	1
chr11	124252297	124253239	OR8B2	942	-	NM_001005468	124252297	124253239	1
chr11	124266305	124267247	OR8B3	942	-	NM_001005467	124266305	124267247	1
chr11	124293837	124294767	OR8B4	930	-	NM_001005196	124293837	124294767	1
chr11	124310045	124310981	OR8B8	936	-	NM_012378	124310045	124310981	1
chr11	124412617	124413550	OR8B12	933	-	NM_001005195	124412617	124413550	1
chr11	124439964	124440945	OR8A1	981	+	NM_001005194	124439964	124440945	1
chr11	124481452	124490251	PANX3	8799	+	NM_052959	124481452	124489831	4
chr11	124492741	124505822	TBRG1	13081	+	NM_032811	124492979	124502134	9
chr11	124505684	124546199	SIAE	40515	-	NM_001199922	124506846	124539379	12
chr11	124543739	124564687	SPA17	20948	+	NM_017425	124545160	124564342	5
chr11	124609828	124617102	NRGN	7274	+	NM_006176	124609980	124615620	4
chr11	124617369	124622109	VSIG2	4740	-	NM_014312	124617430	124622033	7
chr11	124623018	124632223	ESAM	9205	-	NM_138961	124623541	124632050	7
chr11	124629029	124635816	LOC101929340	6787	+	NR_120577	124635816	124635816	2
chr11	124636393	124670300	MSANTD2	33907	-	NM_024631	124637071	124670276	4
chr11	124670323	124704383	LOC100507283	34060	+	NR_103862	124704383	124704383	5
chr11	124735304	124751370	ROBO3	16066	+	NM_022370	124735473	124751146	28
chr11	124754113	124767831	ROBO4	13718	-	NM_001301088	124754786	124766531	18
chr11	124789145	124790573	HEPN1	1428	+	NM_001037558	124789646	124789913	1
chr11	124789145	124806308	HEPACAM	17163	-	NM_152722	124791033	124805902	7
chr11	124824016	124911385	CCDC15	87369	+	NM_025004	124824628	124910607	16
chr11	124933012	124960412	SLC37A2	27400	+	NM_198277	124933263	124956127	19
chr11	124964265	124981659	TMEM218	17394	-	NM_001258240	124967501	124972137	7
chr11	125028356	125034505	PKNOX2-AS1	6149	-	NR_125759	125034505	125034505	3
chr11	125034558	125303285	PKNOX2	268727	+	NM_022062	125221201	125301288	13
chr11	125315640	125366206	FEZ1	50566	-	NM_005103	125315990	125359673	10
chr11	125365109	125369422	LOC403312	4313	+	NM_001301851	125365224	125366707	2
chr11	125439282	125454584	EI24	15302	+	NR_110770	125454584	125454584	12
chr11	125440185	125462463	STT3A-AS1	22278	-	NR_132372	125462463	125462463	3
chr11	125462689	125492654	STT3A	29965	+	NM_001278503	125465810	125490705	19
chr11	125495030	125546150	CHEK1	51120	+	NM_001114121	125496663	125525215	14
chr11	125542228	125550793	ACRV1	8565	-	NM_020108	125542487	125550675	5
chr11	125616187	125619743	PATE1	3556	+	NM_138294	125616199	125618628	5
chr11	125646027	125648714	PATE2	2687	-	NM_212555	125647276	125648668	4
chr11	125658005	125661495	PATE3	3490	+	NM_001129883	125658046	125660497	3
chr11	125703210	125709967	PATE4	6757	+	NM_001144874	125703254	125708322	3
chr11	125753508	125770541	HYLS1	17033	+	NM_145014	125769263	125770163	4
chr11	125763379	125773116	PUS3	9737	-	NM_031307	125763679	125766179	4
chr11	125774260	125793006	DDX25	18746	+	NM_013264	125774412	125792776	12
chr11	125826712	125933187	CDON	106475	-	NM_001243597	125830836	125893371	20
chr11	126071988	126081587	RPUSD4	9599	-	NM_032795	126073312	126081533	7
chr11	126081618	126132879	FAM118B	51261	+	NM_024556	126104896	126132028	9
chr11	126132813	126138877	SRPRA	6064	-	NM_003139	126133810	126138699	14
chr11	126138934	126148027	FOXRED1	9093	+	NM_017547	126139101	126147584	11
chr11	126152981	126164828	TIRAP	11847	+	NM_001039661	126160789	126163582	6
chr11	126173646	126215648	DCPS	42002	+	NM_014026	126173975	126215508	6
chr11	126211611	126225482	ST3GAL4-AS1	13871	-	NR_033839	126225482	126225482	2
chr11	126225539	126284536	ST3GAL4	58997	+	NM_001254757	126276050	126283942	11
chr11	126293395	126870766	KIRREL3	577371	-	NM_032531	126294474	126870405	17
chr11	126522672	126551998	LOC101929427	29326	+	NR_120532	126551998	126551998	2
chr11	126810641	126814986	KIRREL3-AS2	4345	+	NR_046986	126814986	126814986	3
chr11	126858353	126858438	MIR3167	85	-	NR_036126	126858438	126858438	1
chr11	126872804	126875953	KIRREL3-AS3	3149	+	NR_040078	126875953	126875953	3
chr11	126936896	126971201	LOC101929473	34305	+	NR_120578	126971201	126971201	3
chr11	127140964	127206928	LOC101929497	65964	+	NR_120580	127206928	127206928	3
chr11	128328655	128457453	ETS1	128798	-	NM_001143820	128332255	128443025	10
chr11	128392284	128392344	MIR6090	60	+	NR_106738	128392344	128392344	1
chr11	128396036	128400278	LOC101929517	4242	+	NR_120581	128400278	128400278	4
chr11	128556429	128683162	FLI1	126733	+	NM_001271012	128628211	128680883	7
chr11	128561566	128565918	SENCR	4352	-	NR_038908	128565918	128565918	3
chr11	128707908	128737268	KCNJ1	29360	-	NM_153767	128709019	128710138	4
chr11	128761312	128787951	KCNJ5	26639	+	NM_000890	128781168	128786626	3
chr11	128769459	128776126	C11orf45	6667	-	NR_045767	128776126	128776126	4
chr11	128804626	128813294	TP53AIP1	8668	-	NM_001195195	128804931	128807713	4
chr11	128834954	129062093	ARHGAP32	227139	-	NM_001142685	128838801	129062093	22
chr11	129245880	129322174	BARX2	76294	+	NM_003658	129245930	129321297	4
chr11	129482015	129487164	LINC01395	5149	-	NR_120582	129487164	129487164	4
chr11	129685740	129729898	TMEM45B	44158	+	NM_138788	129722377	129728580	6
chr11	129733669	129765490	NFRKB	31821	-	NM_001143835	129734619	129762744	27
chr11	129769600	129872730	PRDM10	103130	-	NM_020228	129772207	129830859	22
chr11	129872518	129875381	LINC00167	2863	+	NR_024233	129875381	129875381	1
chr11	129939715	130014706	APLP2	74991	+	NM_001642	129939872	130013343	18
chr11	130029681	130080257	ST14	50576	+	NM_021978	130029874	130079718	19
chr11	130096573	130184607	ZBTB44	88034	-	NM_001301098	130103250	130131768	8
chr11	130274817	130298539	ADAMTS8	23722	-	NM_007037	130275452	130298181	9
chr11	130318868	130346539	ADAMTS15	27671	+	NM_139055	130318868	130343716	8
chr11	130536629	130536698	MIR8052	69	+	NR_107019	130536698	130536698	1
chr11	130542850	130587247	C11orf44	44397	+	NM_001271983	130542873	130584092	3
chr11	130714087	130732005	LOC100507431	17918	-	NR_125383	130732005	130732005	6
chr11	130736143	130740142	LOC103611081	3999	-	NR_125382	130740142	130740142	1
chr11	130745765	130786382	SNX19	40617	-	NM_001301089	130748316	130780218	11
chr11	131240370	132206716	NTM	966346	+	NM_001048209	131240701	132205040	8
chr11	131403750	131410761	LOC101929653	7011	-	NR_110140	131410761	131410761	8
chr11	131532022	131533450	NTM-AS1	1428	-	NR_126159	131533450	131533450	2
chr11	132154195	132158353	NTM-IT	4158	+	NR_046820	132158353	132158353	3
chr11	132284874	133402403	OPCML	1117529	-	NM_001012393	132290086	133402219	8
chr11	133653565	133680271	LOC646522	26706	-	NR_120444	133680271	133680271	3
chr11	133710516	133715433	SPATA19	4917	-	NM_174927	133711933	133715341	7
chr11	133766329	133771635	MIR4697HG	5306	-	NR_024344	133771635	133771635	1
chr11	133768398	133768476	MIR4697	78	-	NR_039846	133768476	133768476	1
chr11	133778519	133826649	IGSF9B	48130	-	NM_001277285	133778963	133826649	20
chr11	133902166	133911236	LOC100128239	9070	+	NR_027276	133911236	133911236	3
chr11	133938819	134021652	JAM3	82833	+	NM_032801	133938978	134019076	9
chr11	134022336	134094426	NCAPD3	72090	-	NM_015261	134022838	134093820	35
chr11	134094498	134117686	VPS26B	23188	+	NM_052875	134095016	134115484	6
chr11	134118172	134123260	THYN1	5088	-	NM_199298	134118331	134122776	8
chr11	134123433	134135746	ACAD8	12313	+	NM_014384	134123494	134134854	11
chr11	134146274	134189458	GLB1L3	43184	+	NM_001080407	134146634	134188836	20
chr11	134201767	134246218	GLB1L2	44451	+	NM_138342	134201955	134244952	20
chr11	134248397	134281812	B3GAT1	33415	-	NM_018644	134251831	134257553	7
chr11	134306375	134375555	LOC283177	69180	+	NR_033852	134375555	134375555	6
chr12	67606	69079	FAM138D	1473	+	NR_026823	69079	69079	3
chr12	73724	91263	LOC100288778	17539	+	NR_130745	91263	91263	11
chr12	176048	287625	IQSEC3	111577	+	NM_001170738	176048	284199	14
chr12	246576	258332	LOC574538	11756	-	NR_033859	258332	258332	10
chr12	299242	323371	SLC6A12	24129	-	NM_001122848	300233	319152	16
chr12	312810	314259	LOC101929384	1449	+	NR_120475	314259	314259	3
chr12	329786	372039	SLC6A13	42253	-	NM_016615	330113	369218	15
chr12	362607	366465	LOC102723544	3858	-	NR_120482	366465	366465	3
chr12	389222	498621	KDM5A	109399	-	NM_001042603	394621	498257	28
chr12	498515	551806	CCDC77	53291	+	NM_001130147	520970	551086	12
chr12	569542	671058	B4GALNT3	101516	+	NM_173593	569542	670617	20
chr12	673461	772907	NINJ2	99446	-	NM_016533	674400	772664	4
chr12	740056	755044	LOC100049716	14988	+	NR_122124	755044	755044	5
chr12	862088	1020618	WNK1	158530	+	NM_018979	862731	1017958	28
chr12	1020901	1099207	RAD52	78306	-	NM_001297419	1022556	1042224	12
chr12	1100373	1605099	ERC1	504726	+	NR_027948	1605099	1605099	20
chr12	1609656	1613590	LINC00942	3934	+	NR_028415	1613590	1613590	2
chr12	1675158	1703331	FBXL14	28173	-	NM_152441	1675913	1703232	2
chr12	1726221	1756377	WNT5B	30156	+	NM_030775	1740520	1755418	5
chr12	1769480	1769546	MIR3649	66	-	NR_037422	1769546	1769546	1
chr12	1800246	1897845	ADIPOR2	97599	+	NM_024551	1863509	1895238	8
chr12	1901122	2027870	CACNA2D4	126748	-	NM_172364	1902820	2027639	38
chr12	1929432	1945918	LRTM2	16486	+	NM_001163926	1937314	1943887	5
chr12	2038367	2045742	LINC00940	7375	-	NR_036546	2045742	2045742	2
chr12	2055213	2113677	DCP1B	58464	-	NM_152640	2055371	2113597	9
chr12	2157517	2158628	CACNA1C-IT2	1111	+	NR_046768	2158628	2158628	2
chr12	2162415	2807115	CACNA1C	644700	+	NM_001129827	2162728	2800365	49
chr12	2329702	2332647	CACNA1C-AS4	2945	-	NR_046578	2332647	2332647	4
chr12	2378941	2397911	CACNA1C-IT3	18970	+	NR_046769	2397911	2397911	3
chr12	2777665	2781386	CACNA1C-AS2	3721	-	NR_046579	2781386	2781386	2
chr12	2785166	2800323	CACNA1C-AS1	15157	-	NR_045725	2800323	2800323	4
chr12	2870365	2880835	LOC283440	10470	-	NR_033958	2880835	2880835	5
chr12	2904107	2914587	FKBP4	10480	+	NM_002014	2904305	2912424	10
chr12	2921787	2939770	ITFG2	17983	+	NR_130744	2939770	2939770	13
chr12	2934513	2944221	NRIP2	9708	-	NM_031474	2936372	2944149	6
chr12	2945981	2968961	LOC100507424	22980	+	NR_038933	2968961	2968961	4
chr12	2966846	2986321	FOXM1	19475	-	NM_202002	2967803	2983644	10
chr12	2985423	2998691	RHNO1	13268	+	NR_046433	2998691	2998691	2
chr12	3000032	3050306	TULP3	50274	+	NM_001160408	3000113	3049892	12
chr12	3068477	3149842	TEAD4	81365	+	NM_003213	3103932	3149644	13
chr12	3186520	3395730	TSPAN9	209210	+	NM_006675	3310359	3392282	9
chr12	3490514	3703138	PRMT8	212624	+	NM_001256536	3490560	3702348	10
chr12	3592877	3601985	THCAT155	9108	-	NR_126055	3601985	3601985	2
chr12	3724493	3862366	CRACR2A	137873	-	NM_001144958	3724520	3806165	20
chr12	3918026	3982614	PARP11	64588	-	NR_104461	3982614	3982614	9
chr12	4357932	4385350	CCND2-AS1	27418	-	NR_125790	4385350	4385350	2
chr12	4382901	4414522	CCND2	31621	+	NM_001759	4383206	4409175	5
chr12	4430358	4469190	TIGAR	38832	+	NM_020375	4430437	4461857	6
chr12	4477392	4488894	FGF23	11502	-	NM_020638	4479508	4488748	3
chr12	4543307	4554780	FGF6	11473	-	NM_020996	4543380	4554736	3
chr12	4596895	4647674	C12orf4	50779	-	NM_001304811	4598972	4645360	14
chr12	4647949	4669213	RAD51AP1	21264	+	NM_001130862	4648105	4668159	10
chr12	4699237	4723054	DYRK4	23817	+	NM_003845	4700346	4722919	13
chr12	4724673	4758213	AKAP3	33540	-	NM_006422	4724904	4747362	6
chr12	4758263	4796720	NDUFA9	38457	+	NM_005002	4758292	4796274	11
chr12	4809582	4829268	LOC101929549	19686	-	NR_110112	4829268	4829268	4
chr12	4829751	4881892	GALNT8	52141	+	NM_017417	4829843	4881763	11
chr12	4918341	4960278	KCNA6	41937	+	NM_002235	4919207	4920797	2
chr12	5019072	5027422	KCNA1	8350	+	NM_000217	5020544	5022032	2
chr12	5153084	5155954	KCNA5	2870	+	NM_002234	5153313	5155155	1
chr12	5343161	5352317	LOC101929584	9156	-	NR_120476	5352317	5352317	5
chr12	5541279	5604465	NTF3	63186	+	NM_001102654	5541490	5604154	2
chr12	5671816	6055398	ANO2	383582	-	NM_001278597	5672464	6055326	26
chr12	6058039	6233836	VWF	175797	-	NM_000552	6058180	6232362	52
chr12	6309481	6347437	CD9	37956	+	NM_001769	6309665	6346994	8
chr12	6419601	6437672	PLEKHG6	18071	+	NM_018173	6421392	6437311	16
chr12	6437922	6451283	TNFRSF1A	13361	-	NM_001065	6438477	6450980	10
chr12	6456008	6486523	SCNN1A	30515	-	NM_001159575	6457038	6486432	13
chr12	6484533	6500737	LTBR	16204	+	NM_001270987	6484721	6500103	10
chr12	6548166	6560683	CD27-AS1	12517	-	NR_015382	6560683	6560683	6
chr12	6554050	6560884	CD27	6834	+	NM_001242	6554261	6560558	6
chr12	6561176	6571488	TAPBPL	10312	+	NM_018009	6561414	6571315	7
chr12	6571403	6580065	VAMP1	8662	-	NM_014231	6573635	6579697	5
chr12	6601315	6602471	MRPL51	1156	-	NM_016497	6601436	6602302	3
chr12	6603297	6641132	NCAPD2	37835	+	NM_014865	6604264	6640578	32
chr12	6619387	6619717	SCARNA10	330	+	NR_004387	6619717	6619717	1
chr12	6643570	6647541	GAPDH	3971	+	NM_002046	6643998	6647336	9
chr12	6648693	6665249	IFFO1	16556	-	NR_036467	6665249	6665249	10
chr12	6666035	6677498	NOP2	11463	-	NM_001258310	6667193	6677084	17
chr12	6679247	6716599	CHD4	37352	-	NM_001273	6679841	6715539	40
chr12	6690638	6690775	SCARNA11	137	-	NR_003012	6690775	6690775	1
chr12	6728000	6745297	LPAR5	17297	-	NM_020400	6729295	6730414	2
chr12	6747241	6756580	ACRBP	9339	-	NM_032489	6747447	6756532	10
chr12	6759703	6772308	ING4	12605	-	NM_016162	6760360	6772267	8
chr12	6775642	6798738	ZNF384	23096	-	NM_001135734	6776879	6788686	11
chr12	6802956	6810009	PIANP	7053	-	NM_153685	6804201	6807227	6
chr12	6833149	6841041	COPS7A	7892	+	NM_001164095	6833822	6840205	8
chr12	6857157	6862636	MLF2	5479	-	NR_026581	6862636	6862636	9
chr12	6875540	6880118	PTMS	4578	+	NM_002824	6875871	6879608	5
chr12	6881669	6887621	LAG3	5952	+	NM_002286	6882018	6887556	8
chr12	6898637	6929976	CD4	31339	+	NM_000616	6909304	6928495	10
chr12	6930962	6936583	GPR162	5621	+	NM_019858	6933064	6936369	5
chr12	6937537	6949018	P3H3	11481	+	NM_014262	6937605	6948625	15
chr12	6950017	6956559	GNB3	6542	+	NM_002075	6950451	6956062	10
chr12	6955888	6961230	CDCA3	5342	-	NM_001297603	6955951	6960116	5
chr12	6961284	6975795	USP5	14511	+	NM_001098536	6961343	6975241	20
chr12	6976583	6980110	TPI1	3527	+	NM_001159287	6976619	6979547	7
chr12	6980099	6982521	SPSB2	2422	-	NM_032641	6980355	6982065	3
chr12	6993144	6993768	RPL13P5	624	+	NR_002803	6993768	6993768	1
chr12	6993845	6994950	DSTNP2	1105	+	NR_033796	6994950	6994950	1
chr12	7013896	7023406	LRRC23	9510	+	NM_001135217	7014797	7022167	8
chr12	7023613	7032859	ENO2	9246	+	NM_001975	7024996	7031963	12
chr12	7033625	7051484	ATN1	17859	+	NM_001007026	7043164	7050943	10
chr12	7052600	7055166	C12orf57	2566	+	NM_001301836	7052812	7055085	3
chr12	7055739	7070479	PTPN6	14740	+	NM_080548	7055888	7070083	16
chr12	7072861	7072929	MIR200C	68	+	NR_029779	7072929	7072929	1
chr12	7073259	7073354	MIR141	95	+	NR_029682	7073354	7073354	1
chr12	7074514	7079916	PHB2	5402	-	NM_001144831	7074847	7079706	9
chr12	7076499	7076769	SCARNA12	270	-	NR_003010	7076769	7076769	1
chr12	7079943	7085165	EMG1	5222	+	NM_006331	7080086	7084971	7
chr12	7085346	7125842	LPCAT3	40496	-	NM_005768	7086307	7125728	13
chr12	7167979	7178335	C1S	10356	+	NM_001734	7169216	7177955	12
chr12	7187514	7245043	C1R	57529	-	NM_001733	7187835	7244984	9
chr12	7247145	7261874	C1RL	14729	-	NM_001297642	7249552	7261776	6
chr12	7260903	7274447	C1RL-AS1	13544	+	NR_026947	7274447	7274447	12
chr12	7276279	7281466	RBP5	5187	-	NM_031491	7276716	7281371	4
chr12	7282966	7311530	CLSTN3	28564	+	NM_014718	7283244	7310677	18
chr12	7341758	7371169	PEX5	29411	+	NM_001131026	7342973	7362819	18
chr12	7456927	7480969	ACSM4	24042	+	NM_001080454	7456927	7480969	13
chr12	7507555	7596781	CD163L1	89226	-	NM_001297650	7509999	7596723	20
chr12	7623411	7656414	CD163	33003	-	NM_203416	7632486	7656286	17
chr12	7801995	7823195	APOBEC1	21200	-	NM_001304566	7802142	7818468	6
chr12	7842380	7848360	GDF3	5980	-	NM_020634	7842473	7848324	2
chr12	7864049	7870152	DPPA3	6103	+	NM_199286	7864166	7869673	4
chr12	7882010	7902069	CLEC4C	20059	-	NM_130441	7882191	7899944	7
chr12	7917811	7926717	NANOGNB	8906	+	NM_001145465	7917881	7926447	4
chr12	7941991	7948657	NANOG	6666	+	NM_024865	7942210	7947691	4
chr12	7965107	8043792	SLC2A14	78685	-	NM_001286237	7966911	8043723	10
chr12	8071823	8088892	SLC2A3	17069	-	NM_006931	8074008	8088630	10
chr12	8185358	8208118	FOXJ2	22760	+	NM_018416	8192428	8205446	11
chr12	8210918	8218955	C3AR1	8037	-	NM_004054	8211332	8212781	2
chr12	8234806	8250373	NECAP1	15567	+	NM_015509	8234884	8248686	8
chr12	8276227	8291203	CLEC4A	14976	+	NM_016184	8276474	8290883	6
chr12	8286364	8287448	POU5F1P3	1084	-	NR_036440	8287448	8287448	1
chr12	8325149	8332642	ZNF705A	7493	+	NM_001004328	8325221	8330179	5
chr12	8332804	8353596	FAM66C	20792	+	NR_026788	8353596	8353596	8
chr12	8373855	8380214	FAM90A1	6359	-	NM_018088	8374417	8377428	7
chr12	8383644	8395542	FAM86FP	11898	-	NR_024254	8395542	8395542	5
chr12	8388010	8395160	LOC101927905	7150	+	NR_120454	8395160	8395160	3
chr12	8509559	8543348	LINC00937	33789	-	NR_024420	8543348	8543348	2
chr12	8608590	8630926	CLEC6A	22336	+	NM_001007033	8608707	8630060	6
chr12	8666135	8674960	CLEC4D	8825	+	NM_080387	8666328	8673867	6
chr12	8685900	8693558	CLEC4E	7658	-	NM_014358	8687233	8693393	6
chr12	8754761	8765442	AICDA	10681	-	NM_020661	8756879	8765363	5
chr12	8798538	8815484	MFAP5	16946	-	NR_123733	8815484	8815484	11
chr12	8834272	8935694	RIMKLB	101422	+	NR_123740	8935694	8935694	9
chr12	8975067	9029377	A2ML1	54310	+	NM_144670	8975247	9027607	36
chr12	9067315	9094060	PHC1	26745	+	NM_004426	9070273	9092055	15
chr12	9092956	9102357	M6PR	9401	-	NM_002355	9094413	9099000	7
chr12	9142220	9163340	KLRG1	21120	+	NM_005810	9142231	9162133	5
chr12	9208184	9217666	LINC00612	9482	-	NR_034140	9217666	9217666	3
chr12	9217772	9220651	A2M-AS1	2879	+	NR_026971	9220651	9220651	3
chr12	9220303	9268558	A2M	48255	-	NM_000014	9220418	9268445	36
chr12	9301435	9360966	PZP	59531	-	NM_002864	9301567	9360937	36
chr12	9381128	9386803	A2MP1	5675	-	NR_040112	9386803	9386803	9
chr12	9392598	9395645	LINC00987	3047	+	NR_036466	9395645	9395645	2
chr12	9436252	9466684	LOC642846	30432	+	NR_024374	9466684	9466684	22
chr12	9520059	9550213	LOC101930452	30154	+	NR_120479	9550213	9550213	4
chr12	9524377	9534018	LOC101928030	9641	-	NR_120481	9534018	9534018	2
chr12	9570286	9600768	DDX12P	30482	-	NR_033399	9600768	9600768	27
chr12	9747869	9760497	KLRB1	12628	-	NM_002258	9747869	9760435	6
chr12	9769879	9811010	LOC374443	41131	+	NR_046450	9811010	9811010	5
chr12	9822303	9852151	CLEC2D	29848	+	NM_001004419	9822330	9847397	6
chr12	9868455	9885895	CLECL1	17440	-	NM_001253750	9871280	9885860	4
chr12	9905081	9913497	CD69	8416	-	NM_001781	9906076	9913416	5
chr12	9980076	9997603	KLRF1	17527	+	NM_016523	9980140	9997125	6
chr12	10004967	10022458	CLEC2B	17491	-	NM_005127	10005898	10015170	5
chr12	10034087	10048432	KLRF2	14345	+	NM_001190765	10034194	10048432	6
chr12	10051271	10084980	CLEC2A	33709	-	NM_207375	10051502	10084928	5
chr12	10089177	10096094	LOC100506159	6917	-	NR_104634	10096094	10096094	5
chr12	10103914	10138194	CLEC12A	34280	+	NM_001207010	10103945	10137625	7
chr12	10145661	10151899	CLEC1B	6238	-	NM_016509	10145741	10151699	6
chr12	10163230	10171399	CLEC12B	8169	+	NM_001129998	10163358	10171080	6
chr12	10167950	10183205	LOC102724020	15255	-	NR_120484	10183205	10183205	3
chr12	10183275	10218629	CLEC9A	35354	+	NM_207345	10205286	10218231	9
chr12	10222152	10251664	CLEC1A	29512	-	NM_001297750	10223931	10233962	7
chr12	10269375	10282868	CLEC7A	13493	-	NR_125336	10282868	10282868	7
chr12	10310898	10324790	OLR1	13892	-	NM_002543	10312478	10324676	6
chr12	10323197	10344403	TMEM52B	21206	+	NM_001079815	10332173	10342739	6
chr12	10365488	10375724	GABARAPL1	10236	+	NM_031412	10365728	10374451	4
chr12	10457049	10469850	KLRD1	12801	+	NM_001114396	10460676	10467392	7
chr12	10516367	10551105	LOC101928100	34738	+	NR_120430	10551105	10551105	4
chr12	10524951	10542653	KLRK1	17702	-	NM_007360	10525712	10541409	8
chr12	10524951	10562745	KLRC4-KLRK1	37794	-	NM_001199805	10525712	10541409	13
chr12	10559982	10562356	KLRC4	2374	-	NM_013431	10560251	10562174	4
chr12	10564913	10573194	KLRC3	8281	-	NM_002261	10565170	10573149	7
chr12	10583205	10588592	KLRC2	5387	-	NM_002260	10583715	10588585	6
chr12	10594862	10607284	KLRC1	12422	-	NM_001304448	10594897	10603755	9
chr12	10741076	10752434	KLRAP1	11358	-	NR_028045	10752434	10752434	7
chr12	10756363	10766208	MAGOHB	9845	-	NM_018048	10758873	10766131	5
chr12	10771537	10826891	STYK1	55354	-	NM_018423	10772742	10787217	11
chr12	10851675	10875953	YBX3	24278	-	NM_003651	10853886	10875710	10
chr12	10902832	10930050	LOC101928162	27218	+	NR_120463	10930050	10930050	7
chr12	10954130	10955226	TAS2R7	1096	-	NM_023919	10954212	10955169	1
chr12	10958649	10959579	TAS2R8	930	-	NM_023918	10958649	10959579	1
chr12	10961692	10962767	TAS2R9	1075	-	NM_023917	10961735	10962674	1
chr12	10977944	10978868	TAS2R10	924	-	NM_023921	10977944	10978868	1
chr12	10998447	11002075	PRR4	3628	-	NM_001098538	10998542	11002036	4
chr12	10998447	11324224	PRH1-PRR4	325777	-	NR_037918	11324224	11324224	10
chr12	11033559	11324222	PRH1	290663	-	NM_001291314	11034833	11036816	7
chr12	11060524	11062161	TAS2R13	1637	-	NM_023920	11060985	11061897	1
chr12	11081834	11087444	PRH2	5610	+	NM_001110213	11081872	11083661	4
chr12	11090004	11324222	PRH1-TAS2R14	234218	-	NM_001316893	11090852	11199654	5
chr12	11090852	11091806	TAS2R14	954	-	NM_023922	11090852	11091806	1
chr12	11138511	11139511	TAS2R50	1000	-	NM_176890	11138559	11139459	1
chr12	11148560	11150474	TAS2R20	1914	-	NM_176889	11149544	11150474	1
chr12	11174217	11175219	TAS2R19	1002	-	NM_176888	11174270	11175170	1
chr12	11182985	11184006	TAS2R31	1021	-	NM_176885	11183004	11183934	1
chr12	11213963	11214893	TAS2R46	930	-	NM_176887	11213963	11214893	1
chr12	11243885	11244912	TAS2R43	1027	-	NM_176884	11243898	11244828	1
chr12	11285883	11286843	TAS2R30	960	-	NM_001097643	11285883	11286843	1
chr12	11323779	11328619	SMIM10L1	4840	+	NM_001271592	11323955	11324162	1
chr12	11338598	11339543	TAS2R42	945	-	NM_181429	11338598	11339543	1
chr12	11418846	11422641	PRB3	3795	-	NM_006249	11420125	11422603	5
chr12	11460014	11463369	PRB4	3355	-	NM_001261399	11461172	11463332	5
chr12	11504756	11508524	PRB1	3768	-	NM_199354	11506040	11508487	5
chr12	11544473	11548498	PRB2	4025	-	NM_006248	11545760	11548463	4
chr12	11700963	11717335	LINC01252	16372	+	NR_033890	11717335	11717335	8
chr12	11802787	12048325	ETV6	245538	+	NM_001987	11803061	12043980	8
chr12	12223877	12252627	BCL2L14	28750	+	NM_138723	12232239	12251922	6
chr12	12268960	12419811	LRP6	150851	-	NM_002336	12274059	12419669	23
chr12	12482217	12503169	MANSC1	20952	-	NM_018050	12482960	12496248	4
chr12	12508341	12510001	LOH12CR2	1660	-	NR_024061	12510001	12510001	2
chr12	12510012	12619838	BORCS5	109826	+	NM_058169	12510385	12618710	4
chr12	12626215	12715448	DUSP16	89233	-	NM_030640	12629766	12674032	7
chr12	12764766	12798042	CREBL2	33276	+	NM_001310	12765106	12794932	4
chr12	12813994	12849121	GPR19	35127	-	NM_006143	12814134	12815382	4
chr12	12870203	12875316	CDKN1B	5113	+	NM_004064	12870773	12871880	3
chr12	12878850	12944399	APOLD1	65549	+	NM_001130415	12878934	12940586	2
chr12	12917582	12917677	MIR613	95	+	NR_030344	12917677	12917677	1
chr12	12966279	12982915	DDX47	16636	+	NM_016355	12966301	12982488	12
chr12	13028410	13029070	RPL13AP20	660	+	NR_003932	13029070	13029070	1
chr12	13043955	13066600	GPRC5A	22645	+	NM_003979	13061183	13065473	4
chr12	13068762	13068852	MIR614	90	+	NR_030345	13068852	13068852	1
chr12	13093708	13103318	GPRC5D	9610	-	NM_018654	13093708	13103318	3
chr12	13127798	13153243	HEBP1	25445	-	NM_015987	13128241	13153048	4
chr12	13132770	13137576	LOC100506314	4806	+	NR_038920	13137576	13137576	3
chr12	13153375	13157764	HTR7P1	4389	+	NR_002774	13157764	13157764	1
chr12	13197314	13236383	FAM234B	39069	+	NM_020853	13197337	13233564	13
chr12	13236470	13256630	GSG1	20160	-	NM_001080555	13237834	13256446	7
chr12	13349601	13369708	EMP1	20107	+	NM_001423	13364444	13367625	5
chr12	13523604	13529679	LINC01559	6075	-	NR_036555	13529679	13529679	3
chr12	13714409	14133022	GRIN2B	418613	-	NM_000834	13715716	14019142	13
chr12	14518565	14655869	ATF7IP	137304	+	NM_001286514	14576849	14651007	15
chr12	14656596	14720791	PLBD1	64195	-	NM_024829	14656705	14720630	11
chr12	14720665	14772689	PLBD1-AS1	52024	+	NR_120465	14772689	14772689	6
chr12	14765567	14849519	GUCY2C	83952	-	NM_004963	14766050	14849382	27
chr12	14923653	14924065	HIST4H4	412	-	NM_175054	14923706	14924018	1
chr12	14927269	14930936	H2AFJ	3667	+	NR_027716	14930936	14930936	2
chr12	14939411	14956401	WBP11	16990	-	NM_016312	14939998	14954317	12
chr12	14956505	14976791	C12orf60	20286	+	NM_175874	14975869	14976607	2
chr12	14957583	14967116	SMCO3	9533	-	NM_001013698	14958936	14959614	2
chr12	14982244	14996413	ART4	14169	-	NM_021071	14982304	14996047	3
chr12	15034114	15038853	MGP	4739	-	NM_001190839	15035072	15038725	5
chr12	15066960	15091483	ERP27	24523	-	NM_152321	15067668	15091442	7
chr12	15094949	15114562	ARHGDIB	19613	-	NM_001175	15095455	15103646	6
chr12	15125955	15134799	PDE6H	8844	+	NM_006205	15130946	15134410	4
chr12	15154766	15159617	LINC01489	4851	+	NR_120466	15159617	15159617	4
chr12	15260715	15374411	RERG	113696	-	NM_032918	15262043	15370423	5
chr12	15304856	15308215	RERG-AS1	3359	+	NR_046559	15308215	15308215	3
chr12	15475190	15751265	PTPRO	276075	+	NM_030667	15475660	15747975	27
chr12	15773074	15942510	EPS8	169436	-	NM_004447	15774250	15835885	21
chr12	16035287	16056410	STRAP	21123	+	NM_007178	16035641	16055912	10
chr12	16064105	16190315	DERA	126210	+	NM_015954	16064317	16189680	9
chr12	16341418	16430619	SLC15A5	89201	-	NM_001170798	16342601	16430619	9
chr12	16500576	16530123	MGST1	29547	+	NM_001267598	16507186	16529098	4
chr12	16701305	16761148	LMO3	59843	-	NR_045012	16761148	16761148	6
chr12	17141680	17143562	SKP1P2	1882	+	NR_036619	17143562	17143562	1
chr12	17826232	17826328	MIR3974	96	+	NR_039770	17826328	17826328	1
chr12	18233802	18243127	RERGL	9325	-	NM_024730	18234124	18242217	6
chr12	18414473	18801352	PIK3C2G	386879	+	NM_001288774	18435674	18800962	33
chr12	18836109	18890993	PLCZ1	54884	-	NM_033123	18836172	18890305	15
chr12	18891044	18892122	CAPZA3	1078	+	NM_033328	18891202	18892102	1
chr12	19282625	19529333	PLEKHA5	246708	+	NM_001256470	19282733	19522721	32
chr12	19592607	19675173	AEBP2	82566	+	NM_001114176	19592633	19671654	9
chr12	20167618	20251802	LOC100506393	84184	+	NR_040098	20251802	20251802	3
chr12	20522178	20837041	PDE3A	314863	+	NM_000921	20522218	20833205	16
chr12	20848288	20906320	SLCO1C1	58032	+	NM_001145946	20852510	20905413	16
chr12	20963637	21069843	SLCO1B3	106206	+	NM_019844	20968672	21069181	16
chr12	21168629	21243040	SLCO1B7	74411	+	NM_001009562	21168629	21243040	13
chr12	21284127	21392730	SLCO1B1	108603	+	NM_006446	21294508	21392123	15
chr12	21417533	21548371	SLCO1A2	130838	-	NM_134431	21422481	21487581	16
chr12	21525801	21532914	IAPP	7113	+	NM_000415	21526285	21531360	3
chr12	21590537	21624182	PYROXD1	33645	+	NM_024854	21590664	21621688	12
chr12	21621843	21654603	RECQL	32760	-	NM_032941	21623127	21652504	16
chr12	21654698	21671337	GOLT1B	16639	+	NM_016072	21654857	21668641	5
chr12	21679255	21684210	SPX	4955	+	NM_030572	21679406	21684129	6
chr12	21689122	21757781	GYS2	68659	-	NM_021957	21689887	21757526	16
chr12	21788275	21810789	LDHB	22514	-	NM_001315537	21788454	21807605	8
chr12	21917888	21927755	KCNJ8	9867	-	NM_004982	21918656	21926550	3
chr12	21950323	22089628	ABCC9	139305	-	NM_020297	21953977	22089608	38
chr12	22199109	22218606	CMAS	19497	+	NM_018686	22199237	22218245	8
chr12	22346324	22487648	ST8SIA1	141324	-	NM_003034	22354485	22487166	5
chr12	22601479	22697480	C2CD5	96001	-	NM_001286175	22602693	22697084	28
chr12	22778075	22843608	ETNK1	65533	+	NM_018638	22778097	22837888	8
chr12	23328569	23344521	LOC101928441	15952	+	NR_120471	23344521	23344521	5
chr12	23685230	24715383	SOX5	1030153	-	NM_152989	23687152	24048957	18
chr12	24365354	24365429	MIR920	75	+	NR_030625	24365429	24365429	1
chr12	24376204	24390899	LOC101928471	14695	+	NR_120472	24390899	24390899	5
chr12	24719897	24737102	LINC00477	17205	-	NR_029451	24737102	24737102	4
chr12	24962957	25102393	BCAT1	139436	-	NM_005504	24970941	25101866	11
chr12	25146364	25150373	C12orf77	4009	-	NM_001101339	25147230	25150168	4
chr12	25205180	25261269	LRMP	56089	+	NM_006152	25222341	25260994	21
chr12	25261222	25348094	CASC1	86872	-	NM_001204102	25261481	25311465	17
chr12	25348149	25357949	LYRM5	9800	+	NM_001001660	25356890	25357246	3
chr12	25357722	25403865	KRAS	46143	-	NM_033360	25368374	25398318	6
chr12	25649250	25801496	LMNTD1	152246	-	NM_001145727	25656693	25801485	8
chr12	26026952	26027012	MIR4302	60	-	NR_036188	26027012	26027012	1
chr12	26107587	26112375	RASSF8-AS1	4788	-	NR_038228	26112375	26112375	4
chr12	26111963	26232825	RASSF8	120862	+	NM_007211	26208276	26232006	6
chr12	26272958	26278003	BHLHE41	5045	-	NM_030762	26274998	26277712	5
chr12	26348268	26387708	SSPN	39440	+	NM_001135823	26377255	26384009	3
chr12	26488269	26986131	ITPR2	497862	-	NM_002223	26492329	26985714	57
chr12	27058111	27091254	ASUN	33143	-	NM_018164	27058429	27089736	17
chr12	27091304	27119581	FGFR1OP2	28277	+	NM_015633	27107091	27117666	7
chr12	27124505	27167339	TM7SF3	42834	-	NM_016551	27126897	27167101	12
chr12	27175454	27183606	MED21	8152	+	NM_004264	27175512	27181394	4
chr12	27233989	27235455	C12orf71	1466	-	NM_001080406	27234106	27235416	2
chr12	27397077	27478890	STK38L	81813	+	NM_015000	27450653	27475388	14
chr12	27485786	27578746	ARNTL2	92960	+	NM_020183	27486005	27573465	17
chr12	27542721	27599567	ARNTL2-AS1	56846	-	NR_109975	27599567	27599567	4
chr12	27619742	27655118	SMCO2	35376	+	NM_001145010	27623564	27655054	9
chr12	27677044	27848497	PPFIBP1	171453	+	NM_003622	27786329	27845815	30
chr12	27849427	27850566	REP15	1139	+	NM_001029874	27849495	27850206	1
chr12	27863705	27909237	MRPS35	45532	+	NM_021821	27863776	27908383	8
chr12	27915598	27924209	MANSC4	8611	-	NM_001146221	27915670	27924209	3
chr12	27933186	27955973	KLHL42	22787	+	NM_020782	27933263	27951099	3
chr12	28111016	28124916	PTHLH	13900	-	NM_198965	28111491	28122427	5
chr12	28410132	28703099	CCDC91	292967	+	NM_018318	28410148	28702106	12
chr12	29301935	29488549	FAR2	186614	+	NM_001271783	29423382	29486727	12
chr12	29433348	29470781	LOC100506606	37433	-	NR_103860	29470781	29470781	7
chr12	29493578	29534143	ERGIC2	40565	-	NM_016570	29494088	29524566	14
chr12	29542226	29640257	OVCH1-AS1	98031	+	NR_073172	29640257	29640257	2
chr12	29580488	29650619	OVCH1	70131	-	NM_183378	29580503	29650619	28
chr12	29653745	29937692	TMTC1	283947	-	NM_175861	29659778	29920986	18
chr12	30781914	30848929	IPO8	67015	-	NM_006390	30783793	30848581	25
chr12	30862485	30907448	CAPRIN2	44963	-	NM_032156	30863377	30906697	18
chr12	30948614	30955645	LINC00941	7031	+	NR_040245	30955645	30955645	5
chr12	31079837	31149537	TSPAN11	69700	+	NM_001080509	31106925	31144850	8
chr12	31173696	31226781	DDX11-AS1	53085	-	NR_038927	31226781	31226781	3
chr12	31226778	31257725	DDX11	30947	+	NM_001257145	31231405	31256770	27
chr12	31433519	31479159	FAM60A	45640	-	NM_001135812	31435645	31451138	6
chr12	31477249	31478879	FLJ13224	1630	+	NR_026806	31478879	31478879	1
chr12	31535156	31743952	DENND5B	208796	-	NM_144973	31540536	31743766	21
chr12	31742856	31768285	DENND5B-AS1	25429	+	NR_046909	31768285	31768285	3
chr12	31800093	31822016	METTL20	21923	+	NM_001135864	31814887	31820924	4
chr12	31824070	31882108	AMN1	58038	-	NR_103522	31882108	31882108	9
chr12	31944118	31945175	H3F3C	1057	-	NM_001013699	31944692	31945100	1
chr12	32112352	32146043	KIAA1551	33691	+	NM_018169	32133889	32145469	6
chr12	32260184	32531141	BICD1	270957	+	NM_001714	32260265	32530561	10
chr12	32638905	32798984	FGD4	160079	+	NM_001304481	32639067	32793467	17
chr12	32832133	32898584	DNM1L	66451	+	NM_001278464	32832297	32896344	21
chr12	32899477	32908887	YARS2	9410	-	NM_001040436	32900137	32908808	5
chr12	32943679	33049780	PKP2	106101	-	NM_004572	32945357	33049665	14
chr12	33528347	33592754	SYT10	64407	-	NM_198992	33529764	33592457	7
chr12	34175215	34181236	ALG10	6021	+	NM_032834	34175534	34179850	3
chr12	38710556	38723528	ALG10B	12972	+	NM_001013620	38710695	38715015	3
chr12	39046001	39299420	CPNE8	253419	-	NM_153634	39047683	39299336	20
chr12	39687029	39837192	KIF21A	150163	-	NM_001173464	39688225	39836772	38
chr12	39945021	40013843	ABCD2	68822	-	NM_005164	39947713	40013417	10
chr12	40019971	40115720	C12orf40	95749	+	NM_001031748	40020138	40115053	13
chr12	40148822	40499661	SLC2A13	350839	-	NM_052885	40153827	40499610	10
chr12	40618812	40763086	LRRK2	144274	+	NM_198578	40618933	40761567	51
chr12	40787195	40964557	MUC19	177362	+	NM_173600	40787249	40964448	173
chr12	41086243	41466213	CNTN1	379970	+	NM_001843	41302234	41463837	24
chr12	41582249	41968392	PDZRN4	386143	+	NM_001164595	41582257	41967692	10
chr12	42475647	42538673	GXYLT1	63026	-	NM_173601	42481587	42538448	8
chr12	42550906	42632154	YAF2	81248	-	NM_005748	42554390	42631982	4
chr12	42705887	42719932	ZCRB1	14045	-	NM_033114	42706868	42717904	8
chr12	42717501	42717661	MIR7851	160	-	NR_107005	42717661	42717661	1
chr12	42719946	42842422	PPHLN1	122476	+	NM_016488	42729704	42840420	13
chr12	42852139	42983572	PRICKLE1	131433	-	NM_153026	42853610	42866318	8
chr12	43009304	43040300	LOC101927058	30996	-	NR_110042	43040300	43040300	6
chr12	43748011	43945724	ADAMTS20	197713	-	NM_025003	43748011	43945724	39
chr12	44122409	44152620	PUS7L	30211	-	NM_031292	44124178	44149048	9
chr12	44152746	44183346	IRAK4	30600	+	NM_001114182	44161914	44180518	13
chr12	44187525	44200178	TWF1	12653	-	NM_001242397	44189387	44200048	10
chr12	44229663	44783545	TMEM117	553882	+	NM_032256	44238454	44782455	8
chr12	44902057	45307711	NELL2	405654	-	NM_001145110	44902716	45307619	21
chr12	45408538	45444882	DBX2	36344	-	NM_001004329	45410068	45444710	4
chr12	45456400	45459194	RACGAP1P	2794	-	NR_026583	45459194	45459194	1
chr12	45566816	45609789	PLEKHA8P1	42973	-	NR_037144	45609789	45609789	3
chr12	45580873	45581252	RNY5	379	-	NR_001571	45581252	45581252	2
chr12	45609769	45834187	ANO6	224418	+	NM_001142679	45610104	45833721	20
chr12	46119502	46121704	LINC00938	2202	-	NR_028408	46121704	46121704	1
chr12	46123619	46301819	ARID2	178200	+	NM_152641	46123619	46298861	21
chr12	46312913	46384401	SCAF11	71488	-	NM_004719	46315830	46357950	15
chr12	46576839	46663208	SLC38A1	86369	-	NM_001278387	46582752	46633583	18
chr12	46751970	46766645	SLC38A2	14675	-	NM_018976	46754893	46765076	16
chr12	46777458	47046362	LOC100288798	268904	+	NR_125379	47046362	47046362	4
chr12	47158543	47219780	SLC38A4	61237	-	NM_018018	47160483	47186854	17
chr12	47469489	47473734	AMIGO2	4245	-	NM_181847	47471216	47472785	2
chr12	47473385	47630446	PCED1B	157061	+	NM_138371	47628846	47630145	4
chr12	47581594	47581674	MIR4698	80	+	NR_039847	47581674	47581674	1
chr12	47602202	47610226	PCED1B-AS1	8024	-	NR_026544	47610226	47610226	3
chr12	47757968	47758052	MIR4494	84	-	NR_039715	47758052	47758052	1
chr12	48055714	48099844	RPAP3	44130	-	NM_024604	48057287	48096623	17
chr12	48103517	48119355	ENDOU	15838	-	NM_001172439	48104584	48119196	10
chr12	48128452	48152889	RAPGEF3	24437	-	NM_001098531	48131349	48152339	28
chr12	48166966	48176536	SLC48A1	9570	+	NM_017842	48167087	48174064	3
chr12	48176493	48213763	HDAC7	37270	-	NM_015401	48177623	48213568	26
chr12	48235319	48298814	VDR	63495	-	NM_001017535	48238528	48272896	11
chr12	48357329	48362661	TMEM106C	5332	+	NM_001143843	48358019	48362012	8
chr12	48366747	48398285	COL2A1	31538	-	NM_001844	48367189	48398104	54
chr12	48436680	48500091	SENP1	63411	-	NM_001267594	48439104	48495255	18
chr12	48499655	48540187	PFKM	40532	+	NM_001166686	48501156	48539491	25
chr12	48526579	48526650	MIR6505	71	+	NR_106760	48526650	48526650	1
chr12	48541571	48551377	ASB8	9806	-	NM_024095	48543148	48547279	4
chr12	48577365	48579709	CCDC184	2344	+	NM_001013635	48577905	48578490	1
chr12	48596121	48597075	OR10AD1	954	-	NM_001004134	48596121	48597075	1
chr12	48722762	48724062	H1FNT	1300	+	NM_181788	48723074	48723842	1
chr12	48733792	48745029	ZNF641	11237	-	NM_001172682	48736755	48741873	5
chr12	48866447	48866843	ANP32D	396	+	NM_012404	48866447	48866843	1
chr12	48876285	48890297	C12orf54	14012	+	NM_152319	48877079	48888722	9
chr12	48919414	48921886	OR8S1	2472	+	NM_001005203	48919414	48921886	2
chr12	48961466	48963829	LALBA	2363	-	NM_002289	48961739	48963803	4
chr12	49046994	49076035	KANSL2	29041	-	NM_017822	49047826	49075415	10
chr12	49048164	49048301	SNORA2C	137	-	NR_002968	49048301	49048301	1
chr12	49048226	49048313	MIR1291	87	-	NR_031623	49048313	49048313	1
chr12	49050430	49050565	SNORA2A	135	-	NR_002950	49050565	49050565	1
chr12	49061239	49061376	SNORA2B	137	-	NR_002951	49061376	49061376	1
chr12	49082240	49110781	CCNT1	28541	-	NM_001240	49086815	49110458	9
chr12	49121217	49159569	LINC00935	38352	+	NR_029449	49159569	49159569	4
chr12	49159973	49182879	ADCY6	22906	-	NM_015270	49162373	49177217	22
chr12	49165757	49165820	MIR4701	63	-	NR_039850	49165820	49165820	1
chr12	49182929	49184318	LOC100506125	1389	+	NR_110019	49184318	49184318	3
chr12	49208214	49222726	CACNB3	14512	+	NM_001206917	49208330	49221682	13
chr12	49223538	49245957	DDX23	22419	-	NM_004818	49224251	49239565	17
chr12	49250915	49259653	RND1	8738	-	NM_014470	49251778	49259550	5
chr12	49297892	49315359	CCDC65	17467	+	NM_001286957	49308315	49315226	8
chr12	49315741	49319330	FKBP11	3589	-	NM_016594	49315766	49319211	6
chr12	49329991	49351252	ARF3	21261	-	NM_001659	49332729	49334878	5
chr12	49359122	49365641	WNT10B	6519	-	NM_003394	49359877	49364312	5
chr12	49372235	49376396	WNT1	4161	+	NM_005430	49372433	49375423	4
chr12	49388932	49393088	DDN	4156	-	NM_015086	49390522	49393070	2
chr12	49396054	49412629	PRKAG1	16575	-	NM_001206709	49396681	49412523	12
chr12	49412757	49449107	KMT2D	36350	-	NM_003482	49415562	49449107	54
chr12	49458458	49463808	RHEBL1	5350	-	NM_001303126	49458885	49462935	8
chr12	49483205	49488602	DHH	5397	-	NM_021044	49483641	49488295	3
chr12	49490922	49504683	LMBR1L	13761	-	NM_001300750	49491454	49500469	18
chr12	49521566	49525304	TUBA1B	3738	-	NM_006082	49521740	49525083	4
chr12	49578577	49583107	TUBA1A	4530	-	NM_001270400	49578792	49580514	4
chr12	49621708	49667121	TUBA1C	45413	+	NM_001303115	49663349	49667010	6
chr12	49686413	49718359	LOC101927267	31946	-	NR_120449	49718359	49718359	8
chr12	49688908	49692481	PRPH	3573	+	NM_006262	49688983	49692136	9
chr12	49716970	49725514	TROAP	8544	+	NM_005480	49717391	49725400	15
chr12	49726199	49730971	C1QL4	4772	-	NM_001008223	49726836	49730260	2
chr12	49740699	49747467	DNAJC22	6768	+	NM_001304944	49742655	49745285	4
chr12	49760687	49921209	SPATS2	160522	+	NM_001293285	49854795	49920038	15
chr12	49782956	49786116	LOC100335030	3160	+	NR_033267	49786116	49786116	1
chr12	49932939	49952095	KCNH3	19156	+	NM_012284	49933199	49951736	15
chr12	49952076	49961928	MCRS1	9852	-	NM_006337	49952425	49960514	15
chr12	49976657	49999410	FAM186B	22753	-	NR_027450	49999410	49999410	7
chr12	50017196	50038452	PRPF40B	21256	+	NM_001031698	50017373	50037975	26
chr12	50031723	50101197	FMNL3	69474	-	NM_175736	50039597	50100963	26
chr12	50135292	50158717	TMBIM6	23425	+	NM_003217	50146276	50156679	10
chr12	50184928	50222208	NCKAP5L	37280	-	NM_001037806	50185621	50197827	13
chr12	50222325	50234937	BCDIN3D-AS1	12612	+	NR_027500	50234937	50234937	4
chr12	50229825	50236912	BCDIN3D	7087	-	NM_181708	50232153	50236870	2
chr12	50260678	50297760	FAIM2	37082	-	NM_012306	50264286	50297575	12
chr12	50302665	50305646	LOC283332	2981	-	NR_026948	50305646	50305646	3
chr12	50305735	50320122	LOC101927292	14387	+	NR_110048	50320122	50320122	6
chr12	50344523	50352664	AQP2	8141	+	NM_000486	50344613	50349391	4
chr12	50345294	50356566	LOC101927318	11272	-	NR_110591	50356566	50356566	3
chr12	50355278	50359465	AQP5	4187	+	NM_001651	50355800	50358960	4
chr12	50366619	50370922	AQP6	4303	+	NM_001652	50366956	50369454	4
chr12	50382944	50419307	RACGAP1	36363	-	NM_001126103	50384050	50410498	19
chr12	50451419	50477405	ASIC1	25986	+	NR_046389	50477405	50477405	13
chr12	50478982	50494494	SMARCD1	15512	+	NM_003076	50479152	50492783	13
chr12	50497601	50505103	GPD1	7502	+	NM_005276	50497833	50503302	8
chr12	50505763	50514240	COX14	8477	+	NM_001257133	50513826	50514000	3
chr12	50523088	50561316	CERS5	38228	-	NM_001281731	50524327	50538574	11
chr12	50569562	50677353	LIMA1	107791	-	NM_001113546	50570846	50642534	11
chr12	50627924	50627995	MIR1293	71	-	NR_031625	50627995	50627995	1
chr12	50721094	50790405	FAM186A	69311	-	NM_001145475	50721165	50790267	8
chr12	50794591	50873788	LARP4	79197	+	NM_052879	50794793	50869647	16
chr12	50850353	50850569	SNORD133	216	+	NR_132753	50850569	50850569	1
chr12	50898767	51142450	DIP2B	243683	+	NM_173602	50898923	51138622	38
chr12	51157788	51214943	ATF1	57155	+	NM_005171	51173928	51213562	7
chr12	51236700	51281663	TMPRSS12	44963	+	NM_182559	51236747	51281296	5
chr12	51318533	51326300	METTL7A	7767	+	NM_014033	51318821	51323933	2
chr12	51347781	51364289	HIGD1C	16508	+	NM_001109619	51347781	51364289	3
chr12	51373565	51420199	SLC11A2	46634	-	NR_033422	51420199	51420199	18
chr12	51442081	51454207	LETMD1	12126	+	NM_015416	51442139	51453214	9
chr12	51454987	51477454	CSRNP2	22467	-	NM_030809	51457528	51470344	5
chr12	51487538	51566926	TFCP2	79388	-	NM_001173452	51489023	51566205	15
chr12	51580718	51611477	POU6F1	30759	-	NR_026893	51611477	51611477	11
chr12	51632507	51640501	DAZAP2	7994	+	NM_001136269	51632691	51639928	4
chr12	51639132	51664202	SMAGP	25070	-	NM_001031628	51639724	51663062	4
chr12	51674821	51718464	BIN2	43643	-	NM_001290007	51675282	51718299	13
chr12	51722226	51740463	CELA1	18237	-	NM_001971	51722360	51740422	8
chr12	51745832	51785200	GALNT6	39368	-	NM_007210	51748162	51773565	12
chr12	51785100	51909547	SLC4A8	124447	+	NM_001258401	51844688	51901222	25
chr12	51985019	52206648	SCN8A	221629	+	NM_014191	52056601	52201213	27
chr12	52211675	52225701	FIGNL2	14026	-	NM_001013690	52214235	52216197	2
chr12	52281792	52285505	ANKRD33	3713	+	NM_001130015	52282859	52285124	6
chr12	52301201	52317145	ACVRL1	15944	+	NM_000020	52306258	52314677	10
chr12	52345450	52390863	ACVR1B	45413	+	NM_020328	52345527	52387894	10
chr12	52400728	52409673	GRASP	8945	+	NM_181711	52400803	52408983	8
chr12	52416615	52453291	NR4A1	36676	+	NM_001202233	52435676	52452728	8
chr12	52463757	52471279	ATG101	7522	+	NM_021934	52467434	52470974	4
chr12	52473479	52502103	OR7E47P	28624	+	NR_120437	52502103	52502103	3
chr12	52562779	52585784	KRT80	23005	-	NM_001081492	52565306	52585686	9
chr12	52599364	52604639	C12orf80	5275	-	NM_001242696	52599898	52602125	4
chr12	52604713	52617597	LINC00592	12884	+	NR_027358	52617597	52617597	5
chr12	52626953	52642709	KRT7	15756	+	NM_005556	52627080	52642544	9
chr12	52679696	52685299	KRT81	5603	-	NM_002281	52680038	52685249	9
chr12	52695648	52702947	KRT86	7299	+	NM_002284	52695700	52702369	9
chr12	52708084	52715182	KRT83	7098	-	NM_002282	52708414	52715119	9
chr12	52753789	52761309	KRT85	7520	-	NM_002283	52754636	52761189	9
chr12	52771595	52779417	KRT84	7822	-	NM_033045	52771817	52779369	9
chr12	52787734	52800176	KRT82	12442	-	NM_033033	52788758	52800061	9
chr12	52817853	52828110	KRT75	10257	-	NM_004693	52818300	52828088	9
chr12	52840434	52845910	KRT6B	5476	-	NM_005555	52840973	52845862	9
chr12	52862299	52867569	KRT6C	5270	-	NM_173086	52862845	52867521	9
chr12	52880957	52887181	KRT6A	6224	-	NM_005554	52881503	52886972	9
chr12	52908358	52914243	KRT5	5885	-	NM_000424	52908725	52914080	9
chr12	52937692	52946931	KRT71	9239	-	NM_033448	52938315	52946861	9
chr12	52959602	52967609	KRT74	8007	-	NM_175053	52960752	52967561	9
chr12	52979372	52995322	KRT72	15950	-	NM_001146225	52979765	52995236	10
chr12	53001353	53012343	KRT73	10990	-	NM_175068	53001979	53012308	9
chr12	53003634	53009089	KRT73-AS1	5455	+	NR_126005	53009089	53009089	3
chr12	53038341	53045959	KRT2	7618	-	NM_000423	53038802	53045926	9
chr12	53068519	53074191	KRT1	5672	-	NM_006121	53068976	53074132	9
chr12	53083410	53097247	KRT77	13837	-	NM_175078	53084948	53097218	9
chr12	53161938	53171129	KRT76	9191	-	NM_015848	53162496	53171075	9
chr12	53183468	53189892	KRT3	6424	-	NM_057088	53183825	53189826	9
chr12	53200326	53207900	KRT4	7574	-	NM_002272	53200852	53207842	9
chr12	53215230	53228077	KRT79	12847	-	NM_175834	53215655	53228044	9
chr12	53231587	53242778	KRT78	11191	-	NM_173352	53232896	53242714	9
chr12	53290970	53343650	KRT8	52680	-	NM_001256293	53291211	53298765	9
chr12	53342654	53346685	KRT18	4031	+	NM_199187	53342957	53346626	8
chr12	53400041	53435993	EIF4B	35952	+	NM_001417	53400267	53434007	15
chr12	53436972	53448222	LOC283335	11250	-	NR_033854	53448222	53448222	4
chr12	53440809	53458162	TNS2	17353	+	NM_198316	53448075	53457666	29
chr12	53450727	53450796	MIR6757	69	+	NR_106815	53450796	53450796	1
chr12	53458099	53473204	SPRYD3	15105	-	NM_032840	53459615	53473117	11
chr12	53491435	53496128	IGFBP6	4693	+	NM_002178	53491501	53495951	4
chr12	53497273	53518323	SOAT2	21050	+	NM_003578	53497361	53517907	15
chr12	53551446	53574693	CSAD	23247	-	NM_001244705	53552294	53567254	17
chr12	53574534	53584654	ZNF740	10120	+	NM_001004304	53575767	53581374	7
chr12	53585101	53601091	ITGB7	15990	-	NM_000889	53585339	53594227	16
chr12	53604349	53626040	RARG	21691	-	NM_000966	53605459	53621329	10
chr12	53645369	53648190	MFSD5	2821	+	NM_001170790	53645516	53647972	2
chr12	53662082	53687427	ESPL1	25345	+	NM_012291	53662550	53687258	31
chr12	53689234	53693234	PFDN5	4000	+	NM_002624	53689351	53693129	6
chr12	53693469	53700965	C12orf10	7496	+	NM_021640	53693521	53700933	7
chr12	53701239	53715412	AAAS	14173	-	NM_015665	53701272	53715249	16
chr12	53720359	53738577	SP7	18218	-	NM_001300837	53721929	53723171	3
chr12	53773978	53810226	SP1	36248	+	NM_001251825	53774075	53805024	6
chr12	53817638	53825318	AMHR2	7680	+	NM_001164690	53817718	53824976	11
chr12	53835432	53840427	PRR13	4995	+	NM_001005354	53836498	53839843	4
chr12	53845885	53874946	PCBP2	29061	+	NM_005016	53848584	53873226	15
chr12	53858251	53858841	PCBP2-OT1	590	+	NR_109828	53858841	53858841	1
chr12	53874275	53893444	MAP3K12	19169	-	NM_006301	53874965	53881175	15
chr12	53894704	53900215	TARBP2	5511	+	NM_134323	53895192	53899932	9
chr12	53900473	53901422	NPFF	949	-	NM_003717	53900559	53901258	3
chr12	53901639	54020199	ATF7	118560	-	NR_073163	54020199	54020199	13
chr12	53907767	53911392	LOC100652999	3625	+	NR_046221	53911392	53911392	3
chr12	54058943	54070512	ATP5G2	11569	-	NM_001002031	54059097	54069976	5
chr12	54104901	54121307	CALCOCO1	16406	-	NM_020898	54105727	54119026	15
chr12	54144230	54150818	CISTR	6588	-	NR_104332	54150818	54150818	3
chr12	54329111	54333427	HOXC13-AS	4316	-	NR_047507	54333427	54333427	3
chr12	54332575	54340328	HOXC13	7753	+	NM_017410	54332690	54339040	2
chr12	54348713	54350350	HOXC12	1637	+	NM_173860	54348713	54350350	2
chr12	54356091	54368740	HOTAIR	12649	-	NR_047517	54368740	54368740	6
chr12	54366909	54370203	HOXC11	3294	+	NM_014212	54367025	54369197	2
chr12	54377734	54379303	HOXC-AS3	1569	-	NR_047506	54379303	54379303	3
chr12	54378945	54384062	HOXC10	5117	+	NM_017409	54379043	54383230	2
chr12	54385521	54385631	MIR196A2	110	+	NR_029617	54385631	54385631	1
chr12	54388991	54390569	HOXC-AS2	1578	-	NR_047505	54390569	54390569	3
chr12	54392805	54393794	HOXC-AS1	989	-	NR_047504	54393794	54393794	2
chr12	54393876	54397120	HOXC9	3244	+	NM_006897	54393972	54396458	2
chr12	54402889	54406545	HOXC8	3656	+	NM_022658	54403068	54405165	2
chr12	54410635	54424607	HOXC6	13972	+	NM_153693	54422551	54423746	3
chr12	54410635	54429144	HOXC5	18509	+	NR_003084	54429144	54429144	2
chr12	54410635	54449814	HOXC4	39179	+	NM_014620	54447706	54448989	4
chr12	54427733	54427829	MIR615	96	+	NR_030753	54427829	54427829	1
chr12	54452037	54516018	FLJ12825	63981	+	NR_026655	54516018	54516018	2
chr12	54472622	54475607	LOC100240735	2985	-	NR_026658	54475607	54475607	3
chr12	54495992	54496483	LOC100240734	491	+	NR_026657	54496483	54496483	1
chr12	54519854	54526626	LOC400043	6772	+	NR_026656	54526626	54526626	2
chr12	54574141	54582778	SMUG1	8637	-	NM_014311	54575879	54577724	4
chr12	54624730	54673915	CBX5	49185	-	NM_012117	54635538	54651434	5
chr12	54625180	54625260	MIR3198-2	80	-	NR_039851	54625260	54625260	1
chr12	54674487	54679030	HNRNPA1	4543	+	NM_031157	54674591	54678097	11
chr12	54674532	54678663	HNRNPA1P10	4131	+	NR_002944	54678663	54678663	10
chr12	54685890	54694821	NFE2	8931	-	NM_001261461	54686157	54689032	4
chr12	54718873	54745635	COPZ1	26762	+	NM_001271736	54734288	54744307	9
chr12	54730999	54731098	MIR148B	99	+	NR_029894	54731098	54731098	1
chr12	54747474	54860814	LOC102724050	113340	+	NR_120487	54860814	54860814	4
chr12	54756228	54758270	GPR84	2042	-	NM_020370	54756444	54757635	2
chr12	54762912	54785089	ZNF385A	22177	-	NM_001130967	54764039	54785028	8
chr12	54789044	54813244	ITGA5	24200	-	NM_002205	54790076	54813129	30
chr12	54849735	54867386	GTSF1	17651	-	NM_144594	54852892	54865032	9
chr12	54891494	54936899	NCKAP1L	45405	+	NM_005337	54891573	54936469	31
chr12	54943176	54973023	PDE1B	29847	+	NM_000924	54943656	54971112	16
chr12	54973023	54982443	PPP1R1A	9420	-	NM_006741	54974170	54982272	7
chr12	55001970	55004246	GLYCAM1	2276	-	NR_003039	55004246	55004246	4
chr12	55024622	55028663	LACRT	4041	-	NM_033277	55024675	55028625	5
chr12	55038374	55042277	DCD	3903	-	NM_001300854	55038527	55042087	6
chr12	55248298	55252174	MUCL1	3876	+	NM_058173	55248366	55252026	4
chr12	55342086	55378530	TESPA1	36444	-	NM_001136030	55354952	55368346	11
chr12	55413728	55423801	NEUROD4	10073	+	NM_021191	55420223	55421219	2
chr12	55523552	55524560	OR9K2	1008	+	NM_001005243	55523552	55524560	1
chr12	55614808	55615759	OR10A7	951	+	NM_001005280	55614808	55615759	1
chr12	55641071	55642010	OR6C74	939	+	NM_001005490	55641071	55642010	1
chr12	55688071	55689016	OR6C6	945	-	NM_001005493	55688071	55689016	1
chr12	55714383	55715322	OR6C1	939	+	NM_001005182	55714383	55715322	1
chr12	55725484	55726420	OR6C3	936	+	NM_054104	55725484	55726420	1
chr12	55758894	55759833	OR6C75	939	+	NM_001005497	55758894	55759833	1
chr12	55794312	55795251	OR6C65	939	+	NM_001005518	55794312	55795251	1
chr12	55820037	55820976	OR6C76	939	+	NM_001005183	55820037	55820976	1
chr12	55845997	55846936	OR6C2	939	+	NM_054105	55845997	55846936	1
chr12	55862983	55863922	OR6C70	939	-	NM_001005499	55862983	55863922	1
chr12	55886161	55887100	OR6C68	939	+	NM_001005519	55886161	55887100	1
chr12	55945010	55945940	OR6C4	930	+	NM_001005494	55945010	55945940	1
chr12	55968198	55969128	OR2AP1	930	+	NM_001258285	55968198	55969128	1
chr12	56030675	56031617	OR10P1	942	+	NM_206899	56030675	56031617	1
chr12	56075329	56078394	METTL7B	3065	+	NM_152637	56075538	56077833	2
chr12	56078353	56106089	ITGA7	27736	-	NM_001144997	56078841	56106053	25
chr12	56109817	56113491	BLOC1S1	3674	+	NM_001487	56109835	56113393	4
chr12	56109817	56118526	BLOC1S1-RDH5	8709	+	NR_037658	56118526	56118526	6
chr12	56114150	56118526	RDH5	4376	+	NM_001199771	56114968	56118329	5
chr12	56119226	56123457	CD63	4231	-	NM_001257389	56119344	56122125	8
chr12	56137063	56146665	GDF11	9602	+	NM_005811	56137100	56143666	3
chr12	56146246	56211540	SARNP	65294	-	NR_026723	56211540	56211540	12
chr12	56211805	56214959	ORMDL2	3154	+	NM_014182	56212783	56214179	4
chr12	56214743	56223420	DNAJC14	8677	-	NM_032364	56215760	56222442	7
chr12	56223391	56230030	TMEM198B	6639	+	NR_036478	56230030	56230030	6
chr12	56229213	56236767	MMP19	7554	-	NM_002429	56230819	56236614	9
chr12	56295196	56321697	PYM1	26501	-	NM_032345	56295655	56321545	3
chr12	56324945	56347807	DGKA	22862	+	NM_001345	56330287	56347552	24
chr12	56347888	56360496	PMEL	12608	-	NM_006928	56347997	56359795	12
chr12	56360552	56366573	CDK2	6021	+	NM_001798	56360792	56365409	7
chr12	56367696	56390467	RAB5B	22771	+	NM_001252036	56380744	56385996	6
chr12	56391042	56399309	SUOX	8267	+	NM_000456	56396005	56398811	6
chr12	56414688	56432219	IKZF4	17531	+	NM_022465	56415277	56429115	8
chr12	56435685	56438007	RPS26	2322	+	NM_001029	56435950	56437938	4
chr12	56473808	56497291	ERBB3	23483	+	NM_001982	56474084	56495839	28
chr12	56498102	56507694	PA2G4	9592	+	NM_006191	56498521	56506672	13
chr12	56510373	56511616	RPL41	1243	+	NM_021104	56510571	56511308	4
chr12	56512003	56516280	ZC3H10	4277	+	NM_032786	56514346	56515651	3
chr12	56521985	56538460	ESYT1	16475	+	NM_015292	56522103	56537646	31
chr12	56546203	56551771	MYL6B	5568	+	NM_002475	56547702	56551510	8
chr12	56552044	56555366	MYL6	3322	+	NM_021019	56552185	56554438	7
chr12	56555635	56583351	SMARCC2	27716	-	NM_001130420	56557472	56583245	30
chr12	56596287	56615753	RNF41	19466	-	NM_194359	56600230	56607831	7
chr12	56618124	56623638	NABP2	5514	+	NM_024068	56618640	56622997	7
chr12	56623819	56631629	SLC39A5	7810	+	NM_173596	56625058	56631515	13
chr12	56631590	56652143	ANKRD52	20553	-	NM_173595	56636925	56652053	28
chr12	56660641	56664750	COQ10A	4109	+	NM_144576	56660902	56664101	5
chr12	56665482	56694175	CS	28693	-	NM_004077	56666867	56693985	11
chr12	56704212	56710128	CNPY2	5916	-	NM_014255	56704335	56709001	6
chr12	56710006	56727837	PAN2	17831	-	NM_001166279	56711392	56726878	26
chr12	56732662	56734194	IL23A	1532	+	NM_016584	56732828	56733888	4
chr12	56735381	56754037	STAT2	18656	-	NM_005419	56737172	56750355	24
chr12	56754354	56756583	APOF	2229	-	NM_001638	56755008	56756529	2
chr12	56810156	56843200	TIMELESS	33044	-	NM_003920	56811499	56827954	29
chr12	56843285	56848435	MIP	5150	-	NM_012064	56845063	56848397	4
chr12	56862300	56864767	SPRYD4	2467	+	NM_207344	56862375	56863361	2
chr12	56864727	56882198	GLS2	17471	-	NM_013267	56865270	56881902	18
chr12	56906648	56906764	SNORA105C	116	+	NR_132789	56906764	56906764	1
chr12	56915608	56989980	RBMS2	74372	+	NM_002898	56915807	56982796	14
chr12	56989379	57030163	BAZ2A	40784	-	NM_013449	56992401	57029969	29
chr12	57031958	57039852	ATP5B	7894	-	NM_001686	57032106	57039747	10
chr12	57037463	57037538	SNORD59B	75	-	NR_003046	57037538	57037538	1
chr12	57038810	57038885	SNORD59A	75	-	NR_002737	57038885	57038885	1
chr12	57057124	57082192	PTGES3	25068	-	NM_001282604	57058262	57080666	9
chr12	57106210	57119326	NACA	13116	-	NM_001113203	57106321	57118305	11
chr12	57125363	57146146	PRIM1	20783	-	NM_000946	57125498	57146082	13
chr12	57157001	57181574	HSD17B6	24573	+	NM_003725	57167636	57181126	5
chr12	57316937	57328189	SDR9C7	11252	-	NM_148897	57317616	57328045	4
chr12	57345215	57351418	RDH16	6203	-	NM_003708	57345812	57351246	4
chr12	57388354	57390469	GPR182	2115	+	NM_007264	57388993	57390208	2
chr12	57392616	57400297	ZBTB39	7681	-	NM_014830	57396562	57398701	2
chr12	57403780	57410344	TAC3	6564	-	NR_033654	57410344	57410344	8
chr12	57422300	57444549	MYO1A	22249	-	NM_001256041	57422538	57442107	29
chr12	57449425	57472574	NEMP1	23149	-	NM_001130963	57453661	57472528	9
chr12	57482676	57489259	NAB2	6583	+	NM_005967	57483054	57488504	7
chr12	57489186	57505196	STAT6	16010	-	NM_003153	57490354	57502061	22
chr12	57522281	57607125	LRP1	84844	+	NM_002332	57522747	57606338	89
chr12	57538402	57541402	LRP1-AS	3000	-	NR_131938	57541402	57541402	2
chr12	57588286	57588359	MIR1228	73	+	NR_031597	57588359	57588359	1
chr12	57610577	57620232	NXPH4	9655	+	NM_007224	57610752	57619530	2
chr12	57623355	57628718	SHMT2	5363	+	NM_001166356	57623561	57628144	12
chr12	57628685	57634475	NDUFA4L2	5790	-	NM_020142	57629345	57630868	5
chr12	57637237	57644976	STAC3	7739	-	NM_145064	57637594	57643419	12
chr12	57647547	57704246	R3HDM2	56699	-	NM_014925	57648555	57704211	22
chr12	57828467	57845845	INHBC	17378	+	NM_005538	57828669	57843805	2
chr12	57849095	57851791	INHBE	2696	+	NM_031479	57849319	57850631	2
chr12	57853917	57866047	GLI1	12130	+	NM_001160045	57858646	57865844	10
chr12	57866037	57873633	ARHGAP9	7596	-	NM_032496	57866299	57873189	18
chr12	57881735	57910438	MARS	28703	+	NM_004990	57881873	57910364	21
chr12	57906470	57906533	MIR6758	63	+	NR_106816	57906533	57906533	1
chr12	57910370	57914300	DDIT3	3930	-	NM_001195055	57910591	57911258	4
chr12	57912947	57913042	MIR616	95	-	NR_030346	57913042	57913042	1
chr12	57916658	57923931	MBD6	7273	+	NM_052897	57918086	57923017	13
chr12	57923832	57941114	DCTN2	17282	-	NM_001261413	57924471	57940846	14
chr12	57943846	57978554	KIF5A	34708	+	NM_004984	57944054	57976962	29
chr12	57984941	57997211	PIP4K2C	12270	+	NM_001146258	57985072	57995389	11
chr12	57998404	58003587	DTX3	5183	+	NM_178502	58000300	58002935	7
chr12	58003962	58011028	ARHGEF25	7066	+	NM_001111270	58003999	58010677	16
chr12	58012187	58015686	LOC101927583	3499	-	NR_120450	58015686	58015686	4
chr12	58013692	58019934	SLC26A10	6242	+	NM_133489	58014003	58019528	14
chr12	58019677	58027022	B4GALNT1	7345	-	NM_001478	58020526	58025915	11
chr12	58087737	58115340	OS9	27603	+	NM_001017958	58087944	58114692	15
chr12	58118075	58135944	AGAP2	17869	-	NM_014770	58120334	58135854	18
chr12	58120022	58122139	AGAP2-AS1	2117	+	NR_027032	58122139	58122139	2
chr12	58138783	58142026	TSPAN31	3243	+	NM_005981	58138937	58141073	6
chr12	58141509	58146230	CDK4	4721	-	NM_000075	58142307	58145500	8
chr12	58142400	58142465	MIR6759	65	-	NR_106817	58142465	58142465	1
chr12	58148880	58154193	MARCH9	5313	+	NM_138396	58149311	58152680	4
chr12	58156116	58160976	CYP27B1	4860	-	NM_000785	58156924	58160824	9
chr12	58162350	58165914	METTL1	3564	-	NM_005371	58162778	58165866	6
chr12	58166382	58176324	METTL21B	9942	+	NM_206914	58166507	58174059	4
chr12	58176527	58196639	TSFM	20112	+	NM_001172697	58176584	58196414	6
chr12	58191159	58209852	AVIL	18693	-	NM_006576	58191664	58209823	19
chr12	58213709	58240747	CTDSP2	27038	-	NM_005730	58217384	58240218	8
chr12	58218391	58218475	MIR26A2	84	-	NR_029847	58218475	58218475	1
chr12	58325231	58329947	LOC100506844	4716	-	NR_038269	58329947	58329947	3
chr12	58335444	58351052	XRCC6BP1	15608	+	NM_033276	58335484	58350673	6
chr12	58959741	59175498	LOC101927653	215757	-	NR_120452	59175498	59175498	8
chr12	58985483	59206450	LOC100506869	220967	+	NR_126341	59206450	59206450	2
chr12	59265936	59314319	LRIG3	48383	-	NM_153377	59266353	59314016	19
chr12	59989820	60183635	SLC16A7	193815	+	NM_001270623	60098582	60173460	6
chr12	62102028	62586620	FAM19A2	484592	-	NM_178539	62104186	62261206	5
chr12	62654120	62803501	USP15	149381	+	NM_001252078	62654195	62798155	22
chr12	62654139	62654235	MIR6125	96	+	NR_106740	62654235	62654235	1
chr12	62860596	62991363	MON2	130767	+	NM_001278472	62887735	62986529	36
chr12	62995530	62997214	LINC01465	1684	-	NR_121682	62997214	62997214	1
chr12	62997465	62997549	MIRLET7I	84	+	NR_029661	62997549	62997549	1
chr12	63037762	63328665	PPM1H	290903	-	NM_020700	63042268	63328516	10
chr12	63536538	63546590	AVPR1A	10052	-	NM_000706	63541138	63544616	2
chr12	63952692	64062354	DPY19L2	109662	-	NM_173812	63954291	64062173	22
chr12	64173582	64203338	TMEM5	29756	+	NM_014254	64173740	64202872	6
chr12	64202624	64215936	TMEM5-AS1	13312	-	NR_126167	64215936	64215936	4
chr12	64238540	64541613	SRGAP1	303073	+	NM_020762	64238596	64536452	22
chr12	64580091	64616076	C12orf66	35985	-	NM_001300940	64581358	64616017	4
chr12	64660762	64784345	C12orf56	123583	-	NM_001170633	64660962	64784345	13
chr12	64798152	64842463	XPOT	44311	+	NM_007235	64803815	64841911	25
chr12	64845839	64895899	TBK1	50060	+	NM_013254	64849650	64895161	21
chr12	65004292	65091347	RASSF3	87055	+	NM_178169	65004412	65088692	5
chr12	65016288	65016385	MIR548C	97	+	NR_030347	65016385	65016385	1
chr12	65016288	65016385	MIR548Z	97	-	NR_037515	65016385	65016385	1
chr12	65107221	65153226	GNS	46005	-	NM_002076	65110520	65153056	14
chr12	65218351	65274798	TBC1D30	56447	+	NM_015279	65218659	65269568	12
chr12	65277553	65371302	FLJ41278	93749	+	NR_033988	65371302	65371302	3
chr12	65444403	65515346	WIF1	70943	-	NM_007191	65445128	65514971	10
chr12	65563350	65642141	LEMD3	78791	+	NM_014319	65563376	65640105	13
chr12	65672422	65860687	MSRB3	188265	+	NM_001193460	65702359	65857102	8
chr12	65860598	66036152	LOC100507065	175554	-	NR_120431	66036152	66036152	4
chr12	66151799	66220754	RPSAP52	68955	-	NR_026825	66220754	66220754	2
chr12	66218239	66360071	HMGA2	141832	+	NM_003483	66219050	66357072	5
chr12	66245006	66275947	LOC100129940	30941	-	NM_001292024	66245400	66275764	3
chr12	66417399	66417506	MIR6074	107	-	NR_106722	66417506	66417506	1
chr12	66516848	66524533	LLPH	7685	-	NM_032338	66517619	66522886	3
chr12	66524530	66528229	LLPH-AS1	3699	+	NR_125724	66528229	66528229	2
chr12	66530715	66563852	TMBIM4	33137	-	NM_001282606	66531739	66563731	8
chr12	66582977	66648394	IRAK3	65417	+	NM_007199	66583079	66641951	12
chr12	66644861	66644937	MIR6502	76	+	NR_106757	66644937	66644937	1
chr12	66696334	66737423	HELB	41089	+	NM_033647	66696383	66731882	14
chr12	66741210	67072925	GRIP1	331715	-	NM_021150	66742798	67072684	24
chr12	67471405	67490064	LOC102724421	18659	-	NR_120490	67490064	67490064	4
chr12	67663060	67708472	CAND1	45412	+	NM_018448	67663497	67706610	15
chr12	67913861	67960911	LOC100507175	47050	+	NR_103861	67960911	67960911	3
chr12	68042511	68056444	DYRK2	13933	+	NM_006482	68042913	68052493	3
chr12	68102826	68123255	LOC101927901	20429	-	NR_110063	68123255	68123255	5
chr12	68323014	68363797	LINC01479	40783	+	NR_120456	68363797	68363797	3
chr12	68383224	68415107	IFNG-AS1	31883	+	NR_104124	68415107	68415107	5
chr12	68548549	68553521	IFNG	4972	-	NM_000619	68549132	68553395	4
chr12	68595128	68619571	IL26	24443	-	NM_018402	68595624	68619536	5
chr12	68642024	68647281	IL22	5257	-	NM_020525	68642578	68647228	5
chr12	68688345	68726161	MDM1	37816	-	NM_001205028	68689033	68726025	14
chr12	68825621	68845264	LOC100507195	19643	-	NR_120458	68845264	68845264	4
chr12	69004618	69054385	RAP1B	49767	+	NM_015646	69042504	69050967	8
chr12	69021013	69021155	SNORA70G	142	-	NR_033335	69021155	69021155	1
chr12	69068150	69080639	LOC100507250	12489	-	NR_038930	69080639	69080639	3
chr12	69080730	69136473	NUP107	55743	+	NM_020401	69080845	69136242	28
chr12	69139935	69159853	SLC35E3	19918	+	NM_018656	69140157	69158670	5
chr12	69198216	69199274	LOC100130075	1058	-	NR_073494	69199274	69199274	1
chr12	69201951	69239324	MDM2	37373	+	NM_002392	69202257	69233629	11
chr12	69244955	69357020	CPM	112065	-	NM_001874	69250216	69326617	9
chr12	69633316	69668138	CPSF6	34822	+	NM_001300947	69633426	69656339	11
chr12	69666936	69666998	MIR1279	62	-	NR_031692	69666998	69666998	1
chr12	69742133	69748013	LYZ	5880	+	NM_000239	69742188	69746999	4
chr12	69753489	69784650	YEATS4	31161	+	NM_006530	69753752	69784096	7
chr12	69864128	69973571	FRS2	109443	+	NM_001278353	69962810	69968735	11
chr12	69978501	69978603	MIR3913-1	102	-	NR_037475	69978603	69978603	1
chr12	69978502	69978602	MIR3913-2	100	+	NR_037476	69978602	69978602	1
chr12	69979207	69995357	CCT2	16150	+	NM_006431	69979301	69995105	16
chr12	70002344	70004942	LRRC10	2598	-	NM_201550	70003784	70004618	1
chr12	70037287	70093196	BEST3	55909	-	NM_001282614	70037470	70091578	10
chr12	70107412	70132348	LOC101928002	24936	-	NR_110072	70132348	70132348	4
chr12	70132465	70216984	RAB3IP	84519	+	NM_022456	70149188	70209226	11
chr12	70219102	70352505	MYRFL	133403	+	NM_182530	70219297	70352311	25
chr12	70615969	70637140	LINC01481	21171	-	NR_120460	70637140	70637140	5
chr12	70636773	70748773	CNOT2	112000	+	NM_014515	70672006	70747695	16
chr12	70760061	70828072	KCNMB4	68011	+	NM_014505	70760514	70824433	3
chr12	70910631	71031220	PTPRB	120589	-	NM_001109754	70915268	71031175	34
chr12	71031852	71314584	PTPRR	282732	-	NM_002849	71032963	71314170	14
chr12	71518876	71551779	TSPAN8	32903	-	NM_004616	71519113	71551458	9
chr12	71833549	71980088	LGR5	146539	+	NR_110596	71980088	71980088	20
chr12	72003378	72057749	ZFC3H1	54371	-	NM_144982	72004207	72057390	35
chr12	72057676	72074428	THAP2	16752	+	NM_031435	72058289	72070888	3
chr12	72079877	72097839	TMEM19	17962	+	NM_018279	72080460	72094775	6
chr12	72148642	72187256	RAB21	38614	+	NM_014999	72148909	72179453	7
chr12	72233486	72320629	TBC1D15	87143	+	NM_022771	72233561	72316984	18
chr12	72242073	72244763	MRS2P2	2690	-	NR_024072	72244763	72244763	1
chr12	72332625	72426221	TPH2	93596	+	NM_173353	72332766	72425475	11
chr12	72647286	72667289	TRHDE-AS1	20003	-	NR_026837	72667289	72667289	2
chr12	72666528	73059422	TRHDE	392894	+	NM_013381	72666558	73056975	19
chr12	73552969	73602097	LOC101928137	49128	+	NR_110130	73602097	73602097	4
chr12	74526955	74686411	LOC100507377	159456	-	NR_038300	74686411	74686411	7
chr12	74931550	74935232	ATXN7L3B	3682	+	NM_001136262	74931892	74932186	1
chr12	75433857	75603528	KCNC2	169671	-	NM_139136	75436092	75601763	6
chr12	75670999	75784702	CAPS2	113703	-	NM_001286548	75672669	75706647	18
chr12	75728418	75764169	GLIPR1L1	35751	+	NM_001304964	75728508	75763956	6
chr12	75784849	75826177	GLIPR1L2	41328	+	NR_072995	75826177	75826177	7
chr12	75874512	75895716	GLIPR1	21204	+	NM_006851	75874660	75892758	6
chr12	75891418	75905418	KRR1	14000	-	NM_007043	75893588	75905377	10
chr12	76419226	76425556	PHLDA1	6330	-	NM_007350	76424315	76425521	2
chr12	76439162	76478813	NAP1L1	39651	-	NM_139207	76442208	76467999	16
chr12	76738265	76742222	BBS10	3957	-	NM_024685	76739592	76742138	2
chr12	76745577	76953589	OSBPL8	208012	-	NM_020841	76749668	76881331	24
chr12	77157853	77247474	ZDHHC17	89621	+	NM_015336	77158016	77244765	17
chr12	77252494	77272820	CSRP2	20326	-	NM_001300965	77252731	77260040	6
chr12	77415025	77459360	E2F7	44335	-	NM_203394	77417794	77458415	13
chr12	78225068	78606792	NAV3	381724	+	NM_001024383	78225241	78604297	40
chr12	79257772	79845788	SYT1	588016	+	NM_001135805	79611299	79842904	12
chr12	79813036	79813101	MIR1252	65	+	NR_031700	79813101	79813101	1
chr12	79850650	79852440	MIR5692B	1790	+	NR_049889	79852440	79852440	2
chr12	79985744	80084790	PAWR	99046	-	NM_002583	79986386	80084024	7
chr12	80167342	80329235	PPP1R12A	161893	-	NM_001143885	80169708	80328711	26
chr12	80603232	80772870	OTOGL	169638	+	NM_173591	80603238	80771828	58
chr12	80838125	81073968	PTPRQ	235843	+	NM_001145026	80838125	81072802	42
chr12	81101407	81103256	MYF6	1849	+	NM_002469	81101498	81102739	3
chr12	81110707	81113447	MYF5	2740	+	NM_005593	81110842	81112830	3
chr12	81156932	81164494	LINC01490	7562	+	NR_120469	81164494	81164494	5
chr12	81191170	81331694	LIN7A	140524	-	NM_004664	81205243	81331501	6
chr12	81226311	81226408	MIR617	97	-	NR_030348	81226408	81226408	1
chr12	81329514	81329612	MIR618	98	-	NR_030349	81329612	81329612	1
chr12	81471808	81649582	ACSS3	177774	+	NM_024560	81471899	81648701	16
chr12	81552166	81552240	MIR4699	74	+	NR_039848	81552240	81552240	1
chr12	81651753	82153109	PPFIA2	501356	-	NM_003625	81655760	82148000	33
chr12	81672967	81706201	LOC102724663	33234	+	NR_120491	81706201	81706201	6
chr12	82347497	82386912	LOC101928449	39415	+	NR_110089	82386912	82386912	3
chr12	82746082	82752584	CCDC59	6502	-	NR_033192	82752584	82752584	4
chr12	82752275	82873016	METTL25	120741	+	NM_032230	82752344	82872803	12
chr12	83080933	83528067	TMTC2	447134	+	NM_152588	83081365	83526168	12
chr12	85253266	85306608	SLC6A15	53342	-	NM_182767	85255410	85285899	12
chr12	85408093	85430055	TSPAN19	21962	-	NM_001100917	85408265	85423724	9
chr12	85430098	85638883	LRRIQ1	208785	+	NM_001079910	85431954	85638719	27
chr12	85674035	85695561	ALX1	21526	+	NM_006982	85674039	85695253	4
chr12	86198330	86230318	RASSF9	31988	-	NM_005447	86198479	86229979	2
chr12	86268072	86276770	NTS	8698	+	NM_006183	86268181	86276153	4
chr12	86373036	87232681	MGAT4C	859645	-	NM_013244	86373066	86383324	7
chr12	86946651	86946729	MIR548AL	78	-	NR_039710	86946729	86946729	2
chr12	88176662	88178488	MKRN9P	1826	-	NR_033410	88178488	88178488	1
chr12	88373815	88423176	C12orf50	49361	-	NM_152589	88374107	88420739	13
chr12	88429267	88443937	C12orf29	14670	+	NM_001009894	88429425	88442199	7
chr12	88442789	88535993	CEP290	93204	-	NM_025114	88442960	88535084	54
chr12	88536072	88593664	TMTC3	57592	+	NM_181783	88542092	88589426	14
chr12	88886569	88974250	KITLG	87681	-	NM_000899	88898972	88974055	10
chr12	89404902	89413469	LOC728084	8567	-	NR_038385	89413469	89413469	3
chr12	89741601	89746636	DUSP6	5035	-	NM_001946	89743030	89745816	3
chr12	89813497	89920039	POC1B	106542	-	NM_172240	89814929	89919672	12
chr12	89913189	89918583	GALNT4	5394	-	NM_003774	89916589	89918326	1
chr12	89913189	89920039	POC1B-GALNT4	6850	-	NM_001199782	89916589	89919932	3
chr12	89981825	90049844	ATP2B1	68019	-	NM_001001323	89985046	90049663	21
chr12	90102731	90105729	LINC00936	2998	+	NR_028138	90105729	90105729	1
chr12	91311799	91342446	LINC00615	30647	+	NR_038868	91342446	91342446	5
chr12	91345991	91348953	CCER1	2962	-	NM_152638	91347298	91348519	1
chr12	91357455	91398803	EPYC	41348	-	NM_004950	91357932	91396342	7
chr12	91444270	91452131	KERA	7861	-	NM_007035	91445122	91450058	3
chr12	91497231	91505542	LUM	8311	-	NM_002345	91497941	91502756	3
chr12	91537053	91576901	DCN	39848	-	NM_001920	91539834	91572329	8
chr12	92378751	92536607	LINC01619	157856	-	NR_046160	92536607	92536607	6
chr12	92534053	92539673	BTG1	5620	-	NM_001731	92537855	92539311	2
chr12	92813869	92821924	CLLU1OS	8055	-	NM_001025232	92814785	92821922	4
chr12	92815306	92824778	CLLU1	9472	+	NR_027932	92824778	92824778	3
chr12	93096618	93102325	C12orf74	5707	+	NM_001037671	93100407	93101491	3
chr12	93130264	93165868	PLEKHG7	35604	+	NM_001004330	93131294	93163971	12
chr12	93166284	93323107	EEA1	156823	-	NM_003566	93169786	93322842	29
chr12	93397533	93771512	LOC643339	373979	-	NR_040096	93771512	93771512	5
chr12	93568141	93575608	LOC102724933	7467	+	NR_120492	93575608	93575608	3
chr12	93771698	93797024	NUDT4	25326	+	NM_199040	93772098	93793155	5
chr12	93771701	93796045	NUDT4P2	24344	+	NR_104005	93796045	93796045	5
chr12	93771745	93796052	NUDT4P1	24307	+	NR_002212	93796052	93796052	5
chr12	93802087	93836026	UBE2N	33939	-	NM_003348	93803814	93835660	4
chr12	93861265	93897548	MRPL42	36283	+	NR_038159	93897548	93897548	7
chr12	93959403	93965174	SOCS2-AS1	5771	-	NR_038263	93965174	93965174	4
chr12	93963597	93970521	SOCS2	6924	+	NM_003877	93966673	93968955	3
chr12	94071150	94244531	CRADD	173381	+	NM_003805	94072550	94244047	3
chr12	94101566	94131599	LOC101928731	30033	-	NR_110092	94131599	94131599	3
chr12	94542498	94701451	PLXNC1	158953	+	NM_005761	94542747	94699061	31
chr12	94702055	94853764	CEP83	151709	-	NM_016122	94702588	94806266	17
chr12	94853778	94856344	CEP83-AS1	2566	+	NR_027035	94856344	94856344	1
chr12	94955564	94955635	MIR5700	71	+	NR_049885	94955635	94955635	1
chr12	94960899	95044338	TMCC3	83439	-	NM_020698	94965210	95044206	4
chr12	94965006	94965128	MIR7844	122	-	NR_106998	94965128	94965128	1
chr12	95228173	95228289	MIR492	116	+	NR_030171	95228289	95228289	1
chr12	95228229	95228804	KRT19P2	575	+	NR_036685	95228804	95228804	1
chr12	95365103	95397489	NDUFA12	32386	-	NM_018838	95365215	95397456	4
chr12	95414004	95467404	NR2C1	53400	-	NM_003297	95416004	95461160	14
chr12	95470524	95611240	FGD6	140716	-	NM_018351	95475295	95611016	21
chr12	95611521	95696566	VEZT	85045	+	NR_038241	95696566	95696566	13
chr12	95702195	95702289	MIR331	94	+	NR_029895	95702289	95702289	1
chr12	95703698	95703760	MIR3685	62	+	NR_037456	95703760	95703760	1
chr12	95867821	95909613	METAP2	41792	+	NM_006838	95867955	95907680	11
chr12	95910335	95945266	USP44	34931	-	NM_032147	95911929	95928032	6
chr12	96043030	96067770	PGAM1P5	24740	+	NR_077225	96067770	96067770	5
chr12	96051582	96184536	NTN4	132954	-	NM_021229	96052861	96184087	10
chr12	96252708	96260238	SNRPF	7530	+	NM_003095	96252851	96259849	4
chr12	96260825	96336428	CCDC38	75603	-	NM_182496	96260853	96330287	16
chr12	96337070	96362370	AMDHD1	25300	+	NM_152435	96337176	96361621	9
chr12	96366439	96390143	HAL	23704	-	NM_002108	96368009	96389688	21
chr12	96394530	96437298	LTA4H	42768	-	NM_001256643	96394766	96437153	19
chr12	96588159	96663613	ELK3	75454	+	NM_005230	96617344	96660958	5
chr12	96672038	96794366	CDK17	122328	-	NM_002595	96674019	96728614	17
chr12	96883348	97269333	CFAP54	385985	+	NM_001306084	96883387	97254716	68
chr12	97301000	97347469	NEDD1	46469	+	NM_152905	97303537	97345831	16
chr12	97858798	97927544	RMST	68746	+	NR_024037	97927544	97927544	9
chr12	97885686	97885756	MIR1251	70	+	NR_031653	97885756	97885756	1
chr12	97957589	97957689	MIR135A2	100	+	NR_029678	97957689	97957689	1
chr12	98107189	98147376	LOC643711	40187	-	NR_077241	98147376	98147376	7
chr12	98332833	98332899	MIR4495	66	-	NR_039716	98332899	98332899	1
chr12	98389160	98389226	MIR4303	66	-	NR_036189	98389226	98389226	1
chr12	98847618	98850923	SLC9A7P1	3305	-	NR_033801	98850923	98850923	1
chr12	98879321	98897633	LOC643770	18312	-	NR_038383	98897633	98897633	4
chr12	98906750	98910004	TMPO-AS1	3254	-	NR_027157	98910004	98910004	2
chr12	98909350	98944157	TMPO	34807	+	NM_001032283	98909645	98941636	9
chr12	98987402	98995778	SLC25A3	8376	+	NM_002635	98987756	98995306	8
chr12	98993412	98993662	SNORA53	250	+	NR_003015	98993662	98993662	1
chr12	99007181	99038829	IKBIP	31648	-	NM_201612	99007362	99038479	3
chr12	99039077	99129211	APAF1	90134	+	NM_181861	99042137	99126344	27
chr12	99128568	100378432	ANKS1B	1249864	-	NM_152788	99129337	100378015	26
chr12	99487136	99498789	LOC101928937	11653	+	NR_110095	99498789	99498789	5
chr12	100041527	100043892	FAM71C	2365	+	NM_153364	100041952	100043176	2
chr12	100430862	100536642	UHRF1BP1L	105780	-	NM_015054	100431413	100536413	21
chr12	100550174	100567121	GOLGA2P5	16947	-	NR_036632	100567121	100567121	10
chr12	100583661	100583727	MIR1827	66	+	NR_031728	100583727	100583727	1
chr12	100593864	100618202	ACTR6	24338	+	NM_022496	100594629	100617693	11
chr12	100646041	100660857	DEPDC4	14816	-	NM_152317	100646307	100660854	5
chr12	100660917	100735502	SCYL2	74585	+	NM_001317784	100676748	100732950	18
chr12	100750856	100815837	SLC17A8	64981	+	NM_139319	100751169	100813937	12
chr12	100867550	100957645	NR1H4	90095	+	NM_001206977	100887101	100957267	12
chr12	100967438	101022066	GAS2L3	54628	+	NM_174942	100988682	101018668	10
chr12	101188373	101522419	ANO4	334046	+	NM_001286615	101295563	101520848	28
chr12	101549993	101604016	SLC5A8	54023	-	NM_145913	101551056	101603626	15
chr12	101673904	101780397	UTP20	106493	+	NM_014503	101674060	101779901	62
chr12	101786897	101801598	ARL1	14701	-	NM_001177	101789417	101801423	6
chr12	101871334	101880775	SPIC	9441	+	NM_152323	101871334	101880549	4
chr12	101988708	102079658	MYBPC1	90950	+	NM_002465	101988848	102078183	32
chr12	102091416	102122846	CHPT1	31430	+	NM_020244	102091639	102122723	9
chr12	102122425	102133250	SYCP3	10825	-	NM_153694	102122704	102131713	9
chr12	102139274	102224645	GNPTAB	85371	-	NM_024312	102140941	102224453	21
chr12	102271104	102317401	DRAM1	46297	+	NM_018370	102271567	102315038	7
chr12	102406617	102455902	CCDC53	49285	-	NM_001301107	102406885	102455740	7
chr12	102467966	102513909	NUP37	45943	-	NM_024057	102468131	102512296	10
chr12	102513955	102591298	PARPBP	77343	+	NM_017915	102517666	102590069	11
chr12	102590236	102591623	PMCH	1387	-	NM_002674	102590429	102591548	3
chr12	102789644	102874423	IGF1	84779	-	NM_001111283	102796318	102874159	5
chr12	103203060	103218177	LINC00485	15117	-	NR_033855	103218177	103218177	5
chr12	103232103	103311381	PAH	79278	-	NM_000277	103232952	103310908	13
chr12	103351451	103354294	ASCL1	2843	+	NM_004316	103352022	103352733	2
chr12	103545619	103562086	LOC101929058	16467	+	NR_126333	103562086	103562086	7
chr12	103631368	103889788	C12orf42	258420	-	NR_103526	103889788	103889788	11
chr12	103941571	103953593	LOC101929084	12022	+	NR_110103	103953593	103953593	5
chr12	103981068	104160502	STAB2	179434	+	NM_017564	103981254	104160114	69
chr12	104166080	104234975	NT5DC3	68895	-	NM_001031701	104171606	104234934	14
chr12	104237526	104323989	TTC41P	86463	-	NR_027249	104323989	104323989	16
chr12	104324111	104341708	HSP90B1	17597	+	NM_003299	104324293	104341440	18
chr12	104324202	104324333	MIR3652	131	+	NR_037425	104324333	104324333	1
chr12	104343980	104350993	C12orf73	7013	-	NM_001135570	104345300	104350516	3
chr12	104359592	104382656	TDG	23064	+	NM_003211	104359815	104380868	10
chr12	104382760	104457955	GLT8D2	75195	-	NM_031302	104383185	104413426	12
chr12	104458235	104500304	HCFC2	42069	+	NM_013320	104458338	104497051	15
chr12	104510857	104532040	NFYB	21183	-	NM_006166	104513514	104529231	8
chr12	104609556	104744085	TXNRD1	134529	+	NM_001093771	104609580	104742199	17
chr12	104697509	104698982	EID3	1473	+	NM_001008394	104697712	104698714	1
chr12	104850691	105155792	CHST11	305101	+	NM_018413	104851189	105151581	3
chr12	104985410	104985494	MIR3922	84	+	NR_037487	104985494	104985494	1
chr12	105197274	105322472	SLC41A2	125198	-	NM_032148	105198929	105322305	10
chr12	105380097	105388505	C12orf45	8408	+	NM_152318	105380130	105388474	4
chr12	105413561	105478341	ALDH1L2	64780	-	NR_027752	105478341	105478341	23
chr12	105496249	105501420	LOC414300	5171	-	NR_121211	105501420	105501420	2
chr12	105501491	105562912	KIAA1033	61421	+	NM_015275	105501578	105560709	33
chr12	105567074	105630008	APPL2	62934	-	NM_001251904	105568091	105629790	21
chr12	105698644	105720795	KCCAT198	22151	-	NR_131986	105720795	105720795	3
chr12	105724413	105765296	C12orf75	40883	+	NM_001145199	105724669	105761254	6
chr12	106097980	106137841	CASC18	39861	+	NR_110109	106137841	106137841	5
chr12	106457124	106533811	NUAK1	76687	-	NM_014840	106460579	106532431	7
chr12	106631658	106641713	CKAP4	10055	-	NM_006825	106632801	106641629	2
chr12	106696568	106740792	TCP11L2	44224	+	NM_152772	106704853	106740308	10
chr12	106751435	106903976	POLR3B	152541	+	NM_018082	106751657	106903327	28
chr12	106890187	107168609	LOC100287944	278422	-	NR_040246	107168609	107168609	4
chr12	106976684	107156582	RFX4	179898	+	NM_213594	106977098	107155247	18
chr12	107074535	107078478	LOC100505978	3943	-	NR_038912	107078478	107078478	4
chr12	107168398	107283094	RIC8B	114696	+	NM_018157	107168523	107279793	9
chr12	107349543	107367813	TMEM263	18270	+	NM_152261	107360894	107365169	4
chr12	107371068	107380944	MTERF2	9876	-	NM_001033050	107371334	107372492	3
chr12	107385142	107487635	CRY1	102493	-	NM_004075	107386564	107486739	13
chr12	107712196	108053419	BTBD11	341223	+	NM_001018072	107712717	108051495	17
chr12	108079508	108106939	PWP1	27431	+	NM_007062	108079676	108105997	15
chr12	108126642	108154914	PRDM4	28272	-	NM_012406	108127986	108154292	12
chr12	108130331	108153745	LOC101929162	23414	+	NR_120474	108153745	108153745	5
chr12	108168161	108170421	ASCL4	2260	+	NM_203436	108168992	108169514	1
chr12	108296926	108297548	LOC728739	622	-	NR_037629	108297548	108297548	1
chr12	108523247	108644313	WSCD2	121066	+	NM_014653	108589609	108642120	9
chr12	108681820	108733094	CMKLR1	51274	-	NM_001142343	108685617	108687368	4
chr12	108853201	108867466	LINC01498	14265	-	NR_120483	108867466	108867466	4
chr12	108909050	108913380	FICD	4330	+	NM_007076	108910749	108913252	3
chr12	108915990	108955165	SART3	39175	-	NM_014706	108917233	108954930	19
chr12	108955238	108963160	ISCU	7922	+	NM_014301	108957892	108962692	6
chr12	108983621	108991894	TMEM119	8273	-	NM_181724	108985307	108986159	2
chr12	109015679	109027670	SELPLG	11991	-	NM_003006	109016844	109018083	2
chr12	109029585	109029646	MIR4496	61	+	NR_039717	109029646	109029646	1
chr12	109038884	109125326	CORO1C	86442	-	NM_014325	109041178	109095094	11
chr12	109176465	109251359	SSH1	74894	-	NM_018984	109181763	109251272	15
chr12	109230683	109230782	MIR619	99	-	NR_030350	109230782	109230782	1
chr12	109273856	109294710	DAO	20854	+	NM_001917	109278782	109294311	11
chr12	109301904	109459045	SVOP	157141	-	NM_018711	109306310	109458673	15
chr12	109460893	109525831	USP30	64938	+	NM_001301175	109494496	109523736	16
chr12	109489845	109491770	USP30-AS1	1925	-	NR_038996	109491770	109491770	2
chr12	109525992	109531293	ALKBH2	5301	-	NM_001145374	109526010	109530591	4
chr12	109535398	109548798	UNG	13400	+	NM_080911	109535484	109547774	7
chr12	109577201	109706030	ACACB	128829	+	NM_001093	109577210	109704167	52
chr12	109715782	109747025	FOXN4	31243	-	NM_213596	109717475	109746126	10
chr12	109791991	109797293	LINC01486	5302	-	NR_120462	109797293	109797293	3
chr12	109826523	109886176	MYO1H	59653	+	NM_001101421	109826523	109884987	31
chr12	109886459	109915349	KCTD10	28890	-	NM_001317399	109889399	109915067	7
chr12	109915427	109974510	UBE3B	59083	+	NM_130466	109921356	109972587	28
chr12	109991520	110011358	MMAB	19838	-	NR_038118	110011358	110011358	10
chr12	110011499	110035075	MVK	23576	+	NM_000431	110012627	110034382	11
chr12	110152186	110208312	FAM222A	56126	+	NM_032829	110181951	110207093	3
chr12	110172013	110211292	FAM222A-AS1	39279	-	NR_026661	110211292	110211292	4
chr12	110220891	110271212	TRPV4	50321	-	NM_021625	110221425	110252601	16
chr12	110271152	110271241	MIR4497	89	+	NR_039718	110271241	110271241	1
chr12	110288747	110318293	GLTP	29546	-	NM_016433	110290359	110318179	5
chr12	110338078	110355874	TCHP	17796	+	NM_001143852	110340831	110354428	13
chr12	110367606	110434194	GIT2	66588	-	NM_057169	110370782	110434029	20
chr12	110437234	110477235	ANKRD13A	40001	+	NM_033121	110437493	110475359	15
chr12	110478981	110505500	C12orf76	26519	-	NM_207435	110480155	110503679	5
chr12	110562139	110656600	IFT81	94461	+	NM_014055	110565185	110656031	19
chr12	110719031	110788897	ATP2A2	69866	+	NM_001681	110719594	110788110	21
chr12	110810704	110841535	ANAPC7	30831	-	NM_016238	110811948	110841534	11
chr12	110872694	110888216	ARPC3	15522	-	NM_001287222	110872959	110888065	7
chr12	110890290	110906526	GPN3	16236	-	NM_001164372	110890838	110906441	8
chr12	110906231	110928192	FAM216A	21961	+	NM_013300	110906680	110927942	7
chr12	110929327	110939945	VPS29	10618	-	NM_001282150	110929809	110939308	6
chr12	110940004	110969891	RAD9B	29887	+	NM_001286533	110950669	110968458	12
chr12	110972236	111021064	PPTC7	48828	-	NM_139283	110974841	111020836	6
chr12	111051831	111086935	TCTN1	35104	+	NM_001082538	111051987	111085697	15
chr12	111086490	111127617	HVCN1	41127	-	NM_001040107	111087214	111121050	8
chr12	111157612	111180783	PPP1CC	23171	-	NM_001244974	111157938	111180512	8
chr12	111284763	111345339	CCDC63	60576	+	NM_152591	111290758	111345280	12
chr12	111348623	111358404	MYL2	9781	-	NM_000432	111348880	111358333	7
chr12	111374405	111375250	LINC01405	845	+	NR_036513	111375250	111375250	2
chr12	111471827	111788358	CUX2	316531	+	NM_015267	111471981	111786129	22
chr12	111741945	111742013	MIR6760	68	+	NR_106818	111742013	111742013	1
chr12	111798454	111806925	FAM109A	8471	-	NM_001177996	111800481	111803370	4
chr12	111843751	111889427	SH2B3	45676	+	NM_005475	111855949	111886106	8
chr12	111890017	112037480	ATXN2	147463	-	NM_002973	111890615	112037318	25
chr12	112079949	112123800	BRAP	43851	-	NM_006768	112082002	112123596	12
chr12	112123856	112194911	ACAD10	71055	+	NM_001136538	112130513	112194277	22
chr12	112204690	112247789	ALDH2	43099	+	NM_000690	112204786	112247379	13
chr12	112237637	112237709	MIR6761	72	+	NR_106819	112237709	112237709	1
chr12	112277572	112280706	MAPKAPK5-AS1	3134	-	NR_015404	112280706	112280706	2
chr12	112280031	112331228	MAPKAPK5	51197	+	NM_003668	112280537	112330865	14
chr12	112336866	112339706	ADAM1A	2840	+	NR_036636	112339706	112339706	1
chr12	112369086	112451023	TMEM116	81937	-	NM_001294314	112369424	112381107	13
chr12	112451151	112461024	ERP29	9873	+	NM_006817	112451269	112460456	3
chr12	112464492	112546635	NAA25	82143	-	NM_024953	112467334	112546577	24
chr12	112475402	112475519	MIR3657	117	-	NR_037430	112475519	112475519	1
chr12	112563348	112591408	TRAFD1	28060	+	NM_006700	112568326	112590595	12
chr12	112597991	112819896	HECTD4	221905	-	NM_001109662	112600190	112757291	76
chr12	112601061	112601125	MIR6861	64	-	NR_106921	112601125	112601125	1
chr12	112842993	112847443	RPL6	4450	-	NM_000970	112843027	112846460	7
chr12	112856535	112947717	PTPN11	91182	+	NM_002834	112856915	112942568	16
chr12	113132838	113132981	MIR1302-1	143	-	NR_031631	113132981	113132981	1
chr12	113229548	113336684	RPH3A	107136	+	NM_001143854	113266123	113334585	22
chr12	113344738	113357712	OAS1	12974	+	NM_016816	113344844	113357358	6
chr12	113376237	113411055	OAS3	34818	+	NM_006187	113376335	113407778	16
chr12	113416273	113449528	OAS2	33255	+	NM_016817	113416413	113448289	11
chr12	113495661	113535833	DTX1	40172	+	NM_004416	113495997	113534744	9
chr12	113536623	113574044	RASAL1	37421	-	NM_001193520	113537733	113573267	22
chr12	113587662	113597081	CFAP73	9419	+	NM_001144872	113587662	113595484	8
chr12	113594977	113623284	DDX54	28307	-	NM_001111322	113596681	113623256	20
chr12	113596917	113596982	MIR7106	65	-	NR_106956	113596982	113596982	1
chr12	113623330	113630173	RITA1	6843	+	NM_032848	113624551	113629622	4
chr12	113633245	113658899	IQCD	25654	-	NM_138451	113633379	113645971	3
chr12	113659242	113736389	TPCN1	77147	+	NM_001143819	113663050	113733881	29
chr12	113729327	113729413	MIR6762	86	+	NR_106820	113729413	113729413	1
chr12	113736570	113772925	SLC8B1	36355	-	NM_024959	113737581	113770683	16
chr12	113796370	113827458	PLBD2	31088	+	NM_173542	113796405	113826431	12
chr12	113830250	113841692	SDS	11442	-	NM_006843	113830745	113837513	8
chr12	113860194	113876081	SDSL	15887	+	NM_138432	113865787	113875884	9
chr12	113900693	113909877	LHX5	9184	-	NM_022363	113900994	113909303	5
chr12	113909807	113918286	LHX5-AS1	8479	+	NR_126425	113918286	113918286	2
chr12	114182381	114211488	LINC01234	29107	-	NR_110026	114211488	114211488	3
chr12	114254542	114404176	RBM19	149634	-	NM_001146699	114261028	114404032	25
chr12	114791734	114846247	TBX5	54513	-	NM_000192	114793336	114841703	9
chr12	114845999	114850637	TBX5-AS1	4638	+	NR_038440	114850637	114850637	3
chr12	115108058	115121969	TBX3	13911	-	NM_016569	115109645	115121005	8
chr12	116396380	116714991	MED13L	318611	-	NM_015335	116399070	116714936	31
chr12	116586364	116586459	MIR620	95	-	NR_030351	116586459	116586459	1
chr12	116866056	116866123	MIR4472-2	67	-	NR_039683	116866123	116866123	1
chr12	116971239	116974318	LINC00173	3079	+	NR_027346	116974318	116974318	3
chr12	116997185	117014425	MAP1LC3B2	17240	+	NM_001085481	117013747	117014125	2
chr12	117151124	117175875	C12orf49	24751	-	NM_024738	117155614	117175705	5
chr12	117176095	117291436	RNFT2	115341	+	NM_001109903	117178302	117287253	12
chr12	117298224	117319232	HRK	21008	-	NR_073189	117319232	117319232	5
chr12	117348760	117468953	FBXW8	120193	+	NM_012174	117348842	117465977	11
chr12	117415244	117425142	LOC100506551	9898	-	NR_103809	117425142	117425142	4
chr12	117476727	117537251	TESC	60524	-	NM_017899	117476937	117537087	8
chr12	117537271	117579294	TESC-AS1	42023	+	NR_120464	117579294	117579294	3
chr12	117581584	117628300	FBXO21	46716	-	NM_033624	117583891	117628261	12
chr12	117645946	117799607	NOS1	153661	-	NM_001204218	117653113	117768874	30
chr12	117890816	118406028	KSR2	515212	-	NM_173598	117905003	118405973	20
chr12	118454505	118470042	RFC5	15537	+	NM_181578	118455856	118469083	12
chr12	118470496	118499979	WSB2	29483	-	NM_001278557	118472000	118499967	9
chr12	118501397	118541810	VSIG10	40413	-	NM_019086	118504443	118541476	9
chr12	118573688	118583393	PEBP1	9705	+	NM_002567	118574014	118582608	4
chr12	118587605	118810750	TAOK3	223145	-	NM_016281	118588801	118693372	21
chr12	118814357	118855840	SUDS3	41483	+	NM_022491	118814496	118852238	12
chr12	119419299	119600856	SRRM4	181557	+	NM_194286	119419687	119594603	13
chr12	119616594	119632551	HSPB8	15957	+	NM_014365	119617117	119631663	3
chr12	119721629	119741185	LINC00934	19556	-	NR_024246	119741185	119741185	4
chr12	119772516	119978852	CCDC60	206336	+	NM_178499	119772981	119978520	14
chr12	120031263	120079363	TMEM233	48100	+	NM_001136534	120031653	120078510	3
chr12	120105760	120119429	PRKAB1	13669	+	NM_006253	120106049	120118130	7
chr12	120123594	120315095	CIT	191501	-	NM_001206999	120126036	120313972	48
chr12	120151438	120151529	MIR1178	91	-	NR_031589	120151529	120151529	1
chr12	120427647	120532299	CCDC64	104652	+	NM_207311	120427672	120530965	9
chr12	120532898	120554643	RAB35	21745	-	NM_006861	120535048	120554454	6
chr12	120565013	120632513	GCN1	67500	-	NM_006836	120565652	120632500	58
chr12	120593237	120593303	MIR4498	66	-	NR_039719	120593303	120593303	1
chr12	120634502	120639014	RPLP0	4512	-	NM_001002	120634575	120638586	8
chr12	120639093	120650631	PXN-AS1	11538	+	NR_038924	120650631	120650631	4
chr12	120648241	120703574	PXN	55333	-	NM_001080855	120650116	120703432	12
chr12	120740123	120751045	SIRT4	10922	+	NM_012240	120741364	120750839	4
chr12	120759913	120765592	PLA2G1B	5679	-	NM_000928	120759995	120765556	4
chr12	120779132	120806983	MSI1	27851	-	NM_002442	120783393	120806894	15
chr12	120875892	120878545	COX6A1	2653	+	NM_004373	120875929	120878340	3
chr12	120881763	120884215	TRIAP1	2452	-	NM_016399	120882674	120884175	2
chr12	120884240	120901556	GATC	17316	+	NR_033684	120901556	120901556	5
chr12	120899470	120907558	SRSF9	8088	-	NM_003769	120899821	120907412	4
chr12	120907659	120936298	DYNLL1	28639	+	NM_001037494	120934224	120936013	3
chr12	120928140	120933749	NRAV	5609	-	NR_038854	120933749	120933749	2
chr12	120941081	120966964	COQ5	25883	-	NM_032314	120941586	120966944	7
chr12	120972131	121015397	RNF10	43266	+	NM_014868	120972614	121014469	17
chr12	121016847	121019201	POP5	2354	-	NM_198202	121017120	121019165	4
chr12	121078421	121105127	CABP1	26706	+	NM_001033677	121078488	121104703	6
chr12	121124926	121139667	MLEC	14741	+	NM_014730	121125099	121134348	5
chr12	121148237	121161443	UNC119B	13206	+	NM_001080533	121148277	121157835	5
chr12	121160995	121161069	MIR4700	74	+	NR_039849	121161069	121161069	1
chr12	121163540	121177811	ACADS	14271	+	NM_001302554	121163688	121177251	10
chr12	121200312	121342155	SPPL3	141843	-	NM_139015	121202801	121341670	11
chr12	121342497	121345877	XLOC_009911	3380	+	NR_131215	121345877	121345877	2
chr12	121407640	121410095	HNF1A-AS1	2455	-	NR_024345	121410095	121410095	1
chr12	121416370	121440314	HNF1A	23944	+	NM_000545	121416571	121438995	10
chr12	121440224	121454305	C12orf43	14081	-	NM_001286198	121441955	121450251	7
chr12	121458094	121477045	OASL	18951	-	NM_003733	121458363	121476774	6
chr12	121570621	121624354	P2RX7	53733	+	NR_033953	121624354	121624354	11
chr12	121647663	121671909	P2RX4	24246	+	NR_046372	121671909	121671909	13
chr12	121675494	121736111	CAMKK2	60617	-	NM_006549	121678501	121712329	17
chr12	121746047	121792012	ANAPC5	45965	-	NM_001137559	121746282	121784798	17
chr12	121837885	121862155	RNF34	24270	+	NM_025126	121838015	121861379	6
chr12	121866899	122018920	KDM2B	152021	-	NM_032590	121868090	122018816	23
chr12	121882075	121882155	MIR7107	80	-	NR_106957	121882155	121882155	1
chr12	122034433	122034505	MIR548AQ	72	+	NR_049838	122034505	122034505	2
chr12	122064454	122079946	ORAI1	15492	+	NM_032790	122064647	122079549	2
chr12	122089292	122107560	MORN3	18268	-	NM_173855	122090639	122107389	6
chr12	122150657	122219974	TMEM120B	69317	+	NM_001080825	122150801	122213628	12
chr12	122215659	122231594	RHOF	15935	-	NM_019034	122217403	122231539	5
chr12	122233172	122241390	LINC01089	8218	-	NR_002809	122241390	122241390	7
chr12	122242637	122270562	SETD1B	27925	+	NM_015048	122242643	122268145	17
chr12	122277432	122326517	HPD	49085	-	NM_001171993	122277633	122295314	16
chr12	122326636	122355771	PSMD9	29135	+	NM_002813	122326762	122354217	6
chr12	122356462	122441832	WDR66	85370	+	NM_144668	122359211	122441670	22
chr12	122459791	122499950	BCL7A	40159	+	NM_001024808	122459997	122497069	6
chr12	122516633	122631894	MLXIP	115261	+	NM_014938	122516759	122626359	17
chr12	122652265	122688018	LRRC43	35753	+	NM_152759	122672280	122687989	12
chr12	122656576	122658746	IL31	2170	-	NM_001014336	122656958	122658719	3
chr12	122688227	122692084	B3GNT4	3857	+	NM_030765	122689165	122691935	3
chr12	122692208	122712081	DIABLO	19873	-	NM_019887	122692927	122710561	7
chr12	122710988	122713339	LOC101593348	2351	+	NR_103497	122713339	122713339	1
chr12	122716093	122751068	VPS33A	34975	-	NM_022916	122716792	122750955	13
chr12	122755980	122907116	CLIP1	151136	-	NM_001247997	122757421	122864999	26
chr12	122880088	122884491	CLIP1-AS1	4403	+	NR_045382	122884491	122884491	3
chr12	122956145	122985620	ZCCHC8	29475	-	NM_017612	122958043	122985387	14
chr12	122989189	123011560	RSRC2	22371	-	NR_036435	123011560	123011560	11
chr12	123011808	123110947	KNTC1	99139	+	NM_014708	123014610	123110775	64
chr12	123185839	123187904	HCAR2	2065	-	NM_177551	123186738	123187830	1
chr12	123199302	123201439	HCAR3	2137	-	NM_006018	123200120	123201284	1
chr12	123212152	123215129	HCAR1	2977	-	NM_032554	123213845	123214886	1
chr12	123237367	123255611	DENR	18244	+	NM_003677	123238248	123253625	8
chr12	123259055	123311927	CCDC62	52872	+	NR_027918	123311927	123311927	13
chr12	123319984	123347507	HIP1R	27523	+	NM_003959	123320097	123346300	32
chr12	123349874	123380712	VPS37B	30838	-	NM_024667	123351662	123380609	4
chr12	123405497	123451056	ABCB9	45559	-	NM_001243014	123405584	123444782	12
chr12	123459249	123464588	OGFOD2	5339	+	NM_024623	123460939	123463893	8
chr12	123464606	123467460	ARL6IP4	2854	+	NR_103512	123467460	123467460	6
chr12	123468026	123595036	PITPNM2	127010	-	NM_001300801	123470573	123519137	25
chr12	123495213	123495275	MIR4304	62	-	NR_036187	123495275	123495275	1
chr12	123565930	123569291	LOC100507091	3361	+	NR_038290	123569291	123569291	3
chr12	123640942	123717785	MPHOSPH9	76843	-	NR_103517	123717785	123717785	24
chr12	123717843	123742506	C12orf65	24663	+	NM_152269	123738221	123741578	3
chr12	123745516	123756863	CDK2AP1	11347	-	NR_073007	123756863	123756863	4
chr12	123773655	123834988	SBNO1	61333	-	NM_001167856	123780454	123834988	31
chr12	123849310	123849390	MIR8072	80	-	NR_107039	123849390	123849390	1
chr12	123868703	123893900	KMT5A	25197	+	NM_020382	123868745	123892250	8
chr12	123899585	123921280	RILPL2	21695	-	NM_145058	123900437	123920967	4
chr12	123942650	123956909	SNRNP35	14259	+	NR_104103	123956909	123956909	2
chr12	123955908	124018265	RILPL1	62357	-	NM_178314	123957084	124018029	7
chr12	124020955	124021081	MIR3908	126	+	NR_037470	124021081	124021081	1
chr12	124065612	124068874	LOC101927415	3262	-	NR_110049	124068874	124068874	3
chr12	124069075	124082688	TMED2	13613	+	NM_006815	124069183	124081276	4
chr12	124086671	124105482	DDX55	18811	+	NM_020936	124086695	124104687	14
chr12	124105569	124118323	EIF2B1	12754	-	NM_001414	124106302	124118104	9
chr12	124118285	124147151	GTF2H3	28866	+	NM_001516	124118406	124144782	13
chr12	124155659	124192950	TCTN2	37291	+	NM_001143850	124155787	124192260	18
chr12	124196864	124246301	ATP6V0A2	49437	+	NM_012463	124197112	124242579	20
chr12	124247041	124420267	DNAH10	173226	+	NM_207437	124247066	124420028	78
chr12	124420955	124457532	CCDC92	36577	-	NM_001304958	124421604	124428852	6
chr12	124457761	124499986	ZNF664	42225	+	NM_001204298	124496691	124497477	5
chr12	124457761	124800570	ZNF664-FAM101A	342809	+	NM_001204299	124796399	124799071	5
chr12	124773709	124800570	FAM101A	26861	+	NM_181709	124796399	124799071	3
chr12	124808956	125052010	NCOR2	243054	-	NM_006312	124809947	124979797	49
chr12	124821726	124821788	MIR6880	62	-	NR_106940	124821788	124821788	1
chr12	125262173	125348519	SCARB1	86346	-	NM_005505	125267228	125348266	13
chr12	125396190	125399587	UBC	3397	-	NM_021009	125396259	125398317	2
chr12	125400092	125400205	MIR5188	113	+	NR_049820	125400205	125400205	1
chr12	125431369	125473667	DHX37	42298	-	NM_032656	125432347	125473568	27
chr12	125478193	125510349	BRI3BP	32156	+	NM_080626	125478336	125509976	3
chr12	125509988	125511969	THRIL	1981	-	NR_110375	125511969	125511969	1
chr12	125549924	125627871	AACS	77947	+	NM_023928	125550130	125626775	18
chr12	125811161	126146923	TMEM132B	335762	+	NM_052907	125811169	126139256	9
chr12	126443233	126467920	LINC00939	24687	-	NR_034132	126467920	126467920	6
chr12	126580537	126588478	LOC101927464	7941	+	NR_110053	126588478	126588478	5
chr12	126927026	126957331	LOC100128554	30305	+	NR_130748	126957331	126957331	12
chr12	127137491	127174864	LOC100996671	37373	-	NR_110034	127174864	127174864	3
chr12	127215246	127256808	LINC00944	41562	-	NR_033878	127256808	127256808	5
chr12	127221552	127230800	LINC00943	9248	+	NR_038256	127230800	127230800	4
chr12	127354039	127359236	LOC440117	5197	-	NR_033970	127359236	127359236	3
chr12	127399773	127544942	LOC101927592	145169	-	NR_104646	127544942	127544942	7
chr12	127808699	127824617	LOC101927616	15918	-	NR_110057	127824617	127824617	3
chr12	128115813	128121012	LOC101927637	5199	-	NR_120451	128121012	128121012	4
chr12	128366161	128383184	FLJ37505	17023	+	NR_033987	128383184	128383184	3
chr12	128368534	128468436	LINC00508	99902	-	NR_126452	128468436	128468436	4
chr12	128399954	128436097	LINC00507	36143	+	NR_046392	128436097	128436097	5
chr12	128508332	128511711	CRAT8	3379	-	NR_131985	128511711	128511711	3
chr12	128571527	128602686	LOC100996679	31159	-	NR_104647	128602686	128602686	5
chr12	128602761	128606497	LOC101927694	3736	+	NR_104648	128606497	128606497	3
chr12	128729050	128729118	MIR4419B	68	+	NR_039720	128729118	128729118	1
chr12	128751947	129192460	TMEM132C	440513	+	NM_001136103	128751947	129190840	9
chr12	128778636	128778723	MIR3612	87	+	NR_037406	128778723	128778723	1
chr12	129277738	129308541	SLC15A4	30803	-	NM_145648	129278740	129308488	8
chr12	129337978	129469509	GLT1D1	131531	+	NR_133646	129469509	129469509	11
chr12	129556270	130388212	TMEM132D	831942	-	NM_133448	129558419	130387884	9
chr12	129594234	129597843	LOC283352	3609	+	NR_104172	129597843	129597843	4
chr12	129693145	129697205	LOC101927735	4060	+	NR_110058	129697205	129697205	5
chr12	130518356	130526887	LOC100190940	8531	-	NR_024457	130526887	130526887	3
chr12	130636137	130646223	FZD10-AS1	10086	-	NR_033834	130646223	130646223	4
chr12	130647003	130650285	FZD10	3282	+	NM_007197	130647487	130649233	1
chr12	130822432	130856877	PIWIL1	34445	+	NM_004764	130827136	130856143	21
chr12	130880680	131002410	RIMBP2	121730	-	NM_015347	130883679	130963558	19
chr12	131274144	131323819	STX2	49675	-	NM_194356	131280584	131323644	11
chr12	131356538	131362223	RAN	5685	+	NM_006325	131357138	131360471	7
chr12	131438451	131626008	ADGRD1	187557	+	NM_198827	131439010	131623808	25
chr12	131475170	131478521	LACAT8	3351	-	NR_131950	131478521	131478521	3
chr12	131649555	131697476	LINC01257	47921	+	NR_026670	131697476	131697476	5
chr12	131832014	131852100	LOC338797	20086	+	NR_103736	131852100	131852100	4
chr12	132195631	132284283	SFSWAP	88652	+	NM_001261411	132195774	132284033	19
chr12	132312940	132336316	MMP17	23376	+	NM_016155	132313039	132335819	10
chr12	132379278	132407707	ULK1	28429	+	NM_003565	132379546	132405906	28
chr12	132413744	132428406	PUS1	14662	+	NM_001002020	132414461	132428131	6
chr12	132434464	132565011	EP400	130547	+	NM_015409	132445164	132562218	53
chr12	132515768	132515905	SNORA49	137	+	NR_002979	132515905	132515905	1
chr12	132568827	132610885	EP400NL	42058	+	NR_003290	132610885	132610885	10
chr12	132621139	132628880	DDX51	7741	-	NM_175066	132623816	132628841	15
chr12	132628971	132637018	NOC4L	8047	+	NM_024078	132629033	132636946	15
chr12	132680916	132905905	GALNT9	224989	-	NM_001122636	132681651	132905789	11
chr12	132851976	132857486	LOC100130238	5510	+	NR_024563	132857486	132857486	4
chr12	132906435	132908161	LOC101928416	1726	+	NR_120467	132908161	132908161	2
chr12	133067156	133161773	FBRSL1	94617	+	NM_001142641	133067156	133160364	17
chr12	133158582	133158647	MIR6763	65	+	NR_106821	133158647	133158647	1
chr12	133179735	133187037	LRCOL1	7302	-	NM_001195520	133179987	133182837	6
chr12	133195365	133198972	P2RX2	3607	+	NM_174873	133195402	133198558	12
chr12	133200347	133264110	POLE	63763	-	NM_006231	133201282	133263901	49
chr12	133264191	133281577	PXMP2	17386	+	NM_018663	133264256	133281273	5
chr12	133287392	133299323	PGAM5	11931	+	NM_001170544	133287462	133297414	6
chr12	133302252	133338474	ANKLE2	36222	-	NM_015114	133303827	133338384	13
chr12	133345494	133405288	GOLGA3	59794	-	NM_005895	133349690	133398714	24
chr12	133416937	133464204	CHFR	47267	-	NM_001161345	133418139	133463914	18
chr12	133464427	133465157	LOC101928530	730	+	NR_110919	133465157	133465157	2
chr12	133498018	133532892	ZNF605	34874	-	NM_001164715	133501958	133522221	5
chr12	133562933	133589154	ZNF26	26221	+	NM_001256279	133563426	133588067	5
chr12	133609244	133613808	LOC101928597	4564	-	NR_110091	133613808	133613808	3
chr12	133613871	133639890	ZNF84	26019	+	NM_001289971	133618053	133635518	5
chr12	133656788	133684258	ZNF140	27470	+	NM_001300778	133682172	133683237	6
chr12	133696554	133707059	ZNF891	10505	-	NM_001277291	133696869	133698504	2
chr12	133707213	133736049	ZNF10	28836	+	NM_015394	133721078	133733554	5
chr12	133757994	133783697	ZNF268	25703	+	NM_152943	133758583	133778748	7
chr12	133794897	133812422	ANHX	17525	-	NM_001191054	133795470	133810942	9
chr13	19312239	19314239	LINC00417	2000	-	NR_047508	19314239	19314239	3
chr13	19408542	19446109	ANKRD20A9P	37567	-	NR_027995	19446109	19446109	1
chr13	19479578	19500881	LINC00408	21303	+	NR_104118	19500881	19500881	6
chr13	19582398	19586774	LINC00442	4376	+	NR_026852	19586774	19586774	4
chr13	19747909	19755992	TUBA3C	8083	-	NM_006001	19748002	19755887	5
chr13	19756172	19761605	LOC101928697	5433	+	NR_126054	19761605	19761605	3
chr13	19836939	19919113	ANKRD26P3	82174	-	NR_027248	19919113	19919113	21
chr13	19919188	19920889	LINC00421	1701	+	NR_034026	19920889	19920889	2
chr13	19997018	20135714	TPTE2	138696	-	NR_073485	20135714	20135714	24
chr13	20161257	20162630	LINC00350	1373	+	NR_046988	20162630	20162630	2
chr13	20207787	20247599	MPHOSPH8	39812	+	NM_017520	20207888	20246015	14
chr13	20248891	20357159	PSPC1	108268	-	NR_003272	20357159	20357159	8
chr13	20397623	20437776	ZMYM5	40153	-	NM_001142684	20398616	20426320	8
chr13	20532809	20665984	ZMYM2	133175	+	NM_003453	20567212	20660154	26
chr13	20676839	20677369	LINC01072	530	+	NR_126380	20677369	20677369	2
chr13	20712394	20735183	GJA3	22789	-	NM_021954	20716119	20717427	2
chr13	20761603	20767114	GJB2	5511	-	NM_004004	20763039	20763720	2
chr13	20796100	20806534	GJB6	10434	-	NM_001110219	20796833	20797619	5
chr13	20977805	21100012	CRYL1	122207	-	NM_015974	20978267	21099933	8
chr13	21007916	21007985	MIR4499	69	-	NR_039721	21007985	21007985	1
chr13	21141207	21265576	IFT88	124369	+	NM_175605	21142115	21265314	28
chr13	21277481	21297237	IL17D	19756	+	NM_138284	21278140	21296093	3
chr13	21303072	21348057	N6AMT2	44985	-	NM_174928	21303218	21331737	5
chr13	21351467	21476913	XPO4	125446	-	NM_022459	21357860	21476877	23
chr13	21512702	21523567	LINC00367	10865	-	NR_104058	21523567	21523567	6
chr13	21547175	21635722	LATS2	88547	-	NM_014572	21549008	21620165	8
chr13	21714652	21723224	SAP18	8572	+	NM_005870	21714691	21721481	4
chr13	21727733	21750741	SKA3	23008	-	NM_145061	21729288	21750616	9
chr13	21750371	21753220	MRPL57	2849	+	NM_024026	21751055	21751364	2
chr13	21808706	21809343	LINC01046	637	+	NR_125745	21809343	21809343	2
chr13	21872263	21967061	MIPEPP3	94798	+	NR_046461	21967061	21967061	5
chr13	21877650	21918998	LINC00539	41348	-	NR_103841	21918998	21918998	3
chr13	21946709	22033509	ZDHHC20	86800	-	NR_104486	22033509	22033509	15
chr13	22066827	22178355	MICU2	111528	-	NM_152726	22067387	22178287	12
chr13	22245214	22278640	FGF9	33426	+	NM_002010	22246051	22275574	3
chr13	22446934	22452299	LINC00424	5365	-	NR_047040	22452299	22452299	2
chr13	22784423	22850659	LINC00540	66236	+	NR_103810	22850659	22850659	2
chr13	23471168	23472320	BASP1P1	1152	-	NR_033774	23472320	23472320	1
chr13	23755059	23899304	SGCG	144245	+	NM_000231	23777833	23898680	8
chr13	23902961	24007867	SACS	104906	-	NM_014363	23904274	23985378	10
chr13	23993109	24003008	SACS-AS1	9899	+	NR_103450	24003008	24003008	2
chr13	24043650	24061603	LINC00327	17953	+	NR_038995	24061603	24061603	3
chr13	24144508	24250244	TNFRSF19	105736	+	NM_148957	24164322	24247519	10
chr13	24304327	24463587	MIPEP	159260	-	NM_005932	24304486	24463459	19
chr13	24463027	24466242	C1QTNF9B-AS1	3215	+	NM_001014442	24465665	24466070	4
chr13	24465237	24471641	C1QTNF9B	6404	-	NR_104426	24471641	24471641	6
chr13	24481422	24523454	ANKRD20A19P	42032	-	NR_073430	24523454	24523454	5
chr13	24553764	24881212	SPATA13	327448	+	NM_001286792	24558032	24876911	15
chr13	24736554	24736643	MIR2276	89	+	NR_031753	24736643	24736643	1
chr13	24826886	24828577	SPATA13-AS1	1691	-	NR_046531	24828577	24828577	3
chr13	24881303	24896669	C1QTNF9	15366	+	NM_001303138	24890141	24895906	4
chr13	24905587	24911258	LINC00566	5671	+	NR_131903	24911258	24911258	2
chr13	24995068	25086948	PARP4	91880	-	NM_006437	24995256	25077914	34
chr13	25154345	25171812	TPTE2P6	17467	+	NR_002815	25171812	25171812	9
chr13	25254548	25285923	ATP12A	31375	+	NM_001185085	25254881	25285660	23
chr13	25338300	25454058	RNF17	115758	+	NM_031277	25338341	25453423	36
chr13	25456411	25497027	CENPJ	40616	-	NR_047594	25497027	25497027	18
chr13	25502892	25542607	TPTE2P1	39715	-	NR_026730	25542607	25542607	5
chr13	25670275	25672704	PABPC3	2429	+	NM_030979	25670336	25672232	1
chr13	25735816	25746421	AMER2	10605	-	NM_152704	25743741	25745757	1
chr13	25746961	25754139	LINC00463	7178	-	NR_120428	25754139	25754139	4
chr13	25755469	25764795	LINC01053	9326	+	NR_120427	25764795	25764795	3
chr13	25820340	25861704	MTMR6	41364	-	NM_004685	25823369	25861385	14
chr13	25875665	25916561	NUP58	40896	+	NM_014089	25875911	25914272	16
chr13	25946148	26599989	ATP8A2	653841	+	NM_016529	25946350	26594123	37
chr13	26618734	26625198	SHISA2	6464	-	NM_001007538	26620650	26625113	2
chr13	26706252	26796508	RNF6	90256	-	NM_183045	26706568	26793786	6
chr13	26828755	26978569	CDK8	149814	+	NM_001260	26828778	26978218	13
chr13	27131839	27263082	WASF3	131243	+	NM_001291965	27216407	27259982	10
chr13	27329338	27334922	GPR12	5584	-	NM_005288	27332959	27333964	2
chr13	27640286	27746033	USP12	105747	-	NM_182488	27643419	27745776	9
chr13	27699669	27743272	USP12-AS1	43603	+	NR_046547	27743272	27743272	3
chr13	27746395	27757640	USP12-AS2	11245	+	NR_046548	27757640	27757640	2
chr13	27810418	27811394	LINC00412	976	-	NR_120429	27811394	27811394	2
chr13	27825691	27830702	RPL21	5011	+	NM_000982	27827913	27830662	6
chr13	27825692	27830699	RPL21P28	5007	+	NR_026911	27830699	27830699	6
chr13	27829200	27829272	SNORD102	72	+	NR_002574	27829272	27829272	1
chr13	27829537	27829663	SNORA27	126	+	NR_002575	27829663	27829663	1
chr13	27844463	27847827	RASL11A	3364	+	NM_206827	27845081	27847631	4
chr13	27998680	28009846	GTF3A	11166	+	NM_002097	27998874	28009734	9
chr13	28009775	28024739	MTIF3	14964	-	NM_001166263	28009811	28014585	6
chr13	28120049	28194720	LNX2	74671	-	NM_153371	28122471	28155840	10
chr13	28194879	28241559	POLR1D	46680	+	NM_001206559	28222573	28240090	3
chr13	28366779	28368089	GSX1	1310	+	NM_145657	28366827	28368085	2
chr13	28403895	28495541	PDX1-AS1	91646	-	NR_047484	28495541	28495541	4
chr13	28494167	28500451	PDX1	6284	+	NM_000209	28494275	28498838	2
chr13	28519342	28519710	ATP5EP2	368	+	NR_002162	28519710	28519710	1
chr13	28536204	28543505	CDX2	7301	-	NM_001265	28537251	28543143	3
chr13	28552242	28562774	URAD	10532	-	NM_001105577	28552242	28562774	2
chr13	28577410	28674729	FLT3	97319	-	NR_130706	28674729	28674729	25
chr13	28710979	28713311	PAN3-AS1	2332	-	NR_029383	28713311	28713311	2
chr13	28712642	28869475	PAN3	156833	+	NM_175854	28712794	28866659	19
chr13	28874482	29069265	FLT1	194783	-	NM_002019	28877303	29068980	30
chr13	29233140	29253093	POMP	19953	+	NM_015932	29233321	29252239	6
chr13	29274217	29293150	SLC46A3	18933	-	NM_001135919	29275083	29292135	7
chr13	29598747	30080084	MTUS2	481337	+	NM_001033602	29598805	30077343	14
chr13	30050651	30061887	MTUS2-AS1	11236	-	NR_046378	30061887	30061887	3
chr13	30083550	30169825	SLC7A1	86275	-	NM_003045	30088616	30110325	13
chr13	30338544	30424820	UBL3	86276	-	NM_007106	30341391	30423675	5
chr13	30446749	30462542	LINC00297	15793	-	NR_046510	30462542	30462542	2
chr13	30492783	30500788	LINC00572	8005	-	NR_047501	30500788	30500788	2
chr13	30510667	30524625	LINC00544	13958	+	NR_033889	30524625	30524625	5
chr13	30677314	30683012	LINC00365	5698	-	NR_046998	30683012	30683012	2
chr13	30776766	30881624	KATNAL1	104858	-	NM_032116	30782676	30857914	11
chr13	30914402	30948051	LINC00426	33649	-	NR_024464	30948051	30948051	5
chr13	30993575	30996381	LINC01058	2806	-	NR_125771	30996381	30996381	2
chr13	31032052	31191734	HMGB1	159682	-	NM_001313893	31035493	31037817	5
chr13	31191829	31233686	USPL1	41857	+	NM_005800	31195277	31233493	9
chr13	31287614	31338565	ALOX5AP	50951	+	NM_001204406	31287862	31338243	6
chr13	31377342	31384782	LINC00398	7440	+	NR_047012	31384782	31384782	2
chr13	31456698	31457532	LINC00545	834	+	NR_103813	31457532	31457532	2
chr13	31456971	31506745	TEX26-AS1	49774	-	NR_038287	31506745	31506745	4
chr13	31480311	31499709	MEDAG	19398	+	NM_032849	31480652	31498572	5
chr13	31506833	31549153	TEX26	42320	+	NM_152325	31506852	31549044	7
chr13	31709110	31736525	HSPH1	27415	-	NM_001286504	31711454	31736231	18
chr13	31774111	31906411	B3GLCT	132300	+	NM_194318	31774221	31903805	15
chr13	32313678	32377009	RXFP2	63331	+	NM_130806	32313749	32376542	18
chr13	32420919	32533721	EEF1DP3	112802	+	NR_027062	32533721	32533721	4
chr13	32598195	32605776	FRY-AS1	7581	-	NR_103839	32605776	32605776	4
chr13	32605436	32870776	FRY	265340	+	NM_023037	32605932	32869597	61
chr13	32877907	32886091	ZAR1L	8184	-	NM_001136571	32878015	32886062	4
chr13	32889616	32973809	BRCA2	84193	+	NM_000059	32890597	32972907	27
chr13	32974859	33002315	N4BP2L1	27456	-	NM_001286461	32976016	33002219	6
chr13	33006624	33113022	N4BP2L2	106398	-	NM_033111	33010518	33111164	10
chr13	33070350	33072629	MINOS1P1	2279	-	NR_051980	33072629	33072629	1
chr13	33078642	33083532	N4BP2L2-IT2	4890	-	NR_026928	33083532	33083532	1
chr13	33160563	33352158	PDS5B	191595	+	NM_015032	33222909	33349190	35
chr13	33383327	33485790	LINC00423	102463	-	NR_047020	33485790	33485790	5
chr13	33590570	33640282	KL	49712	+	NM_004795	33590578	33638323	5
chr13	33677271	34250972	STARD13	573701	-	NM_001243476	33679729	34098404	18
chr13	33851690	33855471	STARD13-AS	3781	+	NR_046693	33855471	33855471	3
chr13	34392205	34540695	RFC3	148490	+	NM_181558	34392315	34540262	9
chr13	35009590	35214822	LINC00457	205232	-	NR_047036	35214822	35214822	3
chr13	35516423	36246873	NBEA	730450	+	NM_015678	35516957	36245128	58
chr13	36047925	36050832	MAB21L1	2907	-	NM_005584	36049195	36050275	1
chr13	36048405	36515382	MIR548F5	466977	-	NR_031646	36515382	36515382	5
chr13	36271863	36273392	LINC00445	1529	+	NR_132115	36273392	36273392	2
chr13	36342788	36705514	DCLK1	362726	-	NM_004734	36348778	36700274	18
chr13	36742344	36788752	SOHLH2	46408	-	NM_017826	36743170	36788663	11
chr13	36742344	36871992	CCDC169-SOHLH2	129648	-	NM_001198910	36743170	36857743	16
chr13	36801178	36871992	CCDC169	70814	-	NM_001198908	36801337	36871856	8
chr13	36875774	36944317	SPG20	68543	-	NM_001142294	36878501	36909967	9
chr13	36920567	36943872	SPG20-AS1	23305	+	NR_045180	36943872	36943872	6
chr13	37005966	37017019	CCNA1	11053	+	NM_001111047	37007193	37016802	9
chr13	37248048	37271975	SERTM1	23927	+	NM_203451	37269215	37269539	2
chr13	37393338	37403740	RFXAP	10402	+	NM_000538	37393494	37401890	3
chr13	37418967	37494409	SMAD9	75442	-	NM_001127217	37422812	37453826	7
chr13	37523907	37573504	ALG5	49597	-	NM_013338	37524078	37573437	10
chr13	37574677	37583751	EXOSC8	9074	+	NM_181503	37574942	37583436	11
chr13	37583450	37633850	SUPT20H	50400	-	NM_001014286	37583808	37625627	26
chr13	37677396	37679801	CSNK1A1L	2405	-	NM_145203	37678379	37679393	1
chr13	38055600	38058921	LINC01048	3321	-	NR_125762	38058921	38058921	4
chr13	38109076	38125673	LINC00547	16597	+	NR_040244	38125673	38125673	5
chr13	38136718	38172981	POSTN	36263	-	NM_006475	38137469	38172863	23
chr13	38210772	38443939	TRPC4	233167	-	NM_001135955	38211039	38357470	12
chr13	38624953	38717369	LINC00571	92416	-	NR_047500	38717369	38717369	6
chr13	38923907	38937144	UFM1	13237	+	NM_001286705	38924056	38934203	7
chr13	39106136	39260812	LINC00437	154676	-	NR_126377	39260812	39260812	3
chr13	39141860	39153653	LINC00366	11793	+	NR_046999	39153653	39153653	4
chr13	39261172	39461267	FREM2	200095	+	NM_207361	39261481	39454924	24
chr13	39540061	39564996	STOML3	24935	-	NM_001144033	39540961	39554213	8
chr13	39584001	39612213	PROSER1	28212	-	NM_025138	39585501	39611379	13
chr13	39612447	39624244	NHLRC3	11797	+	NM_001012754	39612776	39622063	7
chr13	39917028	40177356	LHFP	260328	-	NM_005780	39918072	40175353	4
chr13	40229763	40365802	COG6	136039	+	NM_001145079	40229863	40362493	19
chr13	40238170	40238272	MIR4305	102	-	NR_036190	40238272	40238272	1
chr13	40755945	40763167	LINC00332	7222	+	NR_046870	40763167	40763167	4
chr13	40768645	40794639	LINC00548	25994	-	NR_033877	40794639	40794639	6
chr13	40921270	41055143	LINC00598	133873	-	NR_024507	41055143	41055143	7
chr13	41129800	41240734	FOXO1	110934	-	NM_002015	41133659	41240349	3
chr13	41301963	41302011	MIR320D1	48	-	NR_031723	41302011	41302011	1
chr13	41303431	41345347	MRPS31	41916	-	NM_005830	41303507	41345272	7
chr13	41363546	41386596	SLC25A15	23050	+	NM_014252	41367362	41383803	7
chr13	41371120	41495886	TPTE2P5	124766	-	NR_038258	41495886	41495886	8
chr13	41384901	41384997	MIR621	96	+	NR_030352	41384997	41384997	1
chr13	41486024	41495910	SUGT1P3	9886	-	NR_003365	41495910	41495910	3
chr13	41506054	41593508	ELF1	87454	-	NM_172373	41507560	41556190	9
chr13	41635696	41658139	WBP4	22443	+	NM_007187	41635809	41657050	10
chr13	41675154	41675236	MIR3168	82	-	NR_036127	41675236	41675236	1
chr13	41701708	41706936	KBTBD6	5228	-	NM_152903	41704622	41706647	1
chr13	41707063	41810822	LOC101929140	103759	+	NR_120423	41810822	41810822	4
chr13	41765710	41768702	KBTBD7	2992	-	NM_032138	41766338	41768393	1
chr13	41790515	41837713	MTRF1	47198	-	NM_004294	41791250	41835043	10
chr13	41885340	41951166	NAA16	65826	+	NM_024561	41885664	41949738	20
chr13	42016699	42017902	OR7E37P	1203	+	NR_002163	42017902	42017902	1
chr13	42031541	42045013	RGCC	13472	+	NM_014059	42031843	42044621	5
chr13	42140960	42535221	VWA8	394261	-	NM_015058	42142332	42535151	45
chr13	42142421	42142531	MIR5006	110	-	NR_049803	42142531	42142531	1
chr13	42535304	42555701	VWA8-AS1	20397	+	NR_039974	42555701	42555701	4
chr13	42614171	42817033	DGKH	202862	+	NM_001204504	42622909	42803287	30
chr13	42846288	42897403	AKAP11	51115	+	NM_016248	42860484	42893364	13
chr13	43136871	43182149	TNFSF11	45278	+	NM_033012	43155261	43181054	7
chr13	43355685	43365685	FAM216B	10000	+	NM_182508	43358203	43362926	4
chr13	43384501	43386698	LINC01050	2197	-	NR_125747	43386698	43386698	3
chr13	43416547	43446880	LINC00428	30333	-	NR_126389	43446880	43446880	5
chr13	43460523	43566407	EPSTI1	105884	-	NM_001002264	43462385	43566301	13
chr13	43597361	43683306	DNAJC15	85945	+	NM_013238	43597762	43681384	6
chr13	43687300	43733602	LINC00400	46302	+	NR_047013	43733602	43733602	3
chr13	43787665	44361116	ENOX1	573451	-	NM_001242863	43788125	43987050	17
chr13	44022987	44033624	ENOX1-AS2	10637	+	NR_120399	44033624	44033624	4
chr13	44410488	44453826	CCDC122	43338	-	NM_144974	44411415	44443512	7
chr13	44453419	44468068	LACC1	14649	+	NM_001128303	44455121	44464409	7
chr13	44596470	44604599	LINC00284	8129	+	NR_026955	44604599	44604599	3
chr13	44680226	44721871	LINC00390	41645	-	NR_132368	44721871	44721871	4
chr13	44684684	44728211	SMIM2-AS1	43527	+	NR_104065	44728211	44728211	5
chr13	44717286	44735393	SMIM2	18107	-	NM_024058	44718053	44734991	3
chr13	44720605	44732358	SMIM2-IT1	11753	-	NR_046843	44732358	44732358	3
chr13	44770264	44770336	MIR8079	72	-	NR_107046	44770336	44770336	1
chr13	44947977	44971850	SERP2	23873	+	NM_001010897	44948161	44971448	3
chr13	44974385	44980120	TUSC8	5735	-	NR_104174	44980120	44980120	2
chr13	45006278	45150701	TSC22D1	144423	-	NM_183422	45008761	45150210	3
chr13	45150031	45154568	TSC22D1-AS1	4537	+	NR_038381	45154568	45154568	3
chr13	45373639	45383766	LINC00330	10127	-	NR_038433	45383766	45383766	3
chr13	45513383	45563613	NUFIP1	50230	-	NM_012345	45515340	45563571	10
chr13	45563664	45607743	GPALPP1	44079	+	NM_001316952	45583096	45602138	9
chr13	45680413	45687341	LOC101929259	6928	+	NR_120424	45687341	45687341	3
chr13	45694630	45858239	GTF2F2	163609	+	NM_004128	45694790	45857696	8
chr13	45766987	45775175	KCTD4	8188	-	NM_198404	45767922	45768702	2
chr13	45907605	45915419	TPT1	7814	-	NM_003295	45911520	45915204	6
chr13	45911614	45911744	SNORA31	130	-	NR_002967	45911744	45911744	1
chr13	45915479	45965618	TPT1-AS1	50139	+	NR_024458	45965618	45965618	11
chr13	45967453	45992590	SLC25A30	25137	-	NM_001010875	45970108	45985560	10
chr13	45992296	45994506	SLC25A30-AS1	2210	+	NR_047031	45994506	45994506	2
chr13	46039029	46110833	COG3	71804	+	NM_031431	46039171	46108866	23
chr13	46115431	46189874	ERICH6B	74443	-	NM_182542	46115596	46171140	15
chr13	46255333	46275319	LINC01055	19986	-	NR_125786	46275319	46275319	4
chr13	46276438	46288694	SPERT	12256	+	NM_152719	46276525	46288507	3
chr13	46354415	46425846	SIAH3	71431	-	NM_198849	46357517	46425764	2
chr13	46536313	46626896	ZC3H13	90583	-	NM_015070	46537956	46619642	17
chr13	46626982	46675482	CPB2-AS1	48500	+	NR_046226	46675482	46675482	4
chr13	46627321	46679211	CPB2	51890	-	NM_001872	46627748	46679144	11
chr13	46700057	46756459	LCP1	56402	-	NM_002298	46701725	46733797	16
chr13	46786077	46850938	LRRC63	64861	+	NM_001282460	46787169	46850938	10
chr13	46870579	46871979	LINC00563	1400	-	NR_047493	46871979	46871979	1
chr13	46916134	46964177	KIAA0226L	48043	-	NM_001286761	46917519	46946610	15
chr13	47029338	47040911	LINC01198	11573	-	NR_120426	47040911	47040911	6
chr13	47127295	47327175	LRCH1	199880	+	NM_001164213	47127531	47324785	19
chr13	47345390	47371367	ESD	25977	-	NM_001984	47345550	47365548	10
chr13	47405676	47471211	HTR2A	65535	-	NM_000621	47408971	47470041	4
chr13	47426274	47430434	HTR2A-AS1	4160	+	NR_046612	47430434	47430434	3
chr13	48504287	48506757	LINC00562	2470	-	NR_047492	48506757	48506757	1
chr13	48516790	48575462	SUCLA2	58672	-	NM_003850	48517505	48575405	11
chr13	48611702	48621358	NUDT15	9656	+	NM_018283	48611882	48619935	3
chr13	48649863	48669277	MED4	19414	-	NM_014166	48651274	48669214	7
chr13	48651272	48654129	MED4-AS1	2857	+	NR_046511	48654129	48654129	3
chr13	48807273	48836232	ITM2B	28959	+	NM_021999	48807496	48835360	6
chr13	48870648	48877797	LINC00441	7149	-	NR_046414	48877797	48877797	3
chr13	48877882	49056026	RB1	178144	+	NM_000321	48878048	49054207	27
chr13	48985181	49018840	LPAR6	33659	-	NM_005767	48985524	48986559	7
chr13	49063098	49107392	RCBTB2	44294	-	NM_001268	49064246	49096075	15
chr13	49151109	49155037	LINC00462	3928	-	NR_051983	49155037	49155037	3
chr13	49227846	49283498	CYSLTR2	55652	+	NM_001308467	49280953	49281994	6
chr13	49550047	49783915	FNDC3A	233868	+	NM_001079673	49580326	49781531	26
chr13	49794473	49796513	MLNR	2040	+	NM_001507	49794473	49796513	2
chr13	49822046	49867622	CDADC1	45576	+	NM_001193478	49822173	49866918	10
chr13	49882785	50018262	CAB39L	135477	-	NM_001287337	49884949	49957046	12
chr13	50018428	50069139	SETDB2	50711	+	NM_031915	50026029	50065985	15
chr13	50069800	50103117	PHF11	33317	+	NM_001040443	50070137	50102801	10
chr13	50106081	50159719	RCBTB1	53638	-	NM_018191	50108257	50141415	13
chr13	50202434	50208008	ARL11	5574	+	NM_138450	50204583	50205174	2
chr13	50234811	50265623	EBPL	30812	-	NM_001278636	50236038	50265560	5
chr13	50273442	50367057	KPNA3	93615	-	NM_002267	50275935	50366642	17
chr13	50464544	50467516	CTAGE10P	2972	+	NR_003268	50467516	50467516	1
chr13	50486837	50510637	SPRYD7	23800	-	NM_020456	50489198	50510371	5
chr13	50556687	50699677	DLEU2	142990	-	NR_002612	50699677	50699677	11
chr13	50570550	50570637	MIR3613	87	-	NR_037407	50570637	50570637	1
chr13	50571142	50592603	TRIM13	21461	+	NM_001007278	50575241	50587300	4
chr13	50589389	50595058	KCNRG	5669	+	NM_199464	50589629	50594363	3
chr13	50623108	50623197	MIR16-1	89	-	NR_029486	50623197	50623197	1
chr13	50623254	50623337	MIR15A	83	-	NR_029485	50623337	50623337	1
chr13	50656304	51102779	DLEU1	446475	+	NR_109974	51102779	51102779	7
chr13	50746153	50747751	ST13P4	1598	+	NR_002183	50747751	50747751	1
chr13	51095068	51101585	DLEU1-AS1	6517	-	NR_125753	51101585	51101585	3
chr13	51285161	51418075	DLEU7	132914	-	NM_198989	51287352	51417782	2
chr13	51381990	51424041	DLEU7-AS1	42051	+	NR_046551	51424041	51424041	5
chr13	51456514	51484848	RNASEH2B-AS1	28334	-	NR_046552	51484848	51484848	3
chr13	51483813	51544596	RNASEH2B	60783	+	NM_001142279	51484212	51544100	10
chr13	51568646	51640293	GUCY1B2	71647	-	NR_003923	51640293	51640293	17
chr13	51656983	51746524	LINC00371	89541	-	NR_102431	51746524	51746524	5
chr13	51796469	51858377	FAM124A	61908	+	NM_145019	51796637	51855392	5
chr13	51915167	51936239	SERPINE3	21072	+	NM_001101320	51915227	51936133	7
chr13	51922702	51922775	MIR5693	73	-	NR_049878	51922775	51922775	1
chr13	51935700	52027275	INTS6	91575	-	NM_001306091	51939887	51969514	20
chr13	52027480	52028851	INTS6-AS1	1371	+	NR_103812	52028851	52028851	2
chr13	52126724	52126803	MIR4703	79	+	NR_039852	52126803	52126803	1
chr13	52158483	52336171	WDFY2	177688	+	NM_052950	52158823	52333905	12
chr13	52342128	52378298	DHRS12	36170	-	NM_001270424	52342322	52378245	10
chr13	52387482	52419286	LINC00282	31804	-	NR_027047	52419286	52419286	5
chr13	52436116	52440372	CCDC70	4256	+	NM_031290	52439514	52440216	2
chr13	52506805	52585630	ATP7B	78825	-	NM_001243182	52508891	52585473	22
chr13	52586522	52603780	ALG11	17258	+	NM_001004127	52586554	52602726	4
chr13	52598826	52607736	UTP14C	8910	+	NM_021645	52602940	52605241	2
chr13	52638899	52703228	NEK5	64329	-	NM_199289	52639542	52701618	22
chr13	52703030	52706859	LOC101929657	3829	+	NR_110306	52706859	52706859	2
chr13	52706778	52733996	NEK3	27218	-	NM_002498	52707277	52730326	16
chr13	52741844	52768602	MRPS31P5	26758	-	NR_002816	52768602	52768602	9
chr13	52908429	52916018	LOC103191607	7589	+	NR_120400	52916018	52916018	3
chr13	52951302	52980629	THSD1	29327	-	NM_018676	52951545	52976735	5
chr13	52986736	53024813	VPS36	38077	-	NM_001282168	52989964	53024729	14
chr13	53029494	53050766	CKAP2	21272	+	NM_001098525	53029691	53049276	9
chr13	53063127	53161225	TPTE2P3	98098	+	NR_002793	53161225	53161225	24
chr13	53191604	53217919	HNRNPA1L2	26315	+	NM_001011724	53216627	53217590	7
chr13	53226830	53262433	SUGT1	35603	+	NM_001130912	53227055	53261970	14
chr13	53277399	53313947	LECT1	36548	-	NM_001011705	53277729	53313836	7
chr13	53384184	53384275	MIR759	91	+	NR_031582	53384275	53384275	1
chr13	53418108	53422775	PCDH8	4667	-	NM_002590	53418694	53422571	3
chr13	53602875	53626196	OLFM4	23321	+	NM_006418	53602971	53624906	5
chr13	53705880	53726035	LINC01065	20155	-	NR_125788	53726035	53726035	5
chr13	54389553	54450254	LINC00558	60701	+	NR_047488	54450254	54450254	6
chr13	54698458	54707006	LINC00458	8548	-	NR_108062	54707006	54707006	4
chr13	54886106	54886183	MIR1297	77	-	NR_031628	54886183	54886183	1
chr13	55748588	55748683	MIR5007	95	+	NR_049804	55748683	55748683	1
chr13	57715051	57718073	PRR20B	3022	+	NM_001130404	57715438	57717125	3
chr13	57715051	57718073	PRR20D	3022	+	NM_001130406	57715438	57717125	3
chr13	57728194	57731216	PRR20A	3022	+	NM_198441	57728581	57730268	3
chr13	57741330	57744352	PRR20C	3022	+	NM_001130405	57741717	57743404	3
chr13	57741330	57744352	PRR20E	3022	+	NM_001130407	57741717	57743404	3
chr13	58205788	58303065	PCDH17	97277	+	NM_001040429	58206680	58299428	4
chr13	58739960	58783617	LOC101926897	43657	+	NR_120416	58783617	58783617	3
chr13	58785830	58807251	LINC00374	21421	-	NR_132367	58807251	58807251	7
chr13	60239720	60738119	DIAPH3	498399	-	NM_001258366	60240717	60737900	27
chr13	60586851	60618490	DIAPH3-AS1	31639	+	NR_109838	60618490	60618490	5
chr13	60718831	60727639	DIAPH3-AS2	8808	+	NR_046540	60727639	60727639	3
chr13	60788480	60842238	LINC00434	53758	-	NR_047022	60842238	60842238	3
chr13	60970590	61148013	TDRD3	177423	+	NM_030794	61034600	61141775	14
chr13	61247088	61269934	LINC00378	22846	+	NR_047003	61269934	61269934	5
chr13	61773931	61774014	MIR3169	83	-	NR_036128	61774014	61774014	1
chr13	61983818	61989655	PCDH20	5837	-	NM_022843	61985375	61989291	2
chr13	62577657	62603681	LINC00358	26024	-	NR_046995	62603681	62603681	2
chr13	62786414	62824084	LINC01075	37670	+	NR_125787	62824084	62824084	4
chr13	63246417	63370825	LINC00448	124408	-	NR_047029	63370825	63370825	8
chr13	63757234	63902227	LINC00376	144993	-	NR_126409	63902227	63902227	7
chr13	64241814	64312151	LINC00395	70337	-	NR_047011	64312151	64312151	4
chr13	64311567	64316701	OR7E156P	5134	+	NR_002171	64316701	64316701	4
chr13	64402972	64418258	LOC102723968	15286	-	NR_130763	64418258	64418258	6
chr13	66440178	66452351	LINC01052	12173	+	NR_132362	66452351	66452351	3
chr13	66540461	66540561	MIR548X2	100	-	NR_039692	66540561	66540561	1
chr13	66792381	66792456	MIR4704	75	+	NR_039853	66792456	66792456	1
chr13	66876965	67804468	PCDH9	927503	-	NM_203487	66878786	67802572	5
chr13	67399300	67489163	PCDH9-AS2	89863	+	NR_046527	67489163	67489163	6
chr13	67551520	67559908	PCDH9-AS3	8388	+	NR_046636	67559908	67559908	3
chr13	67565017	67576132	PCDH9-AS4	11115	+	NR_046637	67576132	67576132	3
chr13	67946518	67954126	LINC00364	7608	+	NR_130792	67954126	67954126	3
chr13	69435416	69459457	LINC00550	24041	-	NR_038878	69459457	69459457	3
chr13	69796477	69896231	LINC00383	99754	+	NR_125752	69896231	69896231	4
chr13	70274724	70682625	KLHL1	407901	-	NM_020866	70275833	70681831	11
chr13	70681344	70713885	ATXN8OS	32541	+	NR_002717	70713885	70713885	5
chr13	71589272	71742549	LINC00348	153277	+	NR_047699	71742549	71742549	4
chr13	72012097	72441330	DACH1	429233	-	NM_080759	72014786	72440907	11
chr13	73282494	73301938	MZT1	19444	-	NM_001071775	73284459	73301740	3
chr13	73301886	73330336	BORA	28450	+	NM_024808	73301980	73329354	12
chr13	73329539	73356266	DIS3	26727	-	NM_001128226	73333932	73355970	21
chr13	73356229	73590591	PIBF1	234362	+	NM_006346	73357607	73590057	18
chr13	73629113	73651680	KLF5	22567	+	NM_001286818	73636010	73650024	4
chr13	74138380	74162016	LINC00392	23636	+	NR_047009	74162016	74162016	3
chr13	74260148	74708066	KLF12	447918	-	NM_007249	74269626	74569159	8
chr13	74993309	75009296	LINC00381	15987	+	NR_047005	75009296	75009296	5
chr13	75126979	75131257	LINC00347	4278	+	NR_034025	75131257	75131257	3
chr13	75811888	75814517	CTAGE11P	2629	-	NR_027466	75814517	75814517	1
chr13	75814723	75826148	LINC01078	11425	+	NR_132375	75826148	75826148	3
chr13	75858799	76056304	TBC1D4	197505	-	NM_014832	75860927	76055903	21
chr13	76099354	76123575	COMMD6	24221	-	NM_001287394	76100724	76104375	3
chr13	76123615	76180156	UCHL3	56541	+	NM_001270952	76134942	76179948	9
chr13	76178835	76210130	LMO7-AS1	31295	-	NR_120410	76210130	76210130	4
chr13	76194569	76434006	LMO7	239437	+	NM_005358	76195829	76432079	30
chr13	76445173	76457948	LMO7DN	12775	+	NM_001257995	76445262	76457238	4
chr13	76451021	76455261	LMO7DN-IT1	4240	+	NR_126373	76455261	76455261	4
chr13	77454303	77460540	KCTD12	6237	-	NM_138444	77459305	77460283	1
chr13	77502584	77503224	BTF3P11	640	+	NR_026983	77503224	77503224	1
chr13	77526623	77532776	IRG1	6153	+	NM_001258406	77526623	77532120	4
chr13	77566058	77576652	CLN5	10594	+	NM_006493	77566086	77575104	4
chr13	77579388	77601331	FBXL3	21943	-	NM_012158	77581279	77595995	5
chr13	77618791	77901177	MYCBP2	282386	-	NM_015057	77619512	77900910	83
chr13	77649648	77661911	MYCBP2-AS1	12263	+	NR_046716	77661911	77661911	4
chr13	78109808	78219398	SCEL	109590	+	NM_144777	78130010	78218409	33
chr13	78173890	78180686	SCEL-AS1	6796	-	NR_126412	78180686	78180686	4
chr13	78235508	78236938	LOC100129307	1430	-	NM_001310140	78235510	78236761	1
chr13	78271988	78338377	SLAIN1	66389	+	NM_001242868	78272048	78337355	7
chr13	78272146	78272251	MIR3665	105	-	NR_037438	78272251	78272251	1
chr13	78393071	78482563	EDNRB-AS1	89492	+	NR_103853	78482563	78482563	7
chr13	78469615	78549664	EDNRB	80049	-	NM_000115	78472334	78492708	8
chr13	78553900	78568908	LINC01069	15008	-	NR_108076	78568908	78568908	3
chr13	78587017	78627730	LINC00446	40713	+	NR_047028	78627730	78627730	6
chr13	78628989	79191460	RNF219-AS1	562471	+	NR_047001	79191460	79191460	6
chr13	79173229	79177695	POU4F1	4466	-	NM_006237	79175549	79177461	2
chr13	79188420	79233314	RNF219	44894	-	NM_024546	79189714	79233255	6
chr13	79361453	79414185	LINC00331	52732	-	NR_046869	79414185	79414185	5
chr13	79893002	79980356	RBM26	87354	-	NM_001286631	79894755	79979909	22
chr13	79980443	79998468	RBM26-AS1	18025	+	NR_038991	79998468	79998468	7
chr13	80051498	80055366	NDFIP2-AS1	3868	-	NR_046685	80055366	80055366	3
chr13	80055258	80130212	NDFIP2	74954	+	NM_019080	80055338	80125255	8
chr13	80140861	80145581	LINC01068	4720	+	NR_125772	80145581	80145581	3
chr13	80378520	80379817	LINC01038	1297	+	NR_125785	80379817	80379817	2
chr13	80446720	80492171	LINC00382	45451	+	NR_120413	80492171	80492171	6
chr13	80585211	80600798	LINC01080	15587	+	NR_104138	80600798	80600798	2
chr13	80910111	80915086	SPRY2	4975	-	NM_005842	80910892	80911840	2
chr13	81592525	81618577	LINC00377	26052	+	NR_125770	81618577	81618577	4
chr13	81800000	81801118	LINC00564	1118	-	NR_047494	81801118	81801118	1
chr13	84451339	84456528	SLITRK1	5189	-	NM_001281503	84453551	84455642	2
chr13	84714736	85180903	LINC00333	466167	+	NR_046871	85180903	85180903	7
chr13	85357788	85357913	SNORA107	125	+	NR_132852	85357913	85357913	1
chr13	85639221	85722192	LINC00375	82971	-	NR_126383	85722192	85722192	6
chr13	85937737	86118797	LINC00351	181060	+	NR_046989	86118797	86118797	4
chr13	86366921	86373483	SLITRK6	6562	-	NM_032229	86368117	86370643	2
chr13	87564174	87589062	LINC00430	24888	+	NR_132371	87589062	87589062	2
chr13	88096241	88323218	MIR4500HG	226977	-	NR_033829	88323218	88323218	6
chr13	88270919	88270995	MIR4500	76	-	NR_039722	88270995	88270995	1
chr13	88324869	88331870	SLITRK5	7001	+	NM_015567	88327643	88330520	2
chr13	88453297	88462775	LINC00397	9478	-	NR_104059	88462775	88462775	4
chr13	88795121	88888337	LOC105370306	93216	+	NR_131919	88888337	88888337	5
chr13	89193083	89197764	LINC00433	4681	+	NR_047021	89197764	89197764	3
chr13	89867101	89889144	LINC01047	22043	-	NR_131229	89889144	89889144	5
chr13	89887544	89932494	LINC00440	44950	+	NR_047025	89932494	89932494	4
chr13	90129860	90152763	LINC01040	22903	-	NR_131228	90152763	90152763	2
chr13	90201047	90216667	LINC00353	15620	-	NR_046991	90216667	90216667	4
chr13	90712500	90771971	LINC00559	59471	-	NR_047489	90771971	90771971	6
chr13	90883435	90883531	MIR622	96	+	NR_030754	90883531	90883531	1
chr13	91145541	91187595	LINC01049	42054	+	NR_120414	91187595	91187595	6
chr13	91543207	91578851	LINC00410	35644	-	NR_027039	91578851	91578851	6
chr13	91739508	91743693	LINC00380	4185	-	NR_104057	91743693	91743693	3
chr13	91779866	91863952	LINC00379	84086	-	NR_047004	91863952	91863952	4
chr13	92000073	92006829	MIR17HG	6756	+	NR_027349	92006829	92006829	4
chr13	92002858	92002942	MIR17	84	+	NR_029487	92002942	92002942	1
chr13	92003004	92003075	MIR18A	71	+	NR_029488	92003075	92003075	1
chr13	92003144	92003226	MIR19A	82	+	NR_029489	92003226	92003226	1
chr13	92003318	92003389	MIR20A	71	+	NR_029492	92003389	92003389	1
chr13	92003445	92003532	MIR19B1	87	+	NR_029490	92003532	92003532	1
chr13	92003567	92003645	MIR92A1	78	+	NR_029508	92003645	92003645	1
chr13	92050872	93519487	GPC5	1468615	+	NM_004466	92051300	93518692	8
chr13	92992046	93004460	GPC5-AS2	12414	-	NR_120382	93004460	93004460	3
chr13	93353641	93373867	GPC5-AS1	20226	-	NR_046520	93373867	93373867	4
chr13	93697593	93710179	LINC00363	12586	+	NR_126360	93710179	93710179	4
chr13	93879077	95060273	GPC6	1181196	+	NM_005708	93879709	95055471	9
chr13	94470676	94510726	GPC6-AS2	40050	-	NR_046536	94510726	94510726	7
chr13	94806446	94840245	GPC6-AS1	33799	-	NR_046535	94840245	94840245	4
chr13	95091840	95131936	DCT	40096	-	NM_001129889	95092151	95131509	10
chr13	95226307	95248529	TGDS	22222	-	NM_014305	95227035	95248390	12
chr13	95254103	95286899	GPR180	32796	+	NM_180989	95254181	95279425	9
chr13	95356997	95360740	LOC101927248	3743	-	NR_120417	95360740	95360740	3
chr13	95361878	95364797	SOX21	2919	-	NM_007084	95363472	95364303	1
chr13	95364969	95368199	SOX21-AS1	3230	+	NR_046514	95368199	95368199	2
chr13	95413194	95587664	LOC101927284	174470	+	NR_110754	95587664	95587664	5
chr13	95612294	95613573	LINC00557	1279	+	NR_047487	95613573	95613573	1
chr13	95672082	95953700	ABCC4	281618	-	NM_005845	95673828	95953568	31
chr13	96085852	96232010	CLDN10	146158	+	NM_001160100	96086087	96230268	5
chr13	96131697	96186164	CLDN10-AS1	54467	-	NR_046533	96186164	96186164	4
chr13	96230455	96296960	DZIP1	66505	-	NM_198968	96234487	96294283	23
chr13	96325091	96329179	DNAJC3-AS1	4088	-	NR_132117	96329179	96329179	2
chr13	96329392	96447243	DNAJC3	117851	+	NM_006260	96329509	96443284	12
chr13	96453835	96705736	UGGT2	251901	-	NM_020121	96454043	96705566	39
chr13	96743092	97491816	HS6ST3	748724	+	NM_153456	96743116	97485452	2
chr13	97079482	97079546	MIR4501	64	+	NR_039723	97079546	97079546	1
chr13	97593534	97636426	LINC00359	42892	-	NR_051966	97636426	97636426	3
chr13	97637972	97646604	OXGR1	8632	-	NM_080818	97638999	97640013	4
chr13	97824635	97831876	LINC00456	7241	-	NR_125725	97831876	97831876	2
chr13	97874542	98046374	MBNL2	171832	+	NM_001306070	97928489	98043703	8
chr13	98086474	98120252	RAP2A	33778	+	NM_021033	98086724	98116696	2
chr13	98605928	98676550	IPO5	70622	+	NM_002271	98622034	98674076	29
chr13	98794815	99102027	FARP1	307212	+	NM_001286839	98865496	99100571	28
chr13	98828038	98829521	RNF113B	1483	-	NM_178861	98828416	98829490	2
chr13	98860777	98860854	MIR3170	77	+	NR_036129	98860854	98860854	1
chr13	99102452	99229405	STK24	126953	-	NM_001032296	99105426	99229040	11
chr13	99336054	99404929	SLC15A1	68875	-	NM_005073	99336977	99404852	23
chr13	99445740	99738660	DOCK9	292920	-	NM_015296	99447001	99738605	56
chr13	99484337	99486883	DOCK9-AS1	2546	+	NR_046663	99486883	99486883	3
chr13	99738976	99740879	DOCK9-AS2	1903	+	NR_047482	99740879	99740879	1
chr13	99848627	99853011	UBAC2-AS1	4384	-	NR_036531	99853011	99853011	2
chr13	99852678	100038753	UBAC2	186075	+	NM_001144072	99853162	100037589	9
chr13	99868261	100058554	MIR548AN	190293	-	NR_039765	100058554	100058554	5
chr13	99906966	99910682	GPR18	3716	-	NM_005292	99907130	99908126	3
chr13	99946788	99959749	GPR183	12961	-	NM_004951	99947313	99948399	2
chr13	100003673	100004281	FKSG29	608	+	NR_024013	100004281	100004281	1
chr13	100008384	100008482	MIR623	98	+	NR_030353	100008482	100008482	1
chr13	100139215	100151560	LINC01232	12345	-	NR_110731	100151560	100151560	5
chr13	100151976	100153317	LINC00449	1341	-	NR_133664	100153317	100153317	2
chr13	100153627	100216302	TM9SF2	62675	+	NM_004800	100153860	100215012	17
chr13	100229365	100238233	LINC01039	8868	+	NR_126390	100238233	100238233	4
chr13	100258917	100561713	CLYBL	302796	+	NR_104592	100561713	100561713	10
chr13	100295312	100295403	MIR4306	91	+	NR_036191	100295403	100295403	1
chr13	100342351	100343225	CLYBL-AS2	874	-	NR_046526	100343225	100343225	2
chr13	100377923	100381255	CLYBL-AS1	3332	-	NR_120383	100381255	100381255	3
chr13	100393123	100609419	LOC101927437	216296	-	NR_120421	100609419	100609419	5
chr13	100615274	100624178	ZIC5	8904	-	NM_033132	100617630	100623929	2
chr13	100634025	100639019	ZIC2	4994	+	NM_007129	100634318	100637936	3
chr13	100647153	100650163	LINC00554	3010	-	NR_047483	100650163	100650163	1
chr13	100738284	100741197	LOC105370333	2913	-	NR_132422	100741197	100741197	2
chr13	100741268	101182691	PCCA	441423	+	NM_000282	100741374	101182420	24
chr13	101116690	101133269	PCCA-AS1	16579	-	NR_047686	101133269	101133269	5
chr13	101182417	101241046	GGACT	58629	-	NM_001195087	101184383	101184845	3
chr13	101256089	101327189	TMTC4	71100	-	NM_032813	101257247	101322616	19
chr13	101360578	101711638	NALCN-AS1	351060	+	NR_047687	101711638	101711638	8
chr13	101591774	101596618	LINC00411	4844	-	NR_047015	101596618	101596618	3
chr13	101706129	102068813	NALCN	362684	-	NM_052867	101707646	102051477	44
chr13	102104943	102373207	ITGBL1	268264	+	NM_001271754	102220156	102368004	11
chr13	102373204	103054124	FGF14	680920	-	NM_175929	102375180	103054028	5
chr13	102619991	102620096	MIR2681	105	-	NR_039603	102620096	102620096	1
chr13	102698283	102698354	MIR4705	71	-	NR_039854	102698354	102698354	1
chr13	102944669	103046869	FGF14-IT1	102200	-	NR_036486	103046869	103046869	4
chr13	103019879	103026016	FGF14-AS1	6137	+	NR_125912	103026016	103026016	2
chr13	103046927	103048055	FGF14-AS2	1128	+	NR_036487	103048055	103048055	1
chr13	103249285	103331523	TPP2	82238	+	NM_003291	103249388	103330666	29
chr13	103338096	103346871	METTL21C	8775	-	NM_001010977	103338380	103346848	4
chr13	103381716	103411422	CCDC168	29706	-	NM_001146197	103381800	103411282	4
chr13	103418237	103426171	TEX30	7934	-	NM_138779	103418750	103422376	6
chr13	103436630	103451404	KDELC1	14774	-	NM_024089	103436844	103451020	10
chr13	103451398	103493888	BIVM	42490	+	NM_017693	103459617	103492215	11
chr13	103459495	103528351	BIVM-ERCC5	68856	+	NM_001204425	103459617	103528253	23
chr13	103498190	103528351	ERCC5	30161	+	NM_000123	103498616	103528253	15
chr13	103532448	103548383	METTL21EP	15935	+	NR_026965	103548383	103548383	4
chr13	103696347	103719196	SLC10A2	22849	-	NM_000452	103698482	103718599	6
chr13	103934828	103934848	MIR548AS	20	-	NR_049840	103934848	103934848	1
chr13	104077549	104080035	LINC01309	2486	+	NR_126374	104080035	104080035	2
chr13	106111405	106158030	DAOA-AS1	46625	-	NR_040247	106158030	106158030	7
chr13	106118215	106143383	DAOA	25168	+	NM_001161814	106124966	106142430	6
chr13	106359178	106414145	LINC00343	54967	+	NR_046391	106414145	106414145	4
chr13	107028910	107030142	LINC00460	1232	+	NR_034119	107030142	107030142	3
chr13	107142078	107187388	EFNB2	45310	-	NM_004093	107145387	107187312	5
chr13	107195661	107220514	ARGLU1	24853	-	NM_018011	107196343	107220267	4
chr13	107270157	107284006	LINC00551	13849	+	NR_051977	107284006	107284006	4
chr13	107306227	107324528	LINC00443	18301	+	NR_047026	107324528	107324528	3
chr13	107820878	108519460	FAM155A	698582	-	NM_001080396	107822844	108518944	3
chr13	108183518	108183596	MIR1267	78	-	NR_031671	108183596	108183596	1
chr13	108439708	108487806	FAM155A-IT1	48098	-	NR_046848	108487806	108487806	2
chr13	108859791	108870716	LIG4	10925	-	NM_001098268	108860880	108863616	2
chr13	108870762	108886603	ABHD13	15841	+	NM_032859	108881566	108882580	2
chr13	108921976	108960832	TNFSF13B	38856	+	NM_006573	108922243	108959286	6
chr13	109248499	109860355	MYO16	611856	+	NM_015011	109318271	109859184	35
chr13	109816252	109819651	MYO16-AS1	3399	-	NR_047700	109819651	109819651	3
chr13	110053042	110053986	LINC00399	944	+	NR_126361	110053986	110053986	2
chr13	110380620	110382381	LINC00676	1761	+	NR_103846	110382381	110382381	3
chr13	110406183	110438914	IRS2	32731	-	NM_003749	110408650	110438400	2
chr13	110705631	110707299	LINC00396	1668	+	NR_126387	110707299	110707299	4
chr13	110801304	110959504	COL4A1	158200	-	NM_001845	110802709	110959374	52
chr13	110959630	111165373	COL4A2	205743	+	NM_001846	110960250	111164538	48
chr13	110993304	110993376	MIR8073	72	+	NR_107040	110993376	110993376	1
chr13	111154922	111160526	COL4A2-AS1	5604	-	NR_046583	111160526	111160526	3
chr13	111175412	111214084	RAB20	38672	-	NM_017817	111176011	111213866	2
chr13	111267806	111292342	CARKD	24536	+	NM_001242882	111267948	111290875	10
chr13	111293756	111358527	CARS2	64771	-	NM_024537	111293883	111358440	15
chr13	111364969	111373421	ING1	8452	+	NM_198217	111365320	111372279	2
chr13	111516333	111522655	LINC00346	6322	-	NR_027701	111522655	111522655	1
chr13	111530886	111567454	ANKRD10	36568	-	NR_104587	111567454	111567454	7
chr13	111618373	111642949	LINC00431	24576	+	NR_126378	111642949	111642949	2
chr13	111748184	111758237	LINC00368	10053	+	NR_120415	111758237	111758237	3
chr13	111766158	111768025	ARHGEF7-AS2	1867	-	NR_046667	111768025	111768025	2
chr13	111767623	111947542	ARHGEF7	179919	+	NM_001113511	111767873	111944679	20
chr13	111796651	111800912	ARHGEF7-AS1	4261	-	NR_046516	111800912	111800912	3
chr13	111800543	111805924	LOC101060553	5381	-	NR_120398	111805924	111805924	2
chr13	111968531	111996594	TEX29	28063	+	NM_001303133	111980547	111996470	7
chr13	112547691	112555490	LINC00354	7799	+	NR_046992	112555490	112555490	3
chr13	112626623	112762329	LINC00403	135706	+	NR_120392	112762329	112762329	4
chr13	112721912	112726020	SOX1	4108	+	NM_005986	112721972	112723148	1
chr13	112851646	112855316	LINC01070	3670	+	NR_108094	112855316	112855316	3
chr13	112911039	112927314	LOC101928730	16275	-	NR_120422	112927314	112927314	9
chr13	112976880	112985539	LINC01044	8659	-	NR_126345	112985539	112985539	3
chr13	113030650	113089009	SPACA7	58359	+	NM_145248	113030699	113088863	7
chr13	113139318	113242499	TUBGCP3	103181	-	NM_001286277	113140306	113242294	22
chr13	113301357	113338811	ATP11AUN	37454	+	NM_207440	113333693	113337694	3
chr13	113344642	113541482	ATP11A	196840	+	NM_015205	113344730	113532608	30
chr13	113399762	113409045	ATP11A-AS1	9283	-	NR_046661	113409045	113409045	2
chr13	113621797	113622952	MCF2L-AS1	1155	-	NR_034002	113622952	113622952	1
chr13	113623534	113754053	MCF2L	130519	+	NM_001112732	113623693	113751173	30
chr13	113760101	113774995	F7	14894	+	NM_000131	113760155	113773322	9
chr13	113777112	113803843	F10	26731	+	NM_000504	113777169	113803831	8
chr13	113782468	113784360	F10-AS1	1892	-	NR_126424	113784360	113784360	3
chr13	113812967	113826698	PROZ	13731	+	NM_001256134	113812974	113826419	9
chr13	113831852	113863029	PCID2	31177	-	NM_001127203	113832511	113862948	15
chr13	113862506	113919392	CUL4A	56886	+	NM_001278513	113873294	113917896	20
chr13	113917233	113917313	MIR8075	80	+	NR_107042	113917313	113917313	1
chr13	113951468	113977741	LAMP1	26273	+	NM_005561	113951749	113976736	9
chr13	113978478	114018463	GRTP1	39985	-	NM_024719	113978802	114018366	8
chr13	114005987	114016182	GRTP1-AS1	10195	+	NR_046541	114016182	114016182	3
chr13	114053924	114068708	LOC101928841	14784	-	NM_001304433	114057692	114062504	2
chr13	114076254	114107839	ADPRHL1	31585	-	NM_138430	114077136	114107752	7
chr13	114110133	114145023	DCUN1D2	34890	-	NM_001014283	114112343	114144984	7
chr13	114145307	114204544	TMCO3	59237	+	NM_017905	114149896	114203853	13
chr13	114239002	114295788	TFDP1	56786	+	NR_026580	114295788	114295788	11
chr13	114303121	114312513	ATP4B	9392	-	NM_000705	114303688	114312459	7
chr13	114321596	114438637	GRK1	117041	+	NM_002929	114321701	114438336	7
chr13	114451483	114454062	LINC00552	2579	-	NR_028064	114454062	114454062	1
chr13	114462215	114514899	TMEM255B	52684	+	NM_182614	114462242	114514876	9
chr13	114518582	114545814	GAS6-AS1	27232	+	NR_044995	114545814	114545814	5
chr13	114523521	114567076	GAS6	43555	-	NM_000820	114523836	114566893	15
chr13	114567149	114569805	GAS6-AS2	2656	+	NR_044993	114569805	114569805	2
chr13	114598075	114624290	LINC00452	26215	+	NM_001278674	114618843	114624053	8
chr13	114629486	114631964	LINC00565	2478	-	NR_047495	114631964	114631964	1
chr13	114747193	114898095	RASA3	150902	-	NM_007368	114748757	114897964	24
chr13	115000361	115038150	CDC16	37789	+	NM_003903	115000559	115037918	19
chr13	115009979	115010036	MIR548AR	57	+	NR_049839	115010036	115010036	1
chr13	115039302	115039383	MIR4502	81	+	NR_039724	115039383	115039383	1
chr13	115047058	115071291	UPF3A	24233	+	NM_023011	115047114	115070392	10
chr13	115079964	115092803	CHAMP1	12839	+	NM_001164144	115089317	115091756	3
chr13	115095231	115099423	LINC01054	4192	-	NR_126391	115099423	115099423	3
chr14	19377593	19378574	OR11H12	981	+	NM_001013354	19377593	19378574	1
chr14	19407014	19410111	LOC642426	3097	-	NR_046104	19410111	19410111	3
chr14	19553364	19584942	POTEG	31578	+	NR_027480	19584942	19584942	12
chr14	19563121	19566680	LOC101929572	3559	-	NR_110504	19566680	19566680	2
chr14	19563711	19566680	POTEH-AS1	2969	-	NR_046571	19566680	19566680	2
chr14	19650031	19692916	DUXAP10	42885	+	NR_110526	19692916	19692916	8
chr14	19670791	19681016	BMS1P17	10225	-	NR_073460	19681016	19681016	3
chr14	19670791	19681016	BMS1P18	10225	-	NR_073459	19681016	19681016	3
chr14	19670791	19686002	BMS1P22	15211	-	NR_133911	19686002	19686002	3
chr14	19880208	19925329	LINC01296	45121	-	NR_122111	19925329	19925329	4
chr14	19983953	20020272	POTEM	36319	-	NM_001145442	19990547	20020220	11
chr14	20006912	20010956	LOC100508046	4044	+	NR_110505	20010956	20010956	2
chr14	20181062	20182491	OR11H2	1429	-	NM_001197287	20181094	20182075	2
chr14	20215586	20216528	OR4Q3	942	+	NM_172194	20215586	20216528	1
chr14	20248481	20249423	OR4M1	942	+	NM_001005500	20248481	20249423	1
chr14	20271928	20296531	OR4N2	24603	+	NM_001004723	20295607	20296531	2
chr14	20344426	20345371	OR4K2	945	+	NM_001005501	20344426	20345371	1
chr14	20388765	20389737	OR4K5	972	+	NM_001005483	20388765	20389737	1
chr14	20403766	20404842	OR4K1	1076	+	NM_001004063	20403825	20404761	1
chr14	20443677	20444724	OR4K15	1047	+	NM_001005486	20443677	20444724	1
chr14	20482419	20483352	OR4K14	933	-	NM_001004712	20482419	20483352	1
chr14	20502002	20502917	OR4K13	915	-	NM_001004714	20502002	20502917	1
chr14	20528203	20529142	OR4L1	939	+	NM_001004717	20528203	20529142	1
chr14	20585565	20586597	OR4K17	1032	+	NM_001004715	20585565	20586597	1
chr14	20611894	20612821	OR4N5	927	+	NM_001004724	20611894	20612821	1
chr14	20665494	20666532	OR11G2	1038	+	NM_001005503	20665494	20666532	1
chr14	20691868	20692861	OR11H6	993	+	NM_001004480	20691868	20692861	1
chr14	20710950	20711925	OR11H4	975	+	NM_001004479	20710950	20711925	1
chr14	20757300	20774153	TTC5	16853	-	NM_138376	20757785	20774096	10
chr14	20779526	20801471	CCNB1IP1	21945	-	NM_182852	20779708	20784682	8
chr14	20794599	20794698	SNORD126	99	-	NR_003693	20794698	20794698	1
chr14	20811229	20811570	RPPH1	341	-	NR_002312	20811570	20811570	1
chr14	20811772	20826063	PARP2	14291	+	NM_001042618	20811800	20825956	16
chr14	20833825	20881579	TEP1	47754	-	NM_007110	20836595	20876598	55
chr14	20896969	20903801	KLHL33	6832	-	NM_001109997	20897007	20898834	4
chr14	20915206	20923267	OSGEP	8061	-	NM_017807	20915398	20922842	11
chr14	20923289	20925931	APEX1	2642	+	NM_001641	20923804	20925667	5
chr14	20926011	20929771	TMEM55B	3760	-	NM_144568	20926717	20929484	7
chr14	20937537	20946165	PNP	8628	+	NM_000270	20937683	20944760	6
chr14	20978630	20979281	RNASE10	651	+	NM_001012975	20978630	20979281	1
chr14	21024251	21029090	RNASE9	4839	-	NM_001110361	21024610	21026774	5
chr14	21051051	21058417	RNASE11	7366	-	NM_145250	21052033	21052633	3
chr14	21056382	21075380	LOC254028	18998	+	NR_122043	21075380	21075380	5
chr14	21058239	21058982	RNASE12	743	-	NM_001024822	21058438	21058882	1
chr14	21108854	21109850	OR6S1	996	-	NM_001001968	21108854	21109850	1
chr14	21152335	21162345	ANG	10010	+	NM_001145	21161723	21162167	2
chr14	21152371	21168761	RNASE4	16390	+	NM_001282192	21167530	21167974	3
chr14	21214098	21216539	EDDM3A	2441	+	NM_006683	21215739	21216183	2
chr14	21236585	21239107	EDDM3B	2522	+	NM_022360	21238309	21238753	2
chr14	21249209	21250626	RNASE6	1417	+	NM_005615	21249858	21250311	2
chr14	21269514	21271036	RNASE1	1522	-	NM_198235	21269756	21270227	3
chr14	21359561	21360507	RNASE3	946	+	NM_002935	21359845	21360328	2
chr14	21387499	21388335	ECRP	836	+	NR_033909	21388335	21388335	2
chr14	21423629	21424594	RNASE2	965	+	NM_002934	21423930	21424416	2
chr14	21457964	21465194	METTL17	7230	+	NM_022734	21458161	21465049	14
chr14	21463995	21467322	LOC101929718	3327	-	NR_110139	21467322	21467322	4
chr14	21467413	21470034	SLC39A2	2621	+	NM_014579	21467605	21469738	4
chr14	21484921	21539031	NDRG2	54110	-	NM_001282211	21485754	21539010	15
chr14	21491472	21491545	MIR6717	73	-	NR_106774	21491545	21491545	1
chr14	21498344	21500332	TPPP2	1988	+	NM_173846	21498740	21500236	4
chr14	21500978	21502944	RNASE13	1966	-	NM_001012264	21501976	21502447	2
chr14	21510384	21512392	RNASE7	2008	+	NM_032572	21511151	21511622	2
chr14	21525980	21526614	RNASE8	634	+	NM_138331	21526051	21526516	1
chr14	21538418	21558406	ARHGEF40	19988	+	NM_018071	21538555	21557030	24
chr14	21558204	21572863	ZNF219	14659	-	NM_001102454	21558694	21561750	5
chr14	21567095	21571883	TMEM253	4788	+	NM_001146683	21569502	21571417	8
chr14	21623095	21624184	OR5AU1	1089	-	NM_001004731	21623095	21624184	1
chr14	21668237	21675059	LINC00641	6822	-	NR_038971	21675059	21675059	2
chr14	21677295	21737638	HNRNPC	60343	-	NM_004500	21679381	21702352	9
chr14	21756135	21819460	RPGRIP1	63325	+	NM_020366	21756135	21819375	24
chr14	21819630	21852425	SUPT16H	32795	-	NM_007192	21820831	21852086	26
chr14	21853352	21905457	CHD8	52105	-	NM_020920	21853771	21899975	38
chr14	21860309	21860412	SNORD9	103	-	NR_003029	21860412	21860412	1
chr14	21865451	21865560	SNORD8	109	-	NR_002916	21865560	21865560	1
chr14	21927178	21945132	RAB2B	17954	-	NR_028074	21945132	21945132	8
chr14	21945334	21967321	TOX4	21987	+	NM_014828	21945437	21964764	9
chr14	21966274	21979517	METTL3	13243	-	NM_019852	21966401	21979365	11
chr14	21989230	22005350	SALL2	16120	-	NM_001291446	21990141	22005055	4
chr14	22037933	22038875	OR10G3	942	-	NM_001005465	22037933	22038875	1
chr14	22101991	22103096	OR10G2	1105	-	NM_001005466	22102065	22102998	1
chr14	22133296	22134238	OR4E2	942	+	NM_001001912	22133296	22134238	1
chr14	22138124	22139232	OR4E1	1108	-	NM_001317107	22138200	22139150	2
chr14	23033806	23058143	DAD1	24337	-	NM_001344	23044002	23058063	3
chr14	23067146	23081265	ABHD4	14119	+	NM_022060	23067215	23079854	7
chr14	23235730	23240998	OXA1L	5268	+	NM_005015	23235730	23240767	10
chr14	23242431	23289020	SLC7A7	46589	-	NM_001126106	23242818	23282607	11
chr14	23299091	23304246	MRPL52	5155	+	NM_178336	23299121	23303530	5
chr14	23305741	23316808	MMP14	11067	+	NM_004995	23306026	23315248	10
chr14	23340959	23347291	LRP10	6332	+	NM_014045	23341512	23346736	7
chr14	23352431	23356889	REM2	4458	+	NM_173527	23352496	23356118	5
chr14	23369853	23388396	RBM23	18543	-	NM_001077351	23370938	23380602	14
chr14	23388664	23392616	PRMT5-AS1	3952	+	NR_120599	23392616	23392616	2
chr14	23389719	23398794	PRMT5	9075	-	NM_001039619	23390112	23398434	17
chr14	23398817	23423901	LOC101926933	25084	+	NR_110002	23423901	23423901	3
chr14	23415436	23426351	HAUS4	10915	-	NM_017815	23415733	23424363	10
chr14	23426158	23426238	MIR4707	80	-	NR_039856	23426238	23426238	1
chr14	23440382	23451851	AJUBA	11469	-	NM_032876	23442651	23451475	8
chr14	23456109	23479410	C14orf93	23301	-	NM_001130706	23456423	23468232	8
chr14	23495059	23504429	PSMB5	9370	-	NM_001130725	23495297	23502772	3
chr14	23511375	23513269	PSMB11	1894	+	NM_001099780	23511434	23512337	1
chr14	23516269	23526747	CDH24	10478	-	NM_022478	23517188	23524942	14
chr14	23527773	23564823	ACIN1	37050	-	NM_014977	23528356	23564495	19
chr14	23564682	23569665	C14orf119	4983	+	NM_017924	23566867	23567290	2
chr14	23586514	23588820	CEBPE	2306	-	NM_001805	23586695	23588300	2
chr14	23594503	23652869	SLC7A8	58366	-	NM_012244	23596385	23652123	11
chr14	23707126	23743494	RNF212B	36368	+	NM_001282322	23709554	23742100	15
chr14	23742843	23755309	HOMEZ	12466	-	NM_020834	23744783	23755161	2
chr14	23765129	23772057	PPP1R3E	6928	-	NM_001276318	23770644	23771785	5
chr14	23775970	23780968	BCL2L2	4998	+	NM_004050	23776976	23778174	4
chr14	23775970	23795394	BCL2L2-PABPN1	19424	+	NM_001199864	23776976	23794495	9
chr14	23789396	23795394	PABPN1	5998	+	NM_004643	23790678	23794495	7
chr14	23815519	23822121	SLC22A17	6602	-	NM_016609	23815856	23821423	10
chr14	23825608	23834842	EFS	9234	-	NM_005864	23826434	23834234	6
chr14	23842017	23845612	IL25	3595	+	NM_172314	23842175	23845089	3
chr14	23846016	23848981	CMTM5	2965	+	NM_001288746	23846460	23848696	6
chr14	23851198	23877486	MYH6	26288	-	NM_002471	23851248	23876432	39
chr14	23857804	23857875	MIR208A	71	-	NR_029595	23857875	23857875	1
chr14	23881946	23904895	MYH7	22949	-	NM_000257	23882062	23902941	40
chr14	23884658	23886804	MHRT	2146	+	NR_126491	23886804	23886804	6
chr14	23887195	23887272	MIR208B	77	-	NR_030624	23887272	23887272	1
chr14	23938897	23947402	NGDN	8505	+	NM_001042635	23938924	23947235	11
chr14	23980968	24028790	THTPA	47822	+	NR_046051	24028790	24028790	5
chr14	23990063	24020858	ZFHX2	30795	-	NM_033400	23991170	24004534	10
chr14	24028771	24037045	AP1G2	8274	-	NM_003917	24028957	24036523	22
chr14	24030305	24037284	LOC102724814	6979	+	NR_110555	24037284	24037284	4
chr14	24037243	24048009	JPH4	10766	-	NM_032452	24038842	24046662	7
chr14	24105572	24114848	DHRS2	9276	+	NM_005794	24108073	24114462	9
chr14	24407939	24424321	DHRS4-AS1	16382	-	NR_023922	24424321	24424321	2
chr14	24422943	24438488	DHRS4	15545	+	NM_021004	24422997	24438080	8
chr14	24439082	24475617	DHRS4L2	36535	+	NM_001193636	24459565	24473579	8
chr14	24476217	24520586	DHRS4L1	44369	+	NR_102688	24520586	24520586	5
chr14	24521205	24538937	LRRC16B	17732	+	NM_138360	24521362	24538613	40
chr14	24540045	24547309	CPNE6	7264	+	NM_001280558	24540191	24546939	18
chr14	24549315	24553832	NRL	4517	-	NM_006177	24550444	24552057	3
chr14	24563339	24573341	PCK2	10002	+	NM_004563	24563614	24573173	10
chr14	24583905	24594451	DCAF11	10546	+	NM_001163484	24584803	24592518	15
chr14	24600674	24602058	FITM1	1384	+	NM_203402	24600772	24602032	2
chr14	24605366	24608176	PSME1	2810	+	NM_001281529	24605471	24608025	11
chr14	24608173	24610797	EMC9	2624	-	NM_016049	24608218	24610513	6
chr14	24612573	24615855	PSME2	3282	-	NM_002818	24612617	24615790	11
chr14	24612697	24612774	MIR7703	77	-	NR_106990	24612774	24612774	1
chr14	24616083	24629870	RNF31	13787	+	NM_001310332	24617644	24629782	21
chr14	24630421	24635774	IRF9	5353	+	NM_006084	24631353	24635405	9
chr14	24641233	24649463	REC8	8230	+	NM_005132	24641761	24649301	20
chr14	24649424	24658124	IPO4	8700	-	NM_024658	24649647	24657993	30
chr14	24658348	24664942	TM9SF1	6594	-	NM_006405	24658620	24664225	6
chr14	24674856	24677454	TSSK4	2598	+	NM_001308067	24675717	24677352	4
chr14	24678786	24683036	CHMP4A	4250	-	NM_014169	24679082	24682774	6
chr14	24683142	24685276	MDP1	2134	-	NM_001199822	24683504	24685161	6
chr14	24683142	24701576	NEDD8-MDP1	18434	-	NM_001199823	24683229	24701473	7
chr14	24686056	24701576	NEDD8	15520	-	NM_006156	24686332	24701473	4
chr14	24701627	24708447	GMPR2	6820	+	NR_104265	24708447	24708447	10
chr14	24708850	24711880	TINF2	3030	-	NM_001099274	24709002	24711538	9
chr14	24718319	24732416	TGM1	14097	-	NM_000359	24718518	24731558	15
chr14	24734743	24740833	RABGGTA	6090	-	NM_182836	24734820	24740321	17
chr14	24759803	24769039	DHRS1	9236	-	NM_001136050	24760064	24768312	9
chr14	24769059	24778332	NOP9	9273	+	NM_001286367	24769160	24774164	10
chr14	24774392	24780576	CIDEB	6184	-	NM_014430	24774838	24777064	7
chr14	24779356	24781259	LTB4R2	1903	+	NM_001164692	24779870	24780947	2
chr14	24780704	24787242	LTB4R	6538	+	NM_001143919	24784857	24785916	2
chr14	24787554	24804277	ADCY4	16723	-	NM_001198592	24787621	24803858	26
chr14	24805226	24809242	RIPK3	4016	-	NM_006871	24805380	24809032	10
chr14	24836116	24848811	NFATC4	12695	+	NM_001198967	24836260	24846911	11
chr14	24867991	24888494	NYNRIN	20503	+	NM_025081	24868452	24886652	9
chr14	24895739	24898731	CBLN3	2992	-	NM_001039771	24896994	24898260	3
chr14	24898491	24910547	KHNYN	12056	+	NM_001290256	24898507	24906491	8
chr14	24908971	24912111	SDR39U1	3140	-	NM_001290292	24909288	24911465	5
chr14	24912158	24971403	LOC101927045	59245	+	NR_110032	24971403	24971403	3
chr14	24974560	24977471	CMA1	2911	-	NM_001836	24974721	24977441	5
chr14	25042723	25045466	CTSG	2743	-	NM_001911	25042842	25045429	5
chr14	25075685	25078926	GZMH	3241	-	NM_033423	25075808	25078819	5
chr14	25100160	25103432	GZMB	3272	-	NM_004131	25100276	25103366	5
chr14	25278860	25519503	STXBP6	240643	-	NM_001304476	25281914	25444024	7
chr14	26915088	27066960	NOVA1	151872	-	NM_002515	26917164	27066642	5
chr14	27244700	27291326	LOC101927062	46626	-	NR_110033	27291326	27291326	4
chr14	27278553	27289909	LOC102724890	11356	+	NR_110557	27289909	27289909	5
chr14	27342338	27383949	MIR4307HG	41611	+	NR_110041	27383949	27383949	4
chr14	27377847	27377931	MIR4307	84	+	NR_036193	27377931	27377931	1
chr14	28081793	28108842	LINC00645	27049	+	NR_039992	28108842	28108842	5
chr14	28102410	28102484	MIR3171	74	-	NR_130461	28102484	28102484	1
chr14	29194447	29234525	FOXG1-AS1	40078	-	NR_125758	29234525	29234525	7
chr14	29236277	29239483	FOXG1	3206	+	NM_005249	29236485	29237955	1
chr14	29241909	29264000	LINC01551	22091	+	NR_026731	29264000	29264000	3
chr14	29896116	30174608	MIR548AI	278492	-	NR_039672	30174608	30174608	5
chr14	30045686	30396899	PRKD1	351213	-	NM_002742	30046443	30396718	18
chr14	31028328	31089267	G2E3	60939	+	NM_017769	31050285	31085740	15
chr14	31091459	31205033	SCFD1	113574	+	NM_016106	31091544	31204815	25
chr14	31343740	31359822	COCH	16082	+	NM_004086	31344144	31358997	12
chr14	31345384	31359014	LOC100506071	13630	-	NR_038356	31359014	31359014	5
chr14	31363004	31495607	STRN3	132603	-	NM_001083893	31364616	31495391	18
chr14	31483851	31483948	MIR624	97	-	NR_030354	31483948	31483948	1
chr14	31494311	31565656	AP4S1	71345	+	NM_001254729	31535402	31562241	6
chr14	31569320	31676729	HECTD1	107409	-	NM_015382	31570135	31675142	43
chr14	31760993	31889788	HEATR5A	128795	-	NM_015473	31762510	31872181	36
chr14	31889963	31922089	LOC101927124	32126	+	NR_110045	31922089	31922089	4
chr14	31915242	31926680	DTD2	11438	-	NM_080664	31917334	31926599	3
chr14	31952149	31957151	GPR33	5002	-	NR_036675	31957151	31957151	2
chr14	32030590	32330429	NUBPL	299839	+	NM_025152	32030645	32328386	11
chr14	32544624	32545905	ARHGAP5-AS1	1281	-	NR_027263	32545905	32545905	1
chr14	32546494	32628934	ARHGAP5	82440	+	NM_001173	32559875	32624154	7
chr14	32798478	33302268	AKAP6	503790	+	NM_004274	32902699	33293979	14
chr14	33408458	34273382	NPAS3	864924	+	NM_001164749	33408522	34270315	12
chr14	34178142	34178319	SNORA89	177	+	NR_132771	34178319	34178319	1
chr14	34393420	34420284	EGLN3	26864	-	NM_022073	34395096	34419958	5
chr14	34902143	34931468	SPTSSA	29325	-	NM_138288	34904406	34931413	2
chr14	34985134	35008943	EAPP	23809	-	NM_018453	34985515	35008834	6
chr14	35030617	35099366	SNX6	68749	-	NM_152233	35032327	35099358	14
chr14	35179587	35184029	CFL2	4442	-	NR_028131	35184029	35184029	4
chr14	35221936	35344853	BAZ1A	122917	-	NM_013448	35222713	35343810	27
chr14	35409127	35409702	IGBP1P1	575	+	NR_002937	35409702	35409702	1
chr14	35452103	35498773	SRP54	46670	+	NM_003136	35465915	35498358	16
chr14	35514112	35552589	FAM177A1	38477	+	NM_001079519	35515738	35550434	7
chr14	35550286	35582336	LOC101927178	32050	+	NR_110415	35582336	35582336	5
chr14	35554673	35591749	PPP2R3C	37076	-	NM_001305156	35554795	35579098	13
chr14	35591526	35743284	KIAA0391	151758	+	NM_014672	35592451	35742772	8
chr14	35747763	35786685	PSMA6	38922	+	NM_001282234	35747905	35786512	7
chr14	35870715	35873960	NFKBIA	3245	-	NM_020529	35871218	35873850	6
chr14	36003247	36006260	INSM2	3013	+	NM_032594	36003458	36005159	1
chr14	36007557	36278432	RALGAPA1	270875	-	NM_001283043	36017736	36278041	42
chr14	36007960	36278350	RALGAPA1P	270390	-	NR_104269	36278350	36278350	43
chr14	36295596	36341169	BRMS1L	45573	+	NM_032352	36295722	36339683	10
chr14	36539632	36634494	LINC00609	94862	+	NR_073454	36634494	36634494	3
chr14	36604915	36645857	PTCSC3	40942	-	NR_049735	36645857	36645857	4
chr14	36767763	36789882	MBIP	22119	-	NM_001144891	36768288	36789794	9
chr14	36942493	36982990	SFTA3	40497	-	NM_001101341	36943062	36982358	4
chr14	36985603	36989430	NKX2-1	3827	-	NM_001079668	36986482	36989334	3
chr14	36988482	36992221	NKX2-1-AS1	3739	+	NR_103710	36992221	36992221	2
chr14	37049215	37051819	NKX2-8	2604	-	NM_014360	37050106	37051594	2
chr14	37126772	37147011	PAX9	20239	+	NM_006194	37131294	37145657	5
chr14	37147125	37641865	SLC25A21	494740	-	NM_001171170	37147688	37641555	11
chr14	37421513	37421596	MIR4503	83	-	NR_039725	37421596	37421596	1
chr14	37641230	37642998	SLC25A21-AS1	1768	+	NR_033240	37642998	37642998	1
chr14	37667117	38020464	MIPOL1	353347	+	NM_001195297	37717093	38016176	15
chr14	38058756	38064325	FOXA1	5569	-	NM_004496	38060569	38064177	2
chr14	38064403	38311830	TTC6	247427	+	NM_001310135	38075914	38311496	33
chr14	38677203	38682268	SSTR1	5065	+	NM_001049	38678594	38679770	3
chr14	38723204	38725575	CLEC14A	2371	-	NM_175060	38723754	38725227	1
chr14	39218542	39386086	LINC00639	167544	-	NR_039982	39386086	39386086	5
chr14	39501122	39572437	SEC23A	71315	-	NM_006364	39502442	39565322	20
chr14	39583487	39606177	GEMIN2	22690	+	NM_003616	39583509	39605683	10
chr14	39617014	39639634	TRAPPC6B	22620	-	NM_001079537	39619553	39639299	6
chr14	39644386	39652422	PNN	8036	+	NM_002687	39644483	39651067	9
chr14	39703124	39722575	MIA2	19451	+	NM_054024	39703318	39722453	6
chr14	39734475	39820397	CTAGE5	85922	+	NM_203354	39734598	39819468	24
chr14	39734906	39736265	LOC100288846	1359	-	NR_038935	39736265	39736265	1
chr14	39865576	39901704	FBXO33	36128	-	NM_203301	39868719	39901366	4
chr14	41423915	41610251	LOC644919	186336	+	NR_109758	41610251	41610251	4
chr14	42076763	42373752	LRFN5	296989	+	NM_152447	42355828	42373378	6
chr14	44973353	44976499	FSCB	3146	-	NM_032135	44973712	44976190	1
chr14	45366506	45376460	C14orf28	9954	+	NM_001017923	45369638	45374753	5
chr14	45368110	45381120	LOC101927418	13010	-	NR_110050	45381120	45381120	3
chr14	45393512	45431179	KLHL28	37667	-	NM_017658	45398230	45415131	5
chr14	45431392	45543634	FAM179B	112242	+	NM_001308120	45431624	45542764	20
chr14	45553301	45584804	PRPF39	31503	+	NM_017922	45564442	45584116	14
chr14	45580077	45580176	SNORD127	99	+	NR_003691	45580176	45580176	1
chr14	45584801	45603732	FKBP3	18931	-	NM_002013	45585400	45603659	7
chr14	45605141	45670093	FANCM	64952	+	NM_020937	45605234	45669211	23
chr14	45672392	45722605	MIS18BP1	50213	-	NM_018353	45673311	45716489	17
chr14	46533361	46971104	LINC00871	437743	+	NR_102701	46971104	46971104	6
chr14	47120219	47121028	RPL10L	809	-	NM_080746	47120294	47120939	1
chr14	47308827	48144157	MDGA2	835330	-	NM_001113498	47311133	48143792	17
chr14	48230197	48230307	MIR548Y	110	-	NR_037503	48230307	48230307	1
chr14	48234155	48264217	LINC00648	30062	-	NR_039996	48264217	48264217	3
chr14	50043389	50053134	RPS29	9745	-	NM_001030001	50044529	50053064	3
chr14	50065414	50081390	LRR1	15976	+	NR_037792	50081390	50081390	6
chr14	50085405	50087403	RPL36AL	1998	-	NM_001001	50085501	50085822	2
chr14	50087488	50090199	MGAT2	2711	+	NM_002408	50087986	50089330	1
chr14	50091891	50101948	DNAAF2	10057	-	NM_018139	50092259	50101867	3
chr14	50110269	50155098	POLE2	44829	-	NM_002692	50110369	50154921	19
chr14	50159822	50219870	KLHDC1	60048	+	NM_172193	50159912	50218490	13
chr14	50234786	50249856	KLHDC2	15070	+	NM_014315	50235186	50249671	13
chr14	50250531	50319791	NEMF	69260	-	NM_004713	50251353	50319471	33
chr14	50359735	50363772	ARF6	4037	+	NM_001663	50360454	50360982	2
chr14	50433116	50433229	MIR6076	113	+	NR_106724	50433229	50433229	1
chr14	50448386	50474238	LINC01588	25852	-	NR_126498	50474238	50474238	4
chr14	50474030	50571761	LINC01599	97731	-	NR_131171	50571761	50571761	9
chr14	50575349	50583297	VCPKMT	7948	-	NM_024558	50576416	50583270	6
chr14	50583845	50698099	SOS2	114254	-	NM_006939	50585061	50698001	23
chr14	50709151	50778947	L2HGDH	69796	-	NM_024884	50713775	50778868	10
chr14	50766572	50766664	MIR4504	92	-	NR_039726	50766664	50766664	1
chr14	50779046	50792946	ATP5S	13900	+	NR_033761	50792946	50792946	6
chr14	50796308	50862642	CDKL1	66334	-	NM_004196	50796791	50862589	9
chr14	50885210	50999376	MAP4K5	114166	-	NM_006575	50886736	50998767	32
chr14	50999799	51099784	ATL1	99985	+	NM_001127713	51026983	51099057	14
chr14	51100297	51135071	SAV1	34774	-	NM_021818	51101900	51134685	5
chr14	51186480	51297839	NIN	111359	-	NM_020921	51190180	51288774	31
chr14	51338877	51371688	ABHD12B	32811	+	NM_001206673	51338892	51371084	13
chr14	51371934	51411248	PYGL	39314	-	NM_002863	51372109	51411121	20
chr14	51441980	51562422	TRIM9	120442	-	NM_015163	51444008	51561657	10
chr14	51706885	51724372	TMX1	17487	+	NM_030755	51707010	51721237	8
chr14	51800110	51832275	LINC00640	32165	+	NR_038358	51832275	51832275	5
chr14	51921229	52066670	FRMD6-AS2	145441	-	NR_051990	52066670	52066670	3
chr14	51955838	52197444	FRMD6	241606	+	NM_001042481	52156554	52194747	15
chr14	52116235	52118462	FRMD6-AS1	2227	-	NR_037676	52118462	52118462	1
chr14	52327021	52436518	GNG2	109497	+	NM_001243773	52417396	52433405	4
chr14	52382862	52385289	LOC102723604	2427	-	NR_126331	52385289	52385289	3
chr14	52456227	52471420	C14orf166	15193	+	NM_016039	52456357	52471234	8
chr14	52471519	52535946	NID2	64427	-	NM_007361	52472203	52535712	22
chr14	52734430	52743442	PTGDR	9012	+	NM_001281469	52734532	52736213	3
chr14	52781015	52795322	PTGER2	14307	+	NM_000956	52781266	52794172	2
chr14	52897307	53019301	TXNDC16	121994	-	NM_020784	52899021	53010275	21
chr14	53019865	53104431	GPR137C	84566	+	NM_001099652	53019865	53101833	7
chr14	53106632	53162649	ERO1A	56017	-	NM_014584	53110287	53162199	16
chr14	53173895	53194716	PSMC6	20821	+	NM_002806	53173895	53194335	14
chr14	53196882	53241705	STYX	44823	+	NM_001130701	53197192	53237824	12
chr14	53241910	53258386	GNPNAT1	16476	-	NM_198066	53245028	53251368	6
chr14	53323988	53417815	FERMT2	93827	-	NM_001134999	53325094	53417286	16
chr14	53503457	53620046	DDHD1	116589	-	NM_001160147	53513485	53619816	13
chr14	53620071	53624246	LOC101927620	4175	+	NR_110062	53624246	53624246	3
chr14	54415144	54415202	MIR5580	58	-	NR_049843	54415202	54415202	1
chr14	54416454	54423580	BMP4	7126	-	NM_001202	54416749	54418940	4
chr14	54863672	54886934	CDKN3	23262	+	NM_005192	54863786	54886796	8
chr14	54893646	54908148	CNIH1	14502	-	NM_005776	54894531	54908045	5
chr14	54941208	54955744	GMFB	14536	-	NM_004124	54944805	54955645	7
chr14	54976586	55005334	CGRRF1	28748	+	NM_006568	54976677	55005101	6
chr14	55034329	55260033	SAMD4A	225704	+	NM_015589	55034634	55255662	12
chr14	55308723	55369542	GCH1	60819	-	NM_001024070	55310511	55369381	7
chr14	55344830	55344911	MIR4308	81	-	NR_036194	55344911	55344911	1
chr14	55405655	55493819	WDHD1	88164	-	NM_007086	55408207	55493505	26
chr14	55493843	55516206	SOCS4	22363	+	NM_199421	55509759	55511082	3
chr14	55518361	55536912	MAPK1IP1L	18551	+	NM_144578	55528401	55531345	4
chr14	55595934	55612148	LGALS3	16214	+	NM_001177388	55604091	55612112	6
chr14	55614833	55658396	DLGAP5	43563	-	NM_001146015	55615171	55655897	20
chr14	55738020	55820329	FBXO34	82309	+	NM_017943	55817108	55819244	2
chr14	55833108	55878576	ATG14	45468	-	NM_014924	55836336	55878540	10
chr14	55880929	55907263	TBPL2	26334	-	NM_199047	55881096	55907263	7
chr14	56042874	56046810	KTN1-AS1	3936	-	NR_027123	56046810	56046810	3
chr14	56046924	56151302	KTN1	104378	+	NR_073129	56151302	56151302	46
chr14	56232962	56234435	RPL13AP3	1473	+	NR_004844	56234435	56234435	1
chr14	56247852	56263392	LINC00520	15540	-	NR_026796	56263392	56263392	4
chr14	56585092	56768031	PELI2	182939	+	NM_021255	56585378	56763884	6
chr14	57046510	57116232	TMEM260	69722	+	NM_017799	57046632	57114215	16
chr14	57267424	57277194	OTX2	9770	-	NM_021728	57268452	57272174	5
chr14	57279900	57397550	OTX2-AS1	117650	+	NR_029385	57397550	57397550	4
chr14	57669193	57735617	EXOC5	66424	-	NM_006544	57675326	57735366	18
chr14	57735605	57756797	AP5M1	21192	+	NM_018229	57736032	57755602	8
chr14	57857270	57879466	NAA30	22196	+	NM_001011713	57857675	57876234	5
chr14	57936017	57960581	C14orf105	24564	-	NM_001283056	57938072	57960433	7
chr14	58030639	58332592	SLC35F4	301953	-	NM_001206920	58030852	58332543	8
chr14	58470807	58618847	C14orf37	148040	-	NM_001001872	58471453	58606076	8
chr14	58666832	58702353	ACTR10	35521	+	NM_018477	58666935	58701269	13
chr14	58711522	58738727	PSMA3	27205	+	NM_152132	58711638	58738613	11
chr14	58732082	58764855	PSMA3-AS1	32773	-	NR_029434	58764855	58764855	5
chr14	58765221	58840451	ARID4A	75230	+	NM_023000	58766572	58838707	24
chr14	58862643	58875419	TOMM20L	12776	+	NM_207377	58862675	58875300	5
chr14	58875211	58894332	TIMM9	19121	-	NM_001304485	58875751	58878663	5
chr14	58894102	59015549	KIAA0586	121447	+	NM_001244189	58894346	59014694	34
chr14	59100785	59115038	DACT1	14253	+	NR_046093	59115038	59115038	4
chr14	59295005	59484046	LINC01500	189041	+	NR_110547	59484046	59484046	6
chr14	59655380	59838123	DAAM1	182743	+	NM_001270520	59730195	59835577	25
chr14	59930239	59932059	GPR135	1820	-	NM_022571	59930459	59931944	1
chr14	59939405	59951073	L3HYPDH	11668	-	NM_144581	59939682	59951034	5
chr14	59951160	59972124	JKAMP	20964	+	NM_001284202	59951788	59970790	8
chr14	59971784	60043549	CCDC175	71765	-	NM_001164399	59971956	60043493	20
chr14	60062693	60337557	RTN1	274864	-	NM_021136	60063462	60337348	9
chr14	60386430	60530277	LRRC9	143847	+	NR_075071	60530277	60530277	33
chr14	60558628	60601532	PCNXL4	42904	+	NM_022495	60581430	60600939	10
chr14	60611499	60632211	DHRS7	20712	-	NM_016029	60611683	60632027	7
chr14	60712469	60765805	PPM1A	53336	+	NM_177952	60712565	60759200	6
chr14	60902673	60952764	C14orf39	50091	-	NM_174978	60903562	60951796	18
chr14	60975937	60978525	SIX6	2588	+	NM_007374	60976116	60977970	2
chr14	61105933	61107134	SALRNA1	1201	+	NR_126480	61107134	61107134	1
chr14	61111416	61116155	SIX1	4739	-	NM_005982	61113000	61115907	2
chr14	61176255	61190852	SIX4	14597	-	NM_017420	61180124	61190792	3
chr14	61201458	61435398	MNAT1	233940	+	NM_002431	61201580	61435067	8
chr14	61438166	61447797	TRMT5	9631	-	NM_020810	61441826	61447691	5
chr14	61447831	61550451	SLC38A6	102620	+	NM_001172702	61447995	61550430	17
chr14	61744088	61748530	TMEM30B	4442	-	NM_001017970	61746809	61747865	1
chr14	61788160	62017698	PRKCH	229538	+	NM_006255	61788819	62016549	14
chr14	62022989	62037371	LOC101927780	14382	-	NR_110416	62037371	62037371	5
chr14	62037257	62121431	FLJ22447	84174	+	NR_039985	62121431	62121431	3
chr14	62147758	62162541	HIF1A-AS1	14783	-	NR_047116	62162541	62162541	2
chr14	62162118	62214977	HIF1A	52859	+	NM_001530	62162522	62213803	15
chr14	62213756	62215807	HIF1A-AS2	2051	-	NR_045406	62215807	62215807	1
chr14	62229074	62263146	SNAPC1	34072	+	NM_003082	62229178	62261701	10
chr14	62462540	62568427	SYT16	105887	+	NM_031914	62462737	62567425	6
chr14	62584074	62600903	LINC00643	16829	+	NR_015358	62600903	62600903	4
chr14	62600867	62606691	LINC00644	5824	-	NR_104063	62606691	62606691	2
chr14	63173290	63511956	KCNH5	338666	-	NM_139318	63174225	63511904	11
chr14	63671101	63760230	RHOJ	89129	+	NM_020663	63671587	63757742	5
chr14	63779548	63785593	GPHB5	6045	-	NM_145171	63779641	63784563	3
chr14	63840609	64010079	PPP2R5E	169470	-	NM_006246	63842726	64006403	14
chr14	64063756	64108641	WDR89	44885	-	NM_001008726	64065496	64066660	4
chr14	64150934	64194813	SGPP1	43879	-	NM_030791	64152822	64194662	3
chr14	64319682	64693167	SYNE2	373485	+	NM_182914	64375866	64692244	116
chr14	64419067	64927439	MIR548AZ	508372	-	NR_106755	64927439	64927439	3
chr14	64561741	64561843	MIR548H1	102	-	NR_031677	64561843	64561843	1
chr14	64693429	64805268	ESR2	111839	-	NM_001291712	64694250	64749703	14
chr14	64812190	64814329	TEX21P	2139	-	NR_033777	64814329	64814329	2
chr14	64854758	64926725	MTHFD1	71967	+	NM_005956	64855145	64925021	28
chr14	64915823	64971931	ZBTB25	56108	-	NM_001304508	64916268	64957251	3
chr14	64932216	64941221	AKAP5	9005	+	NM_004857	64935112	64936396	2
chr14	64971291	65000408	ZBTB1	29117	+	NM_014950	64988222	64998615	3
chr14	64980868	65007086	LOC102723809	26218	-	NR_110550	65007086	65007086	4
chr14	65007185	65009954	HSPA2	2769	+	NM_021979	65007567	65009487	1
chr14	65016619	65056097	PPP1R36	39478	+	NM_172365	65016715	65056056	12
chr14	65171125	65211064	PLEKHG3	39939	+	NM_001308147	65194349	65210421	17
chr14	65213000	65289866	SPTB	76866	-	NM_001024858	65216023	65289812	35
chr14	65252343	65252404	MIR7855	61	-	NR_107009	65252404	65252404	1
chr14	65381078	65402084	CHURC1	21006	+	NM_001204063	65381132	65398948	4
chr14	65381078	65529373	CHURC1-FNTB	148295	+	NM_001202559	65381132	65528030	14
chr14	65405869	65409623	GPX2	3754	-	NR_046321	65409623	65409623	3
chr14	65412531	65438875	RAB15	26344	-	NM_198686	65415214	65438794	7
chr14	65453506	65529370	FNTB	75864	+	NM_002028	65453671	65528030	12
chr14	65472818	65569262	MAX	96444	-	NM_197957	65472921	65569057	4
chr14	65511405	65511487	MIR4706	82	+	NR_039855	65511487	65511487	1
chr14	65556635	65561029	LOC100506321	4394	+	NR_045122	65561029	65561029	3
chr14	65679610	65689065	LOC100128233	9455	-	NR_103769	65689065	65689065	4
chr14	65801835	65801901	MIR4708	66	-	NR_039857	65801901	65801901	1
chr14	65877309	66210839	FUT8	333530	+	NM_178155	66028281	66209128	11
chr14	65877310	65879335	FUT8-AS1	2025	-	NR_024334	65879335	65879335	1
chr14	65937819	65937904	MIR625	85	+	NR_030355	65937904	65937904	1
chr14	66953088	66965271	LINC00238	12183	+	NR_024338	66965271	66965271	11
chr14	66974124	67648525	GPHN	674401	+	NM_020806	66975245	67647654	23
chr14	67656109	67695267	FAM71D	39158	+	NM_173526	67664878	67691914	9
chr14	67708011	67802778	MPP5	94767	+	NM_022474	67745887	67799673	15
chr14	67804580	67826720	ATP6V1D	22140	-	NM_015994	67805337	67826415	9
chr14	67827033	67853233	EIF2S1	26200	+	NM_004094	67831484	67850157	8
chr14	67853695	67878917	PLEK2	25222	-	NM_016445	67854045	67878776	9
chr14	67936982	67982021	TMEM229B	45039	-	NM_182526	67940136	67940640	3
chr14	68000007	68056255	PLEKHH1	56248	+	NM_020715	68008584	68053952	29
chr14	68056022	68067017	PIGH	10995	-	NM_004569	68056796	68066920	4
chr14	68086578	68118436	ARG2	31858	+	NM_001172	68086694	68117637	8
chr14	68117866	68141602	VTI1B	23736	-	NM_006370	68118101	68141206	6
chr14	68143518	68162510	RDH11	18992	-	NM_016026	68145037	68162420	7
chr14	68168602	68201168	RDH12	32566	+	NM_152443	68189359	68200565	9
chr14	68213236	68283306	ZFYVE26	70070	-	NM_015346	68215152	68282680	42
chr14	68286495	69062738	RAD51B	776243	+	NM_133509	68290260	69061320	11
chr14	69254371	69262960	ZFP36L1	8589	-	NM_001244701	69256249	69262866	3
chr14	69340839	69446083	ACTN1	105244	-	NM_001130004	69341575	69445773	22
chr14	69446398	69454180	ACTN1-AS1	7782	+	NR_073422	69454180	69454180	4
chr14	69517636	69619914	DCAF5	102278	-	NM_001284206	69520573	69619695	9
chr14	69658193	69710737	EXD2	52544	+	NR_034164	69710737	69710737	11
chr14	69726680	69821190	GALNT16	94510	+	NM_020692	69727007	69818885	16
chr14	69846839	69865021	ERH	18182	-	NM_004450	69847254	69864950	4
chr14	69865095	69929107	SLC39A9	64012	+	NM_001252152	69908934	69925310	8
chr14	69951470	69995215	PLEKHD1	43745	+	NM_001161498	69951682	69995136	13
chr14	70036530	70041600	CCDC177	5070	-	NM_001271507	70038215	70040339	2
chr14	70078309	70181861	SUSD6	103552	+	NM_014734	70125309	70177696	6
chr14	70232999	70234430	LOC100289511	1431	-	NR_029378	70234430	70234430	1
chr14	70233828	70238722	SRSF5	4894	+	NM_001039465	70234873	70238178	8
chr14	70242551	70264006	SLC10A1	21455	-	NM_003049	70242998	70263872	5
chr14	70346113	70499083	SMOC1	152970	+	NM_001034852	70346395	70496975	12
chr14	70510933	70655787	SLC8A3	144854	-	NM_058240	70512663	70635139	8
chr14	70712469	70714518	ADAM21P1	2049	-	NR_003951	70714518	70714518	1
chr14	70791797	70826448	COX16	34651	-	NM_016468	70793049	70826304	4
chr14	70791797	70883807	SYNJ2BP-COX16	92010	-	NM_001202548	70793049	70883680	6
chr14	70833212	70883807	SYNJ2BP	50595	-	NM_018373	70839707	70883680	4
chr14	70918873	70926622	ADAM21	7749	+	NM_003813	70924216	70926385	2
chr14	70935595	70950473	ADAM20P1	14878	-	NR_037933	70950473	70950473	2
chr14	70989077	71001732	ADAM20	12655	-	NM_003814	70989293	70991624	2
chr14	71049937	71067407	MED6	17470	-	NM_001284211	71050810	71067354	9
chr14	71075514	71108015	LOC101928075	32501	-	NR_110071	71108015	71108015	3
chr14	71108503	71142077	TTC9	33574	+	NM_015351	71108846	71137872	3
chr14	71165414	71178870	LINC01269	13456	+	NR_125769	71178870	71178870	4
chr14	71189242	71275888	MAP3K9	86646	-	NM_033141	71197096	71275888	13
chr14	71374121	71582099	PCNX	207978	+	NM_014982	71374567	71576652	36
chr14	71865053	71865124	SNORD56B	71	+	NR_001276	71865124	71865124	1
chr14	71954577	71956420	LOC145474	1843	+	NR_027046	71956420	71956420	1
chr14	71996028	72207946	SIPA1L1	211918	+	NM_015556	72054589	72205878	22
chr14	72398816	73033238	RGS6	634422	+	NM_001204423	72818823	73029175	16
chr14	72983527	72983606	MIR7843	79	+	NR_106994	72983606	72983606	1
chr14	73086003	73360824	DPF3	274821	-	NM_001280542	73086004	73360796	11
chr14	73393039	73426357	DCAF4	33318	+	NM_001163508	73404686	73425513	14
chr14	73436152	73493920	ZFYVE1	57768	-	NM_021260	73437589	73491216	12
chr14	73525220	73588076	RBM25	62856	+	NM_021239	73538349	73586513	19
chr14	73603142	73690399	PSEN1	87257	+	NM_000021	73614727	73685997	12
chr14	73704204	73741347	PAPLN	37143	+	NM_173462	73706486	73739372	26
chr14	73741917	73925286	NUMB	183369	-	NM_001005743	73743285	73822459	13
chr14	73945188	74025651	HEATR4	80463	-	NM_001220484	73945310	73989856	18
chr14	73957638	73960105	C14orf169	2467	+	NM_024644	73957722	73959647	1
chr14	74003927	74010498	ACOT1	6571	+	NM_001037161	74004125	74010359	3
chr14	74034323	74042362	ACOT2	8039	+	NR_046028	74042362	74042362	4
chr14	74058409	74062470	ACOT4	4061	+	NM_152331	74058663	74062358	3
chr14	74083547	74086592	ACOT6	3045	+	NM_001037162	74083878	74086543	2
chr14	74111577	74170431	DNAL1	58854	+	NM_001201366	74125624	74162645	9
chr14	74178485	74181128	PNMA1	2643	-	NM_006029	74179280	74180342	1
chr14	74181824	74253961	ELMSAN1	72137	-	NM_001043318	74186003	74206711	12
chr14	74225449	74225522	MIR4505	73	+	NR_039727	74225522	74225522	1
chr14	74254062	74270331	LOC100506476	16269	+	NR_109995	74270331	74270331	3
chr14	74318533	74352168	PTGR2	33635	+	NM_001146154	74325565	74350880	10
chr14	74353317	74398991	ZNF410	45674	+	NM_001242924	74358878	74391506	14
chr14	74399694	74417117	FAM161B	17423	-	NM_152445	74400958	74416918	9
chr14	74416636	74429813	COQ6	13177	+	NM_182480	74416795	74429702	12
chr14	74433180	74486026	ENTPD5	52846	-	NM_001249	74433630	74454805	16
chr14	74486058	74532796	BBOF1	46738	+	NM_025057	74486181	74531402	12
chr14	74524367	74551196	ALDH6A1	26829	-	NM_001278594	74527344	74538165	12
chr14	74551655	74667117	LIN52	115462	+	NM_001024674	74551665	74665680	6
chr14	74706174	74729441	VSX2	23267	+	NM_182894	74706264	74727622	5
chr14	74751979	74769767	ABCD4	17788	-	NM_005050	74753163	74769615	19
chr14	74815165	74826711	VRTN	11546	+	NM_018228	74823486	74825595	2
chr14	74872595	74892805	SYNDIG1L	20210	-	NM_001105579	74874237	74876447	4
chr14	74946642	74960084	NPC2	13442	-	NM_006432	74946976	74959977	5
chr14	74946835	74946907	MIR4709	72	-	NR_039858	74946907	74946907	1
chr14	74960422	74962271	ISCA2	1849	+	NM_194279	74960477	74961703	4
chr14	74964885	75079034	LTBP2	114149	-	NM_000428	74967586	75078647	36
chr14	75127954	75179807	AREL1	51853	-	NM_001039479	75130422	75152318	20
chr14	75179849	75203390	FCF1	23541	+	NM_015962	75179900	75201633	8
chr14	75230068	75304013	YLPM1	73945	+	NM_019589	75230192	75302114	21
chr14	75319735	75330537	PROX2	10802	-	NM_001243007	75321834	75330537	4
chr14	75348593	75370450	DLST	21857	+	NM_001933	75348656	75369033	15
chr14	75370656	75389145	RPS6KL1	18489	-	NM_031464	75373716	75388244	11
chr14	75408532	75422467	PGF	13935	-	NM_002632	75409408	75421945	7
chr14	75469611	75476294	EIF2B2	6683	+	NM_014239	75469693	75475891	8
chr14	75480466	75518235	MLH3	37769	-	NM_001040108	75483784	75516358	13
chr14	75519927	75536186	ACYP1	16259	-	NM_001302617	75520146	75535994	3
chr14	75536279	75546690	ZC2HC1C	10411	+	NM_024643	75537276	75544267	3
chr14	75548817	75593778	NEK9	44961	-	NM_033116	75551266	75593624	22
chr14	75598170	75643349	TMED10	45179	-	NM_006827	75601587	75643282	5
chr14	75745480	75748937	FOS	3457	+	NM_005252	75745685	75748127	4
chr14	75761106	75763111	LINC01220	2005	+	NR_038421	75763111	75763111	3
chr14	75894508	75939404	JDP2	44896	+	NM_001135047	75904623	75936178	4
chr14	75988783	76013334	BATF	24551	+	NM_006399	75989025	76013014	3
chr14	76041246	76045931	LOC102724153	4685	-	NR_110552	76045931	76045931	3
chr14	76044939	76114512	FLVCR2	69573	+	NM_017791	76045315	76112815	10
chr14	76117232	76127538	C14orf1	10306	-	NM_007176	76117897	76123845	5
chr14	76127550	76421425	TTLL5	293875	+	NM_015072	76129492	76420789	32
chr14	76424439	76448365	TGFB3	23926	-	NM_003239	76425529	76447236	7
chr14	76452095	76550416	IFT43	98321	+	NR_045665	76550416	76550416	10
chr14	76618227	76679146	GPATCH2L	60919	+	NM_017926	76620706	76668194	10
chr14	76837689	76968180	ESRRB	130491	+	NM_004452	76905696	76967064	11
chr14	77228234	77249363	VASH1	21129	+	NM_014909	77229164	77245361	7
chr14	77248075	77253067	LOC100506603	4992	-	NR_104183	77253067	77253067	3
chr14	77253585	77279283	ANGEL1	25698	-	NM_015305	77255570	77279170	10
chr14	77292724	77336645	LRRC74A	43921	+	NM_194287	77292838	77336492	14
chr14	77425980	77432145	LINC01629	6165	+	NR_133913	77432145	77432145	3
chr14	77490885	77495042	IRF2BPL	4157	-	NM_024496	77491744	77494135	1
chr14	77507391	77535846	LOC283575	28455	+	NR_110554	77535846	77535846	4
chr14	77535522	77542534	LOC102724190	7012	-	NR_110553	77542534	77542534	3
chr14	77564577	77583630	CIPC	19053	+	NM_033426	77572051	77580661	4
chr14	77597612	77608134	ZDHHC22	10522	-	NM_174976	77600025	77606081	3
chr14	77648101	77725838	TMEM63C	77737	+	NM_020431	77685156	77723069	24
chr14	77731833	77737655	NGB	5822	-	NM_021257	77732878	77737280	4
chr14	77732560	77732633	MIR1260A	73	+	NR_031661	77732633	77732633	1
chr14	77741298	77787225	POMT2	45927	-	NM_013382	77743718	77787024	21
chr14	77787229	77797940	GSTZ1	10711	+	NM_001312660	77793844	77797538	10
chr14	77808113	77843396	TMED8	35283	-	NM_213601	77808113	77843396	6
chr14	77843761	77857587	SAMD15	13826	+	NM_001010860	77843761	77857587	3
chr14	77860364	77889399	NOXRED1	29035	-	NM_001113475	77860973	77889232	6
chr14	77893017	77923983	VIPAS39	30966	-	NM_022067	77893958	77920445	21
chr14	77924372	77935815	AHSA1	11443	+	NM_012111	77924532	77935592	9
chr14	77940737	77965210	ISM2	24473	-	NM_199296	77941937	77965136	7
chr14	77972339	78083110	SPTLC2	110771	-	NM_004863	77978626	78082922	12
chr14	78138748	78174356	ALKBH1	35608	-	NM_006020	78140154	78174347	6
chr14	78174413	78183941	SLIRP	9528	+	NR_052025	78183941	78183941	5
chr14	78183943	78227497	SNW1	43554	-	NM_012245	78184430	78227470	14
chr14	78227172	78236085	C14orf178	8913	+	NM_174943	78227385	78236021	3
chr14	78266425	78400297	ADCK1	133872	+	NM_020421	78285321	78399734	11
chr14	78636715	80334633	NRXN3	1697918	+	NR_073547	80334633	80334633	21
chr14	80663867	80697397	DIO2	33530	-	NM_000793	80669031	80677815	4
chr14	80677761	80921810	DIO2-AS1	244049	+	NR_038355	80921810	80921810	9
chr14	80962820	81405884	CEP128	443064	-	NM_152446	80963821	81382891	24
chr14	81421868	81612646	TSHR	190778	+	NM_000369	81422024	81610697	10
chr14	81641795	81687575	GTF2A1	45780	-	NM_201595	81646566	81682771	9
chr14	81669038	81669178	SNORA79	140	-	NR_003021	81669178	81669178	1
chr14	81726993	81893748	STON2	166755	-	NM_001256430	81728125	81864726	8
chr14	81908330	81916501	LOC100506700	8171	-	NR_109999	81916501	81916501	3
chr14	81937890	82000205	SEL1L	62315	-	NM_005065	81943315	82000088	21
chr14	82071690	82089405	LINC01467	17715	-	NR_110074	82089405	82089405	3
chr14	85860222	85886418	LINC00911	26196	+	NR_102737	85886418	85886418	3
chr14	85996487	86094270	FLRT2	97783	+	NM_013231	86087858	86089841	2
chr14	86401021	86596121	LOC101928767	195100	+	NR_110155	86596121	86596121	4
chr14	87372121	87389099	LOC283585	16978	+	NR_038445	87389099	87389099	5
chr14	88399357	88460009	GALC	60652	-	NM_001201402	88401075	88459843	17
chr14	88471467	88481155	GPR65	9688	+	NM_003608	88477191	88478205	2
chr14	88484948	88492656	LOC101928791	7708	-	NR_110121	88492656	88492656	3
chr14	88490893	88553688	LINC01146	62795	+	NR_046094	88553688	88553688	4
chr14	88646451	88793256	KCNK10	146805	-	NM_021161	88651878	88792799	7
chr14	88851987	88904804	SPATA7	52817	+	NM_018418	88852162	88904766	12
chr14	88932121	89021123	PTPN21	89002	-	NM_007039	88934480	89016761	19
chr14	89029252	89079853	ZC3H14	50601	+	NM_024824	89029477	89078095	17
chr14	89081173	89259096	EML5	177923	-	NM_183387	89082161	89258847	43
chr14	89290496	89344340	TTC8	53844	+	NM_144596	89291051	89343754	16
chr14	89622515	90085494	FOXN3	462979	-	NM_001085471	89628757	89878820	7
chr14	89883697	89886137	FOXN3-AS1	2440	+	NR_036500	89886137	89886137	2
chr14	90042559	90043820	FOXN3-AS2	1261	+	NR_024620	90043820	90043820	1
chr14	90261335	90421121	EFCAB11	159786	-	NM_001284267	90263586	90420276	6
chr14	90422245	90511108	TDP1	88863	+	NM_018319	90429458	90509487	17
chr14	90528108	90652201	KCNK13	124093	+	NM_022054	90528549	90651347	2
chr14	90722893	90738966	PSMC1	16073	+	NM_002802	90722941	90738751	11
chr14	90744397	90798481	NRDE2	54084	-	NM_017970	90744679	90798248	14
chr14	90863326	90874619	CALM1	11293	+	NM_006888	90863574	90871061	6
chr14	90921573	90925249	LINC00642	3676	+	NR_033986	90925249	90925249	4
chr14	91006931	91282761	TTC7B	275830	-	NM_001010854	91007711	91282639	20
chr14	91108972	91115232	LOC101928909	6260	+	NR_110134	91115232	91115232	5
chr14	91337166	91526993	RPS6KA5	189827	-	NM_004755	91338417	91526778	17
chr14	91580356	91691740	C14orf159	111384	+	NM_001286470	91626638	91691177	17
chr14	91592769	91592896	SNORA11B	127	+	NR_003709	91592896	91592896	1
chr14	91698875	91720224	GPR68	21349	-	NM_003485	91700296	91701394	2
chr14	91737666	91884188	CCDC88C	146522	-	NM_001080414	91738968	91884034	30
chr14	91923824	91976824	PPP4R3A	53000	-	NM_001284280	91925102	91975991	15
chr14	92047117	92198430	CATSPERB	151313	-	NM_024764	92047232	92195823	27
chr14	92246095	92333880	TC2N	87785	-	NM_001128596	92249443	92280113	12
chr14	92335754	92414046	FBLN5	78292	-	NM_006329	92336567	92413573	11
chr14	92434242	92506403	TRIP11	72161	-	NM_004239	92436016	92506029	21
chr14	92524895	92572965	ATXN3	48070	-	NR_028457	92572965	92572965	12
chr14	92582467	92588153	NDUFB1	5686	-	NM_004545	92582536	92588121	3
chr14	92588297	92630543	CPSF2	42246	+	NM_017437	92597328	92628088	16
chr14	92788924	92967825	SLC24A4	178901	+	NM_153648	92792273	92959972	17
chr14	92980124	93155334	RIN3	175210	+	NM_024832	92980276	93154597	10
chr14	93170151	93215047	LGMN	44896	-	NM_001008530	93170663	93199131	15
chr14	93260575	93306306	GOLGA5	45731	+	NM_005113	93263782	93305791	13
chr14	93389444	93401641	CHGA	12197	+	NM_001301690	93389704	93401229	7
chr14	93403258	93582263	ITPK1	179005	-	NM_001142594	93404827	93581508	11
chr14	93533796	93538478	ITPK1-AS1	4682	+	NR_002808	93538478	93538478	1
chr14	93648540	93651249	MOAP1	2709	-	NM_022151	93649531	93650587	3
chr14	93651295	93653431	TMEM251	2136	+	NM_015676	93652620	93653016	2
chr14	93669236	93673459	C14orf142	4223	-	NM_032490	93670032	93673382	2
chr14	93673400	93695561	UBR7	22161	+	NM_175748	93673636	93693381	11
chr14	93703895	93799438	BTBD7	95543	-	NM_001002860	93708618	93762397	11
chr14	93799564	94173689	UNC79	374125	+	NM_020818	93943986	94173250	50
chr14	93813536	93814700	COX8C	1164	+	NM_182971	93813614	93814466	2
chr14	94184643	94254766	PRIMA1	70123	-	NM_178013	94187789	94254064	5
chr14	94371075	94392718	FAM181A-AS1	21643	-	NR_027004	94392718	94392718	11
chr14	94385239	94395954	FAM181A	10715	+	NM_138344	94391617	94395510	3
chr14	94400498	94443076	ASB2	42578	-	NM_001202429	94401001	94430885	10
chr14	94414571	94414648	MIR4506	77	-	NR_039728	94414648	94414648	1
chr14	94463641	94478041	LINC00521	14400	+	NR_024183	94478041	94478041	11
chr14	94492723	94515276	OTUB2	22553	+	NM_023112	94492883	94512268	6
chr14	94517267	94547558	DDX24	30291	-	NM_020414	94517536	94546088	9
chr14	94547638	94569060	IFI27L1	21422	+	NM_145249	94563283	94568914	5
chr14	94577078	94583036	IFI27	5958	+	NM_001288954	94578028	94582864	6
chr14	94594117	94595957	IFI27L2	1840	-	NM_032036	94594135	94595901	4
chr14	94640648	94746072	PPP4R4	105424	+	NM_058237	94640802	94744980	25
chr14	94749649	94759608	SERPINA10	9959	-	NM_001100607	94750301	94756930	5
chr14	94770584	94789688	SERPINA6	19104	-	NM_001756	94770754	94780985	5
chr14	94829974	94833039	SERPINA2	3065	-	NM_006220	94830050	94833035	3
chr14	94843083	94857029	SERPINA1	13946	-	NM_001127701	94844785	94849574	7
chr14	94908800	94919122	SERPINA11	10322	-	NM_001080451	94908942	94915111	5
chr14	94929057	94942670	SERPINA9	13613	-	NM_001284276	94929429	94935784	6
chr14	94953619	94984181	SERPINA12	30562	-	NM_173850	94953639	94964734	6
chr14	95027756	95036250	SERPINA4	8494	+	NM_001289032	95028052	95035932	5
chr14	95047705	95059457	SERPINA5	11752	+	NM_000624	95053699	95058576	6
chr14	95078713	95090390	SERPINA3	11677	+	NM_001085	95080778	95090151	5
chr14	95107061	95113331	SERPINA13P	6270	+	NR_015340	95113331	95113331	5
chr14	95234559	95236499	GSC	1940	-	NM_173849	95234827	95236352	3
chr14	95552564	95624347	DICER1	71783	-	NM_030621	95556834	95599795	29
chr14	95604255	95604323	MIR3173	68	-	NR_036131	95604323	95604323	1
chr14	95624024	95646270	DICER1-AS1	22246	+	NR_015415	95646270	95646270	4
chr14	95648275	95786245	CLMN	137970	-	NM_024734	95657900	95786129	13
chr14	95795920	95801841	LOC101929080	5921	+	NR_110127	95801841	95801841	3
chr14	95873603	95876427	LINC00341	2824	-	NR_026779	95876427	95876427	1
chr14	95883830	95942173	SYNE3	58343	-	NM_152592	95884162	95942158	17
chr14	95999248	96001209	SNHG10	1961	-	NR_001459	96001209	96001209	2
chr14	95999691	95999966	SCARNA13	275	-	NR_003002	95999966	95999966	1
chr14	96001322	96011055	GLRX5	9733	+	NM_016417	96001426	96010462	2
chr14	96117514	96139789	TCL6	22275	+	NR_028288	96139789	96139789	8
chr14	96152753	96158980	TCL1B	6227	+	NM_004918	96152804	96157658	4
chr14	96176303	96180533	TCL1A	4230	-	NR_049726	96180533	96180533	5
chr14	96342728	96391908	TUNAR	49180	+	NR_132399	96391908	96391908	2
chr14	96505660	96560308	C14orf132	54648	+	NM_001282464	96505837	96553072	3
chr14	96671134	96710666	BDKRB2	39532	+	NM_000623	96703444	96707841	3
chr14	96722546	96731100	BDKRB1	8554	+	NM_000710	96730019	96731081	3
chr14	96747594	96829678	ATG2B	82084	-	NM_018036	96752091	96829313	42
chr14	96829788	96853627	GSKIP	23839	+	NM_016472	96848584	96852021	4
chr14	96858447	96955764	AK7	97317	+	NM_152327	96858491	96954680	18
chr14	96967984	96968663	LOC730202	679	-	NR_122121	96968663	96968663	1
chr14	96968712	97033453	PAPOLA	64741	+	NM_032632	96968929	97031387	22
chr14	97263683	97347951	VRK1	84268	+	NM_003384	97299808	97347545	13
chr14	97409915	97411731	LINC00618	1816	+	NR_104113	97411731	97411731	3
chr14	97925152	98047720	LOC101929241	122568	+	NR_110166	98047720	98047720	5
chr14	98098983	98152995	LOC100129345	54012	-	NR_033943	98152995	98152995	4
chr14	98391946	98444461	LINC01550	52515	-	NR_015430	98444461	98444461	3
chr14	99177949	99184103	C14orf177	6154	+	NM_182560	99182528	99183611	4
chr14	99635624	99738050	BCL11B	102426	-	NM_001282237	99640487	99737555	4
chr14	99864082	99947226	SETD3	83144	-	NM_032233	99865015	99932142	13
chr14	99947738	99977852	CCNK	30114	+	NM_001099402	99959014	99977119	11
chr14	99977602	100070727	CCDC85C	93125	-	NM_001144995	99981582	100070296	6
chr14	100111479	100143011	HHIPL1	31532	+	NM_001127258	100111544	100141963	9
chr14	100140218	100140241	MIR5698	23	+	NR_049883	100140241	100140241	1
chr14	100150754	100193638	CYP46A1	42884	+	NM_006668	100150754	100193064	15
chr14	100259744	100408395	EML1	148651	+	NM_001008707	100259813	100406449	23
chr14	100531750	100610573	EVL	78823	+	NM_016337	100531837	100610075	14
chr14	100575755	100575851	MIR151B	96	-	NR_039601	100575851	100575851	1
chr14	100575991	100576090	MIR342	99	+	NR_029888	100576090	100576090	1
chr14	100612752	100626012	DEGS2	13260	-	NM_206918	100613097	100625924	3
chr14	100705101	100745371	YY1	40270	+	NM_003403	100705581	100743937	5
chr14	100743693	100743754	MIR6764	61	+	NR_106822	100743754	100743754	1
chr14	100757447	100772884	SLC25A29	15437	-	NM_001291814	100758619	100759333	5
chr14	100774195	100774293	MIR345	98	+	NR_029906	100774293	100774293	1
chr14	100789678	100796715	SLC25A47	7037	+	NM_207117	100789751	100795982	6
chr14	100800124	100842680	WARS	42556	-	NM_173701	100801211	100835522	11
chr14	100842754	100996640	WDR25	153886	+	NM_001161476	100847261	100996378	7
chr14	101003483	101036131	BEGAIN	32648	-	NM_020836	101004305	101034261	7
chr14	101123604	101139081	LINC00523	15477	+	NR_024096	101139081	101139081	2
chr14	101193201	101204561	DLK1	11360	+	NM_001317172	101193405	101201233	6
chr14	101280827	101280911	MIR2392	84	+	NR_039729	101280911	101280911	1
chr14	101292444	101327360	MEG3	34916	+	NR_003530	101327360	101327360	9
chr14	101318726	101318824	MIR770	98	+	NR_030528	101318824	101318824	1
chr14	101335396	101335485	MIR493	89	+	NR_030172	101335485	101335485	1
chr14	101340829	101340922	MIR337	93	+	NR_029889	101340922	101340922	1
chr14	101341369	101341441	MIR665	72	+	NR_030617	101341441	101341441	1
chr14	101346991	101351184	RTL1	4193	-	NM_001134888	101347048	101351125	1
chr14	101347343	101347457	MIR431	114	+	NR_029965	101347457	101347457	1
chr14	101348222	101348315	MIR433	93	+	NR_029966	101348315	101348315	1
chr14	101349315	101349412	MIR127	97	+	NR_029696	101349412	101349412	1
chr14	101350819	101350913	MIR432	94	+	NR_030173	101350913	101350913	1
chr14	101351038	101351120	MIR136	82	+	NR_029699	101351120	101351120	1
chr14	101361106	101373305	MEG8	12199	+	NR_024149	101373305	101373305	4
chr14	101377475	101377550	MIR370	75	+	NR_029863	101377550	101377550	1
chr14	101391157	101391227	SNORD113-1	70	+	NR_003229	101391227	101391227	1
chr14	101393678	101393749	SNORD113-2	71	+	NR_003230	101393749	101393749	1
chr14	101402827	101402901	SNORD113-4	74	+	NR_003232	101402901	101402901	1
chr14	101404523	101404600	SNORD113-5	77	+	NR_003233	101404600	101404600	1
chr14	101405892	101405966	SNORD113-6	74	+	NR_003234	101405966	101405966	1
chr14	101407462	101407538	SNORD113-7	76	+	NR_003235	101407538	101407538	1
chr14	101411985	101412056	SNORD113-9	71	+	NR_003237	101412056	101412056	1
chr14	101416169	101416240	SNORD114-1	71	+	NR_003193	101416240	101416240	1
chr14	101418192	101418269	SNORD114-2	77	+	NR_003194	101418269	101418269	1
chr14	101419685	101419759	SNORD114-3	74	+	NR_003195	101419759	101419759	1
chr14	101420680	101420784	SNORD114-4	104	+	NR_003196	101420784	101420784	1
chr14	101421706	101421775	SNORD114-5	69	+	NR_003197	101421775	101421775	1
chr14	101423502	101423573	SNORD114-6	71	+	NR_003198	101423573	101423573	1
chr14	101429390	101429466	SNORD114-7	76	+	NR_003199	101429466	101429466	1
chr14	101431117	101431188	SNORD114-8	71	+	NR_003200	101431188	101431188	1
chr14	101432365	101432436	SNORD114-9	71	+	NR_003201	101432436	101432436	1
chr14	101433388	101433459	SNORD114-10	71	+	NR_003203	101433459	101433459	1
chr14	101433988	101452987	SNHG24	18999	+	NR_110178	101452987	101452987	12
chr14	101434447	101434521	SNORD114-11	74	+	NR_003204	101434521	101434521	1
chr14	101435284	101435358	SNORD114-12	74	+	NR_003205	101435358	101435358	1
chr14	101436215	101436288	SNORD114-13	73	+	NR_003206	101436288	101436288	1
chr14	101438439	101438513	SNORD114-14	74	+	NR_003207	101438513	101438513	1
chr14	101439006	101439077	SNORD114-15	71	+	NR_003208	101439077	101439077	1
chr14	101439931	101440000	SNORD114-16	69	+	NR_003209	101440000	101440000	1
chr14	101441142	101441216	SNORD114-17	74	+	NR_003210	101441216	101441216	1
chr14	101442161	101442232	SNORD114-18	71	+	NR_003211	101442232	101442232	1
chr14	101442813	101442887	SNORD114-19	74	+	NR_003212	101442887	101442887	1
chr14	101447340	101447411	SNORD114-20	71	+	NR_003213	101447411	101447411	1
chr14	101448311	101448382	SNORD114-21	71	+	NR_003214	101448382	101448382	1
chr14	101449262	101449333	SNORD114-22	71	+	NR_003215	101449333	101449333	1
chr14	101450212	101450283	SNORD114-23	71	+	NR_003216	101450283	101450283	1
chr14	101451113	101451184	SNORD114-24	71	+	NR_003217	101451184	101451184	1
chr14	101452393	101452464	SNORD114-25	71	+	NR_003218	101452464	101452464	1
chr14	101453382	101453453	SNORD114-26	71	+	NR_003219	101453453	101453453	1
chr14	101454497	101454566	SNORD114-27	69	+	NR_003220	101454566	101454566	1
chr14	101455466	101455537	SNORD114-28	71	+	NR_003221	101455537	101455537	1
chr14	101456427	101456496	SNORD114-29	69	+	NR_003222	101456496	101456496	1
chr14	101458255	101458326	SNORD114-30	71	+	NR_003223	101458326	101458326	1
chr14	101459572	101459646	SNORD114-31	74	+	NR_003224	101459646	101459646	1
chr14	101488402	101488469	MIR379	67	+	NR_029871	101488469	101488469	1
chr14	101489661	101489757	MIR411	96	+	NR_030389	101489757	101489757	1
chr14	101490130	101490193	MIR299	63	+	NR_029841	101490193	101490193	1
chr14	101491353	101491414	MIR380	61	+	NR_029872	101491414	101491414	1
chr14	101491900	101491988	MIR1197	88	+	NR_031713	101491988	101491988	1
chr14	101492068	101492154	MIR323A	86	+	NR_029890	101492154	101492154	1
chr14	101492356	101492444	MIR758	88	+	NR_030406	101492444	101492444	1
chr14	101493121	101493201	MIR329-1	80	+	NR_029967	101493201	101493201	1
chr14	101493436	101493520	MIR329-2	84	+	NR_029968	101493520	101493520	1
chr14	101495970	101496051	MIR494	81	+	NR_030174	101496051	101496051	1
chr14	101496388	101496466	MIR1193	78	+	NR_036132	101496466	101496466	1
chr14	101498323	101498401	MIR543	78	+	NR_030619	101498401	101498401	1
chr14	101500091	101500173	MIR495	82	+	NR_030175	101500173	101500173	1
chr14	101506026	101506092	MIR376C	66	+	NR_029861	101506092	101506092	1
chr14	101506405	101506485	MIR376A2	80	+	NR_030266	101506485	101506485	1
chr14	101506555	101506636	MIR654	81	+	NR_030390	101506636	101506636	1
chr14	101506772	101506872	MIR376B	100	+	NR_030157	101506872	101506872	1
chr14	101507118	101507186	MIR376A1	68	+	NR_029868	101507186	101507186	1
chr14	101507699	101507781	MIR300	82	+	NR_030582	101507781	101507781	1
chr14	101509313	101509398	MIR1185-1	85	+	NR_031575	101509398	101509398	1
chr14	101510534	101510619	MIR1185-2	85	+	NR_031571	101510619	101510619	1
chr14	101511493	101518132	MIR381HG	6639	+	NR_104192	101518132	101518132	3
chr14	101512256	101512331	MIR381	75	+	NR_029873	101512331	101512331	1
chr14	101512791	101512875	MIR487B	84	+	NR_030267	101512875	101512875	1
chr14	101513657	101513735	MIR539	78	+	NR_030256	101513735	101513735	1
chr14	101514237	101514316	MIR889	79	+	NR_030595	101514316	101514316	1
chr14	101514994	101515085	MIR544A	91	+	NR_030257	101515085	101515085	1
chr14	101515886	101515983	MIR655	97	+	NR_030391	101515983	101515983	1
chr14	101518782	101518862	MIR487A	80	+	NR_030162	101518862	101518862	1
chr14	101520642	101520718	MIR382	76	+	NR_029874	101520718	101520718	1
chr14	101521023	101521096	MIR134	73	+	NR_029698	101521096	101521096	1
chr14	101521594	101521660	MIR668	66	+	NR_030408	101521660	101521660	1
chr14	101521755	101521828	MIR485	73	+	NR_030160	101521828	101521828	1
chr14	101522555	101522637	MIR323B	82	+	NR_036133	101522637	101522637	1
chr14	101526091	101526175	MIR154	84	+	NR_029704	101526175	101526175	1
chr14	101526909	101527011	MIR496	102	+	NR_030176	101527011	101527011	1
chr14	101528386	101528455	MIR377	69	+	NR_029869	101528455	101528455	1
chr14	101530831	101530915	MIR541	84	+	NR_030594	101530915	101530915	1
chr14	101531636	101531715	MIR409	79	+	NR_029975	101531715	101531715	1
chr14	101531783	101531874	MIR412	91	+	NR_030155	101531874	101531874	1
chr14	101531934	101532004	MIR369	70	+	NR_029862	101532004	101532004	1
chr14	101532248	101532328	MIR410	80	+	NR_030156	101532328	101532328	1
chr14	101533060	101533138	MIR656	78	+	NR_030392	101533138	101533138	1
chr14	101536247	101539273	MEG9	3026	+	NR_047664	101539273	101539273	2
chr14	101872323	101874259	LINC00524	1936	-	NR_126006	101874259	101874259	2
chr14	102018559	102022013	DIO3OS	3454	-	NR_002770	102022013	102022013	1
chr14	102026623	102026759	MIR1247	136	-	NR_031649	102026759	102026759	1
chr14	102027687	102029789	DIO3	2102	+	NM_001362	102027833	102028748	1
chr14	102196773	102198862	LINC00239	2089	+	NR_026774	102198862	102198862	4
chr14	102228134	102394328	PPP2R5C	166194	+	NM_001161725	102228230	102391609	16
chr14	102430864	102517135	DYNC1H1	86271	+	NM_001376	102431028	102516900	78
chr14	102547074	102606086	HSP90AA1	59012	-	NM_001017963	102548048	102605741	12
chr14	102606188	102690010	WDR20	83822	+	NM_181291	102606260	102689220	4
chr14	102695157	102771537	MOK	76380	-	NM_014226	102695625	102771305	12
chr14	102783713	102809511	ZNF839	25798	+	NM_001267827	102792381	102808516	8
chr14	102814618	102829253	CINP	14635	-	NM_032630	102814893	102829188	5
chr14	102829248	102968818	TECPR2	139570	+	NM_014844	102843058	102964594	20
chr14	102973197	102976128	ANKRD9	2931	-	NM_152326	102973272	102974226	4
chr14	103005980	103006063	MIR4309	83	+	NR_036192	103006063	103006063	1
chr14	103058995	103196913	RCOR1	137918	+	NM_015156	103059223	103192843	12
chr14	103243815	103377837	TRAF3	134022	+	NM_145725	103336538	103372121	12
chr14	103388992	103397179	AMN	8187	+	NM_030943	103389025	103397017	12
chr14	103398715	103523742	CDC42BPB	125027	-	NM_006035	103400048	103523510	37
chr14	103566480	103576894	EXOC3L4	10414	+	NM_001077594	103566556	103576560	11
chr14	103592663	103603776	TNFAIP2	11113	+	NM_006291	103592794	103601697	11
chr14	103653557	103655365	LINC00605	1808	-	NR_033938	103655365	103655365	3
chr14	103800338	103811361	EIF5	11023	+	NM_001969	103802197	103807389	12
chr14	103804185	103804311	SNORA28	126	+	NR_002964	103804311	103804311	1
chr14	103851700	103970166	MARK3	118466	+	NM_001128918	103852366	103969564	18
chr14	103985994	103989196	CKB	3202	-	NM_001823	103986200	103988830	8
chr14	103995508	104003410	TRMT61A	7902	+	NM_152307	103996315	104001158	4
chr14	104022880	104029151	BAG5	6271	-	NM_001015048	104026157	104027501	2
chr14	104029293	104058510	APOPT1	29217	+	NM_032374	104029299	104056623	5
chr14	104095524	104167888	KLC1	72364	+	NM_001130107	104120901	104167540	16
chr14	104163953	104181823	XRCC3	17870	-	NM_001100119	104165134	104177424	10
chr14	104182080	104200005	ZFYVE21	17925	+	NM_001198953	104182178	104199355	8
chr14	104200087	104313927	PPP1R13B	113840	-	NM_015316	104201490	104313644	17
chr14	104314057	104324386	LINC00637	10329	+	NR_038436	104324386	104324386	3
chr14	104378624	104387903	C14orf2	9279	-	NM_001127393	104379002	104387327	5
chr14	104394816	104519004	TDRD9	124188	+	NM_153046	104394846	104518419	36
chr14	104406762	104408645	RD3L	1883	-	NM_001257268	104407142	104408032	3
chr14	104552022	104579046	ASPG	27024	+	NM_001080464	104552107	104578881	16
chr14	104583741	104583851	MIR203A	110	+	NR_029620	104583851	104583851	1
chr14	104583754	104583840	MIR203B	86	-	NR_039859	104583840	104583840	1
chr14	104605059	104647235	KIF26A	42176	+	NM_015656	104605059	104646127	15
chr14	105046020	105056184	C14orf180	10164	+	NM_001008404	105052767	105055120	5
chr14	105057200	105071097	TMEM179	13897	-	NM_001286389	105059815	105071078	4
chr14	105144030	105144086	MIR4710	56	-	NR_039860	105144086	105144086	1
chr14	105155942	105185947	INF2	30005	+	NM_022489	105167702	105181676	23
chr14	105190533	105213647	ADSSL1	23114	+	NM_152328	105190607	105213340	13
chr14	105219469	105225996	SIVA1	6527	+	NM_006427	105219538	105225822	4
chr14	105235686	105262080	AKT1	26394	-	NM_001014432	105236677	105258980	15
chr14	105267517	105271048	ZBTB42	3531	+	NM_001137601	105267534	105268803	1
chr14	105287537	105290055	LINC00638	2518	+	NR_024396	105290055	105290055	1
chr14	105331649	105363107	CEP170B	31458	+	NM_001112726	105334787	105361295	19
chr14	105391152	105399573	PLD4	8421	+	NM_001308174	105393456	105399301	11
chr14	105403590	105444694	AHNAK2	41104	-	NM_138420	105404399	105444574	7
chr14	105452615	105461855	C14orf79	9240	+	NM_174891	105452768	105461096	5
chr14	105475909	105487425	CDCA4	11516	-	NM_145701	105477540	105478266	3
chr14	105515725	105531887	GPR132	16162	-	NM_001278694	105517330	105521757	5
chr14	105560483	105565833	LOC102723354	5350	+	NR_110546	105565833	105565833	6
chr14	105607317	105635161	JAG2	27844	-	NM_002226	105609031	105634757	26
chr14	105617114	105617201	MIR6765	87	-	NR_106823	105617201	105617201	1
chr14	105639273	105647660	NUDT14	8387	-	NM_177533	105639357	105647546	5
chr14	105675622	105781914	BRF1	106292	-	NM_001242787	105676887	105739151	18
chr14	105714878	105717430	BTBD6	2552	+	NM_033271	105715207	105717009	5
chr14	105767147	105864484	PACS2	97337	+	NM_001243127	105814911	105861009	24
chr14	105864919	105880196	TEX22	15277	+	NM_001195082	105865677	105878170	4
chr14	105883917	105886076	LOC100507437	2159	-	NR_125384	105886076	105886076	3
chr14	105886185	105937057	MTA1	50872	+	NM_004689	105886372	105936552	21
chr14	105939274	105946507	CRIP2	7233	+	NM_001270837	105939584	105945990	8
chr14	105953256	105955124	CRIP1	1868	+	NM_001311	105953596	105954848	6
chr14	105956191	105965585	C14orf80	9394	+	NM_001198983	105957439	105965283	8
chr14	105992952	105996539	TMEM121	3587	+	NM_025268	105995171	105996131	2
chr14	106087452	106087517	MIR8071-1	65	+	NR_107038	106087517	106087517	1
chr14	106106504	106106569	MIR8071-2	65	+	NR_107059	106106569	106106569	1
chr14	106135913	106139144	ELK2AP	3231	-	NR_046211	106139144	106139144	3
chr14	106324292	106324344	MIR4507	52	-	NR_039730	106324344	106324344	1
chr14	106325652	106325722	MIR4537	70	-	NR_130466	106325722	106325722	1
chr14	106383837	106398502	KIAA0125	14665	+	NR_026800	106398502	106398502	6
chr14	106435817	106438358	ADAM6	2541	-	NR_002224	106438358	106438358	2
chr14	106744268	106744966	LINC00226	698	+	NR_033375	106744966	106744966	2
chr14	106938444	106951529	LINC00221	13085	+	NR_027457	106951529	106951529	3
chr14	107259099	107259214	MIR5195	115	-	NR_049827	107259214	107259214	1
chr15	20487996	20496811	CHEK2P2	8815	+	NR_038836	20496811	20496811	6
chr15	20613649	20711433	HERC2P3	97784	-	NR_036432	20711433	20711433	26
chr15	20737093	20747114	GOLGA6L6	10021	-	NM_001145004	20739496	20747023	12
chr15	20767673	20781026	GOLGA8CP	13353	+	NR_027411	20781026	20781026	18
chr15	20874796	20961480	NBEAP1	86684	-	NR_027992	20961480	20961480	3
chr15	21038123	21038198	MIR3118-2	75	+	NR_036062	21038198	21038198	1
chr15	21038123	21038198	MIR3118-3	75	+	NR_036063	21038198	21038198	1
chr15	21038123	21038198	MIR3118-4	75	+	NR_036134	21038198	21038198	1
chr15	21145580	21145662	MIR5701-1	82	+	NR_049886	21145662	21145662	1
chr15	21145580	21145662	MIR5701-2	82	+	NR_049895	21145662	21145662	1
chr15	21145580	21145662	MIR5701-3	82	+	NR_128721	21145662	21145662	1
chr15	21145766	21198633	LINC01193	52867	+	NR_040094	21198633	21198633	5
chr15	21932513	21940739	LOC646214	8226	-	NR_027053	21940739	21940739	1
chr15	22014419	22016878	CXADRP2	2459	-	NR_024387	22016878	22016878	1
chr15	22051852	22082803	POTEB2	30951	-	NM_001277303	22051871	22082770	11
chr15	22051852	22082803	POTEB	30951	-	NM_001277304	22051871	22082770	11
chr15	22051852	22083141	POTEB3	31289	-	NM_207355	22051871	22082770	11
chr15	22133180	22145802	NF1P2	12622	-	NR_028506	22145802	22145802	8
chr15	22278030	22383564	LOC101927079	105534	+	NR_110480	22383564	22383564	9
chr15	22278031	22371088	LOC727924	93057	+	NR_015416	22371088	22371088	11
chr15	22368477	22369561	OR4M2	1084	+	NM_001004719	22368575	22369517	1
chr15	22382381	22383815	OR4N4	1434	+	NM_001005241	22382472	22383423	1
chr15	22413461	22414395	OR4N3P	934	+	NR_028067	22414395	22414395	1
chr15	22546564	22570831	REREP3	24267	+	NR_033735	22570831	22570831	3
chr15	22675147	22675241	MIR4509-1	94	-	NR_039732	22675241	22675241	1
chr15	22675147	22675241	MIR4509-2	94	-	NR_039733	22675241	22675241	1
chr15	22675147	22675241	MIR4509-3	94	-	NR_039734	22675241	22675241	1
chr15	22702284	22715728	GOLGA8DP	13444	-	NR_027407	22715728	22715728	18
chr15	22736245	22746002	GOLGA6L1	9757	+	NM_001001413	22736336	22744278	9
chr15	22833394	22873891	TUBGCP5	40497	+	NM_052903	22833524	22873248	23
chr15	22892648	23003603	CYFIP1	110955	+	NM_001287810	22925782	23003040	32
chr15	23004683	23034427	NIPA2	29744	-	NM_001184889	23006220	23021336	10
chr15	23043278	23086843	NIPA1	43565	-	NM_001142275	23048828	23062272	5
chr15	23094330	23115254	LOC283683	20924	-	NR_040057	23115254	23115254	5
chr15	23187728	23208357	WHAMMP3	20629	-	NR_003521	23208357	23208357	11
chr15	23255241	23262743	GOLGA8IP	7502	+	NR_024074	23262743	23262743	12
chr15	23282264	23378259	HERC2P2	95995	-	NR_002824	23378259	23378259	35
chr15	23390721	23393943	HERC2P7	3222	+	NR_036470	23393943	23393943	3
chr15	23403865	23579357	GOLGA6L22	175492	-	NM_001271664	23405590	23579288	12
chr15	23435069	23448423	GOLGA8EP	13354	+	NR_033350	23448423	23448423	18
chr15	23599894	23613471	GOLGA8S	13577	+	NR_038843	23613471	23613471	18
chr15	23684532	23692390	GOLGA6L2	7858	-	NM_001304388	23684891	23692328	8
chr15	23807208	23807278	MIR4508	70	-	NR_039731	23807278	23807278	1
chr15	23810453	23813166	MKRN3	2713	+	NM_005664	23810929	23812453	1
chr15	23888695	23892993	MAGEL2	4298	-	NM_019066	23889139	23892889	1
chr15	23930553	23932450	NDN	1897	-	NM_002487	23931398	23932364	1
chr15	24220293	24333301	PWRN4	113008	+	NR_126392	24333301	24333301	6
chr15	24409925	24415053	PWRN2	5128	-	NR_026647	24415053	24415053	1
chr15	24686273	24693114	PWRN3	6841	+	NR_130780	24693114	24693114	4
chr15	24803303	24832926	PWRN1	29623	+	NR_026646	24832926	24832926	9
chr15	24920540	24928593	NPAP1	8053	+	NM_018958	24921014	24924485	1
chr15	25068793	25223729	SNRPN	154936	+	NM_022807	25219600	25223591	13
chr15	25200134	25223729	SNURF	23595	+	NM_005678	25200195	25213184	10
chr15	25227140	25227215	SNORD107	75	+	NR_001293	25227215	25227215	1
chr15	25227140	25228937	PWARSN	1797	+	NR_022011	25228937	25228937	1
chr15	25230006	25233379	PWAR5	3373	+	NR_022008	25233379	25233379	1
chr15	25230246	25230313	SNORD64	67	+	NR_001294	25230313	25230313	1
chr15	25232071	25232140	SNORD108	69	+	NR_001292	25232140	25232140	1
chr15	25287120	25287187	SNORD109A	67	+	NR_001295	25287187	25287187	1
chr15	25287120	25287187	SNORD109B	67	+	NR_001289	25287187	25287187	1
chr15	25296622	25296719	SNORD116-1	97	+	NR_003316	25296719	25296719	1
chr15	25302005	25302102	SNORD116-3	97	+	NR_003318	25302102	25302102	1
chr15	25302005	25302102	SNORD116-9	97	+	NR_003324	25302102	25302102	1
chr15	25304683	25304781	SNORD116-4	98	+	NR_003319	25304781	25304781	1
chr15	25307478	25307575	SNORD116-5	97	+	NR_003320	25307575	25307575	1
chr15	25307478	25307575	SNORD116-7	97	+	NR_003322	25307575	25307575	1
chr15	25310171	25310269	SNORD116-2	98	+	NR_003317	25310269	25310269	1
chr15	25310171	25310269	SNORD116-6	98	+	NR_003321	25310269	25310269	1
chr15	25315577	25315674	SNORD116-8	97	+	NR_003323	25315674	25315674	1
chr15	25319259	25319363	SNORD116-10	104	+	NR_003325	25319363	25319363	1
chr15	25321074	25321168	SNORD116-11	94	+	NR_003326	25321168	25321168	1
chr15	25322196	25322290	SNORD116-12	94	+	NR_003327	25322290	25322290	1
chr15	25324203	25324297	SNORD116-13	94	+	NR_003328	25324297	25324297	1
chr15	25325287	25325381	SNORD116-14	94	+	NR_003329	25325381	25325381	1
chr15	25326432	25326526	SNORD116-15	94	+	NR_003330	25326526	25326526	1
chr15	25327913	25328007	SNORD116-16	94	+	NR_003331	25328007	25328007	1
chr15	25328733	25328827	SNORD116-17	94	+	NR_003332	25328827	25328827	1
chr15	25328733	25328827	SNORD116-19	94	+	NR_001290	25328827	25328827	1
chr15	25330530	25330624	SNORD116-18	94	+	NR_003333	25330624	25330624	1
chr15	25332807	25332901	SNORD116-20	94	+	NR_003334	25332901	25332901	1
chr15	25333949	25334043	SNORD116-21	94	+	NR_003335	25334043	25334043	1
chr15	25335068	25335162	SNORD116-22	94	+	NR_003336	25335162	25335162	1
chr15	25336931	25337025	SNORD116-23	94	+	NR_003337	25337025	25337025	1
chr15	25339182	25339276	SNORD116-24	94	+	NR_003338	25339276	25339276	1
chr15	25342808	25342902	SNORD116-25	94	+	NR_003339	25342902	25342902	1
chr15	25344644	25344742	SNORD116-26	98	+	NR_003340	25344742	25344742	1
chr15	25346720	25346814	SNORD116-27	94	+	NR_003341	25346814	25346814	1
chr15	25349787	25349880	SNORD116-28	93	+	NR_003361	25349880	25349880	1
chr15	25351666	25351751	SNORD116-29	85	+	NR_003360	25351751	25351751	1
chr15	25353414	25353499	SNORD116-30	85	+	NR_047032	25353499	25353499	1
chr15	25361691	25367623	IPW	5932	+	NR_023915	25367623	25367623	3
chr15	25380788	25383200	PWAR1	2412	+	NR_022009	25383200	25383200	1
chr15	25415869	25415951	SNORD115-1	82	+	NR_001291	25415951	25415951	1
chr15	25417781	25417863	SNORD115-2	82	+	NR_003294	25417863	25417863	1
chr15	25420073	25420155	SNORD115-3	82	+	NR_003295	25420155	25420155	1
chr15	25421978	25422060	SNORD115-4	82	+	NR_003296	25422060	25422060	1
chr15	25423884	25423966	SNORD115-5	82	+	NR_003297	25423966	25423966	1
chr15	25425643	25425725	SNORD115-6	82	+	NR_003298	25425725	25425725	1
chr15	25427531	25427613	SNORD115-7	82	+	NR_003299	25427613	25427613	1
chr15	25429452	25429534	SNORD115-8	82	+	NR_003300	25429534	25429534	1
chr15	25430777	25430859	SNORD115-9	82	+	NR_003301	25430859	25430859	1
chr15	25430777	25430859	SNORD115-10	82	+	NR_003302	25430859	25430859	1
chr15	25430777	25430859	SNORD115-12	82	+	NR_003304	25430859	25430859	1
chr15	25434560	25434642	SNORD115-11	82	+	NR_003303	25434642	25434642	1
chr15	25434560	25434642	SNORD115-29	82	+	NR_003344	25434642	25434642	1
chr15	25434560	25434642	SNORD115-43	82	+	NR_003358	25434642	25434642	1
chr15	25438467	25438549	SNORD115-13	82	+	NR_003305	25438549	25438549	1
chr15	25440067	25440148	SNORD115-14	81	+	NR_003306	25440148	25440148	1
chr15	25444594	25444676	SNORD115-16	82	+	NR_003308	25444676	25444676	1
chr15	25446469	25446551	SNORD115-17	82	+	NR_003309	25446551	25446551	1
chr15	25446469	25446551	SNORD115-18	82	+	NR_003310	25446551	25446551	1
chr15	25446469	25446551	SNORD115-19	82	+	NR_003311	25446551	25446551	1
chr15	25451408	25451490	SNORD115-20	82	+	NR_003312	25451490	25451490	1
chr15	25451408	25477615	SNORD115-15	26207	+	NR_003307	25477615	25477615	2
chr15	25451408	25477615	SNORD115-21	26207	+	NR_003313	25477615	25477615	2
chr15	25455064	25455146	SNORD115-22	82	+	NR_003314	25455146	25455146	1
chr15	25456838	25457180	PWAR4	342	+	NR_022010	25457180	25457180	1
chr15	25456942	25457024	SNORD115-23	82	+	NR_003315	25457024	25457024	1
chr15	25458805	25458876	SNORD115-24	71	+	NR_003495	25458876	25458876	1
chr15	25460687	25460769	SNORD115-25	82	+	NR_003342	25460769	25460769	1
chr15	25463763	25463845	SNORD115-26	82	+	NR_003343	25463845	25463845	1
chr15	25465649	25465725	SNORD115-27	76	+	NR_003496	25465725	25465725	1
chr15	25467500	25467574	SNORD115-28	74	+	NR_003497	25467574	25467574	1
chr15	25470349	25470431	SNORD115-30	82	+	NR_003345	25470431	25470431	1
chr15	25472255	25472337	SNORD115-31	82	+	NR_003346	25472337	25472337	1
chr15	25474113	25474195	SNORD115-32	82	+	NR_003347	25474195	25474195	1
chr15	25475984	25476066	SNORD115-33	82	+	NR_003348	25476066	25476066	1
chr15	25477533	25477615	SNORD115-34	82	+	NR_003349	25477615	25477615	1
chr15	25479393	25479475	SNORD115-35	82	+	NR_003350	25479475	25479475	1
chr15	25483132	25483214	SNORD115-37	82	+	NR_003352	25483214	25483214	1
chr15	25484984	25485066	SNORD115-38	82	+	NR_003353	25485066	25485066	1
chr15	25486892	25486974	SNORD115-39	82	+	NR_003354	25486974	25486974	1
chr15	25488760	25488842	SNORD115-40	82	+	NR_003355	25488842	25488842	1
chr15	25490624	25490706	SNORD115-41	82	+	NR_003356	25490706	25490706	1
chr15	25492491	25492573	SNORD115-42	82	+	NR_003357	25492573	25492573	1
chr15	25494344	25494426	SNORD115-36	82	+	NR_003351	25494426	25494426	1
chr15	25496005	25496087	SNORD115-44	82	+	NR_003359	25496087	25496087	1
chr15	25509673	25509726	SNORD115-45	53	+	NR_003498	25509726	25509726	1
chr15	25511737	25511808	SNORD115-46	71	+	NR_047033	25511808	25511808	1
chr15	25513663	25513696	SNORD115-47	33	+	NR_003499	25513696	25513696	1
chr15	25514929	25515005	SNORD115-48	76	+	NR_003362	25515005	25515005	1
chr15	25582395	25684175	UBE3A	101780	-	NM_000462	25584283	25653795	14
chr15	25923859	26108349	ATP10A	184490	-	NM_024490	25924487	26108243	21
chr15	26093893	26093972	MIR4715	79	-	NR_039865	26093972	26093972	1
chr15	26147506	26298267	LOC100128714	150761	+	NR_040082	26298267	26298267	5
chr15	26360959	26378184	LINC00929	17225	+	NR_038852	26378184	26378184	6
chr15	26788693	27018935	GABRB3	230242	-	NM_021912	26792939	27018871	9
chr15	27111865	27194357	GABRA5	82492	+	NM_000810	27114395	27193380	11
chr15	27216428	27778373	GABRG3	561945	+	NM_033223	27216682	27778027	10
chr15	27402881	27406466	GABRG3-AS1	3585	-	NR_120343	27406466	27406466	3
chr15	28000020	28344458	OCA2	344438	-	NM_001300984	28000533	28327020	23
chr15	28356182	28567298	HERC2	211116	-	NM_004667	28356908	28566579	93
chr15	28623783	28636412	GOLGA8F	12629	+	NR_033351	28636412	28636412	18
chr15	28623783	28637171	GOLGA8G	13388	+	NR_033353	28637171	28637171	18
chr15	28899587	28930410	HERC2P9	30823	+	NR_036443	28930410	28930410	14
chr15	28943840	28957567	GOLGA8M	13727	-	NM_001282468	28947099	28957469	19
chr15	28982728	29003508	WHAMMP2	20780	+	NR_026589	29003508	29003508	9
chr15	29033388	29034538	LOC100289656	1150	+	NR_036475	29034538	29034538	2
chr15	29034979	29101720	PDCD6IPP2	66741	+	NR_037599	29101720	29101720	14
chr15	29090106	29093821	GOLGA6L7P	3715	-	NR_047567	29093821	29093821	6
chr15	29213839	29410516	APBA2	196677	+	NM_005503	29346087	29409336	14
chr15	29412454	29862927	FAM189A1	450473	-	NM_015307	29415541	29862927	11
chr15	29560352	29562020	NSMCE3	1668	-	NM_138704	29560994	29561909	1
chr15	29991570	30261002	TJP1	269432	-	NM_001301025	29993798	30260964	29
chr15	30375157	30388904	GOLGA8J	13747	+	NM_001282472	30375255	30385702	19
chr15	30427989	30439395	GOLGA8T	11406	+	NR_033933	30439395	30439395	17
chr15	30488238	30506743	DKFZP434L187	18505	+	NR_026771	30506743	30506743	3
chr15	30653442	30685864	CHRFAM7A	32422	-	NM_139320	30654495	30675554	10
chr15	30692764	30706463	GOLGA8R	13699	-	NM_001282484	30695942	30706365	19
chr15	30896232	30910029	GOLGA8H	13797	+	NM_001282490	30896328	30906764	19
chr15	30918878	30931013	ARHGAP11B	12135	+	NM_001039841	30919023	30927833	7
chr15	30938317	31065209	LOC100288637	126892	+	NR_038253	31065209	31065209	6
chr15	31110238	31119986	HERC2P10	9748	+	NR_072991	31119986	31119986	5
chr15	31196075	31235310	FAN1	39235	+	NM_014967	31196866	31229459	15
chr15	31231143	31283807	MTMR10	52664	-	NM_017762	31233672	31283709	16
chr15	31293263	31453476	TRPM1	160213	-	NM_001252020	31294024	31453162	27
chr15	31357234	31357344	MIR211	110	-	NR_029624	31357344	31357344	1
chr15	31514970	31523050	LOC283710	8080	-	NM_001243538	31515483	31522936	4
chr15	31619057	31727868	KLF13	108811	+	NM_001302461	31619415	31727838	2
chr15	31775328	31947542	OTUD7A	172214	-	NM_130901	31775496	31947449	11
chr15	32322685	32462384	CHRNA7	139699	+	NM_001190455	32322797	32460659	10
chr15	32681785	32695493	GOLGA8K	13708	-	NM_001282493	32684982	32695395	19
chr15	32698800	32727065	ULK4P3	28265	-	NR_026859	32727065	32727065	5
chr15	32698811	32727250	ULK4P1	28439	-	NR_026858	32727250	32727250	5
chr15	32698811	32727250	ULK4P2	28439	-	NR_027470	32727250	32727250	5
chr15	32734114	32747835	GOLGA8O	13721	-	NM_001277308	32737306	32747737	19
chr15	32812048	32825942	WHAMMP1	13894	-	NR_036650	32825942	32825942	7
chr15	32828959	32872810	LOC100996255	43851	+	NR_102756	32872810	32872810	3
chr15	32885656	32899511	GOLGA8N	13855	+	NM_001282494	32885754	32896179	19
chr15	32907344	32932150	ARHGAP11A	24806	+	NM_001286479	32917296	32930046	12
chr15	32933869	32989298	SCG5	55429	+	NM_003020	32935793	32988810	6
chr15	33010204	33026870	GREM1	16666	+	NM_001191323	33022891	33023446	3
chr15	33010301	33011066	LOC100131315	765	-	NR_109767	33011066	33011066	2
chr15	33057744	33486934	FMN1	429190	-	NM_001277313	33066510	33447115	21
chr15	33528676	33539756	TMCO5B	11080	-	NR_046005	33539756	33539756	9
chr15	33595857	33602860	LOC101928134	7003	-	NR_120327	33602860	33602860	3
chr15	33603162	34158304	RYR3	555142	+	NM_001036	33603246	34157427	104
chr15	34158427	34331303	AVEN	172876	-	NM_020371	34158813	34331247	6
chr15	34261088	34357287	CHRM5	96199	+	NM_012125	34354918	34356517	3
chr15	34376223	34394053	EMC7	17830	-	NM_020154	34376534	34394040	5
chr15	34394273	34396591	PGBD4	2318	+	NM_152595	34394732	34396490	1
chr15	34432874	34502297	KATNBL1	69423	-	NM_024713	34434539	34455877	10
chr15	34517197	34522366	EMC4	5169	+	NM_016454	34517315	34521989	5
chr15	34522196	34630265	SLC12A6	108069	-	NM_001042495	34526081	34628704	26
chr15	34633916	34635362	NOP10	1446	-	NM_018648	34634168	34635274	2
chr15	34635515	34649938	NUTM1	14423	+	NM_001284292	34635897	34649692	8
chr15	34651088	34659395	LPCAT4	8307	-	NM_153613	34651327	34659301	14
chr15	34671269	34729667	GOLGA8A	58398	-	NR_027409	34729667	34729667	24
chr15	34674269	34674351	MIR1233-1	82	-	NR_036050	34674351	34674351	1
chr15	34674269	34674351	MIR1233-2	82	-	NR_036261	34674351	34674351	1
chr15	34817483	34875771	GOLGA8B	58288	-	NR_027410	34875771	34875771	24
chr15	35044641	35046782	GJD2	2141	-	NM_020660	35044678	35046689	2
chr15	35047284	35105124	LOC101928174	57840	+	NR_120329	35105124	35105124	3
chr15	35080296	35087927	ACTC1	7631	-	NM_005159	35082612	35087009	7
chr15	35148551	35261995	AQR	113444	-	NM_014691	35148992	35261814	35
chr15	35270541	35280497	ZNF770	9956	-	NM_014106	35273559	35275635	3
chr15	35529526	35530264	ANP32AP1	738	+	NR_003144	35530264	35530264	1
chr15	35663169	35838404	DPH6	175235	-	NM_080650	35664350	35838342	9
chr15	35664456	35664565	MIR3942	109	-	NR_037507	35664565	35664565	1
chr15	35838395	36151202	DPH6-AS1	312807	+	NR_038251	36151202	36151202	3
chr15	36219056	36219124	MIR4510	68	+	NR_039735	36219124	36219124	1
chr15	36871803	37102461	C15orf41	230658	+	NM_001130010	36872061	37100654	12
chr15	37091300	37110707	CSNK1A1P1	19407	-	NR_027320	37110707	37110707	4
chr15	37156643	37178734	LOC145845	22091	-	NR_024264	37178734	37178734	7
chr15	37183221	37393500	MEIS2	210279	-	NM_002399	37186954	37390373	13
chr15	37265021	37265102	MIR8063	81	-	NR_107030	37265102	37265102	1
chr15	38226807	38243623	TMCO5A	16816	+	NM_152453	38228524	38243435	12
chr15	38332593	38354541	LOC101928227	21948	+	NR_120330	38354541	38354541	4
chr15	38545051	38649450	SPRED1	104399	+	NM_152594	38545386	38643865	7
chr15	38746327	38779911	FAM98B	33584	+	NM_173611	38746362	38776860	8
chr15	38780298	38857007	RASGRP1	76709	-	NM_001306086	38782863	38856829	15
chr15	38988798	38992239	C15orf53	3441	+	NM_207444	38988808	38990746	2
chr15	39542869	39547043	C15orf54	4174	+	NM_001302797	39544336	39544888	2
chr15	39873279	39891121	THBS1	17842	+	NM_003246	39874058	39887570	22
chr15	39892231	40075039	FSIP1	182808	-	NM_152597	39893080	40068725	12
chr15	40091222	40213093	GPR176	121871	-	NM_001271854	40093332	40212227	4
chr15	40226324	40327797	EIF2AK4	101473	+	NM_001013703	40226396	40327285	39
chr15	40327890	40331403	SRP14	3513	-	NM_001309434	40328533	40330508	6
chr15	40331511	40359710	SRP14-AS1	28199	+	NR_040059	40359710	40359710	4
chr15	40380090	40401085	BMF	20995	-	NM_001003943	40383991	40398287	4
chr15	40453209	40513337	BUB1B	60128	+	NM_001211	40453421	40512960	23
chr15	40509628	40569688	BUB1B-PAK6	60060	+	NM_001128628	40556986	40568295	11
chr15	40531291	40569688	PAK6	38397	+	NM_001276718	40556986	40568295	10
chr15	40542865	40545110	C15orf56	2245	-	NM_001039905	40544485	40545089	2
chr15	40570572	40574787	ANKRD63	4215	-	NM_001190479	40573644	40574787	1
chr15	40580097	40600174	PLCB2	20077	-	NM_001284297	40580915	40599873	32
chr15	40616256	40618916	INAFM2	2660	+	NM_001301268	40616256	40616718	1
chr15	40623652	40633168	C15orf52	9516	-	NM_207380	40627358	40633152	11
chr15	40643233	40648634	PHGR1	5401	+	NM_001145643	40645458	40648504	3
chr15	40650435	40663257	DISP2	12822	+	NM_033510	40650522	40662519	8
chr15	40674921	40686489	KNSTRN	11568	+	NM_033286	40675036	40685798	9
chr15	40697685	40713512	IVD	15827	+	NM_002225	40698019	40710462	12
chr15	40731919	40760441	BAHD1	28522	+	NM_001301132	40750663	40758329	7
chr15	40763159	40765357	CHST14	2198	+	NM_130468	40763412	40764543	1
chr15	40823539	40857256	C15orf57	33717	-	NM_001289132	40824497	40855214	4
chr15	40824082	40824749	MRPL42P5	667	-	NR_002208	40824749	40824749	1
chr15	40861491	40866893	RPUSD2	5402	+	NM_152260	40861536	40866460	3
chr15	40886446	40954881	CASC5	68435	+	NM_170589	40895129	40954386	27
chr15	40985952	40987303	RAD51-AS1	1351	-	NR_040058	40987303	40987303	2
chr15	40987326	41024356	RAD51	37030	+	NM_002875	40990956	41023376	10
chr15	41028081	41047534	RMDN3	19453	-	NM_018145	41028738	41046981	13
chr15	41056284	41059911	GCHFR	3627	+	NM_005258	41056378	41059547	3
chr15	41060066	41099676	DNAJC17	39610	-	NM_018163	41060137	41099644	11
chr15	41062158	41064648	C15orf62	2490	+	NM_001130448	41062693	41063221	1
chr15	41099273	41106767	ZFYVE19	7494	+	NM_032850	41099486	41106424	12
chr15	41107642	41120907	PPP1R14D	13265	-	NM_001130143	41107844	41120839	5
chr15	41136245	41149853	SPINT1	13608	+	NM_003710	41136752	41149173	11
chr15	41164411	41166487	RHOV	2076	-	NM_133639	41165255	41166337	3
chr15	41186627	41196173	VPS18	9546	+	NM_020857	41186966	41195539	5
chr15	41221530	41231258	DLL4	9728	+	NM_019074	41221866	41230232	11
chr15	41245635	41248717	CHAC1	3082	+	NM_001142776	41245655	41247972	4
chr15	41271078	41408444	INO80	137366	-	NM_017553	41272420	41388508	36
chr15	41474930	41522955	EXD1	48025	-	NM_001286441	41476128	41518773	12
chr15	41523436	41574083	CHP1	50647	+	NM_007236	41523580	41571587	7
chr15	41576200	41591795	OIP5-AS1	15595	+	NR_026757	41591795	41591795	4
chr15	41601465	41624819	OIP5	23354	-	NM_007280	41601951	41624759	5
chr15	41624891	41673248	NUSAP1	48357	+	NM_001243143	41625155	41672384	11
chr15	41679546	41694658	NDUFAF1	15112	-	NR_045620	41694658	41694658	6
chr15	41709301	41775761	RTF1	66460	+	NM_015138	41709313	41772885	18
chr15	41786055	41795757	ITPKA	9702	+	NM_002220	41786125	41795364	7
chr15	41795839	41806085	LTK	10246	-	NM_002344	41796193	41805907	20
chr15	41809374	41836475	RPAP1	27101	-	NM_015540	41809739	41829323	25
chr15	41851219	41871536	TYRO3	20317	+	NM_006293	41851455	41870474	19
chr15	41952609	42062141	MGA	109532	+	NM_001164273	41961092	42059478	24
chr15	41983782	41983876	MIR626	94	+	NR_030356	41983876	41983876	1
chr15	42066631	42120053	MAPKBP1	53422	+	NM_001128608	42067473	42117634	32
chr15	42120282	42129785	JMJD7	9503	+	NM_001114632	42120322	42129354	8
chr15	42120282	42140346	JMJD7-PLA2G4B	20064	+	NM_005090	42120322	42140058	25
chr15	42131010	42140346	PLA2G4B	9336	+	NM_001114633	42131111	42140058	20
chr15	42140343	42186275	SPTBN5	45932	-	NM_016642	42140813	42185695	68
chr15	42158692	42158749	MIR4310	57	-	NR_036195	42158749	42158749	1
chr15	42191638	42264755	EHD4	73117	-	NM_139265	42192842	42264692	6
chr15	42213614	42221484	EHD4-AS1	7870	+	NR_120332	42221484	42221484	4
chr15	42264960	42291292	PLA2G4E-AS1	26332	+	NR_120334	42291292	42291292	4
chr15	42273779	42342901	PLA2G4E	69122	-	NM_001206670	42275951	42342901	20
chr15	42359880	42386752	PLA2G4D	26872	-	NM_178034	42360912	42386657	20
chr15	42433331	42448839	PLA2G4F	15508	-	NM_213600	42434181	42448747	20
chr15	42450898	42500524	VPS39	49626	-	NM_001301138	42452951	42500351	26
chr15	42491767	42491864	MIR627	97	-	NR_030357	42491864	42491864	1
chr15	42502649	42565782	TMEM87A	63133	-	NM_015497	42503905	42565596	20
chr15	42566365	42645864	GANC	79499	+	NM_198141	42566679	42644337	24
chr15	42651697	42704515	CAPN3	52818	+	NM_000070	42652003	42703971	24
chr15	42704634	42783395	ZNF106	78761	-	NM_001284307	42709501	42764487	20
chr15	42787503	42825259	SNAP23	37756	+	NM_003825	42804044	42823676	8
chr15	42834719	42841002	LRRC57	6283	-	NM_153260	42836280	42840632	6
chr15	42841010	42862190	HAUS2	21180	+	NM_018097	42841070	42859014	6
chr15	42867856	43013196	STARD9	145340	+	NM_020759	42867913	43011772	33
chr15	43015759	43029417	CDAN1	13658	-	NM_138477	43016688	43029300	28
chr15	43036541	43213007	TTBK2	176466	-	NM_173500	43037992	43170815	15
chr15	43235097	43398286	UBR1	163189	-	NM_174916	43237526	43398220	47
chr15	43425721	43477341	TMEM62	51620	+	NM_024956	43426000	43476784	14
chr15	43477465	43489375	CCNDBP1	11910	+	NM_012142	43477696	43487039	11
chr15	43489425	43513323	EPB42	23898	-	NM_001114134	43489499	43513023	13
chr15	43524792	43559055	TGM5	34263	-	NM_201631	43525388	43559047	13
chr15	43568478	43594453	TGM7	25975	-	NM_052955	43568652	43594448	13
chr15	43619973	43622820	LCMT2	2847	-	NM_014793	43620626	43622687	1
chr15	43622553	43646753	ADAL	24200	+	NM_001159280	43627305	43644143	12
chr15	43650369	43662258	ZSCAN29	11889	-	NM_152455	43653270	43662111	5
chr15	43663256	43699296	TUBGCP4	36040	+	NM_014444	43663552	43697412	18
chr15	43699411	43802707	TP53BP1	103296	-	NM_005657	43699580	43784658	28
chr15	43809805	43823818	MAP1A	14013	+	NM_002373	43813671	43822422	6
chr15	43825659	43882451	PPIP5K1	56792	-	NM_001130858	43826871	43876702	31
chr15	43885251	43891604	CKMT1B	6353	+	NM_020990	43886416	43891471	10
chr15	43891760	43910998	STRC	19238	-	NM_153700	43891869	43910920	29
chr15	43922759	43941043	CATSPER2	18284	-	NM_001282309	43922898	43940259	14
chr15	43985083	43991420	CKMT1A	6337	+	NM_001015001	43986248	43991287	10
chr15	44028145	44038496	CATSPER2P1	10351	-	NR_002318	44038496	44038496	4
chr15	44038589	44064804	PDIA3	26215	+	NM_005313	44038737	44063416	13
chr15	44064797	44069502	ELL3	4705	-	NM_025165	44065313	44069099	11
chr15	44069293	44088287	SERF2	18994	+	NM_001199877	44084574	44085971	5
chr15	44084173	44094769	SERF2-C15ORF63	10596	+	NR_037673	44094769	44094769	6
chr15	44085856	44085957	MIR1282	101	-	NR_031695	44085957	44085957	1
chr15	44086371	44092295	SERINC4	5924	-	NM_001258031	44087197	44092184	12
chr15	44092618	44094769	HYPK	2151	+	NM_016400	44092796	44094004	4
chr15	44096732	44116951	MFAP1	20219	-	NM_005926	44097291	44116767	9
chr15	44119111	44160617	WDR76	41506	+	NM_001167941	44120294	44158590	13
chr15	44162958	44487492	FRMD5	324534	-	NR_104455	44487492	44487492	15
chr15	44168023	44170369	PIN4P1	2346	-	NR_003571	44170369	44170369	1
chr15	44580908	44707959	CASC4	127051	+	NM_138423	44581227	44705604	10
chr15	44719578	44819429	CTDSPL2	99851	+	NM_016396	44751212	44816372	13
chr15	44826702	44829121	EIF3J-AS1	2419	-	NR_034170	44829121	44829121	2
chr15	44829265	44855001	EIF3J	25736	+	NM_003758	44829392	44853347	8
chr15	44854893	44955876	SPG11	100983	-	NM_025137	44855318	44955845	40
chr15	44957929	44969086	PATL2	11157	-	NM_001145112	44958150	44968688	16
chr15	45003684	45010357	B2M	6673	+	NM_004048	45003744	45008540	4
chr15	45021185	45025049	LOC100419583	3864	+	NR_125376	45025049	45025049	2
chr15	45028559	45060027	TRIM69	31468	+	NM_182985	45028902	45059970	7
chr15	45248899	45271421	C15orf43	22522	+	NM_152448	45248916	45270826	7
chr15	45315301	45367287	SORD	51986	+	NR_034039	45367287	45367287	9
chr15	45384851	45406359	DUOX2	21508	-	NM_014080	45386347	45405609	34
chr15	45406522	45410301	DUOXA2	3779	+	NM_207581	45406803	45410107	6
chr15	45409563	45422075	DUOXA1	12512	-	NM_001276268	45411303	45415212	6
chr15	45422191	45457776	DUOX1	35585	+	NM_017434	45424164	45457099	35
chr15	45459411	45493373	SHF	33962	-	NM_138356	45460144	45491272	8
chr15	45543778	45571420	LOC101928414	27642	-	NR_120335	45571420	45571420	5
chr15	45544427	45568132	SLC28A2	23705	+	NM_004212	45545413	45567711	18
chr15	45653321	45670980	GATM	17659	-	NM_001482	45654306	45670651	9
chr15	45694518	45713616	SPATA5L1	19098	+	NR_027635	45713616	45713616	8
chr15	45722726	45725647	C15orf48	2921	+	NM_197955	45722994	45725214	5
chr15	45725247	45725327	MIR147B	80	+	NR_030599	45725327	45725327	1
chr15	45774679	45815002	SLC30A4	40323	-	NM_013309	45777360	45814552	8
chr15	45803333	45848928	HMGN2P46	45595	+	NR_022014	45848928	45848928	6
chr15	45879320	45901914	BLOC1S6	22594	+	NM_012388	45879641	45898712	5
chr15	45923345	45983492	SQRDL	60147	+	NM_001271213	45951121	45983228	11
chr15	47476402	48066420	SEMA6D	590018	+	NM_001198999	48051995	48063982	20
chr15	48095580	48138433	LINC01491	42853	-	NR_120336	48138433	48138433	5
chr15	48413168	48434589	SLC24A5	21421	+	NM_205850	48413241	48434548	9
chr15	48431624	48470558	MYEF2	38934	-	NM_016132	48435104	48470434	17
chr15	48483866	48495951	CTXN2	12085	+	NM_001145668	48493497	48493743	2
chr15	48498497	48596275	SLC12A1	97778	+	NM_000338	48499916	48595082	27
chr15	48623620	48635570	DUT	11950	+	NM_001025249	48624517	48634275	7
chr15	48700502	48937985	FBN1	237483	-	NM_000138	48703186	48936966	66
chr15	49030134	49103343	CEP152	73209	-	NM_001194998	49030445	49097846	27
chr15	49115933	49255641	SHC4	139708	-	NM_203349	49118167	49255212	12
chr15	49170289	49172380	EID1	2091	+	NM_014335	49170373	49170937	1
chr15	49280834	49338760	SECISBP2L	57926	-	NM_001193489	49284440	49338496	18
chr15	49417470	49447854	COPS2	30384	-	NM_004236	49420146	49447775	13
chr15	49447955	49622002	GALK2	174047	+	NM_001001556	49448193	49620356	10
chr15	49448494	49450822	NDUFAF4P1	2328	+	NR_036507	49450822	49450822	1
chr15	49461266	49461350	MIR4716	84	-	NR_039866	49461350	49461350	1
chr15	49620591	49913118	FAM227B	292527	-	NM_152647	49620764	49907368	16
chr15	49715374	49779523	FGF7	64149	+	NM_002009	49716494	49776701	4
chr15	49913225	49937333	DTWD1	24108	+	NM_020234	49917364	49935775	6
chr15	50150434	50411419	ATP8B4	260985	-	NM_024837	50152390	50399163	28
chr15	50474392	50528589	SLC27A2	54197	+	NM_003645	50474624	50528293	10
chr15	50534145	50558162	HDC	24017	-	NM_002112	50534456	50557820	12
chr15	50569388	50647605	GABPB1	78217	-	NM_016654	50570828	50601995	9
chr15	50641134	50647076	FLJ10038	5942	-	NR_026891	50647076	50647076	1
chr15	50646370	50650503	GABPB1-AS1	4133	+	NR_024490	50650503	50650503	1
chr15	50652525	50652607	MIR4712	82	+	NR_039862	50652607	50652607	1
chr15	50716573	50793280	USP8	76707	+	NM_001128610	50731270	50791285	20
chr15	50792758	50838902	USP50	46144	-	NM_203494	50792965	50838722	7
chr15	50849355	50979012	TRPM7	129657	-	NM_001301212	50853874	50978730	39
chr15	50999736	51057910	SPPL2A	58174	-	NM_032802	50999996	51057730	15
chr15	51200868	51298097	AP4E1	97229	+	NM_007347	51200975	51294859	21
chr15	51236325	51238762	DCAF13P3	2437	+	NR_027642	51238762	51238762	1
chr15	51348798	51397473	TNFAIP8L3	48675	-	NM_207381	51350077	51397373	3
chr15	51500253	51630795	CYP19A1	130542	-	NM_031226	51503004	51535109	11
chr15	51534386	51534461	MIR4713	75	+	NR_039863	51534461	51534461	1
chr15	51606228	51606304	MIR7973-2	76	-	NR_107013	51606304	51606304	1
chr15	51606230	51606306	MIR7973-1	76	+	NR_107012	51606306	51606306	1
chr15	51633712	51700209	GLDN	66497	+	NM_181789	51633881	51696951	10
chr15	51739920	51914967	DMXL2	175047	-	NM_001174116	51741180	51914742	43
chr15	51973549	52013223	SCG3	39674	+	NM_013243	51973952	52011723	12
chr15	52015260	52043650	LYSMD2	28390	-	NM_001143917	52015803	52017318	3
chr15	52043757	52108558	TMOD2	64801	+	NM_014548	52058638	52100651	10
chr15	52121824	52204331	TMOD3	82507	+	NM_014547	52155081	52201007	10
chr15	52211159	52216317	LOC100422556	5158	-	NR_109775	52216317	52216317	3
chr15	52230221	52263998	LEO1	33777	-	NM_138792	52230352	52263942	12
chr15	52311410	52358462	MAPK6	47052	+	NM_002748	52338657	52357197	6
chr15	52401465	52404972	BCL2L10	3507	-	NM_001306168	52402003	52404923	2
chr15	52413122	52483565	GNB5	70443	-	NM_016194	52414953	52476873	13
chr15	52472222	52498076	LOC100129973	25854	+	NR_102751	52498076	52498076	3
chr15	52484514	52587995	MYO5C	103481	-	NM_018728	52486098	52587833	41
chr15	52569313	52569397	MIR1266	84	-	NR_031670	52569397	52569397	1
chr15	52599479	52821247	MYO5A	221768	-	NM_000259	52605892	52821003	41
chr15	52839241	52861643	ARPP19	22402	-	NM_001306191	52844130	52861089	6
chr15	52873517	52970831	FAM214A	97314	-	NR_104457	52970831	52970831	13
chr15	53049159	53082209	ONECUT1	33050	-	NM_004498	53049751	53082081	2
chr15	53805937	54055075	WDR72	249138	-	NR_102334	54055075	54055075	20
chr15	54305100	54920806	UNC13C	615706	+	NM_001080534	54305100	54919311	31
chr15	55473511	55489231	RSL24D1	15720	-	NM_016304	55474349	55489088	6
chr15	55495163	55582013	RAB27A	86850	-	NM_183235	55497704	55527132	7
chr15	55609381	55611392	PIGBOS1	2011	-	NM_001308423	55609825	55609990	2
chr15	55611132	55647846	PIGB	36714	+	NM_004855	55611448	55647630	12
chr15	55647420	55700708	CCPG1	53288	-	NM_001204451	55648417	55681622	10
chr15	55647420	55790782	DYX1C1-CCPG1	143362	-	NR_037923	55790782	55790782	16
chr15	55665137	55665232	MIR628	95	-	NR_030358	55665232	55665232	1
chr15	55700722	55710910	C15orf65	10188	+	NM_001198784	55700966	55710768	2
chr15	55709953	55800432	DYX1C1	90479	-	NM_001033560	55710232	55790527	9
chr15	55831084	55881050	PYGO1	49966	-	NM_015617	55838220	55881050	3
chr15	55903738	56035317	PRTG	131579	-	NM_173814	55912209	56035129	20
chr15	56119116	56285944	NEDD4	166828	-	NM_006154	56122094	56285753	29
chr15	56382730	56535483	RFX7	152753	-	NM_022841	56385542	56535483	9
chr15	56657621	56738195	TEX9	80574	+	NM_001286449	56676191	56720642	13
chr15	56720928	56757335	MNS1	36407	-	NM_018365	56721298	56757170	10
chr15	56922373	57026284	ZNF280D	103911	-	NM_017661	56923695	56999307	22
chr15	57178367	57210697	LOC145783	32330	-	NR_015419	57210697	57210697	4
chr15	57210832	57580714	TCF12	369882	+	NM_207037	57212111	57574785	21
chr15	57592562	57599967	LINC00926	7405	+	NR_024433	57599967	57599967	3
chr15	57611335	57617237	LINC01413	5902	+	NR_120337	57617237	57617237	5
chr15	57668702	57842925	CGNL1	174223	+	NM_001252335	57730197	57839688	20
chr15	57884101	57977562	MYZAP	93461	+	NM_001018100	57884232	57976696	13
chr15	57884101	58009755	GCOM1	125654	+	NR_104371	58009755	58009755	17
chr15	57998718	58009755	POLR2M	11037	+	NM_001018102	57999040	58006877	4
chr15	58245621	58358121	ALDH1A2	112500	-	NM_001206897	58247394	58350263	14
chr15	58430407	58478110	AQP9	47703	+	NM_020980	58430764	58476334	6
chr15	58724174	58861073	LIPC	136899	+	NM_000236	58724231	58861026	9
chr15	58727099	58790934	LOC101928694	63835	-	NR_120338	58790934	58790934	3
chr15	58887402	59042177	ADAM10	154775	-	NM_001110	58889745	59041733	16
chr15	58982671	58985806	HSP90AB4P	3135	-	NR_073415	58985806	58985806	1
chr15	59063392	59149734	FAM63B	86342	+	NM_001040453	59063594	59146809	9
chr15	59171243	59225852	SLTM	54609	-	NM_001013843	59172197	59225764	21
chr15	59279864	59389618	RNF111	109754	+	NM_017610	59323021	59387099	14
chr15	59397283	59417244	CCNB2	19961	+	NM_004701	59397467	59417076	9
chr15	59428167	59665071	MYO1E	236904	-	NM_004998	59429578	59664699	28
chr15	59463381	59463461	MIR2116	80	-	NR_031750	59463461	59463461	1
chr15	59499014	59500785	LDHAL6B	1771	+	NM_033195	59499139	59500285	1
chr15	59730371	59815751	FAM81A	85380	+	NM_152450	59750825	59813577	9
chr15	59903981	59912210	GCNT3	8229	+	NM_004751	59910437	59911754	3
chr15	59930260	59949737	GTF2A2	19477	-	NM_004492	59931330	59944476	5
chr15	59955061	59981642	BNIP2	26581	-	NM_004330	59956267	59981639	10
chr15	60296420	60298142	FOXB1	1722	+	NM_012182	60297162	60298140	2
chr15	60639349	60690185	ANXA2	50836	-	NM_001136015	60639828	60678274	14
chr15	60711807	60771359	ICE2	59552	-	NM_001018089	60715832	60758909	16
chr15	60771376	60922838	RORA-AS1	151462	+	NR_120342	60922838	60922838	6
chr15	60780482	61521502	RORA	741020	-	NM_134261	60789653	61521417	11
chr15	60973767	60979448	RORA-AS2	5681	+	NR_120318	60979448	60979448	3
chr15	62144589	62352664	VPS13C	208075	-	NM_020821	62146655	62352573	85
chr15	62359175	62363116	C2CD4A	3941	+	NM_207322	62359812	62360922	2
chr15	62455736	62457482	C2CD4B	1746	-	NM_001007595	62456088	62457183	2
chr15	62596856	62596933	MIR8067	77	-	NR_107034	62596933	62596933	1
chr15	62635227	62635337	MIR6085	110	+	NR_106733	62635337	62635337	1
chr15	62929370	62937380	MGC15885	8010	-	NR_026897	62937380	62937380	3
chr15	62939509	63136829	TLN2	197320	+	NM_015059	62939509	63132809	56
chr15	63116155	63116240	MIR190A	85	+	NR_029709	63116240	63116240	1
chr15	63334837	63364113	TPM1	29276	+	NM_001018006	63335028	63363371	9
chr15	63413998	63434264	LACTB	20266	+	NM_032857	63414070	63434004	6
chr15	63445538	63449741	RPS27L	4203	-	NM_015920	63446230	63449604	4
chr15	63481727	63559973	RAB8B	78246	+	NM_016530	63481823	63555818	8
chr15	63569748	63601325	APH1B	31577	+	NM_031301	63569822	63597980	6
chr15	63615729	63674309	CA12	58580	-	NM_001218	63618483	63673919	11
chr15	63682428	63729735	LOC102723344	47307	+	NR_120375	63729735	63729735	7
chr15	63796709	63886839	USP3	90130	+	NR_046341	63886839	63886839	16
chr15	63879908	63893026	USP3-AS1	13118	-	NR_034080	63893026	63893026	3
chr15	63889551	63894620	FBXL22	5069	+	NM_203373	63889591	63893885	2
chr15	63900816	64126147	HERC1	225331	-	NM_003922	63901279	64067822	78
chr15	64163128	64163218	MIR422A	90	-	NR_029944	64163218	64163218	1
chr15	64199234	64338521	DAPK2	139287	-	NM_014326	64200718	64332460	12
chr15	64220472	64228152	LOC101928988	7680	+	NR_120344	64228152	64228152	4
chr15	64364757	64386207	FAM96A	21450	-	NR_110310	64386207	64386207	6
chr15	64388082	64436433	SNX1	48351	+	NM_003099	64388212	64429817	15
chr15	64443915	64449680	SNX22	5765	+	NR_073534	64449680	64449680	7
chr15	64448013	64455354	PPIB	7341	-	NM_000942	64448221	64455185	5
chr15	64457715	64648442	CSNK1G1	190727	-	NM_022048	64464129	64592698	12
chr15	64657210	64679886	KIAA0101	22676	-	NR_109934	64679886	64679886	4
chr15	64680002	64747502	TRIP4	67500	+	NM_016213	64680062	64747263	13
chr15	64791618	64978266	ZNF609	186648	+	NM_015042	64791618	64973581	9
chr15	64979772	64995480	OAZ2	15708	-	NM_002537	64980902	64995247	5
chr15	65032094	65067770	RBPMS2	35676	-	NM_194272	65033378	65067518	8
chr15	65054585	65054714	MIR1272	129	-	NR_031674	65054714	65054714	1
chr15	65107828	65117867	PIF1	10039	-	NM_025049	65108496	65116534	13
chr15	65134081	65160201	PLEKHO2	26120	+	NM_025201	65134215	65158087	6
chr15	65204100	65251041	ANKDD1A	46941	+	NM_182703	65204129	65249527	15
chr15	65255361	65282284	SPG21	26923	-	NM_016630	65255960	65275907	9
chr15	65293849	65321977	MTFMT	28128	-	NM_139242	65295399	65321951	9
chr15	65337707	65345734	SLC51B	8027	+	NM_178859	65342342	65345502	4
chr15	65345674	65360450	RASL12	14776	-	NM_016563	65347236	65360173	5
chr15	65369153	65372276	KBTBD13	3123	+	NM_001101362	65369153	65370530	1
chr15	65385341	65398697	UBAP1L	13356	-	NM_001163692	65385434	65398553	5
chr15	65409716	65426174	PDCD7	16458	-	NM_005707	65411054	65426119	5
chr15	65440557	65477758	CLPX	37201	-	NM_006660	65443160	65477491	14
chr15	65488336	65503840	CILP	15504	-	NM_003613	65489068	65502093	9
chr15	65550431	65579181	PARP16	28750	-	NM_001316943	65551744	65578764	6
chr15	65619464	65670378	IGDCC3	50914	-	NM_004884	65621246	65670126	14
chr15	65673824	65715410	IGDCC4	41586	-	NM_020962	65676346	65715200	20
chr15	65737997	65810035	DPP8	72038	-	NM_197961	65739221	65808030	20
chr15	65822826	65870693	HACD3	47867	+	NM_016395	65822969	65868717	11
chr15	65871095	65903627	VWA9	32532	-	NM_001207058	65871745	65903486	12
chr15	65903742	65953256	SLC24A1	49514	+	NM_001301033	65916418	65952659	12
chr15	65952956	66084631	DENND4A	131675	-	NM_001144823	65954188	66048788	33
chr15	66011583	66011670	MIR4511	87	-	NR_039736	66011670	66011670	1
chr15	66161796	66184329	RAB11A	22533	+	NM_004663	66161923	66180178	5
chr15	66187633	66546075	MEGF11	358442	-	NM_032445	66190271	66420741	23
chr15	66332570	66332670	MIR4311	100	+	NR_036196	66332670	66332670	1
chr15	66585632	66626236	DIS3L	40604	+	NM_133375	66587435	66625650	17
chr15	66629007	66649054	TIPIN	20047	-	NM_017858	66629295	66645285	8
chr15	66639543	66639680	SCARNA14	137	-	NR_004388	66639680	66639680	1
chr15	66679210	66783882	MAP2K1	104672	+	NM_002755	66679685	66782953	11
chr15	66782665	66790146	SNAPC5	7481	-	NM_006049	66786773	66790069	4
chr15	66789295	66789372	MIR4512	77	-	NR_039737	66789372	66789372	1
chr15	66791652	66797193	RPL4	5541	-	NM_000968	66791744	66797128	10
chr15	66793589	66793656	SNORD18C	67	-	NR_002443	66793656	66793656	1
chr15	66794359	66794429	SNORD18B	70	-	NR_002442	66794429	66794429	1
chr15	66795148	66795248	SNORD16	100	-	NR_002440	66795248	66795248	1
chr15	66795582	66795652	SNORD18A	70	-	NR_002441	66795652	66795652	1
chr15	66797420	66841822	ZWILCH	44402	+	NM_001287821	66811238	66839017	19
chr15	66839805	66858317	LCTL	18512	-	NM_001278562	66840827	66853614	12
chr15	66874527	66978136	LINC01169	103609	+	NR_110372	66978136	66978136	5
chr15	66994673	67074337	SMAD6	79664	+	NR_027654	67074337	67074337	5
chr15	67358194	67487533	SMAD3	129339	+	NM_005902	67358492	67482874	9
chr15	67493012	67547536	AAGAB	54524	-	NM_001271885	67495158	67528779	10
chr15	67547137	67794142	IQCH	247005	+	NM_001031715	67547234	67793084	21
chr15	67695948	67814182	IQCH-AS1	118234	-	NR_040052	67814182	67814182	6
chr15	67813521	67819641	C15orf61	6120	+	NM_001143936	67813586	67818883	2
chr15	67835020	68099455	MAP2K5	264435	+	NM_145160	67835673	68099088	22
chr15	68112041	68126174	SKOR1	14133	+	NM_001258024	68112041	68126174	15
chr15	68126645	68131217	LOC101929076	4572	-	NR_120345	68131217	68131217	3
chr15	68346571	68480404	PIAS1	133833	+	NM_016166	68346664	68480173	14
chr15	68483042	68498448	CALML4	15406	-	NM_033429	68486352	68497714	5
chr15	68499329	68522080	CLN6	22751	-	NM_017882	68500477	68521922	7
chr15	68570140	68588203	FEM1B	18063	+	NM_015322	68570755	68583580	2
chr15	68594041	68724492	ITGA11	130451	-	NM_001004439	68595396	68724405	30
chr15	68871307	69020144	CORO2B	148837	+	NM_006091	68871601	69018313	12
chr15	69070874	69113261	ANP32A	42387	-	NM_006305	69072419	69113090	7
chr15	69094188	69094264	MIR4312	76	-	NR_036197	69094264	69094264	1
chr15	69096159	69099440	ANP32A-IT1	3281	-	NR_026808	69099440	69099440	1
chr15	69116302	69489862	MIR548H4	373560	+	NR_031680	69489862	69489862	5
chr15	69222838	69239150	SPESP1	16312	+	NM_145658	69222992	69238926	2
chr15	69222838	69349501	NOX5	126663	+	NR_033671	69349501	69349501	17
chr15	69373189	69388163	EWSAT1	14974	+	NR_026949	69388163	69388163	4
chr15	69452972	69564544	GLCE	111572	+	NM_015554	69548145	69561583	5
chr15	69591293	69699976	PAQR5	108683	+	NM_017705	69652419	69696161	9
chr15	69689242	69707368	LOC145694	18126	-	NR_132970	69707368	69707368	3
chr15	69706584	69740766	KIF23	34182	+	NM_138555	69706804	69740146	23
chr15	69745158	69747884	RPLP1	2726	+	NM_001003	69745287	69747846	4
chr15	69854058	69863779	DRAIC	9721	+	NR_026979	69863779	69863779	5
chr15	69884538	69988091	PCAT29	103553	+	NR_126438	69988091	69988091	4
chr15	70127572	70135306	LINC00593	7734	+	NR_026764	70135306	70135306	5
chr15	70340129	70390256	TLE3	50127	-	NM_005078	70342435	70389137	20
chr15	70371710	70371807	MIR629	97	-	NR_030714	70371807	70371807	1
chr15	70907885	70908906	SALRNA3	1021	+	NR_126481	70908906	70908906	1
chr15	70927587	70929653	SALRNA2	2066	+	NR_126482	70929653	70929653	1
chr15	70946892	71055850	UACA	108958	-	NM_018003	70949394	71055746	19
chr15	71123862	71146604	LARP6	22742	-	NM_018357	71124390	71146427	3
chr15	71145577	71342436	LRRC49	196859	+	NM_001284357	71165544	71341951	17
chr15	71173680	71184772	THAP10	11092	-	NM_020147	71174792	71184611	3
chr15	71402582	71407839	CT62	5257	-	NM_001102658	71403489	71404621	4
chr15	71433787	72075722	THSD4	641935	+	NM_024817	71433866	72069713	17
chr15	71459150	71481398	THSD4-AS1	22248	-	NR_120348	71481398	71481398	4
chr15	71981039	71983878	THSD4-AS2	2839	-	NR_120346	71983878	71983878	3
chr15	72102887	72110597	NR2E3	7710	+	NM_014249	72103083	72110025	9
chr15	72118360	72410440	MYO9A	292080	-	NM_006901	72118920	72338904	42
chr15	72406598	72433311	SENP8	26713	+	NM_001166340	72431964	72432603	2
chr15	72452146	72490136	GRAMD2	37990	-	NM_001012642	72454349	72490112	12
chr15	72491369	72523965	PKM	32596	-	NM_001206796	72491990	72523328	12
chr15	72533521	72563628	PARP6	30107	-	NM_020214	72533795	72559818	23
chr15	72577067	72612525	CELF6	35458	-	NM_052840	72579605	72612215	13
chr15	72635777	72668520	HEXA	32743	-	NM_000520	72636417	72668313	14
chr15	72668453	72671129	HEXA-AS1	2676	+	NR_027262	72671129	72671129	1
chr15	72690667	72700708	TMEM202	10041	+	NM_001080462	72690667	72700234	5
chr15	72766666	72878896	ARIH1	112230	+	NM_005744	72766980	72875633	14
chr15	72879557	72879654	MIR630	97	+	NR_030359	72879654	72879654	1
chr15	72947037	72959738	GOLGA6B	12701	+	NM_018652	72947078	72958683	18
chr15	72968122	72978490	HIGD2B	10368	-	NR_002780	72978490	72978490	3
chr15	72978519	73030817	BBS4	52298	+	NR_045565	73030817	73030817	17
chr15	73043707	73076126	ADPGK	32419	-	NM_031284	73044681	73076032	7
chr15	73075175	73090540	ADPGK-AS1	15365	+	NR_040107	73090540	73090540	3
chr15	73344824	73597547	NEO1	252723	+	NM_002499	73345016	73595037	29
chr15	73612199	73661605	HCN4	49406	-	NM_005477	73614821	73660611	8
chr15	73735498	73852353	REC114	116855	+	NM_001042367	73735526	73852257	6
chr15	73852343	73925753	NPTN	73410	-	NM_012428	73854250	73925556	9
chr15	73859278	73861884	NPTN-IT1	2606	-	NR_103844	73861884	73861884	1
chr15	73976621	74006859	CD276	30238	+	NM_001024736	73991980	74005297	10
chr15	74027771	74044711	C15orf59	16940	-	NM_001303254	74032257	74043387	3
chr15	74060426	74062143	C15orf59-AS1	1717	+	NR_120353	74062143	74062143	3
chr15	74165926	74181556	TBC1D21	15630	+	NM_153356	74166050	74181442	11
chr15	74209808	74220589	LOXL1-AS1	10781	-	NR_040068	74220589	74220589	3
chr15	74218788	74244478	LOXL1	25690	+	NM_005576	74219124	74244178	7
chr15	74275558	74286963	STOML1	11405	-	NM_001256676	74276277	74281577	7
chr15	74287013	74340155	PML	53142	+	NM_033238	74287153	74337349	9
chr15	74362197	74374891	GOLGA6A	12694	-	NM_001038640	74363250	74374850	18
chr15	74418713	74421619	LOC283731	2906	-	NR_027073	74421619	74421619	2
chr15	74421714	74429143	ISLR2	7429	+	NM_001130136	74425095	74427333	4
chr15	74466086	74469212	ISLR	3126	+	NM_005545	74467199	74468486	2
chr15	74471807	74502046	STRA6	30239	-	NM_001199040	74472420	74501795	19
chr15	74528629	74628482	CCDC33	99853	+	NM_025055	74529060	74628394	19
chr15	74630102	74660081	CYP11A1	29979	-	NM_000781	74630312	74659926	9
chr15	74653892	74654382	LOC729739	490	+	NR_045207	74654382	74654382	1
chr15	74701629	74726299	SEMA7A	24670	-	NM_003612	74702964	74726259	14
chr15	74703697	74703773	MIR6881	76	-	NR_106941	74703773	74703773	1
chr15	74738317	74753529	UBL7	15212	-	NM_001286742	74738430	74753099	12
chr15	74753605	74773633	UBL7-AS1	20028	+	NR_038448	74773633	74773633	5
chr15	74833517	74890472	ARID3B	56955	+	NM_006465	74836277	74888115	9
chr15	74900712	74922542	CLK3	21830	+	NM_003992	74911537	74922224	13
chr15	74922898	74988386	EDC3	65488	-	NM_001142443	74924952	74967465	10
chr15	75011882	75017877	CYP1A1	5995	-	NM_000499	75012829	75015438	7
chr15	75041183	75048941	CYP1A2	7758	+	NM_000761	75042079	75047429	7
chr15	75074424	75095539	CSK	21115	+	NM_001127190	75090638	75094854	14
chr15	75081012	75081098	MIR4513	86	-	NR_039738	75081098	75081098	1
chr15	75105193	75118099	LMAN1L	12906	+	NM_021819	75105195	75117946	14
chr15	75118950	75124136	CPLX3	5186	+	NM_001030005	75119044	75122695	3
chr15	75128456	75135552	ULK3	7096	-	NM_001284365	75129568	75134428	16
chr15	75132982	75133048	MIR6882	66	-	NR_106942	75133048	75133048	1
chr15	75137196	75165670	SCAMP2	28474	-	NM_005697	75137423	75165596	9
chr15	75182351	75191798	MPI	9447	+	NM_002435	75182414	75190071	8
chr15	75192327	75199462	FAM219B	7135	-	NM_020447	75194959	75199141	5
chr15	75212616	75230495	COX5A	17879	-	NM_004255	75215997	75230355	5
chr15	75247442	75249775	RPP25	2333	-	NM_017793	75248324	75248924	1
chr15	75287875	75313836	SCAMP5	25961	+	NM_001178112	75304180	75311324	8
chr15	75315895	75343067	PPCDC	27172	+	NM_021823	75320659	75341576	6
chr15	75494220	75504510	C15orf39	10290	+	NM_015492	75498389	75503457	3
chr15	75550898	75565796	GOLGA6C	14898	+	NM_001164404	75550939	75562540	18
chr15	75575181	75588148	GOLGA6D	12967	+	NM_001145224	75575216	75586816	18
chr15	75628336	75634268	COMMD4	5932	+	NR_104312	75634268	75634268	9
chr15	75639330	75647592	NEIL1	8262	+	NM_024608	75641246	75647375	10
chr15	75645951	75646026	MIR631	75	-	NR_030360	75646026	75646026	1
chr15	75648132	75660968	MAN2C1	12836	-	NM_001256495	75648246	75660924	26
chr15	75661719	75748124	SIN3A	86405	-	NM_001145357	75664319	75722716	21
chr15	75759461	75871632	PTPN9	112171	-	NM_002833	75761109	75871117	13
chr15	75890423	75918719	SNUPN	28296	-	NM_001042588	75890698	75913392	9
chr15	75931425	75932664	IMP3	1239	-	NM_018285	75931954	75932509	1
chr15	75941347	75950968	SNX33	9621	+	NM_153271	75941443	75949556	2
chr15	75966662	76005189	CSPG4	38527	-	NM_001897	75967890	76005096	10
chr15	76016318	76020027	ODF3L1	3709	+	NM_175881	76016540	76019881	4
chr15	76020010	76032418	DNM1P35	12408	-	NR_024595	76032418	76032418	5
chr15	76054555	76054656	MIR4313	101	-	NR_036198	76054656	76054656	1
chr15	76135626	76193388	UBE2Q2	57762	+	NM_173469	76136007	76191799	13
chr15	76196199	76227608	FBXO22	31409	+	NM_147188	76196304	76225443	7
chr15	76225023	76225471	FBXO22-AS1	448	-	NR_003136	76225471	76225471	1
chr15	76234327	76304785	NRG4	70458	-	NM_138573	76235978	76303571	6
chr15	76352298	76497304	TMEM266	145006	+	NM_152335	76426604	76496656	11
chr15	76467231	76473827	LOC101929439	6596	-	NR_120360	76473827	76473827	3
chr15	76508628	76603810	ETFA	95182	-	NM_000126	76508899	76603729	12
chr15	76551629	76552493	TYRO3P	864	-	NR_028510	76552493	76552493	1
chr15	76629064	76634816	ISL2	5752	+	NM_145805	76629224	76634176	6
chr15	76640526	77176217	SCAPER	535691	-	NM_020843	76640973	77176158	31
chr15	76878987	76879032	MIR3713	45	+	NR_037464	76879032	76879032	1
chr15	77223961	77242601	RCN2	18640	+	NM_001271837	77224182	77241563	8
chr15	77287464	77329671	PSTPIP1	42207	+	NM_003978	77287914	77329517	15
chr15	77336359	77363570	TSPAN3	27211	-	NM_005724	77339176	77363296	7
chr15	77400497	77712446	PEAK1	311949	-	NM_024776	77406497	77474268	8
chr15	77516249	77517746	LINC00597	1497	-	NR_026813	77517746	77517746	1
chr15	77712992	77777946	HMG20A	64954	+	NM_018200	77750749	77771657	11
chr15	77905365	78113242	LINGO1	207877	-	NM_001301186	77906385	77908230	6
chr15	77934105	77941581	LINGO1-AS1	7476	+	NR_045123	77941581	77941581	3
chr15	77952392	77960416	LINGO1-AS2	8024	+	NR_120362	77960416	77960416	3
chr15	78206558	78219188	LOC645752	12630	-	NR_027024	78219188	78219188	18
chr15	78285574	78286567	LOC91450	993	-	NR_026998	78286567	78286567	1
chr15	78287326	78369994	TBC1D2B	82668	-	NM_015079	78290596	78369994	13
chr15	78375874	78375901	MIR5003	27	+	NR_049799	78375901	78375901	1
chr15	78384926	78396393	SH2D7	11467	+	NM_001101404	78384926	78395857	6
chr15	78396947	78423877	CIB2	26930	-	NM_006383	78397652	78423557	6
chr15	78441718	78462884	IDH3A	21166	+	NM_005530	78441745	78461347	11
chr15	78463186	78527049	ACSBG1	63863	-	NM_001199377	78463785	78526843	14
chr15	78556486	78574538	DNAJA4	18052	+	NM_018602	78556655	78572802	8
chr15	78575577	78592068	WDR61	16491	-	NM_025234	78575773	78588028	11
chr15	78632665	78640572	CRABP1	7907	+	NM_004378	78632770	78640319	4
chr15	78730517	78793798	IREB2	63281	+	NM_004136	78730679	78790485	22
chr15	78799905	78829715	HYKK	29810	+	NM_001083612	78805430	78829643	5
chr15	78832746	78841563	PSMA4	8817	+	NM_001102667	78834269	78841286	9
chr15	78857861	78887611	CHRNA5	29750	+	NM_001307945	78858061	78885458	6
chr15	78885394	78913637	CHRNA3	28243	-	NR_046313	78913637	78913637	8
chr15	78916635	78933587	CHRNB4	16952	-	NM_000750	78917474	78933475	6
chr15	79044378	79045734	LOC646938	1356	+	NR_036495	79045734	79045734	2
chr15	79051544	79103773	ADAMTS7	52229	-	NM_014272	79051762	79103562	24
chr15	79165122	79190081	MORF4L1	24959	+	NM_206839	79165359	79189409	13
chr15	79214091	79237420	CTSH	23329	-	NM_004390	79214471	79237323	12
chr15	79252288	79383215	RASGRF1	130927	-	NM_002891	79254485	79382840	28
chr15	79484048	79576287	ANKRD34C-AS1	92239	-	NR_038997	79576287	79576287	2
chr15	79502129	79502213	MIR184	84	+	NR_029705	79502213	79502213	1
chr15	79575145	79590581	ANKRD34C	15436	+	NM_001146341	79585626	79587234	2
chr15	79603403	79677061	TMED3	73658	+	NM_001301203	79603591	79675360	3
chr15	79724857	79764642	KIAA1024	39785	+	NM_015206	79748489	79760726	4
chr15	80135888	80189627	MTHFS	53739	-	NM_001199758	80137551	80181642	3
chr15	80135888	80215448	ST20-MTHFS	79560	-	NM_001199760	80137551	80200015	4
chr15	80191181	80216096	ST20	24915	-	NR_037652	80216096	80216096	3
chr15	80215112	80217196	ST20-AS1	2084	+	NR_028330	80217196	80217196	1
chr15	80253231	80263643	BCL2A1	10412	-	NM_001114735	80253500	80263461	3
chr15	80351909	80430735	ZFAND6	78826	+	NM_001242917	80412686	80429970	7
chr15	80445232	80478924	FAH	33692	+	NM_000137	80445396	80478551	14
chr15	80487820	80544603	LINC01314	56783	-	NR_120317	80544603	80544603	3
chr15	80555409	80634147	LINC00927	78738	-	NR_033833	80634147	80634147	3
chr15	80696691	80890277	ARNT2	193586	+	NM_014862	80696857	80886039	19
chr15	80846950	80855285	LOC101929586	8335	-	NR_120363	80855285	80855285	3
chr15	80873443	80873580	MIR5572	137	+	NR_049837	80873580	80873580	1
chr15	80987651	81047962	ABHD17C	60311	+	NM_021214	80987770	81046711	3
chr15	81071683	81244003	CEMIP	172320	+	NM_001293304	81166220	81241265	30
chr15	81134318	81134414	MIR549A	96	-	NR_030393	81134414	81134414	1
chr15	81239667	81282219	MESDC2	42552	-	NR_126327	81282219	81282219	5
chr15	81289757	81289814	MIR4514	57	-	NR_039739	81289814	81289814	1
chr15	81293294	81296345	MESDC1	3051	+	NM_022566	81294612	81295701	1
chr15	81426643	81441516	CFAP161	14873	+	NM_173528	81426670	81440874	7
chr15	81489218	81605104	IL16	115886	+	NM_001172128	81517740	81601139	19
chr15	81605006	81616524	STARD5	11518	-	NM_181900	81605596	81616440	6
chr15	81616673	81735417	TMC3-AS1	118744	+	NR_120365	81735417	81735417	7
chr15	81624759	81666418	TMC3	41659	-	NM_001080532	81624759	81666418	22
chr15	82334118	82338484	MEX3B	4366	-	NM_032246	82335500	82338046	2
chr15	82380934	82390034	LINC01583	9100	+	NR_120367	82390034	82390034	6
chr15	82422560	82555104	EFTUD1	132544	-	NM_024580	82422713	82554119	20
chr15	82555151	82577267	SAXO2	22116	+	NM_001008226	82555220	82575403	3
chr15	82632349	83018198	GOLGA6L10	385849	-	NM_001164465	82635129	83018098	10
chr15	82804002	83195272	GOLGA6L17P	391270	+	NR_111962	83195272	83195272	11
chr15	82804768	83108111	GOLGA6L9	303343	+	NM_001291420	83102799	83105136	8
chr15	82821157	82824952	RPS17	3795	-	NR_111944	82824952	82824952	6
chr15	82882945	82924242	ADAMTS7P1	41297	+	NR_045529	82924242	82924242	24
chr15	83023840	83084341	UBE2Q2P2	60501	+	NR_004847	83084341	83084341	5
chr15	83140198	83182977	GOLGA2P10	42779	-	NR_026811	83182977	83182977	8
chr15	83140203	83182973	LOC727751	42770	-	NR_102748	83182973	83182973	6
chr15	83211950	83316767	CPEB1	104817	-	NM_030594	83213341	83316621	12
chr15	83316520	83361572	CPEB1-AS1	45052	+	NR_046096	83361572	83361572	4
chr15	83328032	83378660	AP3B2	50628	-	NM_001278512	83328311	83378458	27
chr15	83379222	83382745	LOC338963	3523	-	NR_034139	83382745	83382745	4
chr15	83394649	83408532	ACTG1P17	13883	-	NR_036446	83408532	83408532	3
chr15	83419315	83425958	SNHG21	6643	+	NR_110097	83425958	83425958	5
chr15	83424116	83474822	FSD2	50706	-	NM_001007122	83428099	83456142	13
chr15	83424696	83424823	SCARNA15	127	+	NR_003011	83424823	83424823	1
chr15	83478379	83503613	WHAMM	25234	+	NM_001080435	83478478	83502288	10
chr15	83517728	83621476	HOMER2	103748	-	NM_004839	83518466	83621287	9
chr15	83654954	83659809	FAM103A1	4855	+	NM_031452	83657770	83658819	4
chr15	83657714	83680393	C15orf40	22679	-	NM_001160116	83657825	83680359	4
chr15	83685180	83736106	BTBD1	50926	-	NM_025238	83686818	83735903	8
chr15	83736086	83736167	MIR4515	81	+	NR_039740	83736167	83736167	1
chr15	83776323	83806111	TM6SF1	29788	+	NM_023003	83776432	83805424	10
chr15	83806803	83876770	HDGFRP3	69967	-	NM_016073	83808021	83876166	6
chr15	83924654	83953468	BNC1	28814	-	NM_001717	83926193	83953380	5
chr15	84115979	84287493	SH3GL3	171514	+	NM_001301109	84159585	84287039	12
chr15	84322837	84708593	ADAMTSL3	385756	+	NM_207517	84324513	84706558	30
chr15	84748938	84795353	EFTUD1P1	46415	+	NR_036652	84795353	84795353	10
chr15	84841241	84850985	UBE2Q2L	9744	+	NM_001243531	84841253	84850895	3
chr15	84860599	84878025	LOC440300	17426	+	NR_033738	84878025	84878025	8
chr15	84867599	84898920	GOLGA2P7	31321	-	NR_027001	84898920	84898920	7
chr15	84868829	84869441	LOC642423	612	-	NR_049748	84869441	84869441	1
chr15	84904524	84914120	GOLGA6L4	9596	+	NM_001267536	84904586	84911344	9
chr15	84977216	84980581	LOC103171574	3365	+	NR_120379	84980581	84980581	4
chr15	84977315	84978856	LOC102724034	1541	+	NR_120378	84978856	84978856	3
chr15	85045805	85050249	DNM1P41	4444	+	NR_033787	85050249	85050249	1
chr15	85049398	85060078	GOLGA6L5P	10680	-	NR_003246	85060078	85060078	10
chr15	85070426	85114026	UBE2Q2P1	43600	-	NR_003661	85114026	85114026	6
chr15	85113879	85123412	LINC00933	9533	+	NR_038274	85123412	85123412	4
chr15	85144248	85166947	ZSCAN2	22699	+	NM_181877	85147158	85165271	3
chr15	85174690	85185694	SCAND2P	11004	+	NR_004859	85185694	85185694	5
chr15	85184725	85197574	WDR73	12849	-	NR_130945	85197574	85197574	9
chr15	85198359	85201802	NMB	3443	-	NM_021077	85198604	85201383	3
chr15	85212767	85259691	SEC11A	46924	-	NR_073518	85259691	85259691	7
chr15	85291817	85349663	ZNF592	57846	+	NM_014630	85325906	85345624	11
chr15	85359910	85416713	ALPK3	56803	+	NM_020778	85360077	85411687	14
chr15	85427891	85489027	SLC28A1	61136	+	NM_004213	85430991	85488431	19
chr15	85523743	85682376	PDE8A	158633	+	NM_001243137	85607630	85681134	22
chr15	85783640	85790418	GOLGA6L3	6778	+	NM_001310153	85783702	85790401	11
chr15	85923826	85923893	MIR7706	67	+	NR_106993	85923893	85923893	1
chr15	85923846	86292589	AKAP13	368743	+	NM_007200	86028951	86287908	37
chr15	86298171	86301956	LOC101929679	3785	-	NR_120366	86301956	86301956	6
chr15	86302558	86338189	KLHL25	35631	-	NM_022480	86311271	86313041	3
chr15	86313726	86313809	MIR1276	83	-	NR_031682	86313809	86313809	1
chr15	86626575	86659948	LINC01584	33373	-	NR_120368	86659948	86659948	6
chr15	86685241	87572283	AGBL1	887042	+	NM_152336	86686952	87572071	24
chr15	86840064	86860199	AGBL1-AS1	20135	-	NR_046012	86860199	86860199	4
chr15	88120159	88122917	LINC00052	2758	+	NR_026869	88122917	88122917	3
chr15	88419987	88799962	NTRK3	379975	-	NM_001012338	88420165	88799384	20
chr15	88795960	88814297	NTRK3-AS1	18337	+	NR_038229	88814297	88814297	4
chr15	89002708	89010633	MRPL46	7925	-	NM_022163	89002843	89010608	4
chr15	89010683	89021861	MRPS11	11178	+	NM_022839	89010948	89021210	6
chr15	89055713	89089912	DET1	34199	-	NM_017996	89056181	89079565	6
chr15	89128801	89148341	LINC01586	19540	-	NR_120370	89148341	89148341	3
chr15	89151337	89151428	MIR1179	91	+	NR_031590	89151428	89151428	1
chr15	89155055	89155165	MIR7-2	110	+	NR_029606	89155165	89155165	1
chr15	89155077	89155155	MIR3529	78	-	NR_039867	89155155	89155155	1
chr15	89164526	89175512	AEN	10986	+	NM_022767	89169440	89173525	4
chr15	89178867	89199575	ISG20	20708	+	NM_001303234	89182597	89198762	5
chr15	89346673	89418585	ACAN	71912	+	NM_013227	89379437	89417712	18
chr15	89420515	89438857	HAPLN3	18342	-	NM_001307952	89421200	89436343	6
chr15	89441913	89456700	MFGE8	14787	-	NM_001310320	89442625	89455403	9
chr15	89631380	89745591	ABHD2	114211	+	NM_007011	89659558	89738654	15
chr15	89753097	89764922	RLBP1	11825	-	NM_000326	89753515	89762206	9
chr15	89787193	89860362	FANCI	73169	+	NM_001113378	89790878	89859690	38
chr15	89859535	89878026	POLG	18491	-	NM_002693	89859981	89876985	23
chr15	89869969	89870041	MIR6766	72	-	NR_106824	89870041	89870041	1
chr15	89904809	89941718	MIR9-3HG	36909	+	NR_133001	89941718	89941718	7
chr15	89911247	89911337	MIR9-3	90	+	NR_029692	89911337	89911337	1
chr15	90014639	90039844	RHCG	25205	-	NR_110261	90039844	90039844	11
chr15	90048160	90067265	LINC00928	19105	-	NR_027075	90067265	90067265	4
chr15	90118817	90171253	TICRR	52436	+	NM_001308025	90118817	90170317	22
chr15	90171200	90198682	KIF7	27482	-	NM_198525	90171649	90196161	19
chr15	90207599	90222648	PLIN1	15049	-	NM_001145311	90208813	90220720	9
chr15	90224761	90234015	PEX11A	9254	-	NM_001271572	90226607	90233863	3
chr15	90234027	90286869	WDR93	52842	+	NM_001284395	90244977	90286622	17
chr15	90293097	90294540	MESP1	1443	-	NM_018670	90293374	90294462	2
chr15	90319588	90321982	MESP2	2394	+	NM_001039958	90319588	90321565	2
chr15	90328125	90358072	ANPEP	29947	-	NM_001150	90328579	90349814	21
chr15	90373830	90437617	AP3S2	63787	-	NR_023361	90437617	90437617	7
chr15	90373830	90456222	C15orf38-AP3S2	82392	-	NM_001199058	90378746	90456067	10
chr15	90393868	90393953	MIR5094	85	-	NR_049817	90393953	90393953	1
chr15	90439763	90456222	ARPIN	16459	-	NM_182616	90445026	90456067	6
chr15	90544722	90625432	ZNF710	80710	+	NM_198526	90610369	90623061	5
chr15	90549986	90550073	MIR3174	87	+	NR_036135	90550073	90550073	1
chr15	90627210	90645786	IDH2	18576	-	NM_002168	90627497	90645622	11
chr15	90728151	90772892	SEMA4B	44741	+	NM_020210	90744810	90771875	15
chr15	90773476	90808991	CIB1	35515	-	NR_102428	90808991	90808991	7
chr15	90777486	90785312	GDPGP1	7826	+	NM_001013657	90784140	90785298	4
chr15	90792763	90802320	TTLL13P	9557	+	NR_104604	90802320	90802320	10
chr15	90808894	90815443	NGRN	6549	+	NM_001033088	90808944	90815020	3
chr15	90889762	90892679	GABARAPL3	2917	-	NR_028287	90892679	90892679	2
chr15	90895476	90904715	ZNF774	9239	+	NM_001004309	90897892	90904515	4
chr15	90931472	91045475	IQGAP1	114003	+	NM_003870	90931573	91043340	38
chr15	91073117	91188577	CRTC3	115460	+	NM_001042574	91073303	91185372	15
chr15	91163240	91260371	CRTC3-AS1	97131	-	NR_120372	91260371	91260371	4
chr15	91203464	91208185	LINC01585	4721	+	NR_120371	91208185	91208185	3
chr15	91260557	91358692	BLM	98135	+	NM_001287246	91290622	91358509	23
chr15	91411821	91426688	FURIN	14867	+	NM_002569	91418970	91425108	16
chr15	91427664	91439006	FES	11342	+	NM_001143785	91428275	91438788	17
chr15	91447419	91465815	MAN2A2	18396	+	NM_006122	91447437	91463017	22
chr15	91473409	91497323	UNC45A	23914	+	NM_001039675	91478554	91496946	23
chr15	91474147	91475799	HDDC3	1652	-	NR_104447	91475799	91475799	4
chr15	91498105	91506355	RCCD1	8250	+	NM_033544	91499964	91504999	9
chr15	91509267	91537881	PRC1	28614	-	NM_003981	91510360	91537647	15
chr15	91509598	91531854	PRC1-AS1	22256	+	NR_051984	91531854	91531854	4
chr15	91541645	91565851	VPS33B	24206	-	NM_018668	91542204	91565479	23
chr15	91565851	91574369	LOC101926911	8518	+	NR_110104	91574369	91574369	4
chr15	91643181	91844539	SV2B	201358	+	NM_001167580	91795050	91835782	12
chr15	92006568	92038080	CRAT37	31512	+	NR_110106	92038080	92038080	4
chr15	92396937	92715665	SLCO3A1	318728	+	NM_001145044	92397138	92715092	11
chr15	92937139	93011958	ST8SIA2	74819	+	NM_006011	92937294	93007615	6
chr15	93013463	93014776	LOC104613533	1313	-	NR_126501	93014776	93014776	2
chr15	93014906	93044347	C15orf32	29441	+	NM_153040	93015378	93043630	3
chr15	93111047	93115493	LINC00930	4446	-	NR_021493	93115493	93115493	4
chr15	93160678	93199031	FAM174B	38353	-	NM_207446	93162685	93198889	3
chr15	93338713	93340338	ASB9P1	1625	+	NR_033769	93340338	93340338	1
chr15	93426072	93441977	LINC01578	15905	+	NR_037601	93441977	93441977	6
chr15	93443550	93571237	CHD2	127687	+	NM_001271	93444467	93567935	39
chr15	93447628	93447705	MIR3175	77	+	NR_036136	93447705	93447705	1
chr15	93586635	93632443	RGMA	45808	-	NM_020211	93588227	93632161	4
chr15	94399788	94421585	LOC101927153	21797	+	NR_120321	94421585	94421585	4
chr15	94443929	94527379	LINC01580	83450	+	NR_120323	94527379	94527379	3
chr15	94448633	94651167	LINC01581	202534	-	NR_120320	94651167	94651167	9
chr15	94841429	95027181	MCTP2	185752	+	NM_018349	94841494	95022263	22
chr15	95398591	95400293	LOC440311	1702	+	NR_077061	95400293	95400293	1
chr15	95822518	95870329	LINC01197	47811	-	NR_034095	95870329	95870329	4
chr15	95976321	96051076	LINC00924	74755	+	NR_027132	96051076	96051076	7
chr15	96670588	96870347	NR2F2-AS1	199759	-	NR_125738	96870347	96870347	5
chr15	96869156	96883492	NR2F2	14336	+	NM_001145155	96869538	96880851	3
chr15	96876489	96876536	MIR1469	47	+	NR_031715	96876536	96876536	1
chr15	97315234	97326567	SPATA8-AS1	11333	-	NR_102753	97326567	97326567	4
chr15	97326636	97328845	SPATA8	2209	+	NM_001304805	97327410	97328347	4
chr15	97913600	98065041	LOC101927286	151441	-	NR_120324	98065041	98065041	5
chr15	98096513	98103928	LOC101927310	7415	-	NR_110756	98103928	98103928	4
chr15	98285845	98417659	LINC00923	131814	-	NR_024172	98417659	98417659	3
chr15	98503932	98517068	ARRDC4	13136	+	NM_183376	98504091	98514417	8
chr15	98626207	98631982	LINC01582	5775	-	NR_120325	98631982	98631982	4
chr15	98980390	99057611	FAM169B	77221	-	NM_182562	98982859	99029126	7
chr15	99189094	99194450	IRAIN	5356	-	NR_126453	99194450	99194450	1
chr15	99191767	99507759	IGF1R	315992	+	NM_001291858	99192810	99500671	21
chr15	99327654	99327731	MIR4714	77	+	NR_039864	99327731	99327731	1
chr15	99511458	99551024	PGPEP1L	39566	-	NM_001167902	99511706	99512862	5
chr15	99557932	99574275	LUNAR1	16343	+	NR_126487	99574275	99574275	4
chr15	99645285	99675800	SYNM	30515	+	NM_015286	99645405	99673263	5
chr15	99676527	99791431	TTC23	114904	-	NM_001288616	99678214	99768917	12
chr15	99791566	99926514	LRRC28	134948	+	NM_144598	99796162	99926307	10
chr15	99797729	99800481	HSP90B2P	2752	+	NR_073383	99800481	99800481	1
chr15	100106132	100256629	MEF2A	150497	+	NM_001171894	100173324	100252976	12
chr15	100267605	100273649	LYSMD4	6044	-	NM_152449	100269327	100272116	6
chr15	100330360	100347132	DNM1P46	16772	-	NR_003260	100347132	100347132	5
chr15	100511642	100882183	ADAMTS17	370541	-	NM_139057	100514606	100882104	22
chr15	100884661	100890923	SPATA41	6262	-	NR_028139	100890923	100890923	2
chr15	100913143	100978119	CERS3-AS1	64976	+	NR_120374	100978119	100978119	5
chr15	100940599	101084925	CERS3	144326	-	NM_001290343	100942917	101042054	13
chr15	101087956	101099488	PRKXP1	11532	-	NR_073405	101099488	101099488	1
chr15	101109427	101142445	LINS1	33018	-	NM_001040616	101109442	101121047	7
chr15	101142754	101191904	ASB7	49150	+	NM_198243	101152421	101188667	6
chr15	101419896	101456830	ALDH1A3	36934	+	NM_000693	101420112	101454978	13
chr15	101459419	101610317	LRRK1	150898	+	NM_024652	101464837	101609053	34
chr15	101715927	101792137	CHSY1	76210	-	NM_014918	101717592	101791661	3
chr15	101811113	101817725	VIMP	6612	-	NM_203472	101812981	101817622	7
chr15	101821714	101835460	SNRPA1	13746	-	NM_003090	101821928	101835383	9
chr15	101844132	102030187	PCSK6	186055	-	NM_002570	101845462	102029873	22
chr15	101847455	101849509	LOC100507472	2054	-	NR_045387	101849509	101849509	1
chr15	101874641	101877636	PCSK6-AS1	2995	+	NR_132373	101877636	101877636	3
chr15	102173179	102192594	TM2D3	19415	-	NM_001308026	102173879	102192564	6
chr15	102193954	102264645	TARSL2	70691	-	NM_152334	102194784	102264590	19
chr15	102345922	102346861	OR4F6	939	+	NM_001005326	102345922	102346861	1
chr15	102358389	102359328	OR4F15	939	+	NM_001001674	102358389	102359328	1
chr15	102382321	102390527	OR4F13P	8206	+	NR_046417	102390527	102390527	5
chr15	102462344	102463262	OR4F4	918	-	NM_001004195	102462344	102463262	1
chr15	102495087	102496558	FAM138E	1471	+	NR_026819	102496558	102496558	3
chr15	102501015	102516808	WASH3P	15793	+	NR_003659	102516808	102516808	11
chr15	102516760	102519296	DDX11L9	2536	-	NR_034090	102519296	102519296	3
chr16	61554	64090	DDX11L10	2536	+	NR_045117	64090	64090	3
chr16	72915	75112	WASIR2	2197	+	NR_130735	75112	75112	2
chr16	96978	103632	POLR3K	6654	-	NM_016310	97429	103586	3
chr16	103828	107669	SNRNP25	3841	+	NM_024571	103989	107143	5
chr16	108057	122629	RHBDF1	14572	-	NM_022450	108338	115013	18
chr16	127017	135850	MPG	8833	+	NM_001015054	129435	135776	4
chr16	135803	188697	NPRL3	52894	-	NM_001243247	136703	169208	15
chr16	202853	204504	HBZ	1651	+	NM_005332	202908	204399	3
chr16	215972	216767	HBM	795	+	NM_001003938	215996	216707	3
chr16	222845	223709	HBA2	864	+	NM_000517	222911	223599	3
chr16	226649	227521	HBA1	872	+	NM_000558	226715	227410	3
chr16	230332	231178	HBQ1	846	+	NM_005331	230485	231107	3
chr16	238969	279449	LUC7L	40480	-	NM_018032	239962	279338	9
chr16	284544	319942	FAM234A	35398	+	NR_104317	319942	319942	14
chr16	318299	325943	RGS11	7644	-	NM_003834	319267	325498	17
chr16	330605	333003	ARHGDIG	2398	+	NM_001176	330680	332814	6
chr16	333117	337209	PDIA2	4092	+	NM_006849	333169	337113	11
chr16	337439	402676	AXIN1	65237	-	NM_003502	338121	397025	11
chr16	417383	420569	MRPL28	3186	-	NM_006428	417674	420218	6
chr16	420775	431950	TMEM8A	11175	-	NM_021259	421986	431821	13
chr16	432240	442960	LOC100134368	10720	+	NR_024453	442960	442960	3
chr16	446754	450754	NME4	4000	+	NM_001286436	449108	450342	5
chr16	451857	462487	DECR2	10630	+	NM_020664	451963	461578	9
chr16	475667	572481	RAB11FIP3	96814	+	NM_014700	476006	570839	14
chr16	576846	577407	LINC00235	561	-	NR_024121	577407	577407	1
chr16	577855	604636	CAPN15	26781	+	NM_005632	596838	603516	14
chr16	585315	585368	MIR5587	53	+	NR_049852	585368	585368	1
chr16	593276	593366	MIR3176	90	+	NR_036137	593366	593366	1
chr16	610421	615529	PRR35	5108	+	NM_145270	613294	615307	3
chr16	616994	619495	NHLRC4	2501	+	NM_176677	618047	618419	2
chr16	619967	634136	PIGQ	14169	+	NM_004204	624074	633035	11
chr16	639356	679273	RAB40C	39917	+	NM_001172663	640291	677622	7
chr16	681011	684116	WFIKKN1	3105	+	NM_053284	681253	684057	2
chr16	684426	686366	C16orf13	1940	-	NR_109978	686366	686366	6
chr16	691848	698474	FAM195A	6626	+	NM_138418	691991	698190	5
chr16	699362	717829	WDR90	18467	+	NM_145294	699416	717589	41
chr16	718082	724174	RHOT2	6092	+	NM_138769	718199	723606	19
chr16	725665	728268	RHBDL1	2603	+	NM_001278720	725790	728052	8
chr16	730110	732768	STUB1	2658	+	NM_005861	730525	732489	7
chr16	731666	734439	JMJD8	2773	-	NM_001005920	732793	734382	9
chr16	734621	740424	WDR24	5803	-	NM_032259	734733	739640	9
chr16	742499	755825	FBXL16	13326	-	NM_153350	744274	747405	6
chr16	765172	767480	METRN	2308	+	NM_024042	765289	767387	4
chr16	771141	772590	FAM173A	1449	+	NM_023933	771274	772557	5
chr16	772581	776473	CCDC78	3892	-	NM_001031737	772769	776367	14
chr16	776935	779715	HAGHL	2780	+	NM_001290137	777509	779456	9
chr16	779754	791038	NARFL	11284	-	NM_001304799	780416	786398	12
chr16	810764	818865	MSLN	8101	+	NM_005823	812680	818733	18
chr16	820182	820277	MIR662	95	+	NR_030384	820277	820277	1
chr16	834973	838383	RPUSD1	3410	-	NM_058192	835949	837737	6
chr16	838621	848074	CHTF18	9453	+	NM_022092	838684	847975	22
chr16	848040	850733	GNG13	2693	-	NM_016541	848718	849077	3
chr16	855442	863861	PRR25	8419	+	NM_001013638	855442	863861	3
chr16	903634	1031318	LMF1	127684	-	NR_033645	1031318	1031318	12
chr16	971032	984524	LMF1-AS1	13492	+	NR_110945	984524	984524	3
chr16	1031807	1036979	SOX8	5172	+	NM_014587	1031922	1035386	3
chr16	1114081	1128731	SSTR5-AS1	14650	-	NR_027242	1128731	1128731	4
chr16	1122755	1131454	SSTR5	8699	+	NM_001172560	1128868	1129963	2
chr16	1138225	1146244	C1QTNF8	8019	-	NM_207419	1143500	1144922	5
chr16	1203240	1271772	CACNA1H	68532	+	NM_021098	1203737	1270994	35
chr16	1271650	1275254	TPSG1	3604	-	NM_012467	1271787	1275252	6
chr16	1278335	1280185	TPSB2	1850	-	NM_024164	1278649	1279952	7
chr16	1290677	1292555	TPSAB1	1878	+	NM_003294	1290939	1292241	6
chr16	1306272	1308494	TPSD1	2222	+	NM_012217	1306281	1308377	5
chr16	1359153	1377019	UBE2I	17866	+	NM_194261	1364031	1374794	7
chr16	1383605	1399442	BAIAP3	15837	+	NM_001199097	1388550	1398483	34
chr16	1399240	1401873	TSR3	2633	-	NM_001001410	1399437	1401805	6
chr16	1401899	1413352	GNPTG	11453	+	NM_032520	1401966	1413092	11
chr16	1413205	1464721	UNKL	51516	-	NM_001193388	1416240	1464692	15
chr16	1469744	1470801	C16orf91	1057	-	NM_001272051	1470246	1470724	2
chr16	1484388	1494490	CCDC154	10102	-	NM_001143980	1484408	1494323	17
chr16	1494933	1525085	CLCN7	30152	-	NM_001287	1496631	1524975	25
chr16	1535939	1538468	PTX4	2529	-	NM_001013658	1535939	1538468	3
chr16	1543351	1560460	TELO2	17109	+	NM_016111	1544282	1559937	21
chr16	1560427	1662109	IFT140	101682	-	NM_014714	1560944	1657267	31
chr16	1578741	1605581	TMEM204	26840	+	NM_001256541	1584276	1605027	4
chr16	1664640	1727909	CRAMP1	63269	+	NM_020825	1664640	1724046	20
chr16	1728277	1752073	HN1L	23796	+	NM_144570	1728313	1748999	5
chr16	1756220	1820318	MAPK8IP3	64098	+	NM_015133	1756340	1818825	32
chr16	1784985	1785067	MIR3177	82	+	NR_036138	1785067	1785067	1
chr16	1820320	1821710	NME3	1390	-	NM_002513	1820649	1821535	5
chr16	1821895	1823140	MRPS34	1245	-	NM_001300900	1822221	1823120	3
chr16	1823228	1826239	EME2	3011	+	NM_001257370	1823228	1826239	8
chr16	1826712	1832581	SPSB3	5869	-	NM_080861	1827097	1831484	7
chr16	1832923	1839192	NUBP2	6269	+	NM_001284501	1836802	1838715	8
chr16	1840413	1844909	IGFALS	4496	-	NR_027389	1844909	1844909	2
chr16	1859103	1877195	HAGH	18092	-	NM_001040427	1859283	1872970	10
chr16	1877224	1890203	FAHD1	12979	+	NM_001018104	1877230	1888127	3
chr16	1883983	1922179	MEIOB	38196	-	NM_001163560	1884256	1918176	14
chr16	1928285	1934232	LINC00254	5947	-	NR_033914	1934232	1934232	3
chr16	1961464	1968324	HS3ST6	6860	-	NM_001009606	1961590	1968324	2
chr16	1988233	1993294	MSRB1	5061	-	NM_016332	1989112	1993157	4
chr16	1994579	2004679	RPL3L	10100	-	NM_005061	1994837	2004632	10
chr16	2009516	2011976	NDUFB10	2460	+	NM_004548	2009625	2011907	4
chr16	2012061	2014827	RPS2	2766	-	NM_002952	2012098	2014626	7
chr16	2012334	2012467	SNORA10	133	-	NR_002327	2012467	2012467	1
chr16	2012973	2013107	SNORA64	134	-	NR_002326	2013107	2013107	1
chr16	2014996	2015505	SNHG9	509	+	NR_003142	2015505	2015505	2
chr16	2015184	2015311	SNORA78	127	+	NR_003020	2015311	2015311	1
chr16	2016874	2018976	RNF151	2102	+	NM_174903	2016882	2018926	4
chr16	2022063	2028751	TBL3	6688	+	NM_006453	2022165	2028686	22
chr16	2028917	2031550	NOXO1	2633	-	NM_172168	2029052	2031180	8
chr16	2034149	2037750	GFER	3601	+	NM_005262	2034219	2036029	3
chr16	2039945	2044276	SYNGR3	4331	+	NM_004209	2040103	2043073	4
chr16	2047652	2059822	ZNF598	12170	-	NM_178167	2048232	2059748	14
chr16	2069520	2070756	NPW	1236	+	NM_001099456	2069902	2070620	2
chr16	2076868	2089027	SLC9A3R2	12159	+	NM_004785	2077006	2087985	7
chr16	2089815	2097867	NTHL1	8052	-	NM_002528	2089924	2097848	6
chr16	2097989	2138713	TSC2	40724	+	NM_000548	2098616	2138611	42
chr16	2138710	2185899	PKD1	47189	-	NM_000296	2139727	2185690	46
chr16	2140195	2140285	MIR1225	90	-	NR_030646	2140285	2140285	1
chr16	2156669	2156754	MIR6511B1	85	-	NR_106775	2156754	2156754	1
chr16	2156678	2156749	MIR6511B2	71	-	NR_106965	2156749	2156749	1
chr16	2183119	2183205	MIR4516	86	+	NR_039741	2183205	2183205	1
chr16	2185977	2186130	MIR3180-5	153	-	NR_037467	2186130	2186130	1
chr16	2198144	2204162	RAB26	6018	+	NM_001308053	2199944	2203422	10
chr16	2204782	2205359	SNHG19	577	-	NR_132114	2205359	2205359	2
chr16	2205023	2205106	SNORD60	83	-	NR_002736	2205106	2205106	1
chr16	2205798	2228130	TRAF7	22332	+	NM_032271	2213921	2226575	21
chr16	2227183	2246465	CASKIN1	19282	-	NM_020764	2228550	2246433	20
chr16	2255177	2259418	MLST8	4241	+	NM_001199173	2256086	2258878	9
chr16	2259253	2261069	BRICD5	1816	-	NM_182563	2259362	2260834	6
chr16	2261602	2264822	PGP	3220	-	NM_001042371	2263728	2264778	2
chr16	2273488	2285743	E4F1	12255	+	NM_001288776	2273614	2285235	14
chr16	2286467	2288712	DNASE1L2	2245	+	NM_001374	2286817	2288419	7
chr16	2289872	2301602	ECI1	11730	-	NM_001178029	2289979	2301567	7
chr16	2303116	2318413	RNPS1	15297	-	NM_080594	2303964	2314644	8
chr16	2318663	2323073	LOC106660606	4410	+	NR_132988	2323073	2323073	3
chr16	2320713	2320773	MIR3677	60	+	NR_037448	2320773	2320773	1
chr16	2321747	2321841	MIR940	94	+	NR_030636	2321841	2321841	1
chr16	2324620	2324692	MIR4717	72	+	NR_039868	2324692	2324692	1
chr16	2325878	2390747	ABCA3	64869	-	NM_001089	2326674	2376467	33
chr16	2390922	2476700	ABCA17P	85778	+	NR_003574	2476700	2476700	17
chr16	2479394	2508859	CCNF	29465	+	NM_001761	2479482	2507021	17
chr16	2495392	2495458	MIR6767	66	+	NR_106825	2495458	2495458	1
chr16	2510114	2514964	C16orf59	4850	+	NM_025108	2510145	2514669	10
chr16	2513967	2514039	MIR6768	72	+	NR_106826	2514039	2514039	1
chr16	2521499	2524146	NTN3	2647	+	NM_006181	2521702	2524106	6
chr16	2525146	2555734	TBC1D24	30588	+	NM_001199107	2546149	2550959	8
chr16	2563726	2570224	ATP6V0C	6498	+	NM_001198569	2564104	2569746	4
chr16	2570362	2580955	AMDHD2	10593	+	NM_001145815	2570459	2580760	11
chr16	2580035	2581409	CEMP1	1374	-	NM_001048212	2580330	2581074	1
chr16	2581922	2582006	MIR3178	84	-	NR_036139	2582006	2582006	1
chr16	2587964	2653191	PDPK1	65227	+	NM_002613	2588113	2647768	14
chr16	2653384	2680495	LOC652276	27111	+	NR_015441	2680495	2680495	4
chr16	2688982	2696130	FLJ42627	7148	+	NR_024492	2696130	2696130	1
chr16	2708389	2723440	ERVK13-1	15051	-	NR_040023	2723440	2723440	3
chr16	2732494	2759031	KCTD5	26537	+	NM_018992	2732549	2757328	6
chr16	2762422	2770552	PRSS27	8130	-	NM_031948	2762620	2770161	6
chr16	2787076	2802601	SRRM2-AS1	15525	-	NR_027275	2802601	2802601	6
chr16	2802329	2821413	SRRM2	19084	+	NM_016333	2806365	2820868	15
chr16	2821414	2827297	TCEB2	5883	-	NM_207013	2821472	2827240	5
chr16	2833953	2836708	PRSS33	2755	-	NM_152891	2834644	2836548	6
chr16	2848485	2855133	PRSS41	6648	+	NM_001135086	2848485	2855133	5
chr16	2867163	2871723	PRSS21	4560	+	NM_001270452	2867269	2871371	6
chr16	2880172	2882285	ZG16B	2113	+	NM_145252	2880248	2882160	4
chr16	2889573	2892752	PRSS30P	3179	-	NR_026864	2892752	2892752	2
chr16	2902727	2908171	PRSS22	5444	-	NM_022119	2903093	2908105	6
chr16	2933195	2949383	FLYWCH2	16188	+	NM_001142499	2946450	2949150	4
chr16	2961979	3001209	FLYWCH1	39230	+	NM_032296	2979686	2998728	10
chr16	3014216	3018384	KREMEN2	4168	+	NM_001253726	3014521	3018021	9
chr16	3019245	3023490	PAQR4	4245	+	NM_152341	3019675	3021949	3
chr16	3022791	3030540	PKMYT1	7749	-	NM_001258451	3022953	3027015	9
chr16	3039054	3044510	LINC00514	5456	+	NR_033861	3044510	3044510	5
chr16	3048955	3050814	LOC101929613	1859	+	NR_110947	3050814	3050814	6
chr16	3062456	3064506	CLDN9	2050	+	NM_020982	3063363	3064017	1
chr16	3064712	3068188	CLDN6	3476	-	NM_021195	3065359	3066022	2
chr16	3070312	3072383	TNFRSF12A	2071	+	NM_016639	3070398	3071827	4
chr16	3072620	3074287	HCFC1R1	1667	-	NM_001288665	3072863	3073942	5
chr16	3074031	3077756	THOC6	3725	+	NM_024339	3074327	3077658	13
chr16	3077867	3085542	CCDC64B	7675	-	NM_001103175	3078106	3085497	9
chr16	3082481	3089133	LOC100128770	6652	+	NR_047572	3089133	3089133	8
chr16	3096681	3110724	MMP25	14043	+	NM_022468	3096918	3109099	10
chr16	3102125	3109371	MMP25-AS1	7246	-	NR_123723	3109371	3109371	5
chr16	3115312	3119668	IL32	4356	+	NM_001012633	3115812	3119356	8
chr16	3138890	3149318	ZSCAN10	10428	-	NM_032805	3139091	3142938	6
chr16	3160460	3165599	ZNF205-AS1	5139	-	NR_024166	3165599	3165599	3
chr16	3162562	3170518	ZNF205	7956	+	NM_003456	3163431	3170326	7
chr16	3175529	3184883	ZNF213-AS1	9354	-	NR_110900	3184883	3184883	6
chr16	3185056	3192805	ZNF213	7749	+	NR_104432	3192805	3192805	6
chr16	3194291	3199947	CASP16P	5656	+	NR_132322	3199947	3199947	10
chr16	3254246	3255185	OR1F1	939	+	NM_012360	3254246	3255185	1
chr16	3265561	3266546	OR1F2P	985	+	NR_002169	3266546	3266546	1
chr16	3272324	3285457	ZNF200	13133	-	NM_001145446	3273891	3283755	5
chr16	3292027	3306627	MEFV	14600	-	NM_000243	3293140	3306587	10
chr16	3313767	3317566	LINC00921	3799	+	NR_033904	3317566	3317566	2
chr16	3333486	3341459	ZNF263	7973	+	NM_005741	3333818	3340558	6
chr16	3348807	3355439	TIGD7	6632	-	NM_033208	3348964	3350614	2
chr16	3355405	3368576	ZNF75A	13171	+	NM_001302109	3358428	3367869	7
chr16	3405888	3406924	OR2C1	1036	+	NM_012368	3405940	3406879	1
chr16	3421052	3422283	MTRNR2L4	1231	-	NM_001190476	3421815	3421902	1
chr16	3432080	3451065	ZSCAN32	18985	-	NM_001284527	3432851	3447557	7
chr16	3451189	3459364	ZNF174	8175	+	NM_003450	3452004	3458919	3
chr16	3482421	3493537	ZNF597	11116	-	NM_152457	3486423	3493153	4
chr16	3493610	3536963	NAA60	43353	+	NM_001083601	3526227	3534855	8
chr16	3535380	3535469	MIR6126	89	-	NR_106741	3535469	3535469	1
chr16	3543483	3545421	C16orf90	1938	-	NM_001080524	3543838	3545421	3
chr16	3550944	3589051	CLUAP1	38107	+	NM_015041	3551067	3586271	12
chr16	3589035	3627405	NLRC3	38370	-	NR_075083	3627405	3627405	21
chr16	3631183	3661585	SLX4	30402	-	NM_032444	3632342	3658965	15
chr16	3702939	3708096	DNASE1	5157	+	NM_005223	3705374	3707954	9
chr16	3708037	3767598	TRAP1	59561	-	NM_016292	3708129	3767509	18
chr16	3775055	3930121	CREBBP	155066	-	NM_004380	3777718	3929917	31
chr16	3997625	4000445	LOC102724927	2820	-	NR_120311	4000445	4000445	2
chr16	4012649	4166186	ADCY9	153537	-	NM_001116	4015775	4165443	11
chr16	4239374	4292081	SRL	52707	-	NM_001098814	4242153	4292068	6
chr16	4295825	4303790	LINC01569	7965	-	NR_039999	4303790	4303790	3
chr16	4307186	4323001	TFAP4	15815	-	NM_003223	4308055	4322747	7
chr16	4374648	4378341	GLIS2-AS1	3693	-	NR_110901	4378341	4378341	4
chr16	4382224	4389598	GLIS2	7374	+	NM_032575	4382281	4387525	6
chr16	4390251	4401373	PAM16	11122	-	NM_016069	4390319	4401235	5
chr16	4390251	4466962	CORO7-PAM16	76711	-	NM_001201479	4390319	4466519	31
chr16	4404542	4466962	CORO7	62420	-	NM_024535	4405158	4466519	28
chr16	4421848	4433529	VASN	11681	+	NM_138440	4430878	4432900	2
chr16	4475805	4506775	DNAJA3	30970	+	NM_005147	4475882	4504915	12
chr16	4511677	4524896	NMRAL1	13219	-	NM_020677	4511780	4524133	6
chr16	4524703	4560348	HMOX2	35645	+	NM_001127206	4555525	4559757	6
chr16	4560676	4588816	CDIP1	28140	-	NM_001199056	4562572	4564131	6
chr16	4606490	4650318	C16orf96	43828	+	NM_001145011	4606490	4650318	16
chr16	4658883	4664927	UBALD1	6044	-	NM_145253	4659633	4664798	3
chr16	4674824	4740975	MGRN1	66151	+	NM_001142290	4674961	4736300	17
chr16	4721318	4721391	MIR6769A	73	+	NR_106827	4721391	4721391	1
chr16	4743693	4745860	NUDT16L1	2167	+	NM_001193452	4743727	4745053	3
chr16	4746510	4784378	ANKS3	37868	-	NR_040252	4784378	4784378	17
chr16	4784288	4799397	C16orf71	15109	+	NM_139170	4786515	4797626	10
chr16	4800814	4817219	ZNF500	16405	-	NM_001303450	4801630	4815979	7
chr16	4827614	4838522	SEPT12	10908	-	NM_144605	4827797	4837646	10
chr16	4838397	4846492	SMIM22	8095	+	NM_001253790	4845735	4846232	5
chr16	4846962	4852951	ROGDI	5989	-	NM_024589	4847460	4852572	11
chr16	4853203	4897303	GLYR1	44100	-	NM_001308096	4855236	4897266	16
chr16	4897631	4932402	UBN1	34771	+	NM_001079514	4902918	4930133	18
chr16	4932507	4987136	PPL	54629	-	NM_002705	4933384	4987046	22
chr16	5008317	5069156	SEC14L5	60839	+	NM_014692	5009324	5064971	16
chr16	5074844	5083942	NAGPA	9098	-	NM_016256	5075478	5083915	10
chr16	5083702	5092972	NAGPA-AS1	9270	+	NR_038913	5092972	5092972	2
chr16	5094122	5116146	C16orf89	22024	-	NM_001098514	5094348	5115909	8
chr16	5121809	5137380	ALG1	15571	+	NM_019109	5121850	5134882	13
chr16	5134300	5147821	EEF2KMT	13521	-	NM_201400	5135632	5147740	8
chr16	5651169	5666251	LINC01570	15082	-	NR_110902	5666251	5666251	3
chr16	5682467	5682567	MIR8065	100	+	NR_107032	5682567	5682567	1
chr16	6069131	7763340	RBFOX1	1694209	+	NM_018723	7102072	7760747	16
chr16	8576550	8602209	TMEM114	25659	-	NR_110736	8602209	8602209	2
chr16	8715526	8740079	METTL22	24553	+	NM_024109	8719522	8740000	11
chr16	8768443	8878432	ABAT	109989	+	NM_020686	8829596	8875287	16
chr16	8889036	8891505	TMEM186	2469	-	NM_015421	8889808	8891471	2
chr16	8891669	8943194	PMM2	51525	+	NM_000303	8891739	8941682	8
chr16	8946798	8962869	CARHSP1	16071	-	NM_001278260	8949020	8953185	5
chr16	8985950	9057341	USP7	71391	-	NM_003470	8987854	9057142	31
chr16	9185536	9213555	C16orf72	28019	+	NM_014117	9185901	9210769	4
chr16	9328773	9328803	MIR548X	30	+	NR_036166	9328803	9328803	1
chr16	9535150	9538842	LINC01177	3692	-	NR_126397	9538842	9538842	4
chr16	9539869	9549362	LINC01195	9493	-	NR_126349	9549362	9549362	5
chr16	9847261	10276611	GRIN2A	429350	-	NM_000833	9857005	10274268	14
chr16	10479911	10577495	ATF7IP2	97584	+	NM_001256160	10524477	10575756	12
chr16	10622278	10674573	EMP2	52295	-	NM_001424	10626761	10641474	5
chr16	10721360	10788802	TEKT5	67442	-	NM_144674	10721439	10788730	7
chr16	10837642	10863208	NUBP1	25566	+	NM_002484	10837720	10862962	11
chr16	10860532	10912621	TVP23A	52089	-	NM_001079512	10864128	10912350	8
chr16	10971054	11018840	CIITA	47786	+	NM_000246	10971187	11017160	20
chr16	11022747	11036257	DEXI	13510	-	NM_014015	11035574	11035862	2
chr16	11038344	11276046	CLEC16A	237702	+	NM_015226	11038574	11272547	23
chr16	11348273	11350039	SOCS1	1766	-	NM_003745	11348699	11349335	2
chr16	11361713	11363160	TNP2	1447	-	NM_005425	11361852	11363119	2
chr16	11367055	11367452	PRM3	397	-	NM_021247	11367140	11367452	1
chr16	11369492	11370337	PRM2	845	-	NR_104428	11370337	11370337	3
chr16	11374692	11375192	PRM1	500	-	NM_002761	11374848	11375095	2
chr16	11439294	11445620	RMI2	6326	+	NM_152308	11439328	11444647	2
chr16	11559115	11567030	LOC101927131	7915	+	NR_110907	11567030	11567030	3
chr16	11641577	11681322	LITAF	39745	-	NR_024320	11681322	11681322	4
chr16	11762288	11773015	SNN	10727	+	NM_003498	11769915	11770182	2
chr16	11772935	11836734	TXNDC11	63799	-	NM_001303447	11773050	11836586	13
chr16	11844441	11891114	ZC3H7A	46673	-	NM_014153	11845172	11876210	23
chr16	11913690	11922689	BCAR4	8999	-	NR_131222	11922689	11922689	3
chr16	11928054	11945442	RSL1D1	17388	-	NM_015659	11931643	11945369	9
chr16	11961984	12010519	GSPT1	48535	-	NM_001130007	11966975	11991718	15
chr16	12058963	12061925	TNFRSF17	2962	+	NM_001192	12059181	12061704	3
chr16	12070590	12668146	SNX29	597556	+	NM_032167	12070663	12662486	21
chr16	12753655	12897744	CPPED1	144089	-	NM_018340	12758742	12897633	4
chr16	12814177	12814228	MIR4718	51	+	NR_039869	12814228	12814228	1
chr16	12995476	13334273	SHISA9	338797	+	NM_001145204	12995921	13329266	5
chr16	14014013	14046205	ERCC4	32192	+	NM_005236	14014022	14042204	11
chr16	14103132	14109875	LOC101927311	6743	-	NR_110909	14109875	14109875	3
chr16	14112736	14114934	LOC101927348	2198	-	NR_110915	14114934	14114934	3
chr16	14165169	14360636	MKL2	195467	+	NM_014048	14234463	14355301	17
chr16	14396144	14420374	MIR193BHG	24230	+	NR_132983	14420374	14420374	2
chr16	14397823	14397906	MIR193B	83	+	NR_030177	14397906	14397906	1
chr16	14403141	14403228	MIR365A	87	+	NR_029854	14403228	14403228	1
chr16	14456965	14464123	LOC105447648	7158	-	NR_131191	14464123	14464123	2
chr16	14529556	14724128	PARN	194572	-	NM_001134477	14530573	14721187	24
chr16	14726667	14763093	BFAR	36426	+	NM_016561	14738203	14761684	8
chr16	14766404	14788430	PLA2G10	22026	-	NR_133651	14788430	14788430	5
chr16	14805545	14820185	NPIPA2	14640	+	NM_001277324	14805545	14820150	8
chr16	14805545	14820195	NPIPA3	14650	+	NM_001277323	14805545	14820150	8
chr16	14916288	14918559	ABCC6P2	2271	-	NR_023387	14918559	14918559	2
chr16	14927642	14990014	NOMO1	62372	+	NM_014287	14927708	14989502	31
chr16	14995364	14995448	MIR3179-1	84	+	NR_036140	14995448	14995448	1
chr16	14995364	14995448	MIR3179-2	84	+	NR_036143	14995448	14995448	1
chr16	14995364	14995448	MIR3179-3	84	+	NR_036145	14995448	14995448	1
chr16	14995364	14995448	MIR3179-4	84	+	NR_128709	14995448	14995448	1
chr16	15001573	15001638	MIR3670-1	65	+	NR_037442	15001638	15001638	1
chr16	15001573	15001638	MIR3670-2	65	+	NR_049832	15001638	15001638	1
chr16	15001573	15001638	MIR3670-3	65	+	NR_128712	15001638	15001638	1
chr16	15001573	15001638	MIR3670-4	65	+	NR_128713	15001638	15001638	1
chr16	15005076	15005170	MIR3180-1	94	+	NR_036141	15005170	15005170	1
chr16	15005076	15005170	MIR3180-3	94	+	NR_036144	15005170	15005170	1
chr16	15005080	15005168	MIR3180-2	88	+	NR_036142	15005168	15005168	1
chr16	15019606	15021140	LOC100288162	1534	-	NR_103772	15021140	15021140	3
chr16	15019793	15019860	MIR6511A1	67	+	NR_106766	15019860	15019860	1
chr16	15019793	15019860	MIR6511A2	67	+	NR_106969	15019860	15019860	1
chr16	15019793	15019860	MIR6511A3	67	+	NR_106970	15019860	15019860	1
chr16	15019793	15019860	MIR6511A4	67	+	NR_106971	15019860	15019860	1
chr16	15024676	15024736	MIR6770-1	60	+	NR_106828	15024736	15024736	1
chr16	15024676	15024736	MIR6770-2	60	+	NR_107060	15024736	15024736	1
chr16	15024676	15024736	MIR6770-3	60	+	NR_107061	15024736	15024736	1
chr16	15031299	15045931	NPIPA1	14632	+	NM_006985	15031299	15045882	8
chr16	15068819	15233206	PDXDC1	164387	+	NM_001285449	15069056	15232833	17
chr16	15131709	15149936	NTAN1	18227	-	NM_173474	15131887	15149828	10
chr16	15153878	15188192	RRN3	34314	-	NM_018427	15155600	15188090	18
chr16	15188267	15203054	LOC100505915	14787	+	NR_125434	15203054	15203054	4
chr16	15198158	15230816	PKD1P6	32658	-	NR_123721	15230816	15230816	29
chr16	15248706	15248859	MIR3180-4	153	-	NR_037466	15248859	15248859	1
chr16	15457480	15472151	NPIPA5	14671	-	NM_001277325	15457515	15472151	8
chr16	15489610	15503543	MPV17L	13933	+	NM_001128423	15489754	15501969	4
chr16	15528324	15682116	C16orf45	153792	+	NM_033201	15528510	15680686	6
chr16	15688225	15737023	KIAA0430	48798	-	NM_001184999	15690549	15733090	27
chr16	15704886	15704952	MIR6506	66	-	NR_106761	15704952	15704952	1
chr16	15737123	15820208	NDE1	83085	+	NM_001143979	15758635	15818108	10
chr16	15737150	15737229	MIR484	79	+	NR_030159	15737229	15737229	1
chr16	15796991	15950887	MYH11	153896	-	NM_001040113	15802667	15932109	43
chr16	15959575	15982506	FOPNL	22931	-	NM_001304499	15961296	15982442	6
chr16	16043433	16236930	ABCC1	193497	+	NM_004996	16043608	16235138	31
chr16	16243421	16317328	ABCC6	73907	-	NM_001171	16243989	16317291	31
chr16	16326388	16388668	NOMO3	62280	+	NM_001004067	16326523	16388156	31
chr16	16411465	16444465	PKD1P1	33000	+	NR_036447	16444465	16444465	31
chr16	17196180	17564738	XYLT1	368558	-	NM_022166	17202551	17564653	12
chr16	18411775	18426519	NPIPA7	14744	-	NM_001282507	18411824	18426519	8
chr16	18411775	18426519	NPIPA8	14744	-	NM_001282511	18411824	18426519	8
chr16	18511181	18573434	NOMO2	62253	-	NM_001004060	18511227	18573362	32
chr16	18582569	18609607	ABCC6P1	27038	+	NR_003569	18609607	18609607	10
chr16	18794276	18801656	RPS15A	7380	-	NM_001030009	18794330	18800435	5
chr16	18802988	18813000	ARL6IP1	10012	-	NM_015161	18804573	18812788	6
chr16	18816174	18937726	SMG1	121552	-	NM_015092	18820890	18937363	63
chr16	18995255	19075262	TMC7	80007	+	NM_024847	18995385	19073165	16
chr16	19074075	19079013	LOC102723385	4938	-	NR_119379	19079013	19079013	4
chr16	19078916	19091417	COQ7	12501	+	NM_016138	19078986	19089480	6
chr16	19125253	19132952	ITPRIPL2	7699	+	NR_028028	19132952	19132952	2
chr16	19179534	19279656	SYT17	100122	+	NM_016524	19179968	19278398	8
chr16	19297104	19322269	CLEC19A	25165	+	NM_001256720	19297173	19320405	5
chr16	19421860	19510434	TMC5	88574	+	NM_001308161	19451360	19509288	21
chr16	19513014	19533450	GDE1	20436	-	NM_016641	19514791	19533286	6
chr16	19535178	19564728	CCP110	29550	+	NM_014711	19539203	19562593	15
chr16	19566736	19712485	C16orf62	145749	+	NM_020314	19566784	19711798	31
chr16	19717673	19729492	KNOP1	11819	-	NM_001012991	19718231	19726357	5
chr16	19727777	19869789	IQCK	142012	+	NM_153208	19729628	19867870	10
chr16	19870292	19896956	GPRC5B	26664	-	NM_001304771	19871821	19896916	4
chr16	20043042	20085100	GPR139	42058	-	NM_001002911	20043056	20084938	2
chr16	20320895	20338942	GP2	18047	-	NM_001007240	20322544	20337753	12
chr16	20344372	20364200	UMOD	19828	-	NM_001278614	20344635	20362059	12
chr16	20370491	20416033	PDILT	45542	-	NM_174924	20370640	20410622	12
chr16	20420855	20452281	ACSM5	31426	+	NM_017888	20422806	20451749	14
chr16	20462782	20498991	ACSM2A	36209	+	NM_001308954	20471436	20498000	15
chr16	20548082	20587695	ACSM2B	39613	-	NM_182617	20548579	20576167	15
chr16	20634558	20702578	ACSM1	68020	-	NM_052956	20634807	20702510	13
chr16	20744985	20753286	THUMPD1	8301	-	NM_001304550	20748201	20753061	5
chr16	20775311	20808479	ACSM3	33168	+	NM_005622	20781356	20808294	14
chr16	20791514	20817795	ERI2	26281	-	NM_080663	20791963	20817752	11
chr16	20817766	20860990	LOC81691	43224	+	NM_001199053	20818275	20860802	20
chr16	20869395	20911561	DCUN1D3	42166	-	NM_173475	20871207	20873860	3
chr16	20911189	20936331	LYRM1	25142	+	NM_020424	20926877	20935438	5
chr16	20944432	21170762	DNAH3	226330	-	NM_017539	20944475	21170762	62
chr16	21169697	21191937	TMEM159	22240	+	NR_125971	21191937	21191937	7
chr16	21208772	21225831	ZP2	17059	-	NM_003460	21208800	21222868	20
chr16	21245015	21263750	ANKS4B	18735	+	NM_145865	21245058	21262141	2
chr16	21269838	21314457	CRYM	44619	-	NM_001888	21270101	21289572	10
chr16	21312169	21329912	CRYM-AS1	17743	+	NR_026675	21329912	21329912	3
chr16	21360683	21397254	SNX29P1	36571	+	NR_045011	21397254	21397254	6
chr16	21413454	21436658	NPIPB3	23204	-	NM_130464	21413604	21436419	12
chr16	21443344	21445776	LOC100190986	2432	-	NR_024456	21445776	21445776	1
chr16	21458003	21513602	SMG1P3	55599	-	NR_027155	21513602	21513602	29
chr16	21517369	21517456	MIR3680-1	87	-	NR_037451	21517456	21517456	1
chr16	21517369	21517456	MIR3680-2	87	-	NR_049833	21517456	21517456	1
chr16	21529229	21531765	SLC7A5P2	2536	-	NR_002594	21531765	21531765	1
chr16	21601018	21610706	LOC101927814	9688	-	NR_110930	21610706	21610706	3
chr16	21608541	21668794	METTL9	60253	+	NM_001288660	21608576	21666753	5
chr16	21652604	21663987	IGSF6	11383	-	NM_005849	21652854	21663919	6
chr16	21689834	21772050	OTOA	82216	+	NM_144672	21689835	21771861	28
chr16	21807950	21830495	RRN3P1	22545	-	NR_003370	21830495	21830495	12
chr16	21845883	21869077	NPIPB4	23194	-	NM_001310148	21846038	21868699	8
chr16	21964384	21994981	UQCRC2	30597	+	NM_003366	21964744	21994492	14
chr16	21995185	22012431	PDZD9	17246	-	NR_033694	22012431	22012431	5
chr16	22019455	22095972	C16orf52	76517	+	NM_001164579	22019622	22092201	3
chr16	22103858	22168287	VWA3A	64429	+	NM_173615	22103958	22167223	34
chr16	22217591	22300066	EEF2K	82475	+	NM_013302	22237050	22295317	18
chr16	22308695	22346424	POLR3E	37729	+	NM_018119	22314289	22345021	21
chr16	22357256	22385938	CDR2	28682	-	NM_001802	22358285	22385630	5
chr16	22430866	22449036	RRN3P3	18170	-	NR_027460	22449036	22449036	7
chr16	22448328	22503541	SMG1P1	55213	+	NR_027154	22503541	22503541	29
chr16	22524843	22547841	NPIPB5	22998	+	NM_001135865	22525122	22547706	7
chr16	22557018	22588186	LOC653786	31168	+	NR_003676	22588186	22588186	9
chr16	22729602	22803362	MIR548D2	73760	+	NR_030385	22803362	22803362	4
chr16	22729602	22803363	MIR548AA2	73761	-	NR_037517	22803363	22803363	4
chr16	22825859	22927659	HS3ST2	101800	+	NM_006043	22825931	22926883	2
chr16	23072727	23160591	USP31	87864	-	NM_020718	23079366	23160591	16
chr16	23194039	23228200	SCNN1G	34161	+	NM_001039	23197592	23226790	13
chr16	23313590	23392620	SCNN1B	79030	+	NM_000336	23359920	23392122	13
chr16	23399813	23464512	COG7	64699	-	NM_153603	23400240	23464315	17
chr16	23474862	23521815	GGA2	46953	-	NM_015044	23478910	23521732	17
chr16	23533333	23568696	EARS2	35363	-	NR_003501	23568696	23568696	10
chr16	23568861	23585710	UBFD1	16849	+	NM_019116	23569063	23581911	7
chr16	23592334	23607639	NDUFAB1	15305	-	NM_005003	23593604	23607611	5
chr16	23614482	23652678	PALB2	38196	-	NM_024675	23614779	23652478	13
chr16	23652686	23685068	DCTN5	32382	+	NR_037573	23685068	23685068	7
chr16	23690092	23701688	PLK1	11596	+	NM_005030	23690253	23701384	10
chr16	23701625	23724821	ERN2	23196	-	NM_033266	23702151	23724508	22
chr16	23765947	23770272	CHP2	4325	+	NM_022097	23766370	23768904	7
chr16	23847299	24231932	PRKCB	384633	+	NM_002738	23847496	24226137	17
chr16	24266873	24373737	CACNG3	106864	+	NM_006539	24268075	24373184	4
chr16	24550907	24584183	RBBP6	33276	+	NM_006910	24551947	24583766	18
chr16	24672742	24682383	LINC01567	9641	-	NR_122072	24682383	24682383	3
chr16	24741048	24837547	TNRC6A	96499	+	NM_014494	24741162	24835128	25
chr16	24857183	24922949	SLC5A11	65766	+	NM_001258411	24869964	24922854	16
chr16	24930704	25026699	ARHGAP17	95995	-	NM_001006634	24931450	25026582	20
chr16	25043061	25044098	LOC554206	1037	+	NR_038379	25044098	25044098	1
chr16	25111884	25122876	LCMT1-AS1	10992	-	NR_120306	25122876	25122876	3
chr16	25123046	25189551	LCMT1	66505	+	NM_016309	25123204	25189344	11
chr16	25151891	25160353	LCMT1-AS2	8462	-	NR_039998	25160353	25160353	3
chr16	25228284	25240253	AQP8	11969	+	NM_001169	25228366	25239813	6
chr16	25247321	25268855	ZKSCAN2	21534	-	NM_001012981	25251136	25268448	7
chr16	25703346	26149009	HS3ST4	445663	+	NM_006040	25703738	26147569	2
chr16	27078218	27080487	C16orf82	2269	+	NM_001145545	27078316	27078781	1
chr16	27214806	27233089	KDM8	18283	+	NM_024773	27221444	27232051	8
chr16	27236314	27280113	NSMCE1	43799	-	NM_145080	27236477	27268891	8
chr16	27279525	27301789	FLJ21408	22264	+	NR_037184	27301789	27301789	5
chr16	27325229	27376099	IL4R	50870	+	NM_000418	27351524	27375151	11
chr16	27413482	27463363	IL21R	49881	+	NM_181079	27414491	27460604	10
chr16	27458990	27464714	IL21R-AS1	5724	-	NR_037158	27464714	27464714	3
chr16	27471933	27561251	GTF3C1	89318	-	NM_001286242	27472670	27561211	37
chr16	27561467	27791692	KIAA0556	230225	+	NM_015202	27561491	27789950	28
chr16	27798849	28074830	GSG1L	275981	-	NM_001109763	27802690	28074745	7
chr16	28109297	28223239	XPO6	113942	-	NM_001270940	28109858	28192313	25
chr16	28303839	28335170	SBK1	31331	+	NM_001024401	28328712	28332242	4
chr16	28353838	28374181	NPIPB6	20343	-	NM_001282524	28353927	28374143	7
chr16	28402302	28402372	MIR6862-1	70	-	NR_106922	28402372	28402372	1
chr16	28402302	28402372	MIR6862-2	70	-	NR_107058	28402372	28402372	1
chr16	28477973	28503403	CLN3	25430	-	NM_001286109	28488836	28500670	14
chr16	28505969	28510291	APOBR	4322	+	NM_018690	28506002	28509826	4
chr16	28510682	28518155	IL27	7473	-	NM_145659	28510971	28518132	5
chr16	28548661	28550495	NUPR1	1834	-	NM_001042483	28549339	28550228	3
chr16	28565248	28603111	SGF29	37863	+	NM_138414	28592390	28603027	10
chr16	28603263	28608391	SULT1A2	5128	-	NM_001054	28603348	28607251	8
chr16	28616907	28634907	SULT1A1	18000	-	NM_177536	28617141	28634518	6
chr16	28649681	28669951	NPIPB8	20270	+	NM_001310136	28649681	28669951	7
chr16	28699878	28747050	EIF3C	47172	+	NM_001199142	28723007	28746834	21
chr16	28722740	28747050	EIF3CL	24310	+	NM_001317856	28723007	28746834	21
chr16	28763755	28784144	NPIPB9	20389	+	NM_001287251	28763888	28784076	8
chr16	28834368	28848558	ATXN2L	14190	+	NM_148414	28834580	28847801	24
chr16	28853731	28857729	TUFM	3998	-	NM_003321	28854295	28857590	10
chr16	28855239	28855328	MIR4721	89	-	NR_039872	28855328	28855328	1
chr16	28857920	28885534	SH2B1	27614	+	NM_001308293	28877415	28885141	11
chr16	28889808	28915830	ATP2A1	26022	+	NM_004320	28889992	28915025	23
chr16	28890277	28891242	ATP2A1-AS1	965	-	NR_046290	28891242	28891242	2
chr16	28915741	28936532	RABEP2	20791	-	NM_024816	28916263	28936484	13
chr16	28943259	28950668	CD19	7409	+	NM_001178098	28943321	28950284	15
chr16	28962317	28977767	NFATC2IP	15450	+	NM_032815	28962332	28975184	8
chr16	28969903	28969982	MIR4517	79	+	NR_039742	28969982	28969982	1
chr16	28986095	28995869	SPNS1	9774	+	NM_001142448	28986472	28995620	13
chr16	28996146	29002104	LAT	5958	+	NM_001014989	28996182	29001333	13
chr16	29086162	29128038	RRN3P2	41876	+	NR_003369	29128038	29128038	17
chr16	29313607	29376380	SNX29P2	62773	+	NR_002939	29376380	29376380	9
chr16	29392638	29415123	NPIPB11	22485	-	NM_001310137	29392766	29415123	8
chr16	29460665	29461236	LOC606724	571	+	NR_002454	29461236	29461236	1
chr16	29464913	29466285	BOLA2B	1372	-	NM_001039182	29464953	29465772	3
chr16	29464913	29466285	BOLA2	1372	-	NM_001031827	29464953	29465772	3
chr16	29465821	29469545	SLX1A	3724	+	NM_001014999	29466063	29469445	6
chr16	29465821	29469545	SLX1B	3724	+	NM_024044	29466063	29469445	6
chr16	29476288	29478899	LOC388242	2611	-	NR_002556	29478899	29478899	5
chr16	29476288	29478899	LOC613038	2611	-	NR_002557	29478899	29478899	5
chr16	29538928	29577540	SMG1P2	38612	-	NR_002473	29577540	29577540	27
chr16	29624423	29625038	SLC7A5P1	615	-	NR_002593	29625038	29625038	1
chr16	29674270	29681823	SPN	7553	+	NM_001030288	29675049	29676252	2
chr16	29690440	29709314	QPRT	18874	+	NM_014298	29690518	29708732	4
chr16	29753785	29757340	C16orf54	3555	-	NM_175900	29755597	29756272	2
chr16	29789560	29792969	ZG16	3409	+	NM_152338	29790587	29791740	4
chr16	29802033	29816706	KIF22	14673	+	NM_001256269	29808347	29816631	15
chr16	29817416	29822504	MAZ	5088	+	NM_001276275	29817465	29821552	6
chr16	29823408	29827202	PRRT2	3794	+	NM_145239	29824375	29825959	4
chr16	29827527	29833816	PAGR1	6289	+	NM_024516	29827846	29831075	3
chr16	29831714	29859360	MVP	27646	+	NM_017458	29841870	29859310	15
chr16	29869676	29874609	CDIPT	4933	-	NM_006319	29870509	29874178	6
chr16	29875003	29879374	CDIPT-AS1	4371	+	NR_024370	29879374	29879374	6
chr16	29882479	29910585	SEZ6L2	28106	-	NM_001243332	29883019	29910340	18
chr16	29912146	29917377	ASPHD1	5231	+	NM_181718	29912292	29917218	3
chr16	29917656	29937553	KCTD13	19897	-	NM_178863	29918192	29937354	6
chr16	29973350	29984373	TMEM219	11023	+	NM_001083613	29974464	29982866	6
chr16	29985187	30003582	TAOK2	18395	+	NM_004783	29989093	30002889	19
chr16	30003641	30007417	HIRIP3	3776	-	NM_003609	30004527	30006926	7
chr16	30007529	30017111	INO80E	9582	+	NM_001304563	30007631	30015957	8
chr16	30016834	30024917	DOC2A	8083	-	NM_001282062	30017506	30021543	12
chr16	30034654	30036023	C16orf92	1369	+	NM_001109660	30034675	30035548	4
chr16	30035747	30042186	FAM57B	6439	-	NM_031478	30036503	30041848	5
chr16	30064410	30081741	ALDOA	17331	+	NM_000034	30078575	30081533	14
chr16	30087296	30096698	PPP4C	9402	+	NM_002720	30087698	30096383	9
chr16	30097114	30103205	TBX6	6091	-	NM_004608	30097545	30102514	9
chr16	30103636	30107537	YPEL3	3901	-	NM_001145524	30104030	30106689	5
chr16	30116130	30124878	GDPD3	8748	-	NM_024307	30116192	30124799	10
chr16	30125425	30134630	MAPK3	9205	-	NM_002746	30127988	30134530	9
chr16	30194730	30200397	CORO1A	5667	+	NM_001193333	30196530	30200285	12
chr16	30205753	30215650	SLX1A-SULT1A3	9897	+	NR_037608	30215650	30215650	11
chr16	30205753	30215650	SLX1B-SULT1A4	9897	+	NR_037609	30215650	30215650	11
chr16	30210548	30215650	SULT1A3	5102	+	NM_177552	30212049	30215241	8
chr16	30210548	30215650	SULT1A4	5102	+	NM_001017390	30212049	30215241	8
chr16	30234349	30256932	LOC613037	22583	-	NR_002555	30256932	30256932	7
chr16	30278913	30346695	SMG1P5	67782	-	NR_002453	30346695	30346695	28
chr16	30362086	30366682	CD2BP2	4596	-	NM_006110	30364305	30366002	7
chr16	30368421	30381522	TBC1D10B	13101	-	NM_015527	30369264	30381504	9
chr16	30386122	30389310	MYLPF	3188	+	NM_013292	30386178	30389221	7
chr16	30389453	30394171	SEPT1	4718	-	NM_052838	30389754	30394125	12
chr16	30389632	30411429	ZNF48	21797	+	NM_001214906	30407115	30410428	3
chr16	30418734	30429916	ZNF771	11182	+	NM_016643	30419374	30429688	3
chr16	30435018	30441373	DCTPP1	6355	-	NM_024096	30435553	30441301	3
chr16	30454945	30457296	SEPHS2	2351	-	NM_012248	30455701	30457048	1
chr16	30483982	30534506	ITGAL	50524	+	NM_002209	30484158	30532986	31
chr16	30515239	30515322	MIR4518	83	+	NR_039743	30515322	30515322	1
chr16	30535321	30537910	ZNF768	2589	-	NM_024671	30535837	30537734	2
chr16	30541687	30546291	ZNF747	4604	-	NM_001305019	30543819	30546000	3
chr16	30565084	30569642	ZNF764	4558	-	NM_001172679	30566514	30569503	3
chr16	30581018	30583728	ZNF688	2710	-	NM_001024683	30581236	30583596	3
chr16	30591993	30597092	ZNF785	5099	-	NM_152458	30593880	30596932	3
chr16	30613878	30622096	ZNF689	8218	-	NR_073481	30622096	30622096	3
chr16	30662240	30667734	PRR14	5494	+	NM_024031	30662966	30667632	12
chr16	30670839	30682131	FBRS	11292	+	NM_001105079	30670839	30680966	18
chr16	30709024	30709810	LOC730183	786	-	NM_001256932	30709077	30709629	2
chr16	30710461	30751450	SRCAP	40989	+	NM_006662	30712145	30751054	34
chr16	30721857	30721986	SNORA30	129	+	NR_002966	30721986	30721986	1
chr16	30751511	30756517	TMEM265	5006	+	NM_001256829	30753064	30755264	3
chr16	30759619	30772497	PHKG2	12878	+	NM_001172432	30760141	30771481	11
chr16	30768743	30773565	CCDC189	4822	-	NM_001014979	30768796	30773069	9
chr16	30772932	30787628	RNF40	14696	+	NM_001207033	30773866	30785435	20
chr16	30789769	30798523	ZNF629	8754	-	NM_001080417	30793038	30795803	3
chr16	30845361	30905623	BCL7C	60262	-	NM_001286526	30846268	30905265	6
chr16	30886586	30886644	MIR4519	58	-	NR_039744	30886644	30886644	1
chr16	30886780	30906539	MIR762HG	19759	+	NR_110942	30906539	30906539	3
chr16	30905223	30905306	MIR762	83	+	NR_031576	30905306	30905306	1
chr16	30907927	30914881	CTF1	6954	+	NM_001330	30907964	30913860	3
chr16	30930639	30934590	FBXL19-AS1	3951	-	NR_024348	30934590	30934590	1
chr16	30934375	30960104	FBXL19	25729	+	NM_001282351	30941480	30958551	11
chr16	30960404	30966259	ORAI3	5855	+	NM_152288	30960610	30965165	2
chr16	30968614	30995983	SETD1A	27369	+	NM_014712	30970052	30995344	19
chr16	30996518	31000473	HSD3B7	3955	+	NM_025193	30996979	30999504	7
chr16	31000576	31021959	STX1B	21383	-	NM_052874	31004141	31021717	10
chr16	31044415	31051488	STX4	7073	+	NM_001272096	31044841	31051124	12
chr16	31072163	31085641	ZNF668	13478	-	NM_024706	31072388	31075780	3
chr16	31085742	31094833	ZNF646	9091	+	NM_014699	31087645	31094413	3
chr16	31094744	31100130	PRSS53	5386	-	NM_001039503	31095110	31100130	11
chr16	31102162	31106320	VKORC1	4158	-	NM_001311311	31102454	31106050	4
chr16	31119614	31124112	BCKDK	4498	+	NM_005881	31120544	31123586	12
chr16	31128984	31142714	KAT8	13730	+	NM_032188	31129002	31142580	11
chr16	31142753	31147151	PRSS8	4398	-	NM_002773	31143329	31146819	6
chr16	31150246	31161415	PRSS36	11169	-	NM_173502	31150458	31161356	15
chr16	31191430	31206192	FUS	14762	+	NM_001170634	31191535	31202759	15
chr16	31212806	31214097	PYCARD	1291	-	NM_013258	31212905	31214011	3
chr16	31213205	31214773	PYCARD-AS1	1568	+	NR_102400	31214773	31214773	2
chr16	31225341	31236510	TRIM72	11169	+	NM_001008274	31226059	31236076	7
chr16	31227282	31228414	PYDC1	1132	-	NM_152901	31228079	31228349	2
chr16	31271287	31344213	ITGAM	72926	+	NM_000632	31271385	31343028	30
chr16	31366454	31394318	ITGAX	27864	+	NM_001286375	31366575	31393817	31
chr16	31404632	31437826	ITGAD	33194	+	NM_005353	31404681	31437449	30
chr16	31439051	31439749	COX6A2	698	-	NM_005205	31439094	31439646	3
chr16	31446884	31454348	ZNF843	7464	-	NM_001136509	31447123	31448170	2
chr16	31469593	31478488	ARMC5	8895	+	NM_001288767	31469717	31478210	8
chr16	31483475	31489281	TGFB1I1	5806	+	NM_001042454	31483509	31488897	11
chr16	31494438	31502091	SLC5A2	7653	+	NM_003041	31494457	31501856	14
chr16	31500795	31519740	C16orf58	18945	-	NM_022744	31502155	31519694	13
chr16	31539202	31540124	AHSP	922	+	NM_016633	31539460	31540012	3
chr16	31579087	31580845	YBX3P1	1758	-	NR_027011	31580845	31580845	1
chr16	31711933	31718745	CLUHP3	6812	+	NR_024034	31718745	31718745	9
chr16	31724549	31772886	ZNF720	48337	+	NM_001130913	31724753	31770697	5
chr16	31885078	31928629	ZNF267	43551	+	NR_049749	31928629	31928629	5
chr16	32181363	32199434	HERC2P4	18071	-	NR_109773	32199434	32199434	14
chr16	32264644	32267249	TP53TG3D	2605	+	NR_110898	32267249	32267249	3
chr16	32300867	32301302	LOC390705	435	-	NR_033866	32301302	32301302	1
chr16	32684848	32687450	TP53TG3B	2602	-	NR_110897	32687450	32687450	4
chr16	32684848	32687450	TP53TG3	2602	-	NR_110886	32687450	32687450	4
chr16	32685408	32687448	TP53TG3C	2040	-	NR_110914	32687448	32687448	3
chr16	32888796	32896463	SLC6A10P	7667	-	NR_003083	32896463	32896463	9
chr16	33571843	33586742	ENPP7P13	14899	+	NR_130771	33586742	33586742	3
chr16	33961051	33962503	LINC00273	1452	-	NR_038368	33962503	33962503	1
chr16	34403801	34404762	UBE2MP1	961	-	NR_002837	34404762	34404762	1
chr16	34597786	34626084	LINC01566	28298	+	NR_027080	34626084	34626084	7
chr16	34711784	34714967	FRG2DP	3183	-	NR_026980	34714967	34714967	3
chr16	34739458	34741541	TP53TG3HP	2083	-	NR_034018	34741541	34741541	3
chr16	34980922	34990995	FLJ26245	10073	+	NR_033985	34990995	34990995	3
chr16	46503248	46603009	ANKRD26P1	99761	-	NR_026556	46603009	46603009	17
chr16	46614467	46655311	SHCBP1	40844	-	NM_024745	46615640	46655271	13
chr16	46693588	46723144	VPS35	29556	-	NM_018206	46694383	46723045	17
chr16	46723557	46732306	ORC6	8749	+	NM_014321	46723617	46731497	7
chr16	46736193	46797158	MYLK3	60965	-	NM_001308301	46741615	46766558	12
chr16	46835958	46865074	C16orf87	29116	-	NM_001001436	46836863	46865061	4
chr16	46918291	46965209	GPT2	46918	+	NM_133443	46918627	46962909	12
chr16	46989273	47007625	DNAJA2	18352	-	NM_005880	46990940	47007483	9
chr16	47115430	47177936	NETO2	62506	-	NM_001201477	47117131	47177523	9
chr16	47177978	47196657	ITFG1-AS1	18679	+	NR_110903	47196657	47196657	5
chr16	47188298	47495185	ITFG1	306887	-	NM_030790	47189629	47494956	18
chr16	47495209	47735434	PHKB	240225	+	NM_001031835	47497849	47733277	32
chr16	47883224	47921041	LOC100507534	37817	-	NR_110649	47921041	47921041	2
chr16	47892491	47942342	LOC101927132	49851	+	NR_110650	47942342	47942342	6
chr16	48116883	48180681	ABCC12	63798	-	NM_033226	48117625	48180335	29
chr16	48200821	48269088	ABCC11	68267	-	NM_032583	48201184	48265832	30
chr16	48274602	48420559	MIR548AE2	145957	+	NR_039639	48420559	48420559	4
chr16	48278077	48387890	LONP2	109813	+	NM_031490	48278299	48385713	15
chr16	48344528	48658037	MIR5095	313509	+	NR_039970	48658037	48658037	5
chr16	48389595	48396910	LOC100507577	7315	+	NR_040677	48396910	48396910	2
chr16	48394453	48419229	SIAH1	24776	-	NM_003031	48395490	48396339	2
chr16	48572636	48644120	N4BP1	71484	-	NM_153029	48576814	48643883	7
chr16	49311828	49315742	CBLN1	3914	-	NM_004352	49313314	49315376	3
chr16	49407718	49433342	C16orf78	25624	+	NM_144602	49407850	49433189	5
chr16	49524514	49891830	ZNF423	367316	-	NM_001271620	49525185	49764778	8
chr16	50059116	50070999	CNEP1R1	11883	+	NM_153261	50059226	50069369	7
chr16	50099880	50139375	HEATR3	39495	+	NM_182922	50100042	50138972	15
chr16	50186828	50269219	PAPD5	82391	+	NM_001040285	50186863	50263239	13
chr16	50300450	50344440	ADCY7	43990	+	NM_001286057	50322090	50344409	19
chr16	50326526	50326586	MIR6771	60	+	NR_106829	50326586	50326586	1
chr16	50352928	50402845	BRD7	49917	-	NM_001173984	50353121	50402685	17
chr16	50582240	50674771	NKD1	92531	+	NM_033119	50582464	50667692	10
chr16	50700210	50715264	SNX20	15054	-	NM_001144972	50701925	50711437	4
chr16	50702765	50705550	LOC101927272	2785	+	NR_110908	50705550	50705550	3
chr16	50731049	50766988	NOD2	35939	+	NM_022162	50731154	50765730	12
chr16	50775960	50835846	CYLD	59886	+	NM_015247	50783609	50830419	20
chr16	50776215	50776288	MIR3181	73	+	NR_130462	50776288	50776288	1
chr16	51051668	51069688	LOC101927334	18020	+	NR_110913	51069688	51069688	3
chr16	51169885	51185183	SALL1	15298	-	NM_002968	51171022	51185152	3
chr16	51796429	51806557	LINC01571	10128	+	NR_110916	51806557	51806557	3
chr16	52060263	52107847	C16orf97	47584	-	NM_001242473	52060279	52107796	6
chr16	52116976	52119021	LINC00919	2045	-	NR_038233	52119021	52119021	3
chr16	52119192	52132979	LOC102467079	13787	+	NR_104655	52132979	52132979	3
chr16	52471917	52581714	TOX3	109797	-	NM_001146188	52473136	52553392	8
chr16	52585998	52640887	CASC16	54889	-	NR_033920	52640887	52640887	4
chr16	53088944	53361414	CHD9	272470	+	NM_025134	53190001	53358807	39
chr16	53403273	53405041	LOC643802	1768	-	NM_001207030	53404021	53404901	2
chr16	53407404	53418171	LOC102723373	10767	+	NR_119378	53418171	53418171	3
chr16	53468350	53525560	RBL2	57210	+	NM_005611	53468468	53524212	22
chr16	53524951	53537216	AKTIP	12265	-	NM_001012398	53526323	53534171	10
chr16	53633150	53737846	RPGRIP1L	104696	-	NM_015272	53635987	53734635	27
chr16	53737874	54148379	FTO	410505	+	NM_001080432	53738096	54145827	9
chr16	54073304	54074285	FTO-IT1	981	+	NR_103838	54074285	54074285	2
chr16	54279456	54304791	LOC100996338	25335	-	NR_126340	54304791	54304791	3
chr16	54317211	54320378	IRX3	3167	-	NM_024336	54317597	54319962	4
chr16	54952776	54963101	CRNDE	10325	-	NR_110453	54963101	54963101	6
chr16	54965110	54968395	IRX5	3285	+	NM_005853	54965110	54967785	3
chr16	55358470	55364672	IRX6	6202	+	NM_024335	55359003	55364217	6
chr16	55512741	55540603	MMP2	27862	+	NM_001302508	55516895	55539354	13
chr16	55542912	55620582	LPCAT2	77670	+	NM_017839	55543093	55617010	14
chr16	55600583	55601592	CAPNS2	1009	+	NM_032330	55600668	55601415	1
chr16	55690555	55740104	SLC6A2	49549	+	NM_001172504	55690606	55739184	14
chr16	55758836	55784123	CES1P2	25287	+	NR_033740	55784123	55784123	14
chr16	55794510	55808826	CES1P1	14316	+	NR_003276	55808826	55808826	6
chr16	55836763	55867075	CES1	30312	-	NM_001025195	55836960	55866967	14
chr16	55880065	55989943	CES5A	109878	-	NM_001190158	55880362	55989797	14
chr16	56126898	56225006	LOC283856	98108	-	NR_027078	56225006	56225006	5
chr16	56225250	56391356	GNAO1	166106	+	NM_020988	56226147	56388965	9
chr16	56226528	56228437	DKFZP434H168	1909	-	NR_026889	56228437	56228437	1
chr16	56279431	56279535	MIR3935	104	+	NR_037499	56279535	56279535	1
chr16	56395363	56459450	AMFR	64087	-	NM_001144	56396820	56459239	14
chr16	56463047	56485261	NUDT21	22214	-	NM_007006	56466623	56485114	7
chr16	56485423	56511407	OGFOD1	25984	+	NM_018233	56485524	56510117	13
chr16	56518258	56554008	BBS2	35750	-	NM_031885	56518672	56553774	17
chr16	56598960	56602869	MT4	3909	+	NM_032935	56599040	56602844	3
chr16	56623266	56625000	MT3	1734	+	NM_005954	56623502	56624861	3
chr16	56642477	56643409	MT2A	932	+	NM_005953	56642567	56643266	3
chr16	56651372	56652730	MT1L	1358	+	NR_001447	56652730	56652730	3
chr16	56659584	56661024	MT1E	1440	+	NM_175617	56659763	56660883	3
chr16	56666533	56667898	MT1M	1365	+	NM_176870	56666643	56667754	3
chr16	56669650	56670998	MT1JP	1348	+	NR_036677	56670998	56670998	3
chr16	56672577	56673999	MT1A	1422	+	NM_005946	56672650	56673862	3
chr16	56677598	56678853	MT1DP	1255	+	NR_027781	56678853	56678853	3
chr16	56685810	56687116	MT1B	1306	+	NM_005947	56685865	56686977	3
chr16	56691854	56693215	MT1F	1361	+	NM_005949	56691970	56693076	3
chr16	56700646	56701977	MT1G	1331	-	NM_005950	56700790	56701905	3
chr16	56703725	56705041	MT1H	1316	+	NM_005951	56703796	56704901	3
chr16	56710027	56711789	MT1IP	1762	+	NR_003669	56711789	56711789	3
chr16	56716381	56718108	MT1X	1727	+	NM_005952	56716452	56717961	3
chr16	56764016	56878861	NUP93	114845	+	NM_014669	56782159	56878521	22
chr16	56892429	56892513	MIR138-2	84	+	NR_029680	56892513	56892513	1
chr16	56899118	56949762	SLC12A3	50644	+	NM_000339	56899147	56947317	26
chr16	56938175	56938265	MIR6863	90	+	NR_106923	56938265	56938265	1
chr16	56966001	56977793	HERPUD1	11792	+	NM_014685	56966156	56977202	8
chr16	56995834	57017756	CETP	21922	+	NM_000078	56995891	57017578	16
chr16	57050985	57117436	NLRC5	66451	+	NM_032206	57054624	57116440	48
chr16	57126454	57181878	CPNE2	55424	+	NM_152727	57144654	57181570	16
chr16	57186377	57219976	FAM192A	33599	-	NM_024946	57188201	57207766	7
chr16	57220195	57274387	RSPRY1	54192	+	NM_133368	57238570	57272887	15
chr16	57279037	57287545	ARL2BP	8508	+	NM_012106	57279279	57286179	6
chr16	57290008	57318584	PLLP	28576	-	NM_015993	57290824	57318452	4
chr16	57392694	57400102	CCL22	7408	+	NM_002990	57392728	57397500	3
chr16	57406372	57418960	CX3CL1	12588	+	NM_002996	57406480	57416944	3
chr16	57438678	57449974	CCL17	11296	+	NM_002987	57447844	57449773	4
chr16	57462080	57481440	CIAPIN1	19360	-	NM_001308347	57463081	57474840	9
chr16	57481336	57495187	COQ9	13851	+	NM_020312	57481417	57494536	9
chr16	57496550	57505921	POLR2C	9371	+	NM_032940	57496636	57505031	9
chr16	57505869	57520385	DOK4	14516	-	NM_018110	57507288	57513419	9
chr16	57546089	57570477	CCDC102A	24388	-	NM_033212	57546652	57563089	9
chr16	57576332	57611100	ADGRG5	34768	+	NM_001304376	57596005	57609450	12
chr16	57653604	57698951	ADGRG1	45347	+	NM_001290143	57687152	57697494	14
chr16	57702156	57723290	ADGRG3	21134	+	NM_170776	57702259	57722373	12
chr16	57728712	57765367	DRC7	36655	+	NM_001289162	57731861	57765170	19
chr16	57769659	57791162	KATNB1	21503	+	NM_005886	57771155	57790858	20
chr16	57792128	57836439	KIFC3	44311	-	NM_001130100	57793060	57832155	20
chr16	57806200	57806264	MIR6772	64	-	NR_106830	57806264	57806264	1
chr16	57844548	57850831	LOC388282	6283	+	NM_001278081	57844620	57850127	5
chr16	57916243	58005020	CNGB1	88777	-	NM_001286130	57918067	58001190	33
chr16	58010338	58022017	TEPP	11679	+	NM_199456	58010375	58021330	8
chr16	58028571	58033762	ZNF319	5191	-	NM_020807	58030420	58032169	2
chr16	58035276	58055527	USB1	20251	+	NM_024598	58035387	58054149	7
chr16	58059281	58080804	MMP15	21523	+	NM_002428	58060254	58079350	10
chr16	58147496	58163296	CFAP20	15800	-	NM_013242	58147928	58163019	6
chr16	58191811	58231782	CSNK2A2	39971	-	NM_001896	58197974	58231640	12
chr16	58283839	58317734	CCDC113	33895	+	NM_014157	58283918	58313681	9
chr16	58313900	58328951	PRSS54	15051	-	NM_001080492	58314127	58327720	7
chr16	58426297	58440048	GINS3	13751	+	NM_001126129	58426505	58438633	4
chr16	58497548	58547523	NDRG4	49975	+	NM_020465	58521682	58545480	16
chr16	58549382	58554431	SETD6	5049	+	NM_024860	58549441	58552933	9
chr16	58553849	58663790	CNOT1	109941	-	NR_049763	58663790	58663790	50
chr16	58582402	58582537	SNORA46	135	-	NR_002978	58582537	58582537	1
chr16	58593699	58593835	SNORA50A	136	-	NR_002980	58593835	58593835	1
chr16	58699012	58718681	SLC38A7	19669	-	NM_018231	58701288	58714030	12
chr16	58741034	58768261	GOT2	27227	-	NM_002080	58742074	58768132	10
chr16	59788044	59789095	APOOP5	1051	-	NR_028471	59789095	59789095	1
chr16	59889256	60087875	LOC101927580	198619	+	NR_110917	60087875	60087875	4
chr16	60392358	60393667	LOC729159	1309	-	NM_001282301	60392358	60393606	1
chr16	61685914	62070739	CDH8	384825	-	NM_001796	61687511	62055307	12
chr16	64977656	65156040	CDH11	178384	-	NM_001308392	64981993	65038772	14
chr16	65175658	65210476	LOC101927650	34818	-	NR_110918	65210476	65210476	4
chr16	65318401	65610203	LINC00922	291802	-	NR_027755	65610203	65610203	9
chr16	66400509	66438689	CDH5	38180	+	NM_001795	66413240	66437072	12
chr16	66442426	66444803	LINC00920	2377	+	NR_046242	66444803	66444803	2
chr16	66461199	66527432	BEAN1	66233	+	NM_001197225	66511500	66527344	5
chr16	66503698	66510305	BEAN1-AS1	6607	-	NR_109960	66510305	66510305	3
chr16	66541905	66584315	TK2	42410	-	NM_001271934	66545870	66581882	11
chr16	66586465	66600190	CKLF	13725	+	NM_001040138	66586618	66599994	4
chr16	66586465	66613038	CKLF-CMTM1	26573	+	NM_001204098	66586618	66612755	4
chr16	66600293	66613038	CMTM1	12745	+	NM_181269	66600416	66612904	4
chr16	66613350	66622177	CMTM2	8827	+	NM_144673	66613510	66622022	4
chr16	66637934	66647795	CMTM3	9861	+	NR_037613	66647795	66647795	6
chr16	66648652	66730610	CMTM4	81958	-	NM_178818	66651179	66730428	5
chr16	66754798	66785525	DYNC1LI2	30727	-	NM_006141	66757624	66785494	13
chr16	66785654	66788645	LOC106699570	2991	+	NR_133569	66788645	66788645	2
chr16	66788878	66835523	CCDC79	46645	-	NM_001136505	66788878	66830701	19
chr16	66836780	66864879	NAE1	28099	-	NM_001018159	66836911	66861917	21
chr16	66878281	66888049	CA7	9768	+	NM_005182	66878390	66887401	7
chr16	66914382	66925002	PDP2	10620	+	NM_020786	66918187	66919777	2
chr16	66942024	66952887	CDH16	10863	-	NM_001204745	66942294	66951968	18
chr16	66955581	66959439	RRAD	3858	-	NM_004165	66955978	66959082	5
chr16	66965957	66968326	FAM96B	2369	-	NR_046109	66968326	66968326	5
chr16	66968346	66978994	CES2	10648	+	NM_003869	66969346	66977928	12
chr16	66995131	67009052	CES3	13921	+	NM_001185177	66995210	67006952	13
chr16	67022491	67043659	CES4A	21168	+	NM_173815	67022675	67042968	12
chr16	67063049	67134958	CBFB	71909	+	NM_001755	67063310	67132635	6
chr16	67143914	67182442	C16orf70	38528	+	NM_025187	67144078	67181034	16
chr16	67182004	67184902	B3GNT9	2898	-	NM_033309	67183179	67184388	2
chr16	67188088	67193812	TRADD	5724	-	NM_003789	67188551	67190563	5
chr16	67193890	67198077	FBXL8	4187	+	NM_018378	67195688	67197723	3
chr16	67197287	67203848	HSF4	6561	+	NM_001040667	67198714	67203688	15
chr16	67204399	67209640	NOL3	5241	+	NM_001276307	67208072	67208957	6
chr16	67209504	67217883	KIAA0895L	8379	-	NM_001040715	67210713	67214513	7
chr16	67218281	67224107	EXOC3L1	5826	-	NM_178516	67218296	67223579	14
chr16	67226067	67232821	E2F4	6754	+	NM_001950	67226130	67232026	10
chr16	67233027	67237927	ELMO3	4900	+	NM_024712	67233070	67237780	20
chr16	67236223	67236298	MIR328	75	-	NR_029887	67236298	67236298	1
chr16	67241041	67260901	LRRC29	19860	-	NM_001004055	67241507	67244091	7
chr16	67261015	67263182	TMEM208	2167	+	NM_014187	67261121	67263016	6
chr16	67263291	67281425	FHOD1	18134	-	NM_013241	67263538	67281313	22
chr16	67282854	67306094	SLC9A5	23240	+	NM_004594	67282917	67305113	16
chr16	67312059	67323403	PLEKHG4	11344	+	NM_001129727	67313947	67322711	23
chr16	67323392	67360661	KCTD19	37269	-	NM_001100915	67323471	67360610	16
chr16	67360746	67419109	LRRC36	58363	+	NM_018296	67360765	67418992	14
chr16	67423709	67427438	TPPP3	3729	-	NM_016140	67424076	67425014	5
chr16	67428321	67450339	ZDHHC1	22018	-	NM_013304	67428568	67441678	11
chr16	67465035	67471454	HSD11B2	6419	+	NM_000196	67465151	67470906	5
chr16	67471916	67515089	ATP6V0D1	43173	-	NM_004691	67472430	67514989	8
chr16	67516473	67517716	AGRP	1243	-	NM_001138	67516538	67517301	4
chr16	67551608	67562648	LOC100505942	11040	-	NR_104656	67562648	67562648	2
chr16	67562716	67580691	FAM65A	17975	+	NM_024519	67572349	67580366	22
chr16	67596309	67673088	CTCF	76779	+	NM_006565	67644735	67671775	12
chr16	67679029	67691472	RLTPR	12443	+	NM_001013838	67679149	67691421	38
chr16	67691414	67694718	ACD	3304	-	NM_022914	67691508	67694381	12
chr16	67694850	67696681	PARD6A	1831	+	NM_001037281	67694941	67696550	3
chr16	67696849	67700628	ENKD1	3779	-	NM_032140	67697063	67700345	7
chr16	67700716	67702661	C16orf86	1945	+	NM_001012984	67700873	67702503	4
chr16	67708435	67753273	GFOD2	44838	-	NM_030819	67709057	67719618	3
chr16	67757004	67840555	RANBP10	83551	-	NM_020850	67760330	67840439	14
chr16	67840780	67861971	TSNAXIP1	21191	+	NM_001288990	67841052	67861896	16
chr16	67862059	67881361	CENPT	19302	-	NM_025082	67862169	67867762	16
chr16	67876212	67878098	THAP11	1886	+	NM_020457	67876457	67877402	1
chr16	67880818	67905219	NUTF2	24401	+	NM_005796	67899033	67904816	5
chr16	67906925	67918417	EDC4	11492	+	NM_014329	67907164	67918051	29
chr16	67918780	67920271	NRN1L	1491	+	NM_198443	67918806	67920162	3
chr16	67927174	67963581	PSKH1	36407	+	NM_006742	67942652	67961545	3
chr16	67963472	67965778	CTRL	2306	-	NM_001907	67963836	67965755	7
chr16	67968406	67970780	PSMB10	2374	-	NM_002801	67968462	67970652	8
chr16	67973786	67978015	LCAT	4229	-	NM_000229	67973806	67978004	6
chr16	67977376	68002597	SLC12A4	25221	-	NM_001145961	67978742	68002456	24
chr16	68009565	68014452	DPEP3	4887	-	NM_001129758	68009667	68014358	10
chr16	68021292	68033421	DPEP2	12129	-	NM_022355	68021408	68027115	11
chr16	68047338	68049814	LOC100131303	2476	-	NM_001282442	68048010	68049673	2
chr16	68055176	68057770	DDX28	2594	-	NM_018380	68055482	68057105	1
chr16	68056846	68113226	DUS2	56380	+	NM_017803	68071926	68112889	17
chr16	68119268	68263162	NFATC3	143894	+	NM_004555	68119584	68248332	11
chr16	68262449	68270136	ESRP2	7687	-	NM_024939	68264128	68269948	15
chr16	68267328	68267402	MIR6773	74	-	NR_106831	68267402	68267402	1
chr16	68279246	68294961	PLA2G15	15715	+	NM_012320	68279329	68293560	6
chr16	68298418	68335726	SLC7A6	37308	+	NM_001076785	68308629	68331231	12
chr16	68334517	68344868	SLC7A6OS	10351	-	NM_032178	68335177	68344829	5
chr16	68344876	68391169	PRMT7	46293	+	NM_019023	68349882	68391127	19
chr16	68392229	68482409	SMPD3	90180	-	NM_018667	68395108	68406084	9
chr16	68573115	68609975	ZFP90	36860	+	NM_001305204	68573695	68609779	5
chr16	68678738	68732970	CDH3	54232	+	NM_001793	68679282	68732303	16
chr16	68771192	68869445	CDH1	98253	+	NM_001317185	68849645	68867402	16
chr16	68776418	68776474	MIR7641-2	56	+	NR_106988	68776474	68776474	1
chr16	68877508	69119085	TANGO6	241577	+	NM_024562	68877520	69117564	18
chr16	69140128	69152619	HAS3	12491	+	NM_138612	69143298	69152365	4
chr16	69151911	69166493	CHTF8	14582	-	NM_001039690	69154327	69155361	4
chr16	69166498	69202937	UTP4	36439	+	NM_032830	69167362	69202840	17
chr16	69221049	69342955	SNTB2	121906	+	NM_006750	69221069	69334827	7
chr16	69345286	69358946	VPS4A	13660	+	NM_013245	69345414	69358212	11
chr16	69362523	69364498	PDF	1975	-	NM_022341	69362924	69364473	2
chr16	69362523	69373526	COG8	11003	-	NM_032382	69364741	69373455	6
chr16	69373414	69377013	NIP7	3599	+	NM_016101	69373732	69375555	5
chr16	69377148	69385712	TMED6	8564	-	NM_144676	69377309	69385656	4
chr16	69389463	69419891	TERF2	30428	-	NM_005652	69390800	69419874	10
chr16	69458497	69500167	CYB5B	41670	+	NM_030579	69458586	69496423	5
chr16	69599710	69599771	MIR1538	61	-	NR_031719	69599771	69599771	1
chr16	69599868	69738569	NFAT5	138701	+	NM_138714	69680959	69729274	16
chr16	69743303	69760571	NQO1	17268	-	NM_001286137	69744878	69760342	4
chr16	69775756	69788871	NOB1	13115	-	NM_014062	69776234	69788813	9
chr16	69796186	69975644	WWP2	179458	+	NM_007014	69820913	69973843	25
chr16	69966983	69967083	MIR140	100	+	NR_029681	69967083	69967083	1
chr16	69984607	69998250	CLEC18A	13643	+	NM_001136214	69985269	69997514	13
chr16	70010201	70099851	PDXDC2P	89650	-	NR_003610	70099851	70099851	26
chr16	70064248	70064325	MIR1972-1	77	+	NR_036054	70064325	70064325	1
chr16	70064248	70064325	MIR1972-2	77	+	NR_036265	70064325	70064325	1
chr16	70147528	70195184	PDPR	47656	+	NM_017990	70154395	70190782	19
chr16	70190242	70207351	LOC400541	17109	-	NR_126007	70207351	70207351	3
chr16	70208075	70220798	CLEC18C	12723	+	NM_173619	70208181	70220423	12
chr16	70253483	70259936	SMG1P7	6453	-	NR_033959	70259936	70259936	6
chr16	70284133	70285833	EXOSC6	1700	-	NM_058219	70284984	70285803	1
chr16	70286296	70323412	AARS	37116	-	NM_001605	70286623	70316666	21
chr16	70323669	70367735	DDX19B	44066	+	NM_001257174	70351429	70367485	10
chr16	70349542	70380650	LOC100506083	31108	-	NR_039997	70380650	70380650	5
chr16	70380823	70407281	DDX19A	26458	+	NM_018332	70380894	70405889	12
chr16	70413337	70472991	ST3GAL2	59654	-	NM_006927	70415591	70432433	7
chr16	70488497	70514177	FUK	25680	+	NM_145059	70497093	70513583	24
chr16	70514471	70557457	COG4	42986	-	NM_015386	70514912	70557446	19
chr16	70557690	70611571	SF3B3	53881	+	NM_012426	70560559	70605716	26
chr16	70563401	70563502	SNORD111B	101	+	NR_037420	70563502	70563502	1
chr16	70571907	70572001	SNORD111	94	+	NR_003079	70572001	70572001	1
chr16	70613797	70694585	IL34	80788	+	NM_001172771	70680850	70694090	7
chr16	70695106	70719954	MTSS1L	24848	-	NM_138383	70697579	70719694	15
chr16	70721341	70835061	VAC14	113720	-	NM_018052	70721830	70834803	19
chr16	70788962	70807154	VAC14-AS1	18192	+	NR_034083	70807154	70807154	6
chr16	70841286	71264625	HYDIN	423339	-	NM_001270974	70841482	71220798	86
chr16	71316202	71323509	CMTR2	7307	-	NM_018348	71317510	71319823	3
chr16	71392615	71424342	CALB2	31727	+	NM_001740	71392695	71423768	11
chr16	71481502	71496155	ZNF23	14653	-	NM_001304493	71481995	71483753	7
chr16	71507975	71523254	ZNF19	15279	-	NM_006961	71509072	71516017	6
chr16	71560022	71572493	CHST4	12471	+	NM_005769	71570580	71571741	2
chr16	71598918	71606341	TAT-AS1	7423	+	NR_103852	71606341	71606341	3
chr16	71600753	71610998	TAT	10245	-	NM_000353	71602046	71610318	12
chr16	71660055	71675868	MARVELD3	15813	+	NM_001017967	71660132	71674930	3
chr16	71678828	71758604	PHLPP2	79776	-	NM_015020	71682792	71748698	19
chr16	71732469	71732604	SNORA70D	135	-	NR_033337	71732604	71732604	1
chr16	71762904	71842976	AP1G1	80072	-	NM_001030007	71766960	71823382	24
chr16	71792304	71792390	SNORD71	86	-	NR_003059	71792390	71792390	1
chr16	71879893	71891236	ATXN1L	11343	+	NM_001137675	71883643	71885713	3
chr16	71893582	71918093	ZNF821	24511	-	NM_001201552	71893920	71913849	8
chr16	71928310	71964540	IST1	36230	+	NM_001270976	71928737	71961716	11
chr16	71963440	72033877	PKD1L3	70437	-	NM_181536	71963440	72033877	30
chr16	72042642	72059316	DHODH	16674	+	NM_001361	72042663	72058098	9
chr16	72088507	72094955	HP	6448	+	NM_005143	72088551	72094789	7
chr16	72097124	72111145	HPR	14021	+	NM_020995	72097154	72110980	5
chr16	72118755	72128215	TXNL4B	9460	-	NM_001142318	72120535	72124648	4
chr16	72127614	72146811	DHX38	19197	+	NM_014003	72130056	72146396	27
chr16	72152995	72206349	PMFBP1	53354	-	NM_001160213	72153236	72184707	22
chr16	72317199	72698908	LINC01572	381709	-	NR_126330	72698908	72698908	14
chr16	72816785	73092534	ZFHX3	275749	-	NM_001164766	72821062	72984841	9
chr16	73126247	73127672	HCCAT5	1425	+	NR_027756	73127672	73127672	3
chr16	73160536	73178346	C16orf47	17810	-	NM_207385	73161253	73177680	4
chr16	73420703	73455295	LINC01568	34592	+	NR_038234	73455295	73455295	3
chr16	74226290	74249420	LOC101928035	23130	-	NR_104657	74249420	74249420	4
chr16	74330672	74340186	PSMD7	9514	+	NM_002811	74330812	74339631	7
chr16	74366303	74402153	LOC283922	35850	-	NR_026950	74402153	74402153	15
chr16	74411849	74426012	NPIPB15	14163	+	NM_001306094	74411871	74425978	7
chr16	74442528	74455368	CLEC18B	12840	-	NM_001011880	74442903	74455168	13
chr16	74481325	74641042	GLG1	159717	-	NM_012201	74485953	74640992	27
chr16	74655296	74700779	RFWD3	45483	-	NM_018124	74657825	74695347	13
chr16	74705752	74735046	MLKL	29294	-	NM_152649	74706401	74729655	11
chr16	74746855	74808729	FA2H	61874	-	NM_024306	74748087	74808653	7
chr16	74907470	75019017	WDR59	111547	-	NM_030581	74908106	75018915	26
chr16	75032914	75144892	ZNRF1	111978	+	NM_032268	75033569	75140437	5
chr16	75145757	75150670	LDHD	4913	-	NM_153486	75146253	75150618	11
chr16	75182420	75206132	ZFP1	23712	+	NM_153688	75186849	75204232	4
chr16	75237993	75241072	CTRB2	3079	-	NM_001025200	75238058	75241039	7
chr16	75252883	75258822	CTRB1	5939	+	NM_001906	75252905	75258764	7
chr16	75260280	75262101	LOC100506281	1821	+	NR_109777	75262101	75262101	5
chr16	75262927	75301951	BCAR1	39024	-	NM_001170715	75263408	75301878	7
chr16	75327607	75467387	CFDP1	139780	-	NM_006324	75327849	75467250	7
chr16	75477141	75498635	TMEM170A	21494	-	NM_001304998	75481455	75485735	3
chr16	75507021	75528926	CHST6	21905	-	NM_021615	75512538	75513726	3
chr16	75562427	75569068	CHST5	6641	-	NM_024533	75563046	75564282	3
chr16	75572014	75590184	TMEM231	18170	-	NR_074083	75590184	75590184	7
chr16	75600248	75611779	GABARAPL2	11531	+	NM_007285	75600384	75611267	4
chr16	75632246	75657221	ADAT1	24975	-	NR_036460	75657221	75657221	11
chr16	75661621	75681585	KARS	19964	-	NM_001130089	75661792	75678326	15
chr16	75681634	75691341	TERF2IP	9707	+	NM_018975	75681780	75690509	3
chr16	76311175	76593135	CNTNAP4	281960	+	NM_033401	76311560	76592580	24
chr16	76668894	76692375	LOC101928203	23481	+	NR_110934	76692375	76692375	4
chr16	76902832	76902916	MIR4719	84	+	NR_039870	76902916	76902916	1
chr16	77224815	77233543	MON1B	8728	+	NM_014940	77225382	77232205	6
chr16	77233348	77246976	SYCE1L	13628	+	NM_001129979	77233348	77246828	11
chr16	77316024	77469011	ADAMTS18	152987	-	NM_199355	77317852	77468592	23
chr16	77756388	77776157	NUDT7	19769	+	NM_001243657	77756479	77775549	5
chr16	77822460	78014004	VAT1L	191544	+	NM_020927	77822579	78011592	9
chr16	78056442	78066001	CLEC3A	9559	+	NM_005752	78056496	78064738	3
chr16	78133309	79246564	WWOX	1113255	+	NM_016373	78133675	79245693	9
chr16	79627744	79634622	MAF	6878	-	NM_005360	79628356	79633799	2
chr16	79755208	79804429	MAFTRR	49221	-	NR_104663	79804429	79804429	6
chr16	79804367	79835240	LINC01229	30873	+	NR_104660	79835240	79835240	4
chr16	80189854	80597032	LOC102724084	407178	-	NR_120307	80597032	80597032	6
chr16	80574630	80584706	DYNLRB2	10076	+	NM_001305017	80574661	80584455	4
chr16	80600999	80606705	LINC01227	5706	-	NR_104666	80606705	80606705	3
chr16	80637675	80838175	CDYL2	200500	-	NM_152342	80638284	80838070	7
chr16	80862631	80926493	PRCAT47	63862	-	NR_131947	80926493	80926493	4
chr16	81009698	81040502	CMC2	30804	-	NM_020188	81009989	81030999	4
chr16	81040102	81066709	CENPN	26607	+	NM_001100625	81045544	81066299	11
chr16	81069457	81080951	ATMIN	11494	+	NM_015251	81069475	81078575	4
chr16	81087101	81110872	C16orf46	23771	-	NM_001100873	81087675	81097560	4
chr16	81115551	81129980	GCSH	14429	-	NM_004483	81116470	81129883	5
chr16	81134483	81253975	PKD1L2	119492	-	NM_052892	81134727	81253975	43
chr16	81272295	81324747	BCO1	52452	+	NM_017429	81272513	81324182	11
chr16	81348570	81413803	GAN	65233	+	NM_022041	81348718	81411201	11
chr16	81418622	81418698	MIR4720	76	+	NR_039871	81418698	81418698	1
chr16	81478774	81745367	CMIP	266593	+	NM_198390	81478846	81743404	21
chr16	81567506	81567571	MIR7854	65	+	NR_107008	81567571	81567571	1
chr16	81644952	81645013	MIR6504	61	+	NR_106759	81645013	81645013	1
chr16	81698958	81700879	LOC100129617	1921	+	NR_045112	81700879	81700879	1
chr16	81812862	81996298	PLCG2	183436	+	NM_002661	81819594	81991603	33
chr16	82031250	82045093	SDR42E1	13843	-	NM_145168	82032715	82034463	3
chr16	82068857	82132139	HSD17B2	63282	+	NM_002153	82069029	82132041	5
chr16	82181766	82203829	MPHOSPH6	22063	-	NM_005792	82182335	82203780	5
chr16	82660398	83830215	CDH13	1169817	+	NM_001220488	82660662	83828635	15
chr16	82722535	82722624	MIR8058	89	+	NR_107025	82722624	82722624	1
chr16	82806923	82863243	LOC101928446	56320	+	NR_110938	82863243	82863243	3
chr16	82986834	83023903	LOC101928417	37069	-	NR_110937	83023903	83023903	3
chr16	83541950	83542013	MIR3182	63	+	NR_036147	83542013	83542013	1
chr16	83830840	83837581	LOC102724163	6741	-	NR_120308	83837581	83837581	3
chr16	83841507	83846607	HSBP1	5100	+	NM_001537	83841681	83843028	4
chr16	83932729	83949787	MLYCD	17058	+	NM_012213	83932749	83949094	5
chr16	83986826	83999937	OSGIN1	13111	+	NM_182981	83991276	83999612	6
chr16	84002236	84036379	NECAB2	34143	+	NM_019065	84002253	84035951	13
chr16	84043271	84075762	SLC38A8	32491	-	NM_001080442	84043388	84075762	10
chr16	84087365	84150548	MBTPS1	63183	-	NM_003791	84088053	84135388	23
chr16	84155743	84178800	HSDL1	23057	-	NM_001146051	84158234	84164926	7
chr16	84178864	84211524	DNAAF1	32660	+	NM_178452	84179045	84211447	12
chr16	84211452	84220676	TAF1C	9224	-	NM_001243156	84212546	84218594	15
chr16	84224722	84230772	ADAD2	6050	+	NM_139174	84224836	84230580	11
chr16	84254740	84273356	KCNG4	18616	-	NM_172347	84255822	84271091	3
chr16	84328311	84363457	WFDC1	35146	+	NM_021197	84328577	84360546	7
chr16	84402128	84497793	ATP2C2	95665	+	NM_001286527	84402221	84497338	28
chr16	84509965	84538288	TLDC1	28323	-	NM_020947	84513518	84531692	8
chr16	84599203	84651702	COTL1	52499	-	NM_021149	84600450	84651520	4
chr16	84682116	84701292	KLHL36	19176	+	NM_024731	84684473	84695739	5
chr16	84733554	84813527	USP10	79973	+	NM_001272075	84738433	84812688	15
chr16	84853586	84943116	CRISPLD2	89530	+	NM_031476	84872101	84940248	15
chr16	85008066	85045141	ZDHHC7	37075	-	NM_001145548	85009948	85024224	9
chr16	85061356	85127828	KIAA0513	66472	+	NM_014732	85100677	85121931	13
chr16	85131957	85146114	FAM92B	14157	-	NM_198491	85132790	85145958	8
chr16	85170755	85183049	LOC400548	12294	+	NR_033984	85183049	85183049	3
chr16	85316563	85321685	LINC00311	5122	+	NR_038859	85321685	85321685	3
chr16	85339831	85339931	MIR5093	100	-	NR_049816	85339931	85339931	1
chr16	85645028	85709812	GSE1	64784	+	NM_001134473	85682243	85706145	15
chr16	85711279	85722588	GINS2	11309	-	NM_016095	85711817	85722504	5
chr16	85741123	85784689	C16orf74	43566	-	NM_206967	85741613	85768823	4
chr16	85775226	85775306	MIR1910	80	-	NR_031731	85775306	85775306	1
chr16	85812230	85833148	EMC8	20918	-	NM_006067	85813313	85832901	5
chr16	85833172	85840607	COX4I1	7435	+	NM_001861	85834811	85840480	5
chr16	85932773	85956211	IRF8	23438	+	NM_002163	85936621	85954888	9
chr16	85951952	85952022	MIR6774	70	+	NR_106832	85952022	85952022	1
chr16	86229786	86233324	LINC01082	3538	+	NR_103859	86233324	86233324	2
chr16	86259185	86319853	LINC01081	60668	-	NR_104139	86319853	86319853	6
chr16	86320036	86326995	LOC146513	6959	+	NR_038438	86326995	86326995	3
chr16	86365455	86379285	LINC00917	13830	-	NR_024406	86379285	86379285	7
chr16	86508130	86542466	FENDRR	34336	-	NR_033925	86542466	86542466	4
chr16	86544132	86548070	FOXF1	3938	+	NM_001451	86544175	86546691	2
chr16	86563781	86588841	MTHFSD	25060	-	NR_027489	86588841	86588841	9
chr16	86588925	86590905	FLJ30679	1980	+	NR_026674	86590905	86590905	1
chr16	86598750	86601367	FOXC2-AS1	2617	-	NR_125795	86601367	86601367	2
chr16	86600856	86602537	FOXC2	1681	+	NM_005251	86600941	86602447	1
chr16	86612114	86615304	FOXL1	3190	+	NM_005250	86612329	86613367	1
chr16	87091389	87097597	LOC440390	6208	+	NR_126008	87097597	87097597	3
chr16	87245720	87260035	LOC101928708	14315	+	NR_110939	87260035	87260035	3
chr16	87305511	87326058	LOC101928682	20547	-	NR_104667	87326058	87326058	5
chr16	87336403	87351026	C16orf95	14623	-	NM_001195125	87339364	87350848	5
chr16	87360592	87425713	FBXO31	65121	-	NM_001282683	87364893	87377344	10
chr16	87425800	87438380	MAP1LC3B	12580	+	NM_022818	87426033	87436703	4
chr16	87439851	87525460	ZCCHC14	85609	-	NM_015144	87443885	87525433	13
chr16	87527792	87549236	LOC101928737	21444	+	NR_110943	87549236	87549236	4
chr16	87635440	87731761	JPH3	96321	+	NR_073379	87731761	87731761	6
chr16	87741417	87799598	KLHDC4	58181	-	NM_017566	87741956	87799496	12
chr16	87799936	87812754	LOC102724467	12818	-	NR_120309	87812754	87812754	4
chr16	87863628	87903100	SLC7A5	39472	-	NM_003486	87866575	87903028	10
chr16	87868197	87868266	MIR6775	69	-	NR_106833	87868266	87868266	1
chr16	87921624	87970112	CA5A	48488	-	NM_001739	87921734	87970056	7
chr16	87985037	88110924	BANP	125887	+	NM_001173539	88008721	88110267	13
chr16	88133014	88134591	LOC400553	1577	-	NR_120310	88134591	88134591	2
chr16	88227886	88228823	LOC101928880	937	+	NR_110944	88228823	88228823	3
chr16	88493878	88507165	ZNF469	13287	+	NM_001127464	88493878	88505740	2
chr16	88520013	88601574	ZFPM1	81561	+	NM_153813	88520046	88601387	10
chr16	88535325	88535439	MIR5189	114	+	NR_049821	88535439	88535439	1
chr16	88636788	88698372	ZC3H18	61584	+	NM_001294340	88643531	88697707	19
chr16	88705000	88706882	IL17C	1882	+	NM_013278	88705049	88706480	3
chr16	88709696	88717492	CYBA	7796	-	NM_000101	88709760	88717421	6
chr16	88718347	88729557	MVD	11210	-	NM_002461	88718932	88729488	10
chr16	88729780	88753594	SNAI3-AS1	23814	+	NR_024399	88753594	88753594	4
chr16	88744089	88752882	SNAI3	8793	-	NM_178310	88744855	88752814	3
chr16	88762902	88772829	RNF166	9927	-	NM_178841	88763975	88772733	6
chr16	88772890	88781786	CTU2	8896	+	NM_001012759	88772938	88781659	15
chr16	88781745	88851628	PIEZO1	69883	-	NM_001142864	88782012	88851372	51
chr16	88782685	88782745	MIR4722	60	-	NR_039873	88782745	88782745	1
chr16	88797587	88807833	LOC100289580	10246	+	NR_103774	88807833	88807833	3
chr16	88809174	88812156	LOC339059	2982	+	NR_120387	88812156	88812156	3
chr16	88870185	88875666	CDT1	5481	+	NM_030928	88870239	88874686	10
chr16	88875876	88878342	APRT	2466	-	NM_001030018	88876109	88878307	5
chr16	88880141	88923374	GALNS	43233	-	NM_000512	88880846	88923285	14
chr16	88923505	88927520	TRAPPC2L	4015	+	NM_016209	88923558	88927367	5
chr16	88929747	88933068	PABPN1L	3321	-	NM_001080487	88930163	88933014	7
chr16	88941262	89043504	CBFA2T3	102242	-	NM_005187	88943383	89043215	12
chr16	89006446	89017932	LOC100129697	11486	+	NM_001290330	89006602	89017768	2
chr16	89160216	89222254	ACSF3	62038	+	NR_104293	89222254	89222254	11
chr16	89225627	89230083	LINC00304	4456	+	NR_024347	89230083	89230083	4
chr16	89232790	89235555	LOC400558	2765	+	NR_046200	89235555	89235555	3
chr16	89238162	89261900	CDH15	23738	+	NM_004933	89238239	89261563	14
chr16	89262168	89266529	SLC22A31	4361	-	NM_001242757	89262406	89265558	8
chr16	89284110	89295965	ZNF778	11855	+	NM_001201407	89287535	89294970	7
chr16	89334028	89556969	ANKRD11	222941	-	NM_001256182	89334885	89383427	14
chr16	89387540	89391518	LOC100287036	3978	+	NM_001242885	89389713	89390993	3
chr16	89497325	89520902	LOC101927817	23577	+	NR_110932	89520902	89520902	3
chr16	89574795	89624176	SPG7	49381	+	NM_003119	89574825	89623501	17
chr16	89627064	89633237	RPL13	6173	+	NM_001243131	89627367	89629450	7
chr16	89627837	89627909	SNORD68	72	+	NR_002450	89627909	89627909	1
chr16	89642175	89663654	CPNE7	21479	+	NM_014427	89642305	89663029	17
chr16	89679715	89704839	DPEP1	25124	+	NM_001128141	89696818	89704630	11
chr16	89710838	89724193	CHMP1A	13355	-	NR_046418	89724193	89724193	7
chr16	89724151	89736866	SPATA33	12715	+	NM_153025	89724209	89735905	3
chr16	89753075	89762772	CDK10	9697	+	NM_052988	89753118	89762100	13
chr16	89762764	89768121	SPATA2L	5357	-	NM_152339	89763741	89767640	3
chr16	89773540	89787394	VPS9D1	13854	-	NM_004913	89774268	89787269	15
chr16	89778263	89784573	VPS9D1-AS1	6310	+	NR_036480	89784573	89784573	4
chr16	89787392	89807332	ZNF276	19940	+	NM_152287	89788958	89804654	11
chr16	89803958	89883065	FANCA	79107	-	NM_000135	89805008	89883023	43
chr16	89894906	89937727	SPIRE2	42821	+	NM_032451	89894958	89936680	15
chr16	89939993	89977792	TCF25	37799	+	NM_014972	89940075	89977646	18
chr16	89984286	89987385	MC1R	3099	+	NM_002386	89985666	89986620	1
chr16	89988416	90002505	TUBB3	14089	+	NM_001197181	89999925	90002212	4
chr16	90015138	90034468	DEF8	19330	+	NM_001242820	90020660	90032371	14
chr16	90036182	90039240	CENPBD1	3058	-	NM_145039	90037766	90038330	1
chr16	90038987	90067195	AFG3L1P	28208	+	NR_003228	90067195	90067195	13
chr16	90071272	90086539	DBNDD1	15267	-	NM_001288708	90072742	90078022	5
chr16	90086036	90111379	GAS8	25343	+	NM_001286209	90094115	90109753	11
chr16	90095315	90096309	GAS8-AS1	994	-	NR_122031	90096309	90096309	1
chr16	90106168	90114033	URAHP	7865	-	NR_027335	90114033	90114033	5
chr16	90122973	90142338	PRDM7	19365	-	NM_001098173	90124696	90142318	10
chr16	90168671	90244014	FAM157C	75343	+	NR_126161	90244014	90244014	4
chr17	6010	31421	DOC2B	25411	-	NM_003585	6010	31270	6
chr17	33614	37042	LOC100506371	3428	-	NR_104420	37042	37042	2
chr17	62179	202633	RPH3AL	140454	-	NM_006987	63642	177334	10
chr17	180995	183279	LOC100506388	2284	+	NM_001242780	181348	182999	3
chr17	260117	264457	C17orf97	4340	+	NM_001013672	260133	263906	2
chr17	289770	295731	FAM101B	5961	-	NM_182705	292954	295731	2
chr17	411907	618096	VPS53	206189	-	NM_001128159	422367	617949	22
chr17	635785	646208	FAM57A	10423	+	NM_024792	635887	644810	5
chr17	647660	655501	GEMIN4	7841	-	NM_015721	648105	655382	2
chr17	655572	658576	DBIL5P	3004	+	NR_024120	658576	658576	1
chr17	662548	685571	GLOD4	23023	-	NM_016080	663412	685495	9
chr17	685568	695749	RNMTL1	10181	+	NM_018146	685618	695309	4
chr17	702552	882998	NXN	180446	-	NM_022463	704188	882918	8
chr17	900356	905390	TIMM22	5034	+	NM_013337	900382	904328	4
chr17	906757	1090616	ABR	183859	-	NM_001159746	909319	1028625	23
chr17	925715	925799	MIR3183	84	-	NR_036148	925799	925799	1
chr17	1173857	1174565	BHLHA9	708	+	NM_001164405	1173857	1174565	1
chr17	1182956	1204281	TUSC5	21325	+	NM_172367	1183295	1201558	3
chr17	1247833	1303556	YWHAE	55723	-	NR_024058	1303556	1303556	7
chr17	1324646	1359561	CRK	34915	-	NM_005206	1326936	1359411	3
chr17	1367479	1396001	MYO1C	28522	-	NM_001080779	1369019	1395781	32
chr17	1397870	1420182	INPP5K	22312	-	NM_001135642	1399116	1416779	14
chr17	1420212	1421390	PITPNA-AS1	1178	+	NR_028514	1421390	1421390	2
chr17	1421282	1466110	PITPNA	44828	-	NM_006224	1424894	1465854	12
chr17	1472547	1532180	SLC43A2	59633	-	NM_152346	1478897	1531168	14
chr17	1537151	1549083	SCARF1	11932	-	NR_028075	1549083	1549083	11
chr17	1549444	1553392	RILP	3948	-	NM_031430	1549735	1553098	8
chr17	1553922	1588176	PRPF8	34254	-	NM_006445	1554095	1587865	43
chr17	1606083	1613662	TLCD2	7579	-	NM_001164407	1611063	1613536	4
chr17	1614797	1619566	MIR22HG	4769	-	NR_028504	1619566	1619566	4
chr17	1617196	1617281	MIR22	85	-	NR_029494	1617281	1617281	1
chr17	1619816	1641893	WDR81	22077	+	NM_152348	1631406	1640979	11
chr17	1646129	1658559	SERPINF2	12430	+	NM_000934	1648289	1657828	10
chr17	1665258	1680859	SERPINF1	15601	+	NM_002615	1670204	1680740	8
chr17	1682828	1733175	SMYD4	50347	-	NM_052928	1684579	1731288	11
chr17	1733272	1802848	RPA1	69576	+	NM_002945	1733387	1800469	17
chr17	1837970	1928639	RTN4RL1	90669	-	NM_178568	1839789	1928159	2
chr17	1933430	1946725	DPH1	13295	+	NM_001383	1933448	1945151	13
chr17	1945276	1946725	OVCA2	1449	+	NM_080822	1945341	1946398	2
chr17	1953201	1953302	MIR132	101	-	NR_029674	1953302	1953302	1
chr17	1953564	1953674	MIR212	110	-	NR_029625	1953674	1953674	1
chr17	1958392	1962981	HIC1	4589	+	NM_006497	1959984	1962129	2
chr17	1963132	2207069	SMG6	243937	-	NM_017575	1964785	2207014	19
chr17	2135971	2136904	LOC101927839	933	+	NR_110888	2136904	2136904	2
chr17	2207236	2228558	SRR	21322	+	NM_021947	2218854	2227167	8
chr17	2225981	2240678	TSR1	14697	-	NM_018128	2227489	2239721	15
chr17	2232418	2232504	SNORD91B	86	-	NR_003073	2232504	2232504	1
chr17	2233572	2233664	SNORD91A	92	-	NR_003072	2233664	2233664	1
chr17	2240805	2284348	SGSM2	43543	+	NM_014853	2240982	2282814	24
chr17	2287353	2304258	MNT	16905	-	NM_020310	2290194	2304006	6
chr17	2310274	2318730	LOC284009	8456	-	NR_028335	2318730	2318730	3
chr17	2319347	2415200	METTL16	95853	-	NM_024086	2323263	2405625	10
chr17	2496922	2588909	PAFAH1B1	91987	+	NM_000430	2541582	2585096	11
chr17	2592679	2614927	CLUH	22248	-	NM_015229	2593887	2607844	26
chr17	2596154	2596213	MIR6776	59	-	NR_106834	2596213	2596213	1
chr17	2651371	2651476	MIR1253	105	-	NR_031654	2651476	2651476	1
chr17	2699731	2941035	RAP1GAP2	241304	+	NM_015085	2699821	2935713	25
chr17	2865540	2869189	LOC101927911	3649	-	NR_110818	2869189	2869189	3
chr17	2965962	2966901	OR1D5	939	-	NM_014566	2965962	2966901	1
chr17	2995351	2996290	OR1D2	939	-	NM_002548	2995351	2996290	1
chr17	3029903	3030845	OR1G1	942	-	NM_003555	3029903	3030845	1
chr17	3100810	3101742	OR1A2	932	+	NM_012352	3100812	3101742	1
chr17	3118914	3119844	OR1A1	930	+	NM_014565	3118914	3119844	1
chr17	3143969	3144559	OR1D4	590	+	NR_033795	3144559	3144559	1
chr17	3181183	3182268	OR3A2	1085	-	NM_002551	3181263	3182229	1
chr17	3194928	3195876	OR3A1	948	-	NM_002550	3194928	3195876	1
chr17	3213538	3214740	OR3A4P	1202	+	NR_024128	3214740	3214740	1
chr17	3300759	3301704	OR1E1	945	-	NM_003553	3300759	3301704	1
chr17	3323861	3324827	OR3A3	966	+	NM_012373	3323861	3324827	1
chr17	3336163	3337135	OR1E2	972	-	NM_003554	3336163	3337135	1
chr17	3343305	3375142	SPATA22	31837	-	NM_001170695	3343440	3372619	9
chr17	3377403	3402700	ASPA	25297	+	NM_001128085	3379453	3402382	7
chr17	3413795	3461289	TRPV3	47494	-	NM_145068	3417210	3458144	18
chr17	3468739	3512705	TRPV1	43966	-	NM_080704	3470108	3495644	17
chr17	3511555	3539616	SHPK	28061	-	NM_013276	3513853	3539513	7
chr17	3539761	3566397	CTNS	26636	+	NM_001031681	3543500	3564028	13
chr17	3566186	3571973	TAX1BP3	5787	-	NM_014604	3567041	3571820	4
chr17	3566186	3599698	P2RX5-TAX1BP3	33512	-	NR_037928	3599698	3599698	15
chr17	3572016	3572963	EMC6	947	+	NM_031298	3572440	3572773	2
chr17	3576521	3599698	P2RX5	23177	-	NM_001204519	3577161	3599299	12
chr17	3617918	3704537	ITGAE	86619	-	NM_002208	3618140	3704438	31
chr17	3627196	3629992	GSG2	2796	+	NM_031965	3627229	3629626	1
chr17	3710044	3749545	NCBP3	39501	-	NM_001114118	3716337	3749517	13
chr17	3763616	3796337	CAMKK1	32721	-	NM_032294	3765504	3788981	16
chr17	3799884	3819960	P2RX1	20076	-	NM_002558	3801107	3819519	12
chr17	3827162	3867758	ATP2A3	40596	-	NM_174953	3828715	3867585	23
chr17	3907738	4046253	ZZEF1	138515	-	NM_015113	3910183	4046189	55
chr17	4046461	4060995	CYB5D2	14534	+	NM_001254756	4053270	4060376	4
chr17	4066664	4167274	ANKFY1	100610	-	NM_016376	4071072	4167236	25
chr17	4172511	4269969	UBE2G1	97458	-	NM_003342	4186129	4269611	6
chr17	4174725	4175189	LOC103021295	464	-	NR_110982	4175189	4175189	1
chr17	4337218	4391499	SPNS3	54281	+	NM_182538	4337262	4391189	12
chr17	4402128	4443228	SPNS2	41100	+	NM_001124758	4402342	4440237	13
chr17	4442190	4458681	MYBBP1A	16491	-	NM_001105538	4442234	4458619	27
chr17	4460221	4463891	GGT6	3670	-	NM_001122890	4461309	4463816	4
chr17	4487275	4511614	SMTNL2	24339	+	NM_198501	4495688	4510782	8
chr17	4534213	4544960	ALOX15	10747	-	NM_001140	4534894	4544946	14
chr17	4574678	4607632	PELP1	32954	-	NM_001278241	4574733	4586226	19
chr17	4607524	4608824	LOC101559451	1300	+	NR_103482	4608824	4608824	2
chr17	4613788	4624795	ARRB2	11007	+	NM_004313	4614016	4624334	15
chr17	4634702	4636905	MED11	2203	+	NM_001001683	4634784	4636482	3
chr17	4636823	4643223	CXCL16	6400	-	NM_022059	4637900	4642691	6
chr17	4643309	4649414	ZMYND15	6105	+	NM_001267822	4643843	4649285	14
chr17	4675186	4686506	TM4SF5	11320	+	NM_003963	4675217	4686423	5
chr17	4688579	4689729	VMO1	1150	-	NM_182566	4688656	4689647	3
chr17	4692253	4693884	GLTPD2	1631	+	NM_001014985	4692306	4693591	4
chr17	4699438	4701798	PSMB6	2360	+	NM_002798	4699489	4701717	6
chr17	4710395	4726727	PLD2	16332	+	NM_002663	4711067	4726159	25
chr17	4736634	4801356	MINK1	64722	+	NM_153827	4736878	4800582	32
chr17	4801063	4806369	CHRNE	5306	-	NM_000080	4802030	4806358	12
chr17	4802947	4806227	C17orf107	3280	+	NM_001145536	4803057	4803828	3
chr17	4835569	4838325	GP1BA	2756	+	NM_000173	4835899	4837858	2
chr17	4840425	4843462	SLC25A11	3037	-	NM_001165417	4841035	4843205	8
chr17	4843629	4848517	RNF167	4888	+	NM_015528	4844204	4848311	10
chr17	4848944	4852381	PFN1	3437	-	NM_005022	4849194	4851689	3
chr17	4854383	4860426	ENO3	6043	+	NM_053013	4855124	4860342	12
chr17	4862520	4871132	SPAG7	8612	-	NM_004890	4862828	4871099	7
chr17	4871286	4890960	CAMTA2	19674	-	NM_015099	4872050	4889517	23
chr17	4872996	4873066	MIR6864	70	-	NR_106924	4873066	4873066	1
chr17	4873380	4873445	MIR6865	65	-	NR_106925	4873445	4873445	1
chr17	4891424	4900905	INCA1	9481	-	NM_001167986	4891699	4897732	9
chr17	4901242	4931694	KIF1C	30452	+	NM_006612	4903541	4927446	23
chr17	4922509	4923388	LOC102724009	879	-	NR_120665	4923388	4923388	2
chr17	4935896	4938727	SLC52A1	2831	-	NM_001104577	4936251	4937901	5
chr17	4981753	4999669	ZFP3	17916	+	NM_153018	4994799	4996308	2
chr17	5009030	5026397	ZNF232	17367	-	NM_014519	5009118	5015117	5
chr17	5019732	5078326	USP6	58594	+	NM_001304284	5033662	5076273	38
chr17	5082830	5095178	ZNF594	12348	-	NM_032530	5085127	5087551	2
chr17	5095378	5138931	LOC100130950	43553	+	NR_034082	5138931	5138931	8
chr17	5112215	5138155	SCIMP	25940	-	NM_207103	5114095	5138050	5
chr17	5185557	5289659	RABEP1	104102	+	NM_004703	5185781	5286518	19
chr17	5289345	5323059	NUP88	33714	-	NM_002532	5289525	5322970	17
chr17	5322960	5336340	RPAIN	13380	+	NM_001033002	5323530	5335891	7
chr17	5336098	5342471	C1QBP	6373	-	NM_001212	5336334	5342393	6
chr17	5344231	5372380	DHX33	28149	-	NM_020162	5347524	5372179	12
chr17	5374570	5389550	DERL2	14980	-	NM_016041	5378003	5389481	7
chr17	5389693	5394130	MIS12	4437	+	NM_001258219	5392182	5392800	3
chr17	5402746	5404319	LOC728392	1573	-	NM_001162371	5403916	5404276	2
chr17	5404718	5487832	NLRP1	83114	-	NM_001033053	5405133	5487277	16
chr17	5675553	5834016	LOC339166	158463	+	NR_040000	5834016	5834016	4
chr17	5973933	6027747	WSCD1	53814	+	NM_015253	5983978	6023981	9
chr17	6327056	6338519	AIPL1	11463	-	NM_001285399	6328779	6338424	6
chr17	6347734	6354385	FAM64A	6651	+	NM_019013	6348430	6353378	6
chr17	6354582	6459877	PITPNM3	105295	-	NM_031220	6358657	6459726	20
chr17	6481644	6544247	KIAA0753	62603	-	NM_014804	6483066	6538423	19
chr17	6544221	6547861	TXNDC17	3640	+	NM_032731	6544402	6546339	4
chr17	6546632	6554954	MED31	8322	-	NM_016060	6547786	6554848	4
chr17	6555058	6556617	C17orf100	1559	+	NM_001105520	6555233	6555589	1
chr17	6558758	6558828	MIR4520-1	70	-	NR_039745	6558828	6558828	1
chr17	6558767	6558821	MIR4520-2	54	+	NR_039874	6558821	6558821	1
chr17	6561037	6564701	ALOX15P1	3664	+	NR_045985	6564701	6564701	5
chr17	6588031	6616740	SLC13A5	28709	-	NM_001284509	6589525	6616652	12
chr17	6659155	6678964	XAF1	19809	+	NM_017523	6659397	6676488	7
chr17	6679551	6690965	FBXO39	11414	+	NM_153230	6683187	6690747	4
chr17	6703299	6735060	TEKT1	31761	-	NM_053285	6703345	6733695	8
chr17	6756894	6803668	ALOX12P2	46774	+	NR_002710	6803668	6803668	14
chr17	6888441	6915653	ALOX12-AS1	27212	-	NR_040089	6915653	6915653	3
chr17	6899383	6914055	ALOX12	14672	+	NM_000697	6899436	6913742	14
chr17	6915735	6917852	RNASEK	2117	+	NR_037715	6917852	6917852	4
chr17	6915735	6920843	RNASEK-C17orf49	5108	+	NR_037717	6920843	6920843	8
chr17	6918055	6920843	C17orf49	2788	+	NM_174893	6918176	6920584	6
chr17	6919136	6922973	MIR497HG	3837	-	NR_038310	6922973	6922973	3
chr17	6920933	6921020	MIR195	87	-	NR_029712	6921020	6921020	1
chr17	6921229	6921341	MIR497	112	-	NR_030178	6921341	6921341	1
chr17	6926368	6932961	BCL6B	6593	+	NM_181844	6926990	6930938	9
chr17	6939393	6943440	SLC16A13	4047	+	NM_201566	6939701	6943281	4
chr17	6944948	6947242	SLC16A11	2294	-	NM_153357	6944997	6946904	4
chr17	6977855	6983600	CLEC10A	5745	-	NM_006344	6978372	6982131	9
chr17	7004640	7018130	ASGR2	13490	-	NM_080913	7004893	7017559	9
chr17	7076750	7082883	ASGR1	6133	-	NM_001671	7076977	7081882	9
chr17	7093209	7123369	DLG4	30160	-	NM_001365	7094026	7122168	22
chr17	7120443	7128586	ACADVL	8143	+	NM_001270447	7120464	7128416	21
chr17	7126615	7126698	MIR324	83	-	NR_029896	7126698	7126698	1
chr17	7128660	7137863	DVL2	9203	-	NM_004422	7129183	7137581	15
chr17	7138346	7142825	PHF23	4479	-	NM_001284517	7138944	7142598	5
chr17	7143737	7145753	GABARAP	2016	-	NM_007278	7144172	7145649	4
chr17	7146905	7155259	CTDNEP1	8354	-	NM_015343	7147503	7154615	9
chr17	7155371	7163259	ELP5	7888	+	NM_203415	7155821	7163004	9
chr17	7163221	7166512	CLDN7	3291	-	NM_001185022	7163692	7165362	5
chr17	7185053	7191367	SLC2A4	6314	+	NM_001042	7185253	7189948	11
chr17	7191570	7197876	YBX2	6306	-	NM_015982	7192106	7197819	9
chr17	7210317	7215782	EIF5A	5465	+	NM_001143760	7210365	7214959	6
chr17	7215977	7218658	GPS2	2681	-	NM_004489	7216074	7218371	11
chr17	7218950	7232638	NEURL4	13688	-	NM_001005408	7219441	7232631	29
chr17	7239847	7254793	ACAP1	14946	+	NM_014716	7240053	7254714	22
chr17	7255207	7258262	KCTD11	3055	+	NM_001002914	7256261	7256960	1
chr17	7258496	7260538	TMEM95	2042	+	NM_198154	7258523	7259951	7
chr17	7284292	7293092	TNK1	8800	+	NM_003985	7286245	7292403	13
chr17	7293046	7298162	PLSCR3	5116	-	NM_020360	7293703	7297429	8
chr17	7293046	7307450	TMEM256-PLSCR3	14404	-	NR_037719	7307450	7307450	10
chr17	7306292	7307450	TMEM256	1158	-	NM_152766	7306384	7307403	4
chr17	7311501	7323183	NLGN2	11682	+	NM_020795	7311574	7321118	7
chr17	7323678	7324951	SPEM1	1273	+	NM_199339	7323703	7324924	3
chr17	7328934	7330886	C17orf74	1952	+	NM_175734	7329007	7330816	3
chr17	7338761	7340998	TMEM102	2237	+	NM_178518	7339190	7340825	3
chr17	7341591	7348251	FGF11	6660	+	NR_130156	7348251	7348251	5
chr17	7348405	7360932	CHRNB1	12527	+	NM_000747	7348446	7360042	11
chr17	7362684	7387568	ZBTB4	24884	-	NM_020899	7365258	7370120	4
chr17	7384720	7386383	SLC35G6	1663	+	NM_001102614	7384835	7386320	2
chr17	7387697	7417935	POLR2A	30238	+	NM_000937	7388083	7417496	29
chr17	7452374	7461207	TNFSF12	8833	+	NR_037146	7461207	7461207	8
chr17	7452374	7464925	TNFSF12-TNFSF13	12551	+	NM_172089	7452470	7464150	11
chr17	7461608	7464925	TNFSF13	3317	+	NM_172088	7462356	7464322	7
chr17	7465308	7475287	SENP3	9979	+	NM_015670	7466393	7474801	12
chr17	7465308	7482324	SENP3-EIF4A1	17016	+	NR_037926	7482324	7482324	22
chr17	7476023	7482324	EIF4A1	6301	+	NM_001416	7476159	7481804	11
chr17	7478030	7478165	SNORA48	135	+	NR_002918	7478165	7478165	1
chr17	7480128	7480276	SNORD10	148	+	NR_002604	7480276	7480276	1
chr17	7481272	7481409	SNORA67	137	+	NR_002912	7481409	7481409	1
chr17	7482804	7485429	CD68	2625	+	NM_001251	7482995	7484829	6
chr17	7486964	7491527	MPDU1	4563	+	NM_004870	7487180	7490869	7
chr17	7491497	7493488	SOX15	1991	-	NM_006942	7491695	7492994	2
chr17	7494547	7518215	FXR2	23668	-	NM_004860	7495147	7517850	17
chr17	7517381	7536701	SHBG	19320	+	NM_001289114	7533796	7536670	8
chr17	7529555	7531194	SAT2	1639	-	NM_133491	7529764	7530953	6
chr17	7549944	7561089	ATP1B2	11145	+	NM_001303263	7557163	7559213	6
chr17	7571719	7590868	TP53	19149	-	NM_001126113	7576536	7579912	12
chr17	7589388	7606820	WRAP53	17432	+	NM_001143990	7591966	7606804	11
chr17	7608519	7614693	EFNB3	6174	+	NM_001406	7608916	7612894	5
chr17	7620671	7737062	DNAH2	116391	+	NM_020877	7623052	7736851	86
chr17	7657637	7658286	RPL29P2	649	+	NR_002778	7658286	7658286	1
chr17	7743234	7758118	KDM6B	14884	+	NM_001080424	7748872	7756839	22
chr17	7758383	7759417	TMEM88	1034	+	NM_203411	7758392	7759032	2
chr17	7760002	7761172	NAA38	1170	-	NM_032356	7760048	7760741	2
chr17	7761063	7765600	CYB5D1	4537	+	NM_144607	7761452	7762930	4
chr17	7788122	7816075	CHD3	27953	+	NM_001005271	7788124	7814903	40
chr17	7809440	7809578	SCARNA21	138	+	NR_003000	7809578	7809578	1
chr17	7816639	7819265	LOC284023	2626	-	NR_024349	7819265	7819265	2
chr17	7825176	7832753	KCNAB3	7577	-	NM_004732	7826419	7832753	14
chr17	7833662	7835317	TRAPPC1	1655	-	NM_001166621	7833923	7835147	5
chr17	7835441	7853237	CNTROB	17796	+	NM_053051	7836397	7852828	19
chr17	7905987	7923658	GUCY2D	17671	+	NM_000180	7906365	7919848	20
chr17	7942357	7952451	ALOX15B	10094	+	NM_001141	7942473	7951883	14
chr17	7975953	7991021	ALOX12B	15068	-	NM_001139	7976088	7990760	15
chr17	7991373	7991465	MIR4314	92	+	NR_036201	7991465	7991465	1
chr17	7999217	8022234	ALOXE3	23017	-	NM_001165960	7999944	8022096	16
chr17	8023907	8027410	HES7	3503	-	NM_032580	8024888	8027402	4
chr17	8043787	8055753	PER1	11966	-	NM_002616	8044385	8054024	23
chr17	8048311	8048389	MIR6883	78	-	NR_106943	8048389	8048389	1
chr17	8062464	8066293	VAMP2	3829	-	NM_014232	8064172	8066197	5
chr17	8076296	8079714	TMEM107	3418	-	NM_032354	8077520	8079604	5
chr17	8090262	8090322	MIR4521	60	+	NR_039746	8090322	8090322	1
chr17	8091650	8093564	BORCS6	1914	-	NM_017622	8092384	8093458	1
chr17	8108048	8113944	AURKB	5896	-	NM_004217	8108188	8113542	9
chr17	8123947	8127361	LINC00324	3414	-	NR_026951	8127361	8127361	3
chr17	8128138	8151413	CTC1	23275	-	NM_025099	8131497	8151354	23
chr17	8152595	8173809	PFAS	21214	+	NM_012393	8157255	8172582	28
chr17	8191081	8198170	SLC25A35	7089	-	NM_201520	8192933	8198125	6
chr17	8191968	8193409	RANGRF	1441	+	NM_016492	8192106	8193254	5
chr17	8213555	8225834	ARHGEF15	12279	+	NM_173728	8215357	8224311	16
chr17	8243187	8249363	ODF4	6176	+	NM_153007	8243369	8249170	3
chr17	8261730	8263859	LOC100128288	2129	-	NR_024447	8263859	8263859	1
chr17	8271970	8280029	KRBA2	8059	-	NM_001304947	8272451	8273684	2
chr17	8280833	8286565	RPL26	5732	-	NM_000987	8280881	8285628	4
chr17	8294022	8301144	RNF222	7122	-	NM_001146684	8296116	8296779	3
chr17	8339169	8371495	NDEL1	32326	+	NM_001025579	8347589	8370255	10
chr17	8377522	8534079	MYH10	156557	-	NM_001256012	8379121	8526564	43
chr17	8633245	8648154	CCDC42	14909	-	NM_144681	8633447	8647927	7
chr17	8656423	8661877	SPDYE4	5454	-	NM_001128076	8656455	8661700	6
chr17	8700427	8702667	MFSD6L	2240	-	NM_152599	8700677	8702438	1
chr17	8706040	8770994	PIK3R6	64954	-	NM_001290211	8706590	8739916	20
chr17	8782232	8869029	PIK3R5	86797	-	NM_001251851	8783955	8791945	19
chr17	8924858	9147317	NTN1	222459	+	NM_004822	8925690	9143285	7
chr17	9074384	9082435	LOC101928266	8051	-	NR_110828	9082435	9082435	4
chr17	9153787	9479275	STX8	325488	-	NM_004853	9153894	9479125	8
chr17	9479943	9546776	CFAP52	66833	+	NM_145054	9480012	9546515	14
chr17	9548853	9633003	USP43	84150	+	NM_153210	9548949	9632307	15
chr17	9674750	9694614	DHRS7C	19864	-	NM_001105571	9674804	9694601	6
chr17	9705702	9725388	GSG1L2	19686	-	NM_001310219	9705702	9725388	5
chr17	9728867	9795420	GLP2R	66553	+	NM_004246	9729380	9793022	13
chr17	9801026	9808684	RCVRN	7658	-	NM_002903	9801411	9808497	3
chr17	9813925	10101868	GAS7	287943	-	NM_201433	9820544	10101707	14
chr17	10204182	10276322	MYH13	72140	-	NM_003802	10204267	10267847	41
chr17	10286448	10528857	MYHAS	242409	+	NR_125367	10528857	10528857	11
chr17	10293641	10325267	MYH8	31626	-	NM_002472	10293770	10323544	40
chr17	10346607	10372876	MYH4	26269	-	NM_017533	10346691	10370062	40
chr17	10395626	10421859	MYH1	26233	-	NM_005963	10395732	10419959	40
chr17	10424464	10453017	MYH2	28553	-	NM_017534	10424596	10451237	40
chr17	10531842	10560626	MYH3	28784	-	NM_002470	10531969	10558381	41
chr17	10583648	10600885	SCO1	17237	-	NM_004589	10584435	10600824	6
chr17	10600926	10614875	ADPRM	13949	+	NM_020233	10608243	10614461	4
chr17	10616638	10633646	TMEM220	17008	-	NM_001004313	10618769	10633168	6
chr17	10619259	10619899	MAGOH2P	640	-	NR_049723	10619899	10619899	1
chr17	10633093	10718481	TMEM220-AS1	85388	+	NR_073458	10718481	10718481	4
chr17	10698229	10707416	LINC00675	9187	-	NR_036581	10707416	10707416	2
chr17	10725791	10741418	PIRT	15627	-	NM_001101387	10728548	10728962	2
chr17	11144739	11467380	SHISA6	322641	+	NM_207386	11144739	11461621	6
chr17	11501747	11873065	DNAH9	371318	+	NM_001372	11501815	11872844	69
chr17	11880755	11900827	ZNF18	20072	-	NM_001303281	11881273	11896146	7
chr17	11924134	12047148	MAP2K4	123014	+	NM_001281435	11924203	12044577	12
chr17	11985215	11985313	MIR744	98	+	NR_030613	11985313	11985313	1
chr17	12453284	12540504	LINC00670	87220	+	NR_034145	12540504	12540504	4
chr17	12569206	12672265	MYOCD	103059	+	NM_001146312	12569505	12666961	14
chr17	12575178	12609452	LOC101928418	34274	-	NR_104605	12609452	12609452	3
chr17	12663450	12693601	LOC100128006	30151	-	NR_104607	12693601	12693601	2
chr17	12692828	12894960	ARHGAP44	202132	+	NM_014859	12693155	12893488	21
chr17	12820584	12820659	MIR1269B	75	-	NR_039747	12820659	12820659	1
chr17	12894928	12921381	ELAC2	26453	-	NM_173717	12896134	12921264	24
chr17	13397348	13505259	HS3ST3A1	107911	-	NM_006042	13399513	13504446	2
chr17	13927814	13928915	CDRT15P1	1101	+	NR_003261	13928915	13928915	1
chr17	13932608	13972775	COX10-AS1	40167	-	NR_049718	13972775	13972775	3
chr17	13972718	14111996	COX10	139278	+	NM_001303	13972922	14110530	7
chr17	14139172	14140150	CDRT15	978	-	NM_001007530	14139172	14140150	3
chr17	14204366	14252721	HS3ST3B1	48355	+	NR_130138	14252721	14252721	3
chr17	14207056	14209062	MGC12916	2006	+	NR_026880	14209062	14209062	1
chr17	14934291	14935274	CDRT7	983	+	NR_033371	14935274	14935274	3
chr17	15008301	15009504	CDRT8	1203	-	NR_103559	15009504	15009504	2
chr17	15133093	15168674	PMP22	35581	-	NM_001281456	15134233	15164044	5
chr17	15154943	15155013	MIR4731	70	-	NR_039884	15155013	15155013	1
chr17	15207128	15244958	TEKT3	37830	-	NM_031898	15207252	15234902	9
chr17	15339331	15370925	CDRT4	31594	-	NM_001204477	15341089	15343552	4
chr17	15339331	15466945	TVP23C-CDRT4	127614	-	NM_001204478	15343566	15466762	7
chr17	15405577	15466945	TVP23C	61368	-	NM_145301	15406177	15466762	6
chr17	15468795	15523018	CDRT1	54223	-	NM_001282540	15472205	15522826	13
chr17	15531279	15586193	TRIM16	54914	-	NM_006470	15531928	15554923	9
chr17	15602890	15624100	ZNF286A	21210	+	NM_020652	15603643	15620604	6
chr17	15635590	15648098	TBC1D26	12508	+	NM_178571	15638662	15645342	15
chr17	15668016	15669003	CDRT15P2	987	+	NR_033865	15669003	15669003	3
chr17	15690163	15693019	MEIS3P1	2856	+	NR_002211	15693019	15693019	1
chr17	15709555	15721056	LOC101928567	11501	-	NR_110839	15721056	15721056	3
chr17	15848230	15879210	ADORA2B	30980	+	NM_000676	15848562	15878656	2
chr17	15879874	15903006	ZSWIM7	23132	-	NM_001042698	15881360	15902908	6
chr17	15902693	15932723	TTC19	30030	+	NM_001271420	15905237	15930836	10
chr17	15933407	16118874	NCOR1	185467	-	NM_006311	15935609	16097883	46
chr17	16120508	16229573	PIGL	109065	+	NM_004278	16120540	16229212	7
chr17	16185327	16185402	MIR1288	75	+	NR_031698	16185402	16185402	1
chr17	16245847	16256812	CENPV	10965	-	NM_181716	16246130	16256750	5
chr17	16284106	16286059	UBB	1953	+	NM_001281716	16285221	16285911	2
chr17	16318855	16340317	TRPV2	21462	+	NM_016113	16320982	16340203	15
chr17	16342300	16373962	LRRC75A-AS1	31662	+	NR_027178	16373962	16373962	7
chr17	16342822	16342870	SNORD49B	48	+	NR_003043	16342870	16342870	1
chr17	16343349	16343420	SNORD49A	71	+	NR_002744	16343420	16343420	1
chr17	16344539	16344612	SNORD65	73	+	NR_003054	16344612	16344612	1
chr17	16345318	16395505	LRRC75A	50187	-	NM_001113567	16346901	16395304	4
chr17	16453630	16472520	ZNF287	18890	-	NM_020653	16455169	16471045	6
chr17	16524047	16557167	ZNF624	33120	-	NM_020787	16525601	16553058	6
chr17	16593638	16678313	CCDC144A	84675	+	NM_014695	16593714	16676843	18
chr17	16690205	16707819	USP32P1	17614	+	NR_003190	16707819	16707819	8
chr17	16692056	16693815	FAM106CP	1759	+	NR_026810	16693815	16693815	1
chr17	16733796	16736147	KRT16P2	2351	-	NR_029392	16736147	16736147	5
chr17	16842397	16875402	TNFRSF13B	33005	-	NM_012452	16842860	16875389	5
chr17	16946073	17095962	MPRIP	149889	+	NM_201274	16946162	17083953	24
chr17	17104308	17109646	PLD6	5338	-	NM_178836	17106080	17109600	2
chr17	17115526	17140502	FLCN	24976	-	NM_144997	17116968	17131451	14
chr17	17149937	17184617	COPS3	34680	-	NM_003653	17150411	17184500	12
chr17	17206679	17250977	NT5M	44298	+	NM_020201	17206864	17250261	5
chr17	17380299	17396534	MED9	16235	+	NM_018019	17380355	17394809	2
chr17	17397752	17399709	RASD1	1957	-	NM_001199989	17398841	17399495	2
chr17	17408876	17495017	PEMT	86141	-	NM_001267552	17409147	17494940	8
chr17	17577340	17581002	SMCR2	3662	-	NR_131243	17581002	17581002	4
chr17	17584786	17714765	RAI1	129979	+	NM_030665	17696262	17713295	6
chr17	17662467	17669616	RAI1-AS1	7149	-	NR_130894	17669616	17669616	2
chr17	17679999	17682843	SMCR5	2844	-	NR_024007	17682843	17682843	1
chr17	17714662	17740325	SREBF1	25663	-	NM_001005291	17715935	17740131	20
chr17	17716793	17716859	MIR6777	66	-	NR_106835	17716859	17716859	1
chr17	17717149	17717245	MIR33B	96	-	NR_030361	17717245	17717245	1
chr17	17746821	17875784	TOM1L2	128963	-	NM_001082968	17750948	17875627	15
chr17	17876126	17920189	DRC3	44063	+	NM_001130090	17880912	17919985	15
chr17	17921333	17942480	ATPAF2	21147	-	NM_145691	17921862	17942327	8
chr17	17942610	17971718	GID4	29108	+	NM_024052	17942778	17968557	6
chr17	17991180	18011299	DRG2	20119	+	NM_001388	17991337	18010554	13
chr17	18012019	18083116	MYO15A	71097	+	NM_016239	18022114	18082184	65
chr17	18086866	18113267	ALKBH5	26401	+	NM_017758	18087557	18111710	4
chr17	18128935	18148188	LLGL1	19253	+	NM_004140	18128996	18146135	23
chr17	18148130	18162230	FLII	14100	-	NM_002018	18148451	18162004	30
chr17	18163847	18169095	MIEF2	5248	+	NM_139162	18166034	18168078	4
chr17	18177234	18218321	TOP3A	41087	-	NM_004618	18178115	18218092	19
chr17	18218593	18231370	SMCR8	12777	+	NM_144775	18219103	18226384	2
chr17	18231173	18266877	SHMT1	35704	-	NM_004169	18232063	18259295	12
chr17	18244127	18244200	MIR6778	73	-	NR_106836	18244200	18244200	1
chr17	18281078	18292960	EVPLL	11882	+	NM_001145127	18284251	18291562	11
chr17	18314472	18317702	FLJ35934	3230	+	NR_104343	18317702	18317702	2
chr17	18325494	18328647	KRT17P5	3153	+	NR_001443	18328647	18328647	1
chr17	18343221	18346208	KRT16P1	2987	+	NR_073414	18346208	18346208	7
chr17	18380098	18398259	LGALS9C	18161	+	NM_001040078	18380168	18397681	11
chr17	18414575	18424566	USP32P2	9991	-	NR_003554	18424566	18424566	5
chr17	18427879	18430160	FAM106A	2281	-	NR_026809	18430160	18430160	1
chr17	18441114	18528930	CCDC144B	87816	-	NR_036647	18528930	18528930	17
chr17	18538841	18547740	TBC1D28	8899	-	NM_001039397	18539774	18544665	10
chr17	18561741	18585572	ZNF286B	23831	-	NM_001145045	18565249	18584964	5
chr17	18569235	18576494	FOXO3B	7259	-	NR_026718	18576494	18576494	1
chr17	18625401	18639431	TRIM16L	14030	+	NM_001037330	18630870	18638773	5
chr17	18647325	18682662	FBXW10	35337	+	NM_001267585	18647557	18682611	14
chr17	18684307	18710026	TVP23B	25719	+	NM_016078	18684606	18708880	7
chr17	18759611	18834599	PRPSAP2	74988	+	NM_001243942	18781029	18834011	11
chr17	18853988	18924004	SLC5A10	70016	+	NM_001282417	18862051	18923744	15
chr17	18874380	18908060	FAM83G	33680	-	NM_001039999	18874671	18907354	6
chr17	18923989	18950336	GRAP	26347	-	NM_006613	18925271	18950239	5
chr17	18996525	19000876	LOC79999	4351	+	NM_001291904	18996552	18999511	3
chr17	18996525	19000876	LOC388436	4351	+	NM_001291905	18996552	18999511	3
chr17	19030781	19062148	GRAPL	31367	+	NM_001129778	19030932	19061689	4
chr17	19140689	19240028	EPN2	99339	+	NM_014964	19186432	19237567	11
chr17	19174705	19177701	EPN2-IT1	2996	+	NR_046824	19177701	19177701	3
chr17	19199908	19209574	EPN2-AS1	9666	-	NR_048576	19209574	19209574	3
chr17	19240866	19281495	B9D1	40629	-	NM_001243475	19241016	19263691	7
chr17	19247818	19247887	MIR1180	69	-	NR_031591	19247887	19247887	1
chr17	19281033	19286857	MAPK7	5824	+	NM_139033	19282213	19286544	7
chr17	19286754	19290532	MFAP4	3778	-	NM_001198695	19287774	19290431	6
chr17	19314490	19320589	RNF112	6099	+	NM_007148	19314721	19319488	14
chr17	19437166	19482346	SLC47A1	45180	+	NM_018242	19437252	19480866	17
chr17	19552063	19580908	ALDH3A2	28845	+	NM_000382	19552284	19578885	10
chr17	19581627	19620043	SLC47A2	38416	-	NM_001256663	19581998	19619868	18
chr17	19641297	19651746	ALDH3A1	10449	-	NM_000691	19641533	19648442	11
chr17	19674142	19771239	ULK2	97097	-	NM_001142610	19679661	19770730	28
chr17	19807764	19881169	AKAP10	73405	-	NM_007202	19809539	19880992	15
chr17	19912648	20218072	SPECC1	305424	+	NM_001243439	19999964	20217378	15
chr17	20224486	20305504	CCDC144CP	81018	+	NR_023380	20305504	20305504	16
chr17	20320604	20322363	FAM106B	1759	+	NR_126160	20322363	20322363	1
chr17	20353175	20370848	LGALS9B	17673	-	NM_001042685	20353285	20370783	11
chr17	20404826	20407811	KRT16P3	2985	-	NR_029393	20407811	20407811	7
chr17	20483036	20484224	CDRT15L2	1188	+	NM_001190790	20483056	20484042	2
chr17	20615758	20641178	LOC100287072	25420	+	NR_073509	20641178	20641178	12
chr17	20766707	20799453	CCDC144NL	32746	-	NM_001004306	20768727	20799333	4
chr17	20771745	20808543	CCDC144NL-AS1	36798	+	NR_104185	20808543	20808543	3
chr17	20841832	20885670	LOC339260	43838	+	NR_123730	20885670	20885670	6
chr17	20902905	20946352	USP22	43447	-	NM_015276	20906343	20946148	13
chr17	20978868	20993926	LINC01563	15058	+	NR_110895	20993926	20993926	3
chr17	21030240	21095285	DHRS7B	65045	+	NM_015510	21030284	21094466	7
chr17	21101262	21117908	TMEM11	16646	-	NR_024547	21117908	21117908	3
chr17	21142183	21156578	NATD1	14395	-	NM_152914	21146625	21156576	3
chr17	21187967	21218551	MAP2K3	30584	+	NM_001316332	21201762	21217542	13
chr17	21279698	21323179	KCNJ12	43481	+	NM_021012	21318654	21319956	3
chr17	21308447	21320482	KCNJ18	12035	+	NM_001194958	21318654	21319956	3
chr17	21431570	21454941	C17orf51	23371	-	NM_001113434	21438560	21454685	2
chr17	21825369	21826499	FAM27L	1130	+	NR_028336	21826499	21826499	2
chr17	21904061	21913070	FLJ36000	9009	+	NR_027084	21913070	21913070	2
chr17	22022436	22023991	MTRNR2L1	1555	+	NM_001190452	22023387	22023462	1
chr17	25620935	25621022	MIR4522	87	-	NR_039748	25621022	25621022	1
chr17	25621105	25640645	WSB1	19540	+	NM_015626	25621421	25639395	9
chr17	25745030	25758649	TBC1D3P5	13619	+	NR_033892	25758649	25758649	13
chr17	25799035	25950718	KSR1	151683	+	NM_014238	25904556	25948961	21
chr17	25958173	25976586	LGALS9	18413	+	NM_009587	25958291	25976008	11
chr17	26083791	26127555	NOS2	43764	-	NM_000625	26084271	26125835	27
chr17	26205339	26220409	LYRM9	15070	-	NM_001076680	26206498	26209720	4
chr17	26369687	26523404	NLK	153717	+	NM_016231	26369899	26521662	11
chr17	26553588	26555085	PYY2	1497	+	NR_003064	26555085	26555085	2
chr17	26574469	26575315	PPY2P	846	+	NR_002181	26575315	26575315	2
chr17	26603011	26634408	KRT18P55	31397	-	NR_028334	26634408	26634408	3
chr17	26646120	26655711	TMEM97	9591	+	NM_014573	26646265	26653819	3
chr17	26655350	26662515	IFT20	7165	-	NM_174887	26655747	26659011	6
chr17	26662547	26674035	TNFAIP1	11488	+	NM_021137	26666547	26671626	7
chr17	26673653	26684612	POLDIP2	10959	-	NM_015584	26675142	26684473	11
chr17	26684603	26690705	TMEM199	6102	+	NM_152464	26684693	26688274	6
chr17	26687676	26687757	MIR4723	81	+	NR_039875	26687757	26687757	1
chr17	26691289	26692173	SEBOX	884	-	NM_001080837	26691289	26692173	3
chr17	26694298	26697373	VTN	3075	-	NM_000638	26694389	26697224	8
chr17	26698682	26728055	SARM1	29373	+	NM_015077	26699053	26723305	10
chr17	26721660	26733230	SLC46A1	11570	-	NM_080669	26726671	26733132	6
chr17	26800663	26824798	SLC13A2	24135	+	NR_027384	26824798	26824798	13
chr17	26850958	26865175	FOXN1	14217	+	NM_003593	26850987	26864454	8
chr17	26873724	26879646	UNC119	5922	-	NM_005148	26874314	26879575	5
chr17	26880405	26898887	PIGS	18482	-	NM_033198	26881237	26898514	12
chr17	26900132	26903951	ALDOC	3819	-	NM_005165	26900543	26902550	9
chr17	26904582	26926056	SPAG5	21474	-	NM_006461	26904716	26925964	24
chr17	26926150	26944395	SPAG5-AS1	18245	+	NR_040012	26944395	26944395	3
chr17	26934981	26941211	SGK494	6230	-	NM_001174103	26937495	26941179	12
chr17	26941457	26972177	KIAA0100	30720	-	NM_014680	26942081	26972074	39
chr17	26975373	26989207	SDF2	13834	-	NR_045585	26989207	26989207	3
chr17	26989301	27029249	SUPT6H	39948	+	NM_003170	27000419	27028643	37
chr17	27030214	27038925	PROCA1	8711	-	NM_001304953	27030575	27031464	5
chr17	27041298	27045286	RAB34	3988	-	NM_001142624	27041660	27045285	11
chr17	27043010	27044908	NARR	1898	-	NM_001256281	27043070	27044726	3
chr17	27046999	27051374	RPL23A	4375	+	NM_000984	27047023	27050899	5
chr17	27047567	27047634	SNORD42B	67	+	NR_000013	27047634	27047634	1
chr17	27049599	27049671	SNORD4A	72	+	NR_000010	27049671	27049671	1
chr17	27050446	27050509	SNORD42A	63	+	NR_000014	27050509	27050509	1
chr17	27050698	27050772	SNORD4B	74	+	NR_000009	27050772	27050772	1
chr17	27051365	27053949	TLCD1	2584	-	NM_001160407	27051527	27053826	4
chr17	27055831	27069784	NEK8	13953	+	NM_178170	27055831	27069005	15
chr17	27071022	27077976	TRAF4	6954	+	NM_004295	27071130	27076595	7
chr17	27082995	27169857	FAM222B	86862	-	NM_001288636	27085287	27086592	6
chr17	27181974	27188085	ERAL1	6111	+	NM_005702	27182052	27187571	10
chr17	27188386	27188458	MIR451A	72	-	NR_029970	27188458	27188458	1
chr17	27188388	27188456	MIR451B	68	+	NR_039876	27188456	27188456	1
chr17	27188550	27188636	MIR144	86	-	NR_029685	27188636	27188636	1
chr17	27188672	27188748	MIR4732	76	-	NR_039885	27188748	27188748	1
chr17	27206356	27224715	FLOT2	18359	-	NM_004475	27207578	27224592	11
chr17	27224798	27230089	DHRS13	5291	-	NM_144683	27225458	27229962	5
chr17	27232270	27278508	PHF12	46238	-	NM_001033561	27233200	27277978	15
chr17	27253292	27271766	LOC101927018	18474	+	NR_110803	27271766	27271766	2
chr17	27281946	27333458	SEZ6	51512	-	NM_001290202	27282979	27308737	17
chr17	27369917	27384236	PIPOX	14319	+	NM_016518	27370243	27383323	8
chr17	27400527	27507407	MYO18A	106880	-	NM_078471	27401787	27493958	42
chr17	27400538	27402627	TIAF1	2089	-	NM_004740	27400869	27401217	1
chr17	27573874	27581502	CRYBA1	7628	+	NM_005208	27573881	27581367	6
chr17	27582853	27621166	NUFIP2	38313	-	NM_020772	27591556	27621077	4
chr17	27717679	27717748	MIR4523	69	+	NR_039749	27717748	27717748	1
chr17	27717942	27878921	TAOK1	160979	+	NM_020791	27778566	27870040	20
chr17	27887688	27894042	ABHD15	6354	-	NM_198147	27889578	27893984	2
chr17	27895738	27900175	TP53I13	4437	+	NM_138349	27895776	27899942	7
chr17	27900486	27916610	GIT1	16124	-	NM_001085454	27901719	27916396	21
chr17	27920526	27941779	ANKRD13B	21253	+	NM_152345	27920639	27940600	15
chr17	27941773	27948441	CORO6	6668	-	NM_032854	27942749	27948439	10
chr17	27952956	28257246	SSH2	304290	-	NM_001282129	27957858	28257018	16
chr17	28268622	28435470	EFCAB5	166848	+	NM_198529	28268814	28435042	23
chr17	28443824	28513493	NSRP1	69669	+	NM_032141	28443861	28512692	7
chr17	28444096	28444190	MIR423	94	+	NR_029945	28444190	28444190	1
chr17	28444103	28444178	MIR3184	75	-	NR_036149	28444178	28444178	1
chr17	28521336	28562986	SLC6A4	41650	-	NM_001045	28525473	28548976	15
chr17	28575212	28619184	BLMH	43972	-	NM_000386	28576034	28618837	12
chr17	28643365	28661065	TMIGD1	17700	-	NM_206832	28643704	28659151	7
chr17	28705941	28796675	CPD	90734	+	NM_001304	28705998	28791832	21
chr17	28804425	28853832	GOSR1	49407	+	NM_004871	28804451	28849396	9
chr17	28886583	28890509	TBC1D29	3926	+	NM_015594	28886732	28890443	5
chr17	28903482	28964484	LRRC37BP1	61002	+	NR_015341	28964484	28964484	9
chr17	28951335	28953825	SH3GL1P2	2490	+	NR_033420	28953825	28953825	1
chr17	29036625	29097068	SUZ12P1	60443	+	NR_024187	29097068	29097068	8
chr17	29109701	29151778	CRLF3	42077	-	NM_015986	29111204	29151669	8
chr17	29158987	29222883	ATAD5	63896	+	NM_024857	29159365	29221931	23
chr17	29226000	29233286	TEFM	7286	-	NM_024683	29226186	29233216	4
chr17	29248753	29286211	ADAP2	37458	+	NM_018404	29249032	29284887	11
chr17	29297955	29326929	RNF135	28974	+	NM_001184992	29298091	29325706	6
chr17	29302352	29303017	DPRXP4	665	+	NR_002221	29303017	29303017	1
chr17	29421367	29421443	MIR4733	76	-	NR_039886	29421443	29421443	1
chr17	29421944	29704695	NF1	282751	+	NM_001042492	29422327	29701173	58
chr17	29621667	29624380	OMG	2713	-	NM_002544	29622026	29623349	2
chr17	29630787	29641130	EVI2B	10343	-	NM_006495	29631280	29632627	2
chr17	29643427	29648767	EVI2A	5340	-	NM_001003927	29645320	29647449	3
chr17	29718641	29865236	RAB11FIP4	146595	+	NM_032932	29718870	29858750	15
chr17	29861900	29861989	MIR4724	89	+	NR_039877	29861989	29861989	1
chr17	29887014	29887102	MIR193A	88	+	NR_029710	29887102	29887102	1
chr17	29902287	29902377	MIR4725	90	+	NR_039878	29902377	29902377	1
chr17	29902429	29902540	MIR365B	111	+	NR_029856	29902540	29902540	1
chr17	30178883	30186326	COPRS	7443	-	NM_018405	30179157	30186218	4
chr17	30190189	30228729	UTP6	38540	-	NM_018428	30190377	30228646	19
chr17	30264043	30328057	SUZ12	64014	+	NM_015355	30264265	30326022	16
chr17	30348154	30380519	LRRC37B	32365	+	NM_052888	30348165	30380347	12
chr17	30367354	30369851	SH3GL1P1	2497	+	NR_033412	30369851	30369851	1
chr17	30469472	30552790	RHOT1	83318	+	NR_110083	30552790	30552790	21
chr17	30477386	30478590	ARGFXP2	1204	-	NR_002222	30478590	30478590	1
chr17	30593194	30651680	RHBDL3	58486	+	NM_138328	30593208	30648248	9
chr17	30655459	30669228	C17orf75	13769	-	NM_022344	30658781	30669158	10
chr17	30677127	30677221	MIR632	94	+	NR_030362	30677221	30677221	1
chr17	30677156	30697468	ZNF207	20312	+	NM_001098507	30677304	30696778	12
chr17	30771480	30810337	PSMD11	38857	+	NM_002815	30771541	30807649	14
chr17	30814104	30818271	CDK5R1	4167	+	NM_003885	30814638	30815562	2
chr17	30819539	31204191	MYO1D	384652	-	NM_015194	30821776	31203890	22
chr17	31254927	31268667	TMEM98	13740	+	NM_001301746	31258546	31268011	9
chr17	31318881	31324895	SPACA3	6014	+	NM_173847	31318956	31324796	5
chr17	31340105	32483825	ASIC2	1143720	-	NM_001094	31340982	32483551	10
chr17	31856805	31860779	AA06	3974	-	NR_037584	31860779	31860779	3
chr17	32496394	32510651	LOC101927239	14257	-	NR_110748	32510651	32510651	6
chr17	32582295	32584220	CCL2	1925	+	NM_002982	32582368	32583846	3
chr17	32597234	32599261	CCL7	2027	+	NM_006273	32597309	32598821	3
chr17	32612686	32615199	CCL11	2513	+	NM_002986	32612827	32614709	3
chr17	32646065	32648421	CCL8	2356	+	NM_005623	32646520	32647926	3
chr17	32683470	32685629	CCL13	2159	+	NM_005408	32683545	32685150	3
chr17	32687346	32690252	CCL1	2906	-	NM_002981	32687577	32690180	3
chr17	32901141	32906388	C17orf102	5247	-	NM_207454	32904545	32906299	2
chr17	32907767	32966337	TMEM132E	58570	+	NM_001304438	32908095	32965251	9
chr17	33254877	33288528	CCT6B	33651	-	NM_006584	33255066	33288412	14
chr17	33288548	33290205	ZNF830	1657	+	NM_052857	33288585	33289704	1
chr17	33307516	33332088	LIG3	24572	+	NM_013975	33310024	33331525	20
chr17	33336130	33416348	RFFL	80218	-	NR_037713	33416348	33416348	7
chr17	33336130	33448541	RAD51L3-RFFL	112411	-	NR_037714	33448541	33448541	7
chr17	33426810	33446888	RAD51D	20078	-	NM_002878	33427971	33446632	10
chr17	33448630	33457751	FNDC8	9121	+	NM_017559	33448712	33457453	4
chr17	33458340	33469334	NLE1	10994	-	NM_018096	33459455	33469294	13
chr17	33474835	33516364	UNC45B	41529	+	NM_001033576	33475282	33513578	20
chr17	33519538	33521412	SLC35G3	1874	-	NM_152462	33520309	33521326	1
chr17	33570085	33594761	SLFN5	24676	+	NM_144975	33585709	33592907	5
chr17	33677328	33700720	SLFN11	23392	-	NM_001104590	33679374	33690826	7
chr17	33737940	33760195	SLFN12	22255	-	NM_001289009	33738356	33750047	4
chr17	33762114	33775856	SLFN13	13742	-	NM_144682	33767613	33772699	6
chr17	33801941	33814758	SLFN12L	12817	-	NM_001195790	33801941	33814758	4
chr17	33875143	33885110	SLFN14	9967	-	NM_001129820	33875257	33885081	4
chr17	33900675	33900772	SNORD7	97	+	NR_003037	33900772	33900772	1
chr17	33901813	33905656	PEX12	3843	-	NM_000286	33902800	33905040	3
chr17	33914281	34053436	AP2B1	139155	+	NM_001030006	33921049	34050718	22
chr17	34058678	34070540	RASL10B	11862	+	NM_033315	34062203	34068324	4
chr17	34071529	34079897	GAS2L2	8368	-	NM_139285	34071872	34079869	6
chr17	34083267	34122711	MMP28	39444	-	NR_111988	34122711	34122711	9
chr17	34087915	34092098	C17orf50	4183	+	NM_145272	34087960	34091637	3
chr17	34136458	34174246	TAF15	37788	+	NM_003487	34136573	34173949	16
chr17	34181959	34195895	HEATR9	13936	-	NM_152781	34182066	34195746	15
chr17	34198495	34207377	CCL5	8882	-	NM_001278736	34199273	34207309	4
chr17	34231223	34238027	LRRC37A8P	6804	-	NR_126038	34238027	34238027	1
chr17	34245084	34257780	RDM1	12696	-	NM_145654	34245345	34257731	7
chr17	34261521	34270714	LYZL6	9193	-	NM_001199951	34261799	34266360	5
chr17	34303528	34308532	CCL16	5004	-	NM_004590	34304601	34308456	3
chr17	34310691	34313764	CCL14	3073	-	NM_032962	34310836	34313685	4
chr17	34310691	34329084	CCL15-CCL14	18393	-	NR_027921	34329084	34329084	8
chr17	34324617	34329084	CCL15	4467	-	NM_032965	34324802	34328531	4
chr17	34340095	34345005	CCL23	4910	-	NM_005064	34340236	34344934	4
chr17	34391631	34398841	CCL18	7210	+	NM_002988	34391702	34398401	3
chr17	34415602	34417506	CCL3	1904	-	NM_002983	34416017	34417404	3
chr17	34431219	34433014	CCL4	1795	+	NM_002984	34431298	34432705	3
chr17	34522267	34524147	CCL3L3	1880	-	NM_001001437	34522684	34524072	3
chr17	34538309	34540280	CCL4L1	1971	+	NM_207007	34538543	34539971	3
chr17	34538464	34540280	CCL4L2	1816	+	NM_001291468	34538543	34539971	3
chr17	34623841	34625731	CCL3L1	1890	-	NR_111964	34625731	34625731	3
chr17	34746118	34808060	TBC1D3F	61942	-	NM_032258	34746433	34806518	14
chr17	34797171	34808092	TBC1D3B	10921	-	NM_001001417	34797485	34806518	14
chr17	34842470	34855154	ZNHIT3	12684	+	NM_001281432	34842543	34853610	5
chr17	34851598	34891305	MYO19	39707	-	NM_001163735	34852094	34888368	27
chr17	34891402	34895150	PIGW	3748	+	NM_178517	34892950	34894465	2
chr17	34900736	34946276	GGNBP2	45540	+	NM_024835	34901573	34945841	14
chr17	34948225	34957233	DHRS11	9008	+	NM_024308	34948439	34956632	7
chr17	34958024	34965407	MRM1	7383	+	NM_024864	34958239	34964851	5
chr17	35294771	35301915	LHX1	7144	+	NM_005568	35295494	35300428	5
chr17	35306174	35414171	AATF	107997	+	NM_012138	35306425	35413964	12
chr17	35391041	35391110	MIR2909	69	+	NR_036056	35391110	35391110	1
chr17	35441926	35766902	ACACA	324976	-	NM_198839	35444250	35687339	60
chr17	35601716	35601891	SNORA90	175	+	NR_132772	35601891	35601891	1
chr17	35732984	35749662	C17orf78	16678	+	NM_173625	35733034	35748678	7
chr17	35766976	35837226	TADA2A	70250	+	NM_001166105	35771452	35837087	16
chr17	35849950	35873588	DUSP14	23638	+	NM_007026	35872374	35872971	3
chr17	35874899	35969486	SYNRG	94587	-	NM_198882	35879042	35969403	22
chr17	35969789	36003493	DDX52	33704	-	NM_001291476	35974340	35993410	16
chr17	35974975	35975084	MIR378J	109	-	NR_106744	35975084	35975084	1
chr17	36046433	36105069	HNF1B	58636	-	NM_001165923	36047374	36104875	9
chr17	36202572	36244363	YWHAEP7	41791	-	NR_024178	36244363	36244363	7
chr17	36283976	36294915	TBC1D3C	10939	+	NM_001001418	36285544	36294600	14
chr17	36284002	36294915	TBC1D3L	10913	+	NM_001291459	36285544	36294600	14
chr17	36284002	36294971	TBC1D3H	10969	+	NM_001123392	36285544	36294600	14
chr17	36284004	36295098	TBC1D3	11094	+	NM_001123391	36285544	36294600	14
chr17	36284016	36294915	LOC101060389	10899	+	NM_001291465	36285544	36294600	14
chr17	36284016	36294915	TBC1D3G	10899	+	NM_001291462	36285544	36294600	14
chr17	36284016	36294915	TBC1D3I	10899	+	NM_001291463	36285544	36294600	14
chr17	36284016	36294915	TBC1D3K	10899	+	NM_001291464	36285544	36294600	14
chr17	36284018	36294915	TBC1D3E	10897	+	NM_001291466	36285544	36294600	14
chr17	36351795	36413256	LOC440434	61461	-	NR_036750	36413256	36413256	12
chr17	36452988	36479101	MRPL45	26113	+	NM_032351	36453149	36478478	8
chr17	36481492	36499693	GPR179	18201	-	NM_001004334	36482347	36499672	11
chr17	36508006	36561846	SOCS7	53840	+	NM_014598	36508127	36552221	10
chr17	36584719	36668628	ARHGAP23	83909	+	NM_001199417	36584729	36667208	24
chr17	36686258	36762183	SRCIN1	75925	-	NM_025248	36689531	36761958	19
chr17	36827958	36831187	C17orf96	3229	-	NM_001130677	36829608	36830748	1
chr17	36858514	36858584	MIR4734	70	-	NR_039887	36858584	36858584	1
chr17	36861872	36886056	MLLT6	24184	+	NM_005937	36861885	36881851	20
chr17	36875943	36876001	MIR4726	58	+	NR_039879	36876001	36876001	1
chr17	36886509	36891858	CISD3	5349	+	NM_001136498	36886611	36889708	4
chr17	36890149	36904558	PCGF2	14409	-	NM_007144	36891475	36896655	11
chr17	36908965	36920484	PSMB3	11519	+	NR_104195	36920484	36920484	6
chr17	36921943	36956158	PIP4K2B	34215	-	NM_003559	36925943	36955677	10
chr17	36956686	36981603	CWC25	24917	-	NR_073428	36981603	36981603	11
chr17	36982090	36982145	MIR4727	55	+	NR_039880	36982145	36982145	1
chr17	36991340	36997642	C17orf98	6302	-	NM_001080465	36991441	36997642	3
chr17	37006320	37010053	RPL23	3733	-	NM_000978	37006384	37009963	5
chr17	37009115	37009248	SNORA21	133	-	NR_002576	37009248	37009248	1
chr17	37026111	37078023	LASP1	51912	+	NR_073384	37078023	37078023	8
chr17	37071231	37071295	MIR6779	64	+	NR_106837	37071295	37071295	1
chr17	37081420	37085637	LINC00672	4217	+	NR_038847	37085637	37085637	2
chr17	37092684	37123655	FBXO47	30971	-	NM_001008777	37093427	37119278	11
chr17	37186158	37209458	LRRC37A11P	23300	+	NR_033753	37209458	37209458	5
chr17	37213271	37237704	LOC100131347	24433	+	NR_036551	37237704	37237704	5
chr17	37219555	37307902	PLXDC1	88347	-	NM_020405	37224092	37307690	14
chr17	37313146	37322414	ARL5C	9268	-	NM_001143968	37313146	37322013	6
chr17	37329708	37353956	CACNB1	24248	-	NM_000723	37331445	37353748	14
chr17	37356535	37360980	RPL19	4445	+	NM_000981	37356597	37360901	6
chr17	37366788	37382040	STAC2	15252	-	NM_198993	37368544	37381755	11
chr17	37408896	37557909	FBXL20	149013	-	NM_032875	37417712	37557655	15
chr17	37560537	37607527	MED1	46990	-	NM_004774	37563727	37607315	17
chr17	37617763	37690818	CDK12	73055	+	NM_016507	37618324	37687569	14
chr17	37760020	37764175	NEUROD2	4155	-	NM_006160	37761703	37762852	2
chr17	37783176	37792878	PPP1R1B	9702	+	NM_032192	37783645	37792118	7
chr17	37793332	37820454	STARD3	27122	+	NM_006804	37809784	37819161	15
chr17	37821598	37822807	TCAP	1209	+	NM_003673	37821612	37822362	2
chr17	37824233	37826728	PNMT	2495	+	NR_073461	37826728	37826728	3
chr17	37827374	37844323	PGAP3	16949	-	NM_033419	37829055	37844267	8
chr17	37844336	37884915	ERBB2	40579	+	NM_001289936	37855812	37884297	31
chr17	37882747	37882814	MIR4728	67	+	NR_039881	37882814	37882814	1
chr17	37885408	37886788	MIEN1	1380	-	NM_032339	37885774	37886748	4
chr17	37894161	37903538	GRB7	9377	+	NM_005310	37898554	37903150	15
chr17	37913967	38020441	IKZF3	106474	-	NM_001284514	37922042	37933988	9
chr17	38024454	38034149	ZPBP2	9695	+	NM_199321	38024607	38033062	8
chr17	38060847	38074903	GSDMB	14056	-	NM_001165958	38061064	38073569	11
chr17	38077295	38083884	ORMDL3	6589	-	NM_139280	38078802	38080456	4
chr17	38097726	38100987	LRRC3C	3261	+	NM_001195545	38097776	38100987	2
chr17	38119225	38134019	GSDMA	14794	+	NM_178171	38121940	38133311	12
chr17	38137020	38154213	PSMD3	17193	+	NM_002809	38137223	38153834	12
chr17	38171613	38174066	CSF3	2453	+	NM_000759	38171727	38173212	5
chr17	38175349	38210889	MED24	35540	-	NM_014815	38175781	38209851	26
chr17	38182584	38182662	MIR6884	78	-	NR_106944	38182662	38182662	1
chr17	38183795	38183898	SNORD124	103	-	NR_102369	38183898	38183898	1
chr17	38218445	38250120	THRA	31675	+	NM_001190919	38230741	38249635	10
chr17	38249036	38256978	NR1D1	7942	-	NM_021724	38249335	38256347	8
chr17	38278789	38293045	MSL1	14256	+	NM_001012241	38282456	38290622	10
chr17	38296506	38328431	CASC3	31925	+	NM_007359	38296801	38325874	14
chr17	38318185	38318254	MIR6866	69	+	NR_106926	38318254	38318254	1
chr17	38333262	38351908	RAPGEFL1	18646	+	NM_001303533	38333308	38350040	15
chr17	38349848	38349915	MIR6867	67	+	NR_106927	38349915	38349915	1
chr17	38375573	38438439	WIPF2	62866	+	NM_133264	38412711	38434477	8
chr17	38444145	38459413	CDC6	15268	+	NM_001254	38445672	38458253	12
chr17	38465422	38513895	RARA	48473	+	NM_000964	38487470	38512478	9
chr17	38497118	38499388	RARA-AS1	2270	-	NR_110861	38499388	38499388	3
chr17	38516904	38520945	GJD3	4041	-	NM_152219	38519182	38520067	1
chr17	38544772	38574202	TOP2A	29430	-	NM_001067	38545770	38574043	35
chr17	38599675	38613982	IGFBP4	14307	+	NM_001552	38599987	38612835	4
chr17	38632079	38657854	TNS4	25775	-	NM_032865	38633839	38652677	13
chr17	38710021	38721736	CCR7	11715	-	NM_001838	38710993	38721661	3
chr17	38783975	38804103	SMARCE1	20128	-	NM_003079	38785036	38802054	11
chr17	38811871	38821416	KRT222	9545	-	NM_152349	38812653	38821351	6
chr17	38854242	38860002	KRT24	5760	-	NM_019016	38854488	38859945	8
chr17	38904272	38911584	KRT25	7312	-	NM_181534	38904528	38911523	8
chr17	38922489	38928411	KRT26	5922	-	NM_181539	38922766	38928365	8
chr17	38933059	38938786	KRT27	5727	-	NM_181537	38933250	38938745	8
chr17	38948447	38956211	KRT28	7764	-	NM_181535	38948678	38956145	8
chr17	38974368	38978863	KRT10	4495	-	NM_000421	38974727	38978837	8
chr17	38975343	38992526	TMEM99	17183	+	NM_001195387	38990768	38991545	3
chr17	39017429	39023462	KRT12	6033	-	NM_000223	39017912	39023438	8
chr17	39032140	39041495	KRT20	9355	-	NM_019010	39032612	39041437	8
chr17	39078947	39093895	KRT23	14948	-	NM_015515	39079240	39092855	9
chr17	39114668	39123144	KRT39	8476	-	NM_213656	39114852	39123108	7
chr17	39133967	39143387	KRT40	9420	-	NM_182497	39134448	39140525	9
chr17	39149681	39150385	KRTAP3-3	704	-	NM_033185	39150052	39150349	1
chr17	39155444	39156138	KRTAP3-2	694	-	NM_031959	39155808	39156105	1
chr17	39164773	39165366	KRTAP3-1	593	-	NM_031958	39165029	39165326	1
chr17	39182278	39183454	KRTAP1-5	1176	-	NM_031957	39182882	39183407	1
chr17	39185928	39186377	KRTAP1-4	449	-	NM_001257305	39185964	39186330	1
chr17	39190136	39191107	KRTAP1-3	971	-	NM_030966	39190569	39191073	1
chr17	39196810	39197713	KRTAP1-1	903	-	NM_030967	39197115	39197649	1
chr17	39202795	39203568	KRTAP2-1	773	-	NM_001123387	39203132	39203519	1
chr17	39210750	39211463	KRTAP2-2	713	-	NM_033032	39211091	39211463	1
chr17	39215492	39216344	KRTAP2-3	852	-	NM_001165252	39215915	39216302	1
chr17	39221367	39222131	KRTAP2-4	764	-	NM_033184	39221710	39222097	1
chr17	39240458	39241396	KRTAP4-7	938	+	NM_033061	39240458	39240926	1
chr17	39253233	39254375	KRTAP4-8	1142	-	NM_031960	39253778	39254336	1
chr17	39261640	39262740	KRTAP4-9	1100	+	NM_001146041	39261640	39262273	1
chr17	39273433	39274606	KRTAP4-11	1173	-	NM_033059	39273979	39274567	1
chr17	39279344	39280419	KRTAP4-12	1075	-	NM_031854	39279768	39280374	1
chr17	39295684	39296739	KRTAP4-6	1055	-	NM_030976	39296121	39296739	1
chr17	39305175	39306054	KRTAP4-5	879	-	NM_033188	39305473	39306019	1
chr17	39315905	39316983	KRTAP4-4	1078	-	NM_032524	39316442	39316943	1
chr17	39323482	39324424	KRTAP4-3	942	-	NM_033187	39323836	39324424	1
chr17	39333697	39334460	KRTAP4-2	763	-	NM_033062	39334005	39334416	1
chr17	39340351	39341147	KRTAP4-1	796	-	NM_033060	39340665	39341106	2
chr17	39346138	39346891	KRTAP9-1	753	+	NM_001190460	39346138	39346891	1
chr17	39382899	39383904	KRTAP9-2	1005	+	NM_031961	39382906	39383431	1
chr17	39388714	39389706	KRTAP9-3	992	+	NM_031962	39388753	39389233	1
chr17	39394269	39395256	KRTAP9-8	987	+	NM_031963	39394303	39394783	1
chr17	39405938	39406905	KRTAP9-4	967	+	NM_033191	39405972	39406437	1
chr17	39411635	39412616	KRTAP9-9	981	+	NM_030975	39411637	39412147	1
chr17	39421629	39422112	KRTAP9-6	483	+	NM_001277331	39421629	39422112	1
chr17	39431949	39432459	KRTAP9-7	510	+	NM_001277332	39431949	39432459	1
chr17	39458077	39459103	KRTAP29-1	1026	-	NM_001257309	39458077	39459103	1
chr17	39463951	39465505	KRTAP16-1	1554	-	NM_001146182	39463951	39465505	1
chr17	39471168	39471947	KRTAP17-1	779	-	NM_031964	39471584	39471902	1
chr17	39502344	39507064	KRT33A	4720	-	NM_004138	39502370	39507019	7
chr17	39519745	39526052	KRT33B	6307	-	NM_002279	39520087	39526002	7
chr17	39533920	39538636	KRT34	4716	-	NM_021013	39534310	39538624	7
chr17	39549976	39553844	KRT31	3868	-	NM_002277	39550267	39553791	7
chr17	39558667	39568840	LOC100505782	10173	+	NR_040111	39568840	39568840	3
chr17	39576808	39580822	KRT37	4014	-	NM_003770	39577129	39580775	7
chr17	39592620	39597596	KRT38	4976	-	NM_006771	39593663	39597173	7
chr17	39615764	39623638	KRT32	7874	-	NM_002278	39616361	39623577	7
chr17	39632940	39637392	KRT35	4452	-	NM_002280	39633307	39637349	8
chr17	39642387	39646116	KRT36	3729	-	NM_003771	39642627	39646116	7
chr17	39657232	39661865	KRT13	4633	-	NM_153490	39657507	39661802	8
chr17	39669996	39675270	KRT15	5274	-	NM_002275	39670274	39675079	8
chr17	39673415	39673469	MIR6510	54	-	NR_106765	39673469	39673469	1
chr17	39679868	39684641	KRT19	4773	-	NM_002276	39679994	39684499	6
chr17	39705857	39710747	LINC00974	4890	-	NR_038442	39710747	39710747	3
chr17	39722093	39728310	KRT9	6217	-	NM_000226	39723524	39728244	8
chr17	39738530	39743147	KRT14	4617	-	NM_000526	39738686	39743086	8
chr17	39766030	39769079	KRT16	3049	-	NM_005557	39766186	39768940	8
chr17	39775691	39780882	KRT17	5191	-	NM_000422	39775845	39780761	8
chr17	39782578	39796451	KRT42P	13873	-	NR_033415	39796451	39796451	11
chr17	39845126	39847898	EIF1	2772	+	NM_005801	39845290	39847078	4
chr17	39868577	39872221	GAST	3644	+	NM_000805	39871688	39872124	3
chr17	39878890	39890898	HAP1	12008	-	NM_177977	39880952	39890886	11
chr17	39910858	39942964	JUP	32106	-	NM_021991	39911995	39928106	15
chr17	39958204	39968451	P3H4	10247	-	NM_006455	39959208	39968167	8
chr17	39968961	39979469	FKBP10	10508	+	NM_021939	39969286	39978660	10
chr17	39981333	39992523	NT5C3B	11190	-	NM_052935	39981774	39992445	9
chr17	39994042	40004599	KLHL10	10557	+	NM_152467	39994184	40004559	5
chr17	40004770	40021684	KLHL11	16914	-	NM_018143	40009991	40021623	2
chr17	40023169	40075275	ACLY	52106	-	NM_001303274	40024062	40075267	29
chr17	40086875	40117668	TTC25	30793	+	NM_031421	40086976	40117501	11
chr17	40118758	40129754	CNP	10996	+	NM_033133	40118902	40125942	4
chr17	40128438	40169715	DNAJC7	41277	-	NM_003315	40128750	40169434	14
chr17	40169593	40177656	NKIRAS2	8063	+	NM_001001349	40173595	40175911	4
chr17	40177593	40190044	ZNF385C	12451	-	NM_001242704	40178914	40190044	8
chr17	40253421	40264751	DHX58	11330	-	NM_024119	40253778	40263910	14
chr17	40265128	40273382	KAT2A	8254	-	NM_021078	40265666	40273322	18
chr17	40274755	40275371	HSPB9	616	+	NM_033194	40274868	40275348	1
chr17	40276993	40307062	RAB5C	30069	-	NM_001252039	40277800	40283635	7
chr17	40308909	40333296	KCNH4	24387	-	NM_012285	40312057	40332963	17
chr17	40336077	40337470	HCRT	1393	-	NM_001524	40336171	40337383	2
chr17	40341104	40346550	GHDC	5446	-	NM_032484	40341720	40345599	10
chr17	40351194	40428424	STAT5B	77230	-	NM_012448	40353755	40384145	19
chr17	40439564	40463960	STAT5A	24396	+	NM_003152	40441429	40462687	20
chr17	40465342	40540513	STAT3	75171	-	NM_003150	40467762	40500534	24
chr17	40554466	40575338	PTRF	20872	-	NM_012232	40556704	40575115	2
chr17	40610861	40674597	ATP6V0A1	63736	+	NM_001130021	40612912	40673138	22
chr17	40646790	40646848	MIR548AT	58	+	NR_049845	40646848	40646848	1
chr17	40666205	40666325	MIR5010	120	+	NR_049808	40666325	40666325	1
chr17	40687950	40696466	NAGLU	8516	+	NM_000263	40688290	40696256	6
chr17	40703983	40707232	HSD17B1	3249	+	NM_000413	40704951	40706956	6
chr17	40714091	40718299	COASY	4208	+	NM_001042532	40714429	40717986	11
chr17	40719077	40725221	MLX	6144	+	NM_198204	40719142	40723621	8
chr17	40724327	40729849	PSMC3IP	5522	-	NM_001256016	40724985	40726216	9
chr17	40731525	40761445	FAM134C	29920	-	NM_178126	40733830	40761342	9
chr17	40761357	40767256	TUBG1	5899	+	NM_001070	40761755	40767059	11
chr17	40811265	40819024	TUBG2	7759	+	NM_016437	40811521	40818818	11
chr17	40819931	40829048	PLEKHH3	9117	-	NR_073573	40829048	40829048	13
chr17	40831419	40833845	CCR10	2426	-	NM_016602	40831570	40833841	2
chr17	40834631	40852011	CNTNAP1	17380	+	NM_003632	40834847	40850928	24
chr17	40852292	40897071	EZH1	44779	-	NM_001991	40854549	40880959	21
chr17	40860101	40860169	MIR6780A	68	-	NR_106838	40860169	40860169	1
chr17	40905946	40913275	RAMP2-AS1	7329	-	NR_024462	40913275	40913275	6
chr17	40913211	40915060	RAMP2	1849	+	NM_005854	40913279	40914870	4
chr17	40925453	40931618	VPS25	6165	+	NM_032353	40925493	40931087	6
chr17	40932648	40949084	WNK4	16436	+	NM_032387	40932716	40948706	19
chr17	40949635	40950743	COA3	1108	-	NM_001040431	40950078	40950699	2
chr17	40950853	40963605	CNTD1	12752	+	NM_173478	40951085	40961553	7
chr17	40962149	40976333	BECN1	14184	-	NM_003766	40962777	40975895	12
chr17	40975897	40975961	MIR6781	64	-	NR_106839	40975961	40975961	1
chr17	40985158	40995777	PSME3	10619	+	NM_001267045	40986198	40993595	13
chr17	40996608	41002724	AOC2	6116	+	NM_009590	40996643	41002365	4
chr17	41003200	41010147	AOC3	6947	+	NM_003734	41003360	41008567	4
chr17	41019161	41021234	AOC4P	2073	+	NR_002773	41021234	41021234	1
chr17	41026690	41050751	LINC00671	24061	-	NR_027254	41050751	41050751	6
chr17	41052813	41066450	G6PC	13637	+	NM_000151	41052893	41063443	5
chr17	41102542	41116515	AARSD1	13973	-	NM_001261434	41102609	41116457	12
chr17	41102542	41132545	PTGES3L-AARSD1	30003	-	NM_001136042	41102609	41132199	17
chr17	41120104	41132545	PTGES3L	12441	-	NM_001261430	41121164	41132199	7
chr17	41132581	41145707	RUNDC1	13126	+	NM_173079	41132593	41143733	5
chr17	41150445	41154971	RPL27	4526	+	NM_000988	41150767	41154937	5
chr17	41158741	41166476	IFI35	7735	+	NM_005533	41158964	41166316	7
chr17	41166621	41174459	VAT1	7838	-	NM_006373	41168077	41174339	6
chr17	41177257	41184058	RND2	6801	+	NM_005440	41177364	41180697	5
chr17	41196311	41277500	BRCA1	81189	-	NM_007300	41197694	41276113	24
chr17	41277599	41297125	NBR2	19526	+	NR_003108	41297125	41297125	5
chr17	41300383	41322420	LOC101929767	22037	-	NR_110868	41322420	41322420	2
chr17	41322487	41363708	NBR1	41221	+	NM_031862	41327816	41362093	21
chr17	41363845	41372057	TMEM106A	8212	+	NM_001291587	41365060	41369820	10
chr17	41373436	41381062	LINC00854	7626	-	NR_047479	41381062	41381062	5
chr17	41447212	41466266	LINC00910	19054	-	NR_027412	41466266	41466266	6
chr17	41476352	41478504	ARL4D	2152	+	NM_001661	41477100	41477706	2
chr17	41522173	41522253	MIR2117	80	+	NR_031751	41522253	41522253	1
chr17	41561284	41604164	DHX8	42880	+	NM_001302623	41561405	41603966	23
chr17	41605210	41623800	ETV4	18590	-	NM_001079675	41605886	41622985	13
chr17	41717757	41739262	MEOX1	21505	-	NM_001040002	41719277	41738557	4
chr17	41831098	41836156	SOST	5058	-	NM_025237	41832709	41836109	2
chr17	41843488	41856368	DUSP3	12880	-	NM_004090	41846976	41856292	3
chr17	41857802	41862054	C17orf105	4252	+	NM_001136483	41857830	41861261	6
chr17	41878166	41910547	MPP3	32381	-	NM_001932	41879068	41909274	20
chr17	41924515	41940997	CD300LG	16482	+	NM_145273	41924584	41939279	7
chr17	41952726	41987079	MPP2	34353	-	NM_001278370	41955174	41987011	13
chr17	41994575	41995355	FAM215A	780	+	NR_026770	41995355	41995355	1
chr17	42018171	42019833	PPY	1662	-	NM_002722	42018295	42019022	4
chr17	42030106	42081837	PYY	51731	-	NM_004160	42030323	42030851	7
chr17	42082031	42086436	NAGS	4405	+	NM_153006	42082031	42085969	7
chr17	42088555	42100519	TMEM101	11964	-	NM_001304813	42089295	42091868	5
chr17	42112002	42144987	LSM12	32985	-	NM_152344	42113575	42143955	6
chr17	42148097	42153712	G6PC3	5615	+	NR_028581	42153712	42153712	7
chr17	42154120	42201014	HDAC5	46894	-	NM_001015053	42155743	42194883	27
chr17	42219273	42239844	C17orf53	20571	+	NM_001171251	42219510	42239300	10
chr17	42248073	42256451	ASB16	8378	+	NM_080863	42248157	42255758	5
chr17	42253341	42264085	ASB16-AS1	10744	-	NR_049729	42264085	42264085	4
chr17	42264353	42269099	TMUB2	4746	+	NM_001076674	42265076	42268232	4
chr17	42269172	42275529	ATXN7L3	6357	-	NM_020218	42271630	42275438	12
chr17	42282400	42298994	UBTF	16594	-	NR_045058	42298994	42298994	21
chr17	42285138	42285207	MIR6782	69	-	NR_106840	42285207	42285207	1
chr17	42325757	42345502	SLC4A1	19745	-	NM_000342	42327825	42340234	20
chr17	42376941	42385799	RUNDC3A-AS1	8858	-	NR_110802	42385799	42385799	4
chr17	42385926	42396038	RUNDC3A	10112	+	NM_001144825	42386200	42395606	11
chr17	42396992	42402217	SLC25A39	5225	-	NM_001143780	42397368	42400930	12
chr17	42422453	42430474	GRN	8021	+	NM_002087	42426532	42430166	13
chr17	42431100	42441235	FAM171A2	10135	-	NM_198475	42431100	42441082	8
chr17	42449549	42466873	ITGA2B	17324	-	NM_000419	42449731	42466841	30
chr17	42472644	42580970	GPATCH8	108326	-	NM_001304940	42474935	42513872	10
chr17	42634811	42638630	FZD2	3819	+	NM_001466	42635056	42636754	1
chr17	42723731	42727717	LINC01180	3986	-	NR_110661	42727717	42727717	3
chr17	42733761	42753165	MEIOC	19404	+	NM_001145080	42733981	42751564	8
chr17	42754804	42767165	CCDC43	12361	-	NM_144609	42756223	42767121	5
chr17	42785975	42829636	DBF4B	43661	+	NM_025104	42786188	42829331	15
chr17	42836567	42859214	ADAM11	22647	+	NM_002390	42836567	42857122	27
chr17	42875815	42908179	GJC1	32364	-	NM_001080383	42881994	42883185	3
chr17	42923720	42927848	HIGD1B	4128	+	NM_001271880	42925520	42927764	4
chr17	42927654	42976993	EFTUD2	49339	-	NM_001258354	42928641	42971889	28
chr17	42977079	42981047	CCDC103	3968	+	NM_213607	42978366	42980185	4
chr17	42982993	42992920	GFAP	9927	-	NM_002055	42984714	42992854	9
chr17	43002078	43025079	KIF18B	23001	-	NM_001265577	43003447	43013712	16
chr17	43011985	43012049	MIR6783	64	-	NR_106841	43012049	43012049	1
chr17	43037060	43045644	C1QL1	8584	-	NM_006688	43037555	43045416	2
chr17	43100705	43138477	DCAKD	37772	-	NM_024819	43101800	43112253	5
chr17	43138666	43186382	NMT1	47716	+	NM_021079	43138697	43183007	12
chr17	43189007	43209900	PLCD3	20893	-	NM_133373	43189983	43209777	15
chr17	43191734	43191801	MIR6784	67	-	NR_106842	43191801	43191801	1
chr17	43209966	43221543	ACBD4	11577	+	NM_001135704	43213511	43221008	12
chr17	43224683	43229468	HEXIM1	4785	+	NM_006460	43226557	43227637	1
chr17	43237540	43247407	HEXIM2	9867	+	NM_144608	43240160	43247176	4
chr17	43299291	43324683	FMNL1	25392	+	NM_005892	43299491	43323963	27
chr17	43325291	43345997	MAP3K14-AS1	20706	+	NR_110325	43345997	43345997	5
chr17	43331759	43339479	SPATA32	7720	-	NM_152343	43331792	43339383	5
chr17	43340485	43394430	MAP3K14	53945	-	NM_003954	43342002	43368111	16
chr17	43471267	43507663	ARHGAP27	36396	-	NM_001282290	43472821	43507645	17
chr17	43552728	43552801	MIR4315-1	73	-	NR_036199	43552801	43552801	1
chr17	43552728	43552801	MIR4315-2	73	-	NR_036271	43552801	43552801	1
chr17	43677468	43679228	LOC644172	1760	-	NR_026901	43679228	43679228	1
chr17	43716340	43723595	CRHR1-IT1	7255	+	NR_026906	43723595	43723595	3
chr17	43920721	43972879	MAPT-AS1	52158	-	NR_024559	43972879	43972879	2
chr17	43922255	43924438	SPPL2C	2183	+	NM_175882	43922272	43924327	1
chr17	43971747	44105699	MAPT	133952	+	NM_001123066	44039703	44101537	15
chr17	43973148	43976164	MAPT-IT1	3016	+	NR_024560	43976164	43976164	1
chr17	44076615	44077060	STH	445	+	NM_001007532	44076645	44077032	1
chr17	44270938	44274089	KANSL1-AS1	3151	+	NR_034172	44274089	44274089	2
chr17	44586046	44657088	ARL17A	71042	-	NM_001288812	44594480	44653688	5
chr17	44668034	44834828	NSF	166794	+	NM_006178	44668141	44833189	21
chr17	44839871	44896126	WNT3	56255	-	NM_030753	44845685	44895963	5
chr17	44928967	44954437	WNT9B	25470	+	NM_003396	44929004	44954084	4
chr17	45000485	45018733	GOSR2	18248	+	NM_054022	45000558	45017979	7
chr17	45050382	45050466	MIR5089	84	+	NR_049812	45050466	45050466	1
chr17	45055521	45056614	RPRML	1093	-	NM_203400	45056010	45056373	1
chr17	45195062	45266678	CDC27	71616	-	NM_001114091	45198300	45266538	19
chr17	45286427	45301045	MYL4	14618	+	NM_001002841	45286788	45300408	8
chr17	45331207	45390077	ITGB3	58870	+	NM_000212	45331227	45387570	15
chr17	45380811	45401267	THCAT158	20456	-	NR_110880	45401267	45401267	3
chr17	45401326	45518677	EFCAB13	117351	+	NM_152347	45405719	45518080	25
chr17	45527592	45569986	MRPL45P2	42394	-	NR_033934	45569986	45569986	6
chr17	45608443	45700642	NPEPPS	92199	+	NM_006310	45608666	45699286	23
chr17	45727203	45761004	KPNB1	33801	+	NM_002265	45727610	45759770	22
chr17	45772629	45789429	TBKBP1	16800	+	NM_014726	45773478	45787992	9
chr17	45810609	45823485	TBX21	12876	+	NM_013351	45810820	45822732	6
chr17	45884732	45899147	OSBPL7	14415	-	NM_145798	45885656	45897644	23
chr17	45900637	45908907	MRPL10	8270	-	NM_148887	45901570	45906586	6
chr17	45908992	45915079	LRRC46	6087	+	NM_033413	45909355	45914486	8
chr17	45915046	45918699	SCRN2	3653	-	NM_138355	45915209	45918209	8
chr17	45922279	45933240	SP6	10961	-	NM_199262	45924664	45925795	2
chr17	45973515	46006323	SP2	32808	+	NM_003110	45973652	46005190	7
chr17	45975751	46018770	SP2-AS1	43019	-	NR_103857	46018770	46018770	3
chr17	46018888	46026674	PNPO	7786	+	NM_018129	46019041	46024148	7
chr17	46029333	46035243	PRR15L	5910	-	NM_024320	46030288	46030600	2
chr17	46047893	46059152	CDK5RAP3	11259	+	NM_001278197	46048008	46058868	14
chr17	46103532	46115168	COPZ2	11636	-	NM_016429	46103793	46115139	9
chr17	46114526	46114613	MIR152	87	-	NR_029687	46114613	46114613	1
chr17	46125685	46138907	NFE2L1	13222	+	NM_003204	46128480	46137003	6
chr17	46147413	46178883	CBX1	31470	-	NM_001127228	46148796	46154366	5
chr17	46184919	46200105	SNX11	15186	+	NM_152244	46189405	46198870	8
chr17	46210801	46507594	SKAP1	296793	-	NM_003726	46214597	46507482	13
chr17	46233788	46233873	MIR1203	85	-	NR_031607	46233873	46233873	1
chr17	46371708	46385191	THRA1/BTR	13483	+	NR_131239	46385191	46385191	3
chr17	46522194	46543402	LOC101927166	21208	+	NR_110804	46543402	46543402	6
chr17	46606806	46608272	HOXB1	1466	-	NM_002144	46606908	46608266	2
chr17	46620018	46622393	HOXB2	2375	-	NM_002145	46620429	46622273	2
chr17	46621712	46628603	HOXB-AS1	6891	+	NR_102279	46628603	46628603	7
chr17	46626231	46651810	HOXB3	25579	-	NM_002146	46627695	46629836	4
chr17	46652868	46655743	HOXB4	2875	-	NM_024015	46654083	46655681	2
chr17	46657199	46657309	MIR10A	110	-	NR_029608	46657309	46657309	1
chr17	46667781	46683774	HOXB-AS3	15993	+	NR_033201	46683774	46683774	3
chr17	46668618	46671103	HOXB5	2485	-	NM_002147	46669570	46671044	2
chr17	46673098	46682334	HOXB6	9236	-	NM_018952	46673774	46675512	4
chr17	46684594	46688383	HOXB7	3789	-	NM_004502	46685203	46688280	2
chr17	46689707	46692301	HOXB8	2594	-	NM_024016	46690563	46692066	2
chr17	46698518	46703835	HOXB9	5317	-	NM_024017	46700261	46703631	2
chr17	46709851	46709921	MIR196A1	70	-	NR_029582	46709921	46709921	1
chr17	46799081	46799882	PRAC1	801	-	NM_032391	46799162	46799754	2
chr17	46800529	46802120	PRAC2	1591	+	NM_001282275	46801772	46802045	2
chr17	46801769	46801837	MIR3185	68	-	NR_036150	46801837	46801837	1
chr17	46802126	46806111	HOXB13	3985	-	NM_006361	46804151	46805955	2
chr17	46839592	46894469	TTLL6	54877	-	NM_001130918	46846350	46894434	16
chr17	46908349	46942607	CALCOCO2	34258	+	NM_001261391	46919069	46940367	14
chr17	46970147	46973232	ATP5G1	3085	+	NM_005175	46970779	46973131	5
chr17	46985730	47006422	UBE2Z	20692	+	NM_023079	46985865	47004496	7
chr17	47007458	47022204	SNF8	14746	-	NM_001317194	47007836	47014253	10
chr17	47035917	47045955	GIP	10038	-	NM_004123	47036068	47044594	6
chr17	47074773	47133507	IGF2BP1	58734	+	NM_006546	47075107	47126806	15
chr17	47209821	47247351	B4GALNT2	37530	+	NM_001159388	47218672	47247090	11
chr17	47283595	47287936	GNGT2	4341	-	NM_001198754	47284118	47284784	4
chr17	47287588	47300587	ABI3	12999	+	NM_016428	47288086	47300077	8
chr17	47300731	47308128	PHOSPHO1	7397	-	NM_178500	47301607	47304053	3
chr17	47325604	47336027	FLJ40194	10423	+	NR_034161	47336027	47336027	3
chr17	47365707	47365816	MIR6129	109	-	NR_106745	47365816	47365816	1
chr17	47366567	47439835	ZNF652	73268	-	NM_014897	47375774	47395087	6
chr17	47438731	47457456	LOC102724596	18725	+	NR_110883	47457456	47457456	5
chr17	47481409	47492267	PHB	10858	-	NM_001281715	47482353	47490626	8
chr17	47535222	47539111	LOC101927207	3889	-	NR_110805	47539111	47539111	3
chr17	47572654	47592382	NGFR	19728	+	NM_002507	47572779	47590371	6
chr17	47583018	47651426	LOC100288866	68408	-	NR_103773	47651426	47651426	3
chr17	47588178	47588262	MIR6165	84	+	NR_106751	47588262	47588262	1
chr17	47653297	47661171	NXPH3	7874	+	NM_007225	47653581	47656662	2
chr17	47676245	47755525	SPOP	79280	-	NM_001007230	47677739	47700172	12
chr17	47778295	47785313	SLC35B1	7018	-	NM_001278784	47778819	47784358	9
chr17	47787686	47841518	FAM117A	53832	-	NM_030802	47788616	47841449	8
chr17	47865980	47906458	KAT7	40478	+	NM_007067	47866196	47904864	15
chr17	47915670	47925379	TAC4	9709	-	NM_170685	47916003	47925379	5
chr17	47923271	47926199	FLJ45513	2928	+	NM_001242791	47923566	47924649	3
chr17	48046561	48052323	DLX4	5762	+	NM_138281	48046832	48051307	3
chr17	48067368	48072588	DLX3	5220	-	NM_005220	48068880	48072362	3
chr17	48127712	48133103	LOC284080	5391	-	NR_038230	48133103	48133103	3
chr17	48133331	48167849	ITGA3	34518	+	NM_002204	48133803	48165699	26
chr17	48172100	48188733	PDK2	16633	+	NM_001199898	48174860	48187461	12
chr17	48188672	48207246	SAMD14	18574	-	NM_174920	48190256	48202323	11
chr17	48211098	48227878	PPP1R9B	16780	-	NM_032595	48212695	48227874	10
chr17	48243365	48253293	SGCA	9928	+	NM_000023	48243401	48252798	10
chr17	48248788	48249837	HILS1	1049	-	NR_024192	48249837	48249837	2
chr17	48261456	48279000	COL1A1	17544	-	NM_000088	48262862	48278874	51
chr17	48292054	48292781	LOC101927230	727	+	NR_110806	48292781	48292781	3
chr17	48348766	48358846	TMEM92	10080	+	NM_001168215	48351862	48356669	6
chr17	48358941	48365216	TMEM92-AS1	6275	-	NR_125805	48365216	48365216	4
chr17	48423392	48438546	XYLT2	15154	+	NM_022167	48423501	48437652	11
chr17	48445227	48450562	MRPL27	5335	-	NM_016504	48445452	48450531	4
chr17	48450580	48458820	EME1	8240	+	NM_001166131	48452569	48458300	9
chr17	48458593	48474914	LRRC59	16321	-	NM_018509	48460348	48474678	7
chr17	48503518	48552206	ACSF2	48688	+	NM_001288968	48503622	48551913	17
chr17	48541852	48546227	CHAD	4375	-	NM_001267	48542658	48546174	4
chr17	48556160	48563341	RSAD1	7181	+	NM_018346	48556245	48562222	9
chr17	48585744	48608862	MYCBPAP	23118	+	NM_032133	48585906	48608789	19
chr17	48610047	48621111	EPN3	11064	+	NM_017957	48613917	48619518	10
chr17	48624449	48633213	SPATA20	8764	+	NM_001258373	48625698	48633023	17
chr17	48633567	48639469	CACNA1G-AS1	5902	-	NR_038439	48639469	48639469	2
chr17	48638428	48704832	CACNA1G	66404	+	NM_018896	48638820	48704112	38
chr17	48712217	48769063	ABCC3	56846	+	NM_003786	48712297	48768561	31
chr17	48770550	48785270	ANKRD40	14720	-	NM_052855	48773357	48785015	5
chr17	48796925	48830072	LUC7L3	33147	+	NM_006107	48797093	48828022	11
chr17	48838394	48844876	LINC00483	6482	-	NR_073199	48844876	48844876	4
chr17	48846010	48846091	MIR8059	81	+	NR_107026	48846091	48846091	1
chr17	48912604	48919709	WFIKKN2	7105	+	NM_175575	48913298	48918380	2
chr17	48939586	48945339	TOB1	5753	-	NM_001243877	48940340	48941378	3
chr17	48944039	48945732	TOB1-AS1	1693	+	NR_038458	48945732	48945732	2
chr17	49039534	49198226	SPAG9	158692	-	NM_001130528	49043632	49198017	30
chr17	49230896	49249105	NME1-NME2	18209	+	NR_037149	49249105	49249105	9
chr17	49230919	49239450	NME1	8531	+	NM_198175	49231734	49239206	6
chr17	49242795	49249105	NME2	6310	+	NM_001018137	49244191	49248965	5
chr17	49254785	49337427	MBTD1	82642	-	NM_017643	49257936	49302522	17
chr17	49337896	49375292	UTP18	37396	+	NM_016001	49337945	49374350	14
chr17	49389969	49412523	LOC101927274	22554	-	NR_110751	49412523	49412523	6
chr17	49414075	49419932	LOC440446	5857	+	NR_122104	49419932	49419932	3
chr17	49707673	50237377	CA10	529704	-	NM_001082534	49708944	50235146	10
chr17	51062879	51065012	C17orf112	2133	+	NM_001243552	51063038	51064681	4
chr17	51900238	51902573	KIF2B	2335	+	NM_032559	51900394	51902416	1
chr17	52978051	53039328	TOM1L1	61277	+	NM_005486	52978226	53037987	16
chr17	53029258	53046064	COX11	16806	-	NR_027942	53046064	53046064	5
chr17	53046125	53241449	STXBP4	195324	+	NM_178509	53063580	53237272	18
chr17	53342320	53402426	HLF	60106	+	NM_002126	53342845	53398240	4
chr17	53469973	53499341	MMD	29368	-	NM_012329	53471694	53499056	7
chr17	53796987	53809482	TMEM100	12495	-	NM_001099640	53798026	53798431	4
chr17	53828339	53854748	PCTP	26409	+	NM_021213	53828464	53853461	6
chr17	54230835	54560007	ANKFN1	329172	+	NM_153228	54230870	54559908	17
chr17	54671059	54672951	NOG	1892	+	NM_005450	54671584	54672283	1
chr17	54869273	54911256	C17orf67	41983	-	NM_001085430	54872424	54893171	8
chr17	54911459	54946036	DGKE	34577	+	NM_003647	54912156	54940152	12
chr17	54961462	54962274	MTVR2	812	-	NR_027025	54962274	54962274	1
chr17	54965269	54991409	TRIM25	26140	-	NM_005082	54969060	54991349	9
chr17	54968630	54968716	MIR3614	86	-	NR_037408	54968716	54968716	1
chr17	55015560	55038411	COIL	22851	-	NM_004645	55016431	55038380	7
chr17	55055467	55084129	SCPEP1	28662	+	NM_021626	55055520	55083596	13
chr17	55122838	55124156	RNF126P1	1318	+	NR_002818	55124156	55124156	1
chr17	55162552	55198710	AKAP1	36158	+	NM_003488	55182825	55197685	11
chr17	55333930	55757299	MSI2	423369	+	NM_138962	55334103	55754389	14
chr17	55599608	55600958	LOC101927557	1350	-	NR_110808	55600958	55600958	3
chr17	55678225	55685773	LOC101927539	7548	-	NR_110807	55685773	55685773	3
chr17	55821841	55822690	CCDC182	849	-	NM_001282544	55822171	55822633	1
chr17	55916286	55927433	MRPS23	11147	-	NM_016070	55917143	55927371	5
chr17	55938603	56032684	CUEDC1	94081	-	NM_001271875	55943837	55962925	11
chr17	56048909	56065615	VEZF1	16706	-	NM_007146	56051833	56065472	6
chr17	56078279	56084707	SRSF1	6428	-	NM_006924	56082766	56084498	4
chr17	56154251	56160565	LOC101927666	6314	-	NR_110809	56160565	56160565	3
chr17	56160779	56167618	DYNLL2	6839	+	NM_080677	56164451	56166640	3
chr17	56232514	56233447	OR4D1	933	+	NM_012374	56232514	56233447	1
chr17	56234319	56236480	MSX2P1	2161	+	NR_002307	56236480	56236480	1
chr17	56247016	56247940	OR4D2	924	+	NM_001004707	56247016	56247940	1
chr17	56270088	56282535	EPX	12447	+	NM_000502	56270207	56281784	13
chr17	56282796	56296966	MKS1	14170	-	NM_001165927	56283439	56296872	18
chr17	56315786	56345879	LPO	30093	+	NM_006151	56320340	56345355	13
chr17	56347216	56358296	MPO	11080	-	NM_000250	56348016	56358119	12
chr17	56378587	56406152	BZRAP1	27565	-	NM_001261835	56381730	56405281	32
chr17	56402810	56431088	BZRAP1-AS1	28278	+	NR_038410	56431088	56431088	5
chr17	56408592	56408679	MIR142	87	-	NR_029683	56408679	56408679	1
chr17	56413336	56413383	MIR4736	47	-	NR_039889	56413383	56413383	1
chr17	56422535	56429599	SUPT4H1	7064	-	NM_003168	56423606	56429496	5
chr17	56429860	56494943	RNF43	65083	-	NM_017763	56432303	56492938	10
chr17	56497527	56565762	HSF5	68235	-	NM_001080439	56499720	56565635	6
chr17	56566892	56595251	MTMR4	28359	-	NM_004687	56569023	56593943	19
chr17	56597197	56634286	SEPT4-AS1	37089	+	NR_110810	56634286	56634286	5
chr17	56597610	56618179	SEPT4	20569	-	NM_001256782	56597786	56618034	13
chr17	56618947	56621733	C17orf47	2786	-	NM_001038704	56619175	56621547	2
chr17	56634037	56769416	TEX14	135379	-	NM_001201457	56634371	56729362	33
chr17	56769933	56811703	RAD51C	41770	+	NM_058216	56770004	56811583	9
chr17	56833229	57062540	PPM1E	229311	+	NM_014906	56833358	57058392	7
chr17	57059999	57184266	TRIM37	124267	-	NM_001005207	57060278	57183822	25
chr17	57187307	57232800	SKA2	45493	-	NM_182620	57189637	57232524	4
chr17	57215118	57215233	MIR454	115	-	NR_030411	57215233	57215233	1
chr17	57228496	57228582	MIR301A	86	-	NR_029842	57228582	57228582	1
chr17	57232859	57284070	PRR11	51211	+	NM_018304	57247113	57278992	10
chr17	57287370	57292611	SMG8	5241	+	NM_018149	57287412	57292363	4
chr17	57297827	57353330	GDPD1	55503	+	NM_182569	57297970	57351134	10
chr17	57409052	57479095	YPEL2	70043	+	NM_001005404	57430770	57474551	5
chr17	57443443	57443515	MIR4729	72	+	NR_039882	57443515	57443515	1
chr17	57508229	57604218	LINC01476	95989	-	NR_110813	57604218	57604218	3
chr17	57642885	57685713	DHX40	42828	+	NM_024612	57643032	57684533	18
chr17	57697049	57774317	CLTC	77268	+	NM_004859	57697492	57771213	32
chr17	57774666	57784959	PTRH2	10293	-	NM_001015509	57774799	57776234	3
chr17	57784862	57917952	VMP1	133090	+	NM_030938	57808807	57917272	12
chr17	57918626	57918698	MIR21	72	+	NR_029493	57918698	57918698	1
chr17	57936840	57970306	TUBD1	33466	-	NM_016261	57937682	57968363	9
chr17	57970406	58027786	RPS6KB1	57380	+	NM_001272044	57987940	58024149	16
chr17	58029722	58042117	RNFT1	12395	-	NM_016125	58030337	58042024	9
chr17	58042456	58074333	LOC101927755	31877	+	NR_110815	58074333	58074333	4
chr17	58053384	58096336	TBC1D3P1-DHX40P1	42952	-	NR_002924	58096336	58096336	12
chr17	58120385	58120466	MIR4737	81	-	NR_039890	58120466	58120466	1
chr17	58120551	58156292	HEATR6	35741	-	NM_022070	58120923	58156275	20
chr17	58160926	58165828	WFDC21P	4902	-	NR_030732	58165828	58165828	3
chr17	58179120	58180280	LOC653653	1160	-	NR_027408	58180280	58180280	1
chr17	58227301	58236906	CA4	9605	+	NM_000717	58227395	58236785	8
chr17	58254690	58469586	USP32	214896	-	NM_032582	58256615	58469300	34
chr17	58308876	58309006	SCARNA20	130	-	NR_002999	58309006	58309006	1
chr17	58499864	58508787	C17orf64	8923	+	NM_181707	58499953	58508627	6
chr17	58520509	58603601	APPBP2	83092	-	NM_006380	58524941	58603292	13
chr17	58641906	58663981	LOC388406	22075	+	NR_126009	58663981	58663981	4
chr17	58677543	58743640	PPM1D	66097	+	NM_003620	58677775	58740913	6
chr17	58755171	59470199	BCAS3	715028	+	NM_001099432	58756818	59469486	25
chr17	59470816	59476967	TBX2-AS1	6151	-	NR_125750	59476967	59476967	3
chr17	59477256	59486827	TBX2	9571	+	NM_005994	59477537	59485867	7
chr17	59489111	59490641	C17orf82	1530	+	NM_203425	59489336	59490092	1
chr17	59533806	59561664	TBX4	27858	+	NM_018488	59533851	59560877	8
chr17	59667793	59668563	NACA2	770	-	NM_199290	59667893	59668541	1
chr17	59756546	59940920	BRIP1	184374	-	NM_032043	59760656	59938900	20
chr17	59942727	60005377	INTS2	62650	-	NM_020748	59944917	60005301	25
chr17	60019965	60142643	MED13	122678	-	NM_005121	60023828	60142566	30
chr17	60342066	60353016	TBC1D3P2	10950	-	NR_027486	60353016	60353016	14
chr17	60447578	60493839	EFCAB3	46261	+	NM_001144933	60447649	60493690	12
chr17	60501245	60527454	METTL2A	26209	+	NM_181725	60501263	60526090	9
chr17	60556385	60692841	TLK2	136456	+	NM_001284333	60558486	60689926	23
chr17	60704761	60770962	MRC2	66201	+	NM_006039	60705163	60769812	30
chr17	60778674	60885742	MARCH10	107068	-	NM_001288779	60779063	60879096	12
chr17	60798857	61268734	MIR548W	469877	+	NR_036146	61268734	61268734	4
chr17	61021575	61021673	MIR633	98	+	NR_030363	61021673	61021673	1
chr17	61086897	61505067	TANC2	418170	+	NM_025185	61086920	61499316	25
chr17	61509664	61523722	CYB561	14058	-	NM_001915	61511762	61514908	6
chr17	61554421	61575741	ACE	21320	+	NM_000789	61554455	61574727	25
chr17	61600694	61626338	KCNH6	25644	+	NM_173092	61600774	61623263	15
chr17	61627795	61671642	DCAF7	43847	+	NM_005828	61628038	61666534	8
chr17	61678230	61685725	TACO1	7495	+	NM_016360	61678442	61685362	5
chr17	61699800	61773670	MAP3K3	73870	+	NM_203351	61700119	61771137	17
chr17	61773248	61777519	LIMD2	4271	-	NM_030576	61775911	61776658	5
chr17	61777697	61780045	LOC729683	2348	+	NR_046273	61780045	61780045	1
chr17	61780191	61819330	STRADA	39139	-	NM_001003787	61780958	61805729	13
chr17	61822609	61851088	CCDC47	28479	-	NM_020198	61824240	61843535	13
chr17	61851548	61896677	DDX42	45129	+	NM_007372	61864409	61895758	19
chr17	61896792	61905031	FTSJ3	8239	-	NM_017647	61897161	61904262	21
chr17	61904769	61909387	PSMC5	4618	+	NM_002805	61904850	61909329	12
chr17	61909440	61920351	SMARCD2	10911	-	NM_001098426	61910297	61920034	13
chr17	61934375	61941739	TCAM1P	7364	+	NR_002947	61941739	61941739	6
chr17	61949371	61951089	CSH2	1718	-	NM_020991	61949485	61950974	5
chr17	61957571	61959302	GH2	1731	-	NM_022558	61957592	61959161	5
chr17	61972267	61974021	CSH1	1754	-	NM_001317	61972381	61973871	5
chr17	61986964	61988618	CSHL1	1654	-	NM_022581	61987070	61988556	5
chr17	61994552	61996212	GH1	1660	-	NM_000515	61994668	61996136	5
chr17	62006097	62009704	CD79B	3607	-	NM_000626	62006585	62009621	6
chr17	62015913	62050278	SCN4A	34365	-	NM_000334	62018130	62050201	24
chr17	62073430	62077259	PRR29-AS1	3829	-	NR_126169	62077259	62077259	3
chr17	62075710	62081644	PRR29	5934	+	NM_001164257	62075724	62079121	6
chr17	62079954	62097994	ICAM2	18040	-	NM_001099786	62080106	62084051	6
chr17	62120389	62207502	ERN1	87113	-	NM_001433	62121347	62207389	22
chr17	62223329	62223669	SNHG25	340	+	NR_132278	62223669	62223669	2
chr17	62223437	62223517	SNORD104	80	+	NR_004380	62223517	62223517	1
chr17	62223698	62223831	SNORA50C	133	+	NR_002995	62223831	62223831	1
chr17	62224792	62340683	TEX2	115891	-	NM_001288732	62226328	62291577	12
chr17	62396776	62407083	PECAM1	10307	-	NM_000442	62401175	62407083	2
chr17	62461568	62464760	MILR1	3192	+	NM_001085423	62461568	62463734	5
chr17	62473901	62493184	POLG2	19283	-	NM_007215	62473939	62493086	8
chr17	62494373	62502484	DDX5	8111	-	NM_004396	62496040	62502237	13
chr17	62496891	62496957	MIR3064	66	-	NR_039891	62496957	62496957	1
chr17	62497331	62497431	MIR5047	100	-	NR_039969	62497431	62497431	1
chr17	62502853	62534069	CEP95	31216	+	NR_133644	62534069	62534069	20
chr17	62540734	62658386	SMURF2	117652	-	NM_022739	62541965	62657998	19
chr17	62745779	62778117	LOC146880	32338	-	NR_026899	62778117	62778117	13
chr17	62776876	62776942	MIR6080	66	+	NR_106728	62776942	62776942	1
chr17	62780958	62833302	PLEKHM1P1	52344	-	NR_024386	62833302	62833302	11
chr17	62850429	62915598	LRRC37A3	65169	-	NM_199340	62850716	62893375	15
chr17	62962667	62971703	AMZ2P1	9036	-	NR_026903	62971703	62971703	5
chr17	63005406	63052920	GNA13	47514	-	NM_006572	63010374	63052711	4
chr17	63096929	63107212	LOC100507002	10283	+	NR_110801	63107212	63107212	3
chr17	63133455	63223821	RGS9	90366	+	NM_001081955	63133658	63223525	19
chr17	63453658	63454526	CRAT40	868	+	NR_131984	63454526	63454526	3
chr17	63524682	63557740	AXIN2	33058	-	NM_004655	63526093	63554738	11
chr17	63631657	64188249	CEP112	556592	-	NM_001199165	63632088	64179417	27
chr17	64208146	64225556	APOH	17410	-	NM_000042	64208250	64225497	8
chr17	64298925	64806862	PRKCA	507937	+	NM_002737	64298969	64800155	17
chr17	64394186	64412972	PRKCA-AS1	18786	-	NR_110822	64412972	64412972	4
chr17	64783189	64783286	MIR634	97	+	NR_030364	64783286	64783286	1
chr17	64873390	64881395	CACNG5	8005	+	NM_145811	64873450	64881357	5
chr17	64960979	65029518	CACNG4	68539	+	NM_014405	64961027	65027120	4
chr17	65040651	65052911	CACNG1	12260	+	NM_000727	65040776	65052387	4
chr17	65066553	65241319	HELZ	174766	-	NM_014877	65074367	65214920	33
chr17	65334031	65362743	PSMD12	28712	-	NM_001316341	65336958	65353538	13
chr17	65373396	65693379	PITPNC1	319983	+	NM_181671	65374270	65688693	10
chr17	65713948	65740324	NOL11	26376	+	NM_015462	65714063	65739975	18
chr17	65736785	65736917	SNORA38B	132	+	NR_003706	65736917	65736917	1
chr17	65821779	65980494	BPTF	158715	+	NM_004459	65821840	65978404	30
chr17	65987214	65989765	C17orf58	2551	-	NM_181656	65989034	65989262	3
chr17	66031847	66042970	KPNA2	11123	+	NM_002266	66033248	66042712	11
chr17	66097695	66132070	LINC00674	34375	+	NR_027418	66132070	66132070	6
chr17	66194800	66196443	LOC440461	1643	+	NR_027283	66196443	66196443	1
chr17	66244144	66253305	AMZ2	9161	+	NM_001033569	66246328	66253110	8
chr17	66255322	66417000	ARSG	161678	+	NM_014960	66303634	66416604	12
chr17	66263166	66287405	SLC16A6	24239	-	NM_001174166	66265236	66274461	7
chr17	66409763	66529570	PRKAR1A	119807	+	NM_001278433	66511540	66526590	11
chr17	66417421	66453653	WIPI1	36232	-	NM_017983	66417913	66453562	13
chr17	66420591	66420689	MIR635	98	-	NR_030365	66420689	66420689	1
chr17	66531256	66597095	FAM20A	65839	-	NM_001243746	66533617	66551874	12
chr17	66624294	66675747	LINC01482	51453	+	NR_110825	66675747	66675747	5
chr17	66863427	66951533	ABCA8	88106	-	NM_001288985	66864225	66938175	40
chr17	66970772	67057136	ABCA9	86364	-	NM_080283	66972055	67047267	39
chr17	67000854	67014464	ABCA9-AS1	13610	+	NR_126414	67014464	67014464	4
chr17	67074846	67138015	ABCA6	63169	-	NM_080284	67075113	67136844	39
chr17	67095682	67095797	MIR4524B	115	+	NR_049834	67095797	67095797	1
chr17	67095704	67095773	MIR4524A	69	-	NR_039750	67095773	67095773	1
chr17	67144147	67240956	ABCA10	96809	-	NM_080282	67144967	67221499	40
chr17	67229115	67231153	PRO1804	2038	-	NR_130736	67231153	67231153	1
chr17	67240575	67323323	ABCA5	82748	-	NM_172232	67243677	67310556	39
chr17	67410837	67538470	MAP2K6	127633	+	NM_002758	67411125	67537894	12
chr17	67590127	67899141	LINC01483	309014	+	NR_109971	67899141	67899141	6
chr17	67957847	67979685	LINC01497	21838	+	NR_110875	67979685	67979685	5
chr17	68047411	68064236	LINC01028	16825	+	NR_104129	68064236	68064236	3
chr17	68071365	68131746	KCNJ16	60381	+	NM_001270422	68128228	68129485	6
chr17	68163101	68165543	KCNJ2-AS1	2442	-	NR_036534	68165543	68165543	1
chr17	68165675	68176183	KCNJ2	10508	+	NM_000891	68171180	68172464	2
chr17	69093914	69198320	CASC17	104406	-	NR_104152	69198320	69198320	4
chr17	70017991	70022120	LOC102723505	4129	-	NR_110876	70022120	70022120	3
chr17	70026794	70037438	LINC01152	10644	+	NR_110124	70037438	70037438	3
chr17	70030247	70053875	LOC102723517	23628	-	NR_110877	70053875	70053875	3
chr17	70067182	70112157	SOX9-AS1	44975	-	NR_103738	70112157	70112157	7
chr17	70068473	70089622	LOC101928205	21149	+	NR_110827	70089622	70089622	6
chr17	70117160	70122560	SOX9	5400	+	NM_000346	70117532	70120528	3
chr17	70399462	70588943	LINC00673	189481	-	NR_036488	70588943	70588943	4
chr17	70594179	70636611	LINC00511	42432	-	NR_033876	70636611	70636611	5
chr17	70642084	71088853	SLC39A11	446769	-	NM_139177	70643722	71084903	10
chr17	71161159	71168062	SSTR2	6903	+	NM_001050	71165458	71166568	2
chr17	71189172	71204645	COG1	15473	+	NM_018714	71189208	71204590	14
chr17	71203491	71228533	FAM104A	25042	-	NM_001098832	71205667	71228445	4
chr17	71228371	71245095	C17orf80	16724	+	NM_001288770	71231621	71243480	5
chr17	71244587	71258019	CPSF4L	13432	-	NM_001129885	71244632	71257957	6
chr17	71279762	71308143	CDC42EP4	28381	-	NM_012121	71281568	71282639	2
chr17	71330522	71640227	SDK2	309705	-	NM_001144952	71334725	71640227	45
chr17	71733992	71752696	LOC100134391	18704	+	NM_001278587	71734088	71752543	6
chr17	71745408	71824676	LINC00469	79268	-	NR_027146	71824676	71824676	4
chr17	71782960	71796934	LOC400620	13974	+	NR_040020	71796934	71796934	7
chr17	72199794	72206019	RPL38	6225	+	NM_001035258	72200094	72205968	5
chr17	72206134	72209460	MGC16275	3326	-	NR_026914	72209460	72209460	2
chr17	72209695	72258157	TTYH2	48462	+	NM_032646	72209726	72256348	14
chr17	72270385	72311023	DNAI2	40638	+	NM_001172810	72277956	72310355	14
chr17	72322350	72351959	KIF19	29609	+	NM_153209	72322488	72351451	20
chr17	72352554	72357958	BTBD17	5404	-	NM_001080466	72352795	72357958	3
chr17	72363644	72368739	GPR142	5095	+	NM_181790	72363644	72368739	4
chr17	72427666	72443568	GPRC5C	15902	+	NM_022036	72428177	72443167	4
chr17	72462521	72480937	CD300A	18416	+	NM_007261	72462842	72480265	7
chr17	72517312	72527613	CD300LB	10301	-	NM_174892	72518876	72527489	4
chr17	72537204	72542310	CD300C	5106	-	NM_006678	72537727	72541921	4
chr17	72576110	72588370	CD300LD	12260	-	NM_001115152	72576140	72588341	4
chr17	72580817	72590348	C17orf77	9531	+	NM_001302809	72588185	72588917	3
chr17	72606021	72619897	CD300E	13876	-	NM_181449	72608791	72619760	4
chr17	72667255	72743474	RAB37	76219	+	NM_175738	72667725	72741550	9
chr17	72690446	72709139	CD300LF	18693	-	NM_001289085	72691234	72701394	8
chr17	72744750	72765499	SLC9A3R1	20749	+	NM_004252	72744985	72764795	6
chr17	72744751	72744838	MIR3615	87	+	NR_037409	72744838	72744838	1
chr17	72766667	72772564	NAT9	5897	-	NM_001305079	72768102	72771837	7
chr17	72772621	72835922	TMEM104	63301	+	NM_017728	72773469	72832826	10
chr17	72838161	72856007	GRIN2C	17846	-	NR_103735	72856007	72856007	13
chr17	72858618	72869156	FDXR	10538	-	NM_001258013	72858938	72869069	13
chr17	72873441	72889909	FADS6	16468	-	NM_178128	72874459	72889693	6
chr17	72912175	72919358	USH1G	7183	-	NM_001282489	72914167	72916621	3
chr17	72920369	72930006	OTOP2	9637	+	NM_178160	72920727	72929640	7
chr17	72931896	72946087	OTOP3	14191	+	NM_178233	72931896	72945511	7
chr17	72946838	72968900	HID1	22062	-	NM_030630	72947664	72968751	19
chr17	72966783	72971823	HID1-AS1	5040	+	NR_110878	72971823	72971823	3
chr17	72983726	73001892	CDR2L	18166	+	NM_014603	72984138	73000169	5
chr17	73008758	73017356	ICT1	8598	+	NM_001545	73008781	73017100	6
chr17	73028661	73061984	KCTD2	33323	+	NR_110835	73061984	73061984	8
chr17	73034954	73043074	ATP5H	8120	-	NM_006356	73035026	73038745	6
chr17	73083821	73102255	SLC16A5	18434	+	NM_001271765	73089731	73102128	7
chr17	73106046	73126360	ARMC7	20314	+	NM_001304271	73106383	73124912	3
chr17	73126319	73127890	NT5C	1571	-	NR_045513	73127890	73127890	5
chr17	73131337	73150778	HN1	19441	-	NM_001002033	73132196	73144684	6
chr17	73163824	73179098	SUMO2	15274	-	NM_006937	73164433	73178929	4
chr17	73201544	73231854	NUP85	30310	+	NM_024844	73201856	73231774	19
chr17	73232686	73258474	GGA3	25788	-	NM_001172703	73234359	73240783	17
chr17	73257748	73262457	MRPS7	4709	+	NM_015971	73257981	73262004	5
chr17	73262309	73267311	MIF4GD	5002	-	NM_020679	73262820	73266276	7
chr17	73267379	73269976	LOC100287042	2597	+	NR_036520	73269976	73269976	1
chr17	73269060	73285530	SLC25A19	16470	-	NM_021734	73269531	73282845	8
chr17	73314156	73401790	GRB2	87634	-	NM_203506	73316448	73389709	5
chr17	73402149	73402243	MIR3678	94	+	NR_037449	73402243	73402243	1
chr17	73452663	73496533	TMEM94	43870	+	NM_014738	73467986	73495415	32
chr17	73494628	73494709	MIR6785	81	+	NR_106843	73494709	73494709	1
chr17	73496340	73511664	CASKIN2	15324	-	NM_020753	73497160	73509885	20
chr17	73512608	73520820	TSEN54	8212	+	NM_207346	73512641	73520493	11
chr17	73521782	73571290	LLGL2	49508	+	NM_001031803	73539507	73570959	26
chr17	73584138	73622927	MYO15B	38789	+	NM_001309242	73584138	73622564	63
chr17	73622924	73663269	RECQL5	40345	-	NM_004259	73623501	73662637	20
chr17	73629513	73637486	SMIM5	7973	+	NM_001162995	73636281	73636977	3
chr17	73642645	73644057	SMIM6	1412	+	NM_001162997	73643456	73643645	2
chr17	73663195	73704142	SAP30BP	40947	+	NM_001301855	73663452	73702601	12
chr17	73717515	73753899	ITGB4	36384	+	NM_000213	73720783	73753636	40
chr17	73754017	73761280	GALK1	7263	-	NM_000154	73754136	73761217	8
chr17	73772514	73776016	H3F3B	3502	-	NM_005324	73774675	73775255	4
chr17	73780601	73780688	MIR4738	87	-	NR_039892	73780688	73780688	1
chr17	73780919	73821886	UNK	40967	+	NM_001080419	73780961	73820498	16
chr17	73823307	73840798	UNC13D	17491	-	NM_199242	73824045	73840418	32
chr17	73841779	73851501	WBP2	9722	-	NM_012478	73842814	73851378	8
chr17	73870244	73874656	TRIM47	4412	-	NM_033452	73870563	73874629	6
chr17	73885040	73893084	TRIM65	8044	-	NM_173547	73886859	73893018	6
chr17	73894723	73901181	MRPL38	6458	-	NM_032478	73894930	73900956	9
chr17	73906617	73937119	FBF1	30502	-	NM_001080542	73906803	73934230	29
chr17	73937588	73975515	ACOX1	37927	-	NM_004035	73942828	73975154	14
chr17	73975297	73996667	TEN1	21370	+	NM_001113324	73982273	73996343	4
chr17	73975297	74002080	TEN1-CDK3	26783	+	NR_037709	74002080	74002080	10
chr17	73996986	74002080	CDK3	5094	+	NM_001258	73997506	74001504	8
chr17	73997239	73997409	MIR4538	170	+	NR_130467	73997409	73997409	3
chr17	74002926	74023507	EVPL	20581	-	NM_001988	74003183	74023279	22
chr17	74034855	74068607	SRP68	33752	-	NM_014230	74035786	74068572	16
chr17	74070881	74073622	GALR2	2741	+	NM_003857	74070964	74073512	2
chr17	74075262	74078885	ZACN	3623	+	NM_180990	74075345	74078734	9
chr17	74077073	74099868	EXOC7	22795	-	NM_001145299	74079728	74099773	20
chr17	74094099	74094157	MIR6868	58	-	NR_106928	74094157	74094157	1
chr17	74132414	74137380	FOXJ1	4966	-	NM_001454	74133433	74136476	3
chr17	74136636	74150729	RNF157-AS1	14093	+	NR_040017	74150729	74150729	8
chr17	74138533	74236390	RNF157	97857	-	NM_052916	74141315	74236321	19
chr17	74261285	74267379	UBALD2	6094	+	NM_182565	74261586	74266586	3
chr17	74270129	74303761	QRICH2	33632	-	NM_032134	74270316	74303581	19
chr17	74306867	74350230	PRPSAP1	43363	-	NM_002766	74307622	74349784	10
chr17	74380689	74383941	SPHK1	3252	+	NM_001142601	74381725	74383667	6
chr17	74385612	74449288	UBE2O	63676	-	NM_022066	74387023	74449223	18
chr17	74449432	74466199	AANAT	16767	+	NM_001166579	74462254	74466052	7
chr17	74466974	74497509	RHBDF2	30535	-	NM_024599	74467714	74477606	19
chr17	74523429	74533987	CYGB	10558	-	NM_134268	74524659	74533624	4
chr17	74523667	74541458	PRCD	17791	+	NR_033357	74541458	74541458	5
chr17	74553845	74561430	SNHG16	7585	+	NR_038109	74561430	74561430	4
chr17	74554873	74554951	SNORD1C	78	+	NR_004397	74554951	74554951	1
chr17	74557189	74557275	SNORD1B	86	+	NR_004396	74557275	74557275	1
chr17	74557714	74557788	SNORD1A	74	+	NR_004395	74557788	74557788	1
chr17	74561460	74582145	ST6GALNAC2	20685	-	NM_006456	74562185	74581890	9
chr17	74620837	74639920	ST6GALNAC1	19083	-	NM_001289107	74621411	74625528	10
chr17	74668009	74669740	LOC105274304	1731	+	NR_130916	74669740	74669740	1
chr17	74669731	74707087	MXRA7	37356	-	NM_001008528	74673669	74707028	4
chr17	74708913	74722881	JMJD6	13968	-	NM_001081461	74712767	74722557	7
chr17	74722911	74729963	METTL23	7052	+	NM_001302703	74725792	74729768	6
chr17	74730196	74733493	SRSF2	3297	-	NR_036608	74733493	74733493	4
chr17	74732531	74732630	MIR636	99	-	NR_030366	74732630	74732630	1
chr17	74732646	74775336	MFSD11	42690	+	NM_001242534	74734434	74774434	14
chr17	74795125	74803184	LOC101928514	8059	+	NR_110837	74803184	74803184	3
chr17	74864797	74946471	MGAT5B	81674	+	NM_144677	74865111	74944920	17
chr17	75084724	75091068	SNHG20	6344	+	NR_027058	75091068	75091068	3
chr17	75084724	75213181	SEC14L1	128457	+	NM_001204408	75139678	75212646	20
chr17	75085388	75085575	SCARNA16	187	+	NR_003013	75085575	75085575	1
chr17	75085498	75085579	MIR6516	81	+	NR_106997	75085579	75085579	1
chr17	75277491	75496678	SEPT9	219187	+	NM_001113491	75277617	75494740	12
chr17	75393065	75393136	MIR4316	71	-	NR_036200	75393136	75393136	1
chr17	75543022	75561103	LOC100507351	18081	+	NR_040050	75561103	75561103	2
chr17	75718953	75724641	LOC100132174	5688	-	NR_104134	75724641	75724641	2
chr17	75875082	75880169	FLJ45079	5087	-	NR_028337	75880169	75880169	2
chr17	76000317	76104916	TNRC6C	104599	+	NM_001142640	76045143	76100926	22
chr17	76103482	76107880	TNRC6C-AS1	4398	-	NR_040071	76107880	76107880	2
chr17	76108998	76128488	TMC6	19490	-	NM_007267	76109228	76122913	20
chr17	76126858	76139049	TMC8	12191	+	NM_152468	76127669	76137193	16
chr17	76142433	76162364	C17orf99	19931	+	NM_001163075	76142488	76162127	5
chr17	76164670	76169009	SYNGR2	4339	+	NM_004710	76164697	76168017	4
chr17	76170159	76183285	TK1	13126	-	NM_003258	76170839	76183075	7
chr17	76183397	76203782	AFMID	20385	+	NM_001010982	76183451	76203018	11
chr17	76210276	76221716	BIRC5	11440	+	NM_001012271	76210397	76219635	5
chr17	76227390	76237068	TMEM235	9678	+	NM_001204210	76228104	76235873	6
chr17	76257429	76274573	LOC100996291	17144	-	NR_073178	76274573	76274573	7
chr17	76352857	76356160	SOCS3	3303	-	NM_003955	76354498	76355176	2
chr17	76356528	76369990	LOC101928674	13462	+	NR_110847	76369990	76369990	5
chr17	76374698	76420740	PGS1	46042	+	NM_024419	76374746	76415746	10
chr17	76419777	76573476	DNAH17	153699	-	NM_173628	76419986	76571139	81
chr17	76480991	76499138	DNAH17-AS1	18147	+	NR_102401	76499138	76499138	6
chr17	76613465	76628139	LOC101928710	14674	-	NR_110849	76628139	76628139	5
chr17	76670128	76778424	CYTH1	108296	-	NM_017456	76672172	76778305	13
chr17	76792964	76836969	USP36	44005	-	NM_025090	76794501	76832445	20
chr17	76849058	76921472	TIMP2	72414	-	NM_003255	76851748	76921170	5
chr17	76886661	76899299	CEP295NL	12638	-	NM_001243541	76886719	76888411	3
chr17	76967334	76976061	LGALS3BP	8727	-	NM_005567	76967657	76973273	6
chr17	76987797	77005899	CANT1	18102	-	NM_001159772	76989631	76993704	6
chr17	77015290	77023737	C1QTNF1-AS1	8447	-	NR_040018	77023737	77023737	3
chr17	77019015	77045870	C1QTNF1	26855	+	NM_153372	77040050	77044170	4
chr17	77071018	77084685	ENGASE	13667	+	NM_001042573	77071026	77082431	14
chr17	77085426	77512230	RBFOX3	426804	-	NM_001082575	77086964	77111797	15
chr17	77680984	77681058	MIR4739	74	-	NR_039893	77681058	77681058	1
chr17	77681074	77686081	HP09025	5007	+	NR_109783	77686081	77686081	2
chr17	77704864	77716021	ENPP7	11157	+	NM_178543	77704901	77711845	6
chr17	77751976	77761449	CBX2	9473	+	NM_005189	77752034	77758841	5
chr17	77768175	77770915	CBX8	2740	-	NM_020649	77768433	77770797	5
chr17	77806954	77813213	CBX4	6259	-	NM_003655	77807757	77813050	5
chr17	77889050	77900524	LOC101928766	11474	-	NR_110850	77900524	77900524	6
chr17	77893155	77897803	LOC101928738	4648	+	NR_110851	77897803	77897803	2
chr17	77906141	78009657	TBC1D16	103516	-	NM_019020	77914657	77987346	12
chr17	78010430	78074412	CCDC40	63982	+	NM_017950	78010461	78073574	20
chr17	78075354	78093679	GAA	18325	+	NM_001079803	78078385	78093130	21
chr17	78109012	78120982	EIF4A3	11970	-	NM_014740	78109288	78120760	12
chr17	78143790	78183130	CARD14	39340	+	NR_047566	78183130	78183130	22
chr17	78183078	78194199	SGSH	11121	-	NM_000199	78184250	78194112	8
chr17	78194199	78227308	SLC26A11	33109	+	NM_001166347	78195359	78226515	18
chr17	78234659	78372581	RNF213	137922	+	NM_001256071	78237480	78367298	68
chr17	78325630	78388968	LOC100294362	63338	-	NR_029376	78388968	78388968	2
chr17	78388966	78411884	ENDOV	22918	+	NM_173627	78388994	78409943	10
chr17	78393217	78393293	MIR4730	76	+	NR_039883	78393293	78393293	1
chr17	78440632	78450404	NPTX1	9772	-	NM_002522	78444612	78450246	5
chr17	78518624	78940173	RPTOR	421549	+	NM_020761	78519429	78938130	34
chr17	78775439	78779432	LOC101928855	3993	-	NR_110852	78779432	78779432	4
chr17	78965640	78973933	CHMP6	8293	+	NM_024591	78965718	78972953	8
chr17	79002932	79008519	BAIAP2-AS1	5587	-	NR_026857	79008519	79008519	2
chr17	79008946	79091232	BAIAP2	82286	+	NM_017451	79009054	79090105	15
chr17	79091095	79139872	AATK	48777	-	NM_001080395	79092201	79139792	14
chr17	79099075	79099173	MIR657	98	-	NR_030394	79099173	79099173	1
chr17	79099676	79099755	MIR3065	79	+	NR_036151	79099755	79099755	1
chr17	79099682	79099749	MIR338	67	-	NR_029897	79099749	79099749	1
chr17	79106995	79107108	MIR1250	113	-	NR_031652	79107108	79107108	1
chr17	79139306	79156964	AATK-AS1	17658	+	NR_027255	79156964	79156964	6
chr17	79163392	79196751	CEP131	33359	-	NM_014984	79163568	79193856	26
chr17	79202076	79212891	ENTHD2	10815	-	NM_144679	79202727	79212833	12
chr17	79213110	79215098	C17orf89	1988	+	NM_001086521	79213163	79214816	3
chr17	79218610	79269139	SLC38A10	50529	-	NM_001037984	79219355	79268721	16
chr17	79276623	79283048	LINC00482	6425	-	NR_038080	79283048	79283048	4
chr17	79285071	79304474	TMEM105	19403	-	NM_178520	79287450	79288262	3
chr17	79349698	79359160	LOC100130370	9462	-	NM_001272086	79349891	79358931	4
chr17	79373520	79433358	BAHCC1	59838	+	NM_001291324	79373539	79430843	28
chr17	79374515	79374578	MIR4740	63	-	NR_039894	79374578	79374578	1
chr17	79418129	79418214	MIR3186	85	-	NR_036152	79418214	79418214	1
chr17	79476996	79479892	ACTG1	2896	-	NR_037688	79479892	79479892	7
chr17	79495416	79504156	FSCN2	8740	+	NM_001077182	79495557	79504106	5
chr17	79506910	79519429	FAAP100	12519	-	NM_025161	79507844	79519356	9
chr17	79523910	79604179	NPLOC4	80269	-	NM_017921	79526284	79603956	17
chr17	79604196	79615785	TSPAN10	11589	+	NM_001290212	79604424	79615324	4
chr17	79617488	79623607	PDE6G	6119	-	NM_002602	79618103	79620335	4
chr17	79632065	79633667	OXLD1	1602	-	NM_001039842	79632230	79633607	2
chr17	79633760	79640936	CCDC137	7176	+	NM_199287	79633796	79639734	6
chr17	79648223	79650954	ARL16	2731	-	NM_001040025	79648737	79650855	5
chr17	79650961	79669151	HGS	18190	+	NM_004712	79651096	79668648	22
chr17	79660786	79660899	MIR6786	113	+	NR_106844	79660899	79660899	1
chr17	79670399	79674556	MRPL12	4157	+	NM_002949	79670531	79674270	5
chr17	79679265	79688046	SLC25A10	8781	+	NM_001270953	79679456	79687547	11
chr17	79762007	79771889	GCGR	9882	+	NM_000160	79766894	79771565	14
chr17	79780236	79791170	FAM195B	10934	-	NM_001288798	79781122	79784270	7
chr17	79791367	79792926	PPP1R27	1559	-	NM_001007533	79791604	79792829	3
chr17	79801033	79818544	P4HB	17511	-	NM_000918	79801887	79818347	11
chr17	79825594	79829282	ARHGDIA	3688	-	NM_001301240	79826254	79827806	7
chr17	79845710	79849462	ALYREF	3752	-	NM_005782	79846006	79849456	6
chr17	79848665	79858409	ANAPC11	9744	+	NM_001289414	79852353	79857941	4
chr17	79859984	79860781	NPB	797	+	NM_148896	79860153	79860624	2
chr17	79860776	79869353	PCYT2	8577	-	NM_001184917	79862708	79869231	14
chr17	79869814	79876058	SIRT7	6244	-	NM_016538	79870291	79876007	10
chr17	79876144	79885587	MAFG	9443	-	NM_002359	79880480	79881061	3
chr17	79885704	79888629	MAFG-AS1	2925	+	NR_015454	79888629	79888629	2
chr17	79890261	79895204	PYCR1	4943	-	NM_001282280	79891089	79894690	8
chr17	79897520	79905109	MYADML2	7589	-	NM_001145113	79898693	79899617	3
chr17	79910382	79919057	NOTUM	8675	-	NM_178493	79910836	79918785	11
chr17	79935425	79975282	ASPSCR1	39857	+	NM_001251888	79935522	79975198	17
chr17	79976578	79980785	STRA13	4207	-	NM_001271006	79977080	79980737	5
chr17	79981177	79989027	LRRC45	7850	+	NM_144999	79981519	79988681	17
chr17	79989531	79992080	RAC3	2549	+	NM_005052	79989637	79991705	6
chr17	79993756	79995573	DCXR	1817	-	NM_001195218	79993835	79995558	8
chr17	80005777	80009650	RFNG	3873	-	NM_002917	80006601	80009642	8
chr17	80009762	80015346	GPS1	5584	+	NM_004127	80009807	80015003	13
chr17	80015747	80023697	DUS1L	7950	-	NM_022156	80015990	80022935	14
chr17	80036213	80056106	FASN	19893	-	NM_004104	80037018	80054321	43
chr17	80047835	80048016	SNORD134	181	-	NR_132755	80048016	80048016	1
chr17	80059345	80170689	CCDC57	111344	-	NM_198082	80059557	80159820	17
chr17	80186281	80197375	SLC16A3	11094	+	NM_001042422	80193884	80196852	5
chr17	80194543	80194604	MIR6787	61	+	NR_106845	80194604	80194604	1
chr17	80200536	80231618	CSNK1D	31082	-	NR_110578	80231618	80231618	9
chr17	80272745	80275480	CD7	2735	-	NM_006137	80273196	80275371	4
chr17	80278899	80291921	SECTM1	13022	-	NM_003004	80280036	80285116	5
chr17	80317122	80321652	TEX19	4530	+	NM_207459	80320026	80320521	2
chr17	80332152	80333462	UTS2R	1310	+	NM_018949	80332200	80333370	1
chr17	80347085	80376513	OGFOD3	29428	-	NR_033265	80376513	80376513	10
chr17	80376251	80400516	HEXDC	24265	+	NM_173620	80377675	80400468	12
chr17	80400462	80408707	C17orf62	8245	-	NM_001100407	80401879	80407130	8
chr17	80416059	80446143	NARF	30084	+	NM_001038618	80422231	80446033	11
chr17	80477593	80562483	FOXK2	84890	+	NM_004514	80477764	80559375	9
chr17	80572437	80606411	WDR45B	33974	-	NM_019613	80573794	80606216	10
chr17	80614942	80656598	RAB40B	41656	-	NM_006822	80615738	80656472	6
chr17	80626108	80626183	MIR4525	75	-	NR_039751	80626183	80626183	1
chr17	80674581	80685893	FN3KRP	11312	+	NR_046408	80685893	80685893	7
chr17	80693451	80709073	FN3K	15622	+	NM_022158	80693512	80708631	6
chr17	80709939	80901062	TBCD	191123	+	NM_005993	80710069	80900339	39
chr17	80787309	80797931	ZNF750	10622	-	NM_024702	80788017	80790330	3
chr17	80901666	81009686	B3GNTL1	108020	-	NM_001009905	80904778	81009672	13
chr17	81037566	81052871	METRNL	15305	+	NM_001004431	81037691	81052320	4
chr17	81174665	81188573	RPL23AP87	13908	+	NR_029406	81188573	81188573	4
chr17_ctg5_hap1	128327	183214	PLEKHM1	54887	-	NM_014798	130285	174918	12
chr17_ctg5_hap1	197705	240669	LRRC37A2	42964	-	NM_001006607	197773	240666	14
chr17_ctg5_hap1	197720	424115	LRRC37A4P	226395	-	NR_002940	424115	424115	8
chr17_ctg5_hap1	330260	380553	NSFP1	50293	-	NR_033799	380553	380553	7
chr17_ctg5_hap1	391611	454187	ARL17B	62576	+	NM_001103154	394982	454187	4
chr17_ctg5_hap1	415626	458604	LRRC37A	42978	-	NM_014834	415694	458601	14
chr17_ctg5_hap1	563497	760700	KANSL1	197203	+	NM_001193465	616833	759135	16
chr17_ctg5_hap1	954314	1005883	CRHR1	51569	-	NM_001145146	955379	1005618	14
chr17_ctg5_hap1	954314	1170468	MGC57346-CRHR1	216154	-	NM_001256299	955379	959996	15
chr17_ctg5_hap1	1151951	1170468	MGC57346	18517	-	NR_026680	1170468	1170468	4
chr17_gl000205_random	116622	119732	MGC70870	3110	+	NR_003682	119732	119732	1
chr18	12074	15930	LOC102723376	3856	+	NR_110795	15930	15930	3
chr18	109064	122222	ROCK1P1	13158	+	NR_033770	122222	122222	5
chr18	112255	112339	MIR8078	84	-	NR_107045	112339	112339	1
chr18	158482	213739	USP14	55257	+	NM_005151	158698	211284	16
chr18	214519	268059	THOC1	53540	-	NM_005131	214625	268019	21
chr18	319354	500729	COLEC12	181375	-	NM_130386	320044	500514	10
chr18	580342	582020	CETN1	1678	+	NM_004066	580408	580927	1
chr18	596997	650293	CLUL1	53296	+	NM_001289036	607079	649901	11
chr18	649619	658340	TYMSOS	8721	-	NM_001012716	657875	658247	2
chr18	657603	673499	TYMS	15896	+	NM_001071	657742	672997	7
chr18	670323	712662	ENOSF1	42339	-	NM_001126123	674304	706532	16
chr18	721591	812327	YES1	90736	-	NM_005433	724423	756827	12
chr18	904943	912173	ADCYAP1	7230	+	NM_001099733	905387	909636	5
chr18	1268311	1359630	LINC00470	91319	-	NR_023925	1359630	1359630	7
chr18	2537523	2571502	METTL4	33979	-	NM_022840	2538998	2567215	9
chr18	2571509	2616634	NDC80	45125	+	NM_006101	2572984	2616573	17
chr18	2652168	2655394	CBX3P2	3226	-	NR_033754	2655394	2655394	2
chr18	2655885	2805015	SMCHD1	149130	+	NM_015295	2656074	2802550	48
chr18	2847027	2914090	EMILIN2	67063	+	NM_032048	2847186	2913402	8
chr18	2916991	3011945	LPIN2	94954	-	NM_014646	2920290	2960838	20
chr18	2943212	2946621	LOC727896	3409	-	NR_026659	2946621	2946621	1
chr18	3066804	3220106	MYOM1	153302	-	NM_003803	3067259	3215221	38
chr18	3247479	3256235	MYL12A	8756	+	NM_001303048	3253245	3255916	4
chr18	3255433	3262357	LOC104968399	6924	-	NR_130145	3262357	3262357	4
chr18	3262110	3278282	MYL12B	16172	+	NM_033546	3272896	3277935	4
chr18	3411924	3458406	TGIF1	46482	+	NM_174886	3456395	3457938	4
chr18	3466247	3478976	GAPLINC	12729	+	NR_110429	3478976	3478976	3
chr18	3496029	4455266	DLGAP1	959237	-	NM_004746	3499182	3880068	13
chr18	3594111	3597377	DLGAP1-AS1	3266	+	NR_024101	3597377	3597377	3
chr18	3603734	3610087	DLGAP1-AS2	6353	+	NR_119377	3610087	3610087	3
chr18	3878179	3897069	DLGAP1-AS3	18890	+	NR_038895	3897069	3897069	3
chr18	3885352	3885432	MIR6718	80	+	NR_106776	3885432	3885432	1
chr18	3962352	4013943	DLGAP1-AS4	51591	+	NR_102696	4013943	4013943	5
chr18	4264601	4296000	DLGAP1-AS5	31399	+	NR_036489	4296000	4296000	3
chr18	5143671	5197255	C18orf42	53584	-	NM_001145194	5145560	5197052	2
chr18	5236722	5238028	LINC00526	1306	-	NR_026849	5238028	5238028	1
chr18	5238098	5246505	LINC00667	8407	+	NR_015389	5246505	5246505	3
chr18	5289017	5297052	ZBTB14	8035	-	NM_001243704	5290856	5293245	4
chr18	5392379	5628990	EPB41L3	236611	-	NM_001281535	5394681	5478293	22
chr18	5748817	5795900	MIR3976HG	47083	+	NR_038839	5795900	5795900	5
chr18	5840693	5840832	MIR3976	139	+	NR_039772	5840832	5840832	1
chr18	5890183	5892103	TMEM200C	1920	-	NM_001080209	5890196	5892062	1
chr18	5954704	6414910	L3MBTL4	460206	-	NM_173464	5956218	6311624	20
chr18	6256742	6260933	L3MBTL4-AS1	4191	+	NR_110765	6260933	6260933	3
chr18	6374359	6374424	MIR4317	65	-	NR_036205	6374424	6374424	1
chr18	6511414	6590652	LINC01387	79238	+	NR_120518	6590652	6590652	6
chr18	6834431	6915712	ARHGAP28	81281	+	NM_001010000	6837347	6912153	17
chr18	6925472	6929868	LINC00668	4396	-	NR_034100	6929868	6929868	7
chr18	6941742	7117813	LAMA1	176071	-	NM_005559	6942077	7117719	63
chr18	6954675	6957417	LOC101927188	2742	+	NR_126040	6957417	6957417	2
chr18	7231136	7232042	LRRC30	906	+	NM_001105581	7231136	7232042	1
chr18	7567313	8406859	PTPRM	839546	+	NM_001105244	7567816	8406160	33
chr18	8360817	8367032	LOC100192426	6215	-	NR_024419	8367032	8367032	4
chr18	8609442	8639380	RAB12	29938	+	NM_001025300	8609725	8638260	6
chr18	8695853	8707619	GACAT2	11766	-	NR_120598	8707619	8707619	2
chr18	8717368	8832775	MTCL1	115407	+	NM_015210	8718448	8828944	17
chr18	9102627	9134343	NDUFV2	31716	+	NM_021074	9102741	9134277	8
chr18	9121262	9136718	NDUFV2-AS1	15456	-	NR_110771	9136718	9136718	4
chr18	9136750	9285983	ANKRD12	149233	+	NM_015208	9182430	9281124	13
chr18	9334764	9402418	TWSG1	67654	+	NM_020648	9337227	9399525	5
chr18	9475529	9538106	RALBP1	62577	+	NM_006788	9513043	9535935	10
chr18	9546788	9614605	PPP4R1	67817	-	NR_052003	9614605	9614605	20
chr18	9614804	9619361	PPP4R1-AS1	4557	+	NR_110773	9619361	9619361	3
chr18	9708227	9862553	RAB31	154326	+	NM_006868	9708402	9859322	7
chr18	9885722	9888156	TXNDC2	2434	+	NM_001098529	9886171	9888138	2
chr18	9913954	9960018	VAPA	46064	+	NM_003574	9914253	9954208	7
chr18	10405129	10414367	LINC01254	9238	-	NR_110775	10414367	10414367	3
chr18	10454624	10488698	APCDD1	34074	+	NM_153000	10454978	10488035	5
chr18	10525872	10552766	NAPG	26894	+	NM_003826	10526099	10550217	12
chr18	10661929	10666884	LOC101927410	4955	+	NR_110777	10666884	10666884	3
chr18	10670243	11148761	PIEZO2	478518	-	NM_022068	10671523	11148587	52
chr18	10759581	10759647	MIR6788	66	-	NR_106846	10759647	10759647	1
chr18	11488568	11506982	LINC01255	18414	+	NR_110779	11506982	11506982	4
chr18	11609556	11610611	SLC35G4	1055	+	NM_001282300	11609594	11610611	1
chr18	11654883	11654940	MIR7153	57	-	NR_106975	11654940	11654940	1
chr18	11689013	11885683	GNAL	196670	+	NM_182978	11689562	11881134	12
chr18	11851388	11854448	CHMP1B	3060	+	NM_020412	11851510	11852110	1
chr18	11883471	11908796	MPPE1	25325	-	NR_040242	11908796	11908796	13
chr18	11981426	12030885	IMPA2	49459	+	NM_014214	11981668	12030457	8
chr18	12093847	12129748	ANKRD62	35901	+	NM_001277333	12094016	12127938	14
chr18	12200777	12224709	C18orf61	23932	+	NR_049896	12224709	12224709	5
chr18	12254317	12277594	CIDEA	23277	+	NM_001279	12254382	12277269	5
chr18	12308057	12329824	TUBB6	21767	+	NM_001303525	12308291	12329182	4
chr18	12328942	12377275	AFG3L2	48333	-	NM_006796	12329563	12377081	17
chr18	12407894	12432236	PRELID3A	24342	+	NM_001142405	12407974	12429402	7
chr18	12446510	12657912	SPIRE1	211402	-	NM_001128626	12449636	12657865	17
chr18	12658737	12725739	PSMG2	67002	+	NM_147163	12706584	12725530	7
chr18	12661954	12702776	CEP76	40822	-	NR_073537	12702776	12702776	13
chr18	12739484	12749421	LOC100996324	9937	-	NR_110763	12749421	12749421	2
chr18	12785476	12884334	PTPN2	98858	-	NM_001207013	12785821	12884140	11
chr18	12947982	12987536	SEH1L	39554	+	NM_001013437	12948120	12987056	9
chr18	12991360	13125051	CEP192	133691	+	NM_032142	12999423	13124769	45
chr18	13218728	13652753	LDLRAD4	434025	+	NM_181482	13387721	13645656	6
chr18	13419497	13427533	LDLRAD4-AS1	8036	-	NR_040031	13427533	13427533	4
chr18	13459945	13460025	MIR5190	80	+	NR_049822	13460025	13460025	1
chr18	13611112	13611199	MIR4526	87	+	NR_039752	13611199	13611199	1
chr18	13663345	13726591	FAM210A	63246	-	NM_001098801	13666478	13682076	5
chr18	13726658	13764555	RNMT	37897	+	NM_001308263	13731516	13762159	12
chr18	13825542	13826861	MC5R	1319	+	NM_005913	13825764	13826742	1
chr18	13882042	13915706	MC2R	33664	-	NM_001291911	13884623	13885517	2
chr18	14075988	14132489	ZNF519	56501	-	NR_033354	14132489	14132489	6
chr18	14179095	14227049	ANKRD20A5P	47954	+	NR_040113	14227049	14227049	16
chr18	14337421	14342523	CYP4F35P	5102	+	NR_026756	14342523	14342523	4
chr18	14477953	14498705	CXADRP3	20752	-	NR_024076	14498705	14498705	3
chr18	14511736	14543599	POTEC	31863	-	NM_001137671	14511896	14543145	11
chr18	14748238	14852737	ANKRD30B	104499	+	NM_001145029	14748418	14852479	36
chr18	14830164	14830241	MIR3156-2	77	+	NR_036153	14830241	14830241	1
chr18	14946265	14973755	LINC01443	27490	+	NR_104164	14973755	14973755	4
chr18	14969605	14970467	LINC01444	862	-	NR_110783	14970467	14970467	2
chr18	15313554	15325918	LOC644669	12364	-	NR_027417	15325918	15325918	6
chr18	18529702	18691812	ROCK1	162110	-	NM_005406	18531344	18690871	33
chr18	18822202	19102791	GREB1L	280589	+	NM_001142966	18963479	19102782	33
chr18	19109261	19180693	ESCO1	71432	-	NM_052911	19110303	19154804	12
chr18	19192229	19210206	SNRPD1	17977	+	NM_001291916	19192390	19209099	4
chr18	19230857	19284766	ABHD3	53909	-	NM_138340	19231551	19284626	9
chr18	19263470	19263558	MIR320C1	88	+	NR_031565	19263558	19263558	1
chr18	19321289	19450918	MIB1	129629	+	NM_020774	19321544	19444627	21
chr18	19405439	19411367	MIR133A1HG	5928	-	NR_110369	19411367	19411367	3
chr18	19405658	19405746	MIR133A1	88	-	NR_029675	19405746	19405746	1
chr18	19408964	19409049	MIR1-2	85	-	NR_029662	19409049	19409049	1
chr18	19746858	19748929	GATA6-AS1	2071	-	NR_102763	19748929	19748929	2
chr18	19749397	19782491	GATA6	33094	+	NM_005257	19751105	19780786	7
chr18	19993563	19997878	CTAGE1	4315	-	NM_172241	19995536	19997774	1
chr18	20303453	20366800	LOC101927571	63347	-	NR_110782	20366800	20366800	2
chr18	20513294	20606449	RBBP8	93155	+	NM_002894	20516814	20606203	19
chr18	20513311	20513401	MIR4741	90	+	NR_039895	20513401	20513401	1
chr18	20714527	20840434	CABLES1	125907	+	NM_001256438	20774475	20837331	10
chr18	20875978	21017925	TMEM241	141947	-	NM_032933	20877970	21017816	15
chr18	21032786	21063099	RIOK3	30313	+	NM_003831	21033403	21061243	13
chr18	21083433	21111771	C18orf8	28338	+	NM_013326	21083582	21111668	20
chr18	21111462	21166581	NPC1	55119	-	NM_000271	21112165	21166307	25
chr18	21178889	21242849	ANKRD29	63960	-	NM_173505	21181189	21242694	10
chr18	21269406	21535029	LAMA3	265623	+	NM_198129	21269647	21534612	75
chr18	21572736	21715574	TTC39C	142838	+	NM_153211	21644119	21712538	14
chr18	21574178	21595424	TTC39C-AS1	21246	-	NR_110796	21595424	21595424	6
chr18	21718919	21741564	CABYR	22645	+	NM_012189	21723078	21736947	6
chr18	21742010	21977833	OSBPL1A	235823	-	NM_080597	21743142	21957497	28
chr18	21901649	21901699	MIR320C2	50	+	NR_031724	21901699	21901699	1
chr18	22006608	22033494	IMPACT	26886	+	NM_018439	22006720	22030811	11
chr18	22040592	22059921	HRH4	19329	+	NM_021624	22040692	22057526	3
chr18	22208145	22242162	LOC729950	34017	+	NR_040033	22242162	22242162	3
chr18	22641887	22932214	ZNF521	290327	-	NM_015461	22642675	22930910	8
chr18	23596216	23671181	SS18	74965	-	NM_001308201	23598317	23667541	11
chr18	23713810	23773319	PSMA8	59509	+	NM_001308188	23720049	23772375	8
chr18	23806846	23971649	TAF4B	164803	+	NR_121653	23971649	23971649	16
chr18	24002958	24018008	LINC01543	15050	+	NR_110762	24018008	24018008	4
chr18	24034873	24237365	KCTD1	202492	-	NM_001258222	24035706	24237332	5
chr18	24171430	24171499	MIR8057	69	-	NR_107024	24171499	24171499	1
chr18	24267584	24283602	PCAT18	16018	-	NR_024259	24283602	24283602	2
chr18	24432001	24445808	AQP4	13807	-	NM_001317384	24436087	24445653	5
chr18	24445271	24515910	AQP4-AS1	70639	+	NR_026908	24515910	24515910	8
chr18	24495594	24765302	CHST9	269708	-	NM_031422	24496222	24722773	6
chr18	25530926	25757410	CDH2	226484	-	NM_001792	25532116	25756986	16
chr18	27878875	27878926	MIR302F	51	+	NR_031684	27878926	27878926	1
chr18	28569330	28622781	DSC3	53451	-	NM_024423	28574435	28622626	17
chr18	28645939	28682395	DSC2	36456	-	NM_004949	28648274	28681934	17
chr18	28681550	28742752	DSCAS	61202	+	NR_110785	28742752	28742752	4
chr18	28709213	28742819	DSC1	33606	-	NM_004948	28710765	28742557	17
chr18	28898051	28939209	DSG1	41158	+	NM_001942	28898263	28935309	15
chr18	28923330	29006951	DSG1-AS1	83621	-	NR_110788	29006951	29006951	4
chr18	28956739	28993880	DSG4	37141	+	NM_177986	28956874	28993558	16
chr18	29027731	29058665	DSG3	30934	+	NM_001944	29027840	29056223	16
chr18	29078026	29128814	DSG2	50788	+	NM_001943	29078214	29126706	15
chr18	29122108	29136874	DSG2-AS1	14766	-	NR_045216	29136874	29136874	6
chr18	29171729	29178986	TTR	7257	+	NM_000371	29171865	29178638	4
chr18	29202208	29264686	B4GALT6	62478	-	NM_004775	29205576	29264389	9
chr18	29339658	29340843	SLC25A52	1185	-	NM_001034172	29339730	29340654	1
chr18	29409135	29523091	TRAPPC8	113956	-	NM_014939	29410717	29522727	29
chr18	29598444	29653154	RNF125	54710	+	NM_017831	29598826	29648347	6
chr18	29671817	29711524	RNF138	39707	+	NM_016271	29672739	29709150	8
chr18	29769986	29800366	MEP1B	30380	+	NM_005925	29770033	29800208	15
chr18	29843483	30050447	GAREM1	206964	-	NM_001242409	29847833	30050391	6
chr18	30091625	30094597	WBP11P1	2972	+	NR_003558	30094597	30094597	1
chr18	30252635	30352974	KLHL14	100339	-	NM_020805	30254619	30350554	9
chr18	30517365	31020685	CCDC178	503320	-	NM_198995	30517974	30992052	22
chr18	31158540	31327399	ASXL3	168859	+	NM_030632	31158595	31326559	12
chr18	31431063	31803515	NOL4	372452	-	NM_003787	31432805	31803217	11
chr18	32073253	32471808	DTNA	398555	+	NM_032975	32335940	32464709	22
chr18	32556891	32723432	MAPRE2	166541	+	NM_001143826	32650165	32720333	8
chr18	32820993	32838397	ZNF397	17404	+	NM_032347	32822434	32837902	6
chr18	32831021	32870209	ZSCAN30	39188	-	NM_001166012	32833413	32844316	5
chr18	32870235	32890730	ZNF271P	20495	+	NR_024565	32890730	32890730	3
chr18	32912171	32924431	ZNF24	12260	-	NM_006965	32917195	32920614	4
chr18	32946660	32957301	ZNF396	10641	-	NM_145756	32948314	32954256	5
chr18	33048290	33077955	INO80C	29665	-	NM_001098817	33048574	33077838	7
chr18	33171700	33171770	MIR3975	70	+	NR_039771	33171770	33171770	1
chr18	33234532	33291798	GALNT1	57266	+	NM_020474	33234626	33289734	11
chr18	33484780	33484889	MIR187	109	-	NR_029616	33484889	33484889	1
chr18	33514050	33514105	MIR3929	55	-	NR_037497	33514105	33514105	1
chr18	33552587	33559250	C18orf21	6663	+	NM_031446	33552691	33558969	5
chr18	33569786	33647557	RPRD1A	77771	-	NM_001303412	33573113	33620812	9
chr18	33688493	33709357	SLC39A6	20864	-	NM_012319	33689555	33706970	10
chr18	33709836	33754688	ELP2	44852	+	NM_001242875	33709896	33754604	23
chr18	33767479	33848685	MOCOS	81206	+	NM_017947	33767502	33848648	15
chr18	33877658	34360183	FHOD3	482525	+	NM_001281740	33877798	34359493	29
chr18	34240351	34243381	LOC105372071	3030	-	NR_132982	34243381	34243381	3
chr18	34359987	34409179	TPGS2	49192	-	NM_001271956	34360109	34408730	7
chr18	34409079	34805288	KIAA1328	396209	+	NM_020776	34409101	34802190	10
chr18	34823007	35146000	CELF4	322993	-	NM_001025088	34833773	35145604	13
chr18	35046301	35046467	SNORA111	166	-	NR_132967	35046467	35046467	1
chr18	35237097	35237178	MIR4318	81	+	NR_036202	35237178	35237178	1
chr18	36786887	37331959	MIR924HG	545072	-	NR_024391	37331959	37331959	4
chr18	37202086	37202139	MIR924	53	-	NR_030628	37202139	37202139	1
chr18	37256682	37256741	MIR5583-2	59	-	NR_049848	37256741	37256741	1
chr18	37256684	37256743	MIR5583-1	59	+	NR_049847	37256743	37256743	1
chr18	37646249	37679197	LINC01477	32948	+	NR_110791	37679197	37679197	4
chr18	39060235	39100561	KC6	40326	-	NR_002838	39100561	39100561	6
chr18	39535162	39661446	PIK3C3	126284	+	NM_002647	39535256	39661101	25
chr18	39766632	40271389	LINC00907	504757	+	NR_046174	40271389	40271389	10
chr18	40323182	40695657	RIT2	372475	-	NM_001272077	40500689	40695484	6
chr18	40847856	40857615	SYT4	9759	-	NM_020783	40850305	40857246	4
chr18	41903399	42111662	LINC01478	208263	-	NR_110792	42111662	42111662	5
chr18	42111743	42133868	LOC105667213	22125	+	NR_131768	42133868	42133868	5
chr18	42260862	42648475	SETBP1	387613	+	NM_015559	42281311	42643663	6
chr18	42550046	42550131	MIR4319	85	-	NR_036203	42550131	42550131	1
chr18	42792946	43263060	SLC14A2	470114	+	NM_001242692	43204629	43262484	21
chr18	43018148	43087001	SLC14A2-AS1	68853	-	NR_110899	43087001	43087001	8
chr18	43304087	43332485	SLC14A1	28398	+	NM_001308278	43311143	43329916	9
chr18	43405544	43422521	SIGLEC15	16977	+	NM_213602	43405693	43422152	6
chr18	43427573	43547305	EPG5	119732	-	NM_020964	43432431	43547205	44
chr18	43563501	43652250	PSTPIP2	88749	-	NM_024430	43568675	43652154	15
chr18	43664109	43684199	ATP5A1	20090	-	NM_001001937	43664247	43678197	13
chr18	43684297	43708299	HAUS1	24002	+	NM_138443	43684377	43708091	9
chr18	43753987	43846955	C18orf25	92968	+	NM_145055	43795846	43843081	5
chr18	43914186	44040783	RNF165	126597	+	NM_152470	43914237	44036599	8
chr18	44057216	44236996	LOXHD1	179780	-	NM_144612	44057434	44236996	40
chr18	44259080	44337132	ST8SIA5	78052	-	NM_001307986	44260004	44336471	8
chr18	44390022	44497495	PIAS2	107473	-	NM_004671	44392395	44497308	14
chr18	44526786	44628614	KATNAL2	101828	+	NM_031303	44579344	44627376	15
chr18	44548657	44550534	TCEB3CL2	1877	-	NM_001242907	44548657	44550298	1
chr18	44548657	44550534	TCEB3C	1877	-	NM_145653	44548657	44550298	1
chr18	44554572	44556213	TCEB3CL	1641	-	NM_001100817	44554572	44556213	1
chr18	44558942	44561988	TCEB3B	3046	-	NM_016427	44559373	44561635	1
chr18	44633780	44676871	HDHD2	43091	-	NM_032124	44635052	44662810	7
chr18	44681389	44702745	IER3IP1	21356	-	NM_016097	44682547	44702648	3
chr18	44738459	44775554	SKOR2	37095	-	NM_001278063	44738459	44775554	7
chr18	44906866	44906936	MIR4527	70	+	NR_039753	44906936	44906936	1
chr18	45359465	45457517	SMAD2	98052	-	NM_001003652	45368197	45423127	11
chr18	45553638	45663680	ZBTB7C	110042	-	NM_001039360	45555630	45567478	3
chr18	46065426	46389586	CTIF	324160	+	NM_001142397	46145936	46385930	13
chr18	46196970	46197039	MIR4743	69	+	NR_039897	46197039	46197039	1
chr18	46446222	46477081	SMAD7	30859	-	NM_005904	46447741	46476794	4
chr18	46570171	46987079	DYM	416908	-	NM_017653	46570424	46956764	17
chr18	46576056	46576138	MIR4744	82	-	NR_039898	46576138	46576138	1
chr18	47007547	47013644	C18orf32	6097	-	NM_001035005	47008714	47010118	3
chr18	47007547	47018935	RPL17-C18orf32	11388	-	NM_001199356	47009961	47017264	7
chr18	47013742	47013792	MIR1539	50	+	NR_031720	47013792	47013792	1
chr18	47014850	47018935	RPL17	4085	-	NM_001199340	47014888	47017941	8
chr18	47015604	47015694	SNORD58C	90	-	NR_003701	47015694	47015694	1
chr18	47017652	47017717	SNORD58A	65	-	NR_002571	47017717	47017717	1
chr18	47018033	47018099	SNORD58B	66	-	NR_002572	47018099	47018099	1
chr18	47088400	47119279	LIPG	30879	+	NM_006033	47088678	47116892	10
chr18	47309873	47340251	ACAA2	30378	-	NM_006111	47310216	47339854	10
chr18	47340392	47340813	SCARNA17	421	+	NR_003003	47340813	47340813	1
chr18	47340392	47377429	SNHG22	37037	+	NR_117096	47377429	47377429	4
chr18	47349155	47721451	MYO5B	372296	-	NM_001080467	47352840	47721163	40
chr18	47652868	47652933	MIR4320	65	-	NR_036204	47652933	47652933	1
chr18	47753563	47792892	CFAP53	39329	-	NM_145020	47753750	47792774	8
chr18	47793251	47808144	MBD1	14893	-	NM_001204139	47797870	47806362	17
chr18	47808712	47814692	CXXC1	5980	-	NM_001101654	47808962	47813959	15
chr18	47901391	47920538	SKA1	19147	+	NM_145060	47902200	47918617	7
chr18	48086483	48258196	MAPK4	171713	+	NM_002747	48190328	48256224	6
chr18	48321489	48351754	MRO	30265	-	NM_001127174	48325706	48335770	6
chr18	48405431	48476162	ME2	70731	+	NM_002396	48422190	48473554	16
chr18	48494386	48514490	ELAC1	20104	+	NM_018696	48500774	48513455	4
chr18	48556582	48611411	SMAD4	54829	+	NM_005359	48573416	48604837	12
chr18	48700919	48724051	MEX3C	23132	-	NM_016626	48702720	48723690	2
chr18	48918411	49088839	LOC100287225	170428	+	NR_040074	49088839	49088839	3
chr18	49866541	51062273	DCC	1195732	+	NM_005215	49867157	51057023	29
chr18	50763470	50763560	MIR4528	90	+	NR_130465	50763560	50763560	1
chr18	51094816	51124221	LOC102724651	29405	+	NR_110798	51124221	51124221	6
chr18	51105992	51107429	LOC101928167	1437	-	NR_110800	51107429	51107429	2
chr18	51677970	51751158	MBD2	73188	-	NM_003927	51686146	51750929	7
chr18	51748653	51748782	SNORA37	129	-	NR_002970	51748782	51748782	1
chr18	51795848	51824604	POLI	28756	+	NM_007195	51795916	51820837	10
chr18	51851061	51880943	STARD6	29882	-	NM_139171	51851061	51880943	6
chr18	51884286	51908405	C18orf54	24119	+	NM_001288981	51886942	51904616	9
chr18	52254989	52266724	DYNAP	11735	+	NM_001307955	52255078	52265376	3
chr18	52495707	52562747	RAB27B	67040	+	NM_004163	52544816	52556644	6
chr18	52568739	52626739	CCDC68	58000	-	NM_025214	52571588	52610022	12
chr18	52773134	52791537	LOC101927229	18403	-	NR_110743	52791537	52791537	3
chr18	52889561	53303224	TCF4	413663	-	NM_001243226	52895455	53303128	21
chr18	53119763	53150171	TCF4-AS1	30408	+	NR_132985	53150171	53150171	2
chr18	53146451	53146529	MIR4529	78	+	NR_039754	53146529	53146529	1
chr18	53548918	53587430	LINC01416	38512	-	NR_110755	53587430	53587430	4
chr18	53750586	53804767	LINC01539	54181	-	NR_040025	53804767	53804767	9
chr18	54270052	54305920	TXNL1	35868	-	NR_024546	54305920	54305920	9
chr18	54318615	54697036	WDR7	378421	+	NM_015285	54339746	54694438	28
chr18	54721803	54739350	LINC-ROR	17547	-	NR_048536	54739350	54739350	4
chr18	54814292	54817639	BOD1L2	3347	+	NM_001257964	54814543	54815062	1
chr18	55019720	55036161	ST8SIA3	16441	+	NM_015879	55020077	55027508	4
chr18	55102916	55158530	ONECUT2	55614	+	NM_004852	55102948	55143955	2
chr18	55212072	55253969	FECH	41897	-	NM_000140	55217943	55253852	11
chr18	55267893	55289177	NARS	21284	-	NM_004539	55268883	55288949	14
chr18	55297533	55336508	LOC100505549	38975	+	NM_001242804	55309145	55335407	3
chr18	55313658	55470327	ATP8B1	156669	-	NM_005603	55315719	55399039	28
chr18	55711609	56068772	NEDD4L	357163	+	NM_001144967	55711892	56063501	31
chr18	56118305	56118390	MIR122	85	+	NR_029667	56118390	56118390	1
chr18	56118311	56118384	MIR3591	73	-	NR_039899	56118384	56118384	1
chr18	56148481	56296189	ALPK2	147708	-	NM_052947	56149054	56279029	13
chr18	56267851	56267982	SNORA108	131	+	NR_132963	56267982	56267982	1
chr18	56337240	56339105	LOC101927322	1865	-	NM_001289967	56337842	56338877	2
chr18	56338617	56417371	MALT1	78754	+	NM_006785	56338875	56415074	17
chr18	56530060	56653709	ZNF532	123649	+	NM_018181	56585519	56651698	11
chr18	56702910	56720446	OACYLP	17536	+	NR_024021	56720446	56720446	5
chr18	56807088	56826069	SEC11C	18981	+	NM_033280	56807180	56825917	6
chr18	56887399	56898002	GRP	10603	+	NM_001012513	56887497	56897689	3
chr18	56934266	56940625	RAX	6359	-	NM_013435	56936235	56940438	3
chr18	56962635	56985881	CPLX4	23246	-	NM_181654	56963929	56985694	3
chr18	56995055	57026508	LMAN1	31453	-	NM_005570	56998324	57026476	13
chr18	57098170	57364644	CCBE1	266474	-	NM_133459	57103139	57364574	11
chr18	57567191	57571538	PMAIP1	4347	+	NM_021127	57567409	57569985	2
chr18	58038563	58040001	MC4R	1438	-	NM_005912	58038583	58039582	1
chr18	59157774	59222365	CDH20	64591	+	NM_031891	59157786	59221928	11
chr18	59415408	59421928	LINC01544	6520	+	NR_103449	59421928	59421928	4
chr18	59482303	59560304	RNF152	78001	-	NM_173557	59483084	59483696	2
chr18	59711457	59854289	PIGN	142832	-	NM_176787	59713088	59828586	31
chr18	59854523	59974355	KIAA1468	119832	+	NM_020854	59854738	59972767	29
chr18	59992519	60054943	TNFRSF11A	62424	+	NM_003839	59992585	60052267	10
chr18	60190657	60253976	ZCCHC2	63319	+	NR_126534	60253976	60253976	15
chr18	60382671	60647676	PHLPP1	265005	+	NM_194449	60382916	60646664	17
chr18	60790578	60986613	BCL2	196035	-	NM_000633	60795857	60985899	3
chr18	60994970	61034506	KDSR	39536	-	NM_002035	60999014	61034351	10
chr18	61056424	61089752	VPS4B	33328	-	NM_004869	61058207	61089492	11
chr18	61144143	61172318	SERPINB5	28175	+	NM_002639	61151661	61170955	7
chr18	61223392	61236560	SERPINB12	13168	+	NM_001307928	61223392	61234244	7
chr18	61254533	61266433	SERPINB13	11900	+	NM_001307923	61255901	61264597	8
chr18	61304492	61311553	SERPINB4	7061	-	NM_002974	61304952	61310811	8
chr18	61322430	61329197	SERPINB3	6767	-	NM_006919	61322890	61328450	8
chr18	61369537	61391127	SERPINB11	21590	+	NM_080475	61377427	61390633	9
chr18	61420280	61472610	SERPINB7	52330	+	NM_001040147	61449606	61471869	8
chr18	61554938	61571124	SERPINB2	16186	+	NM_001143818	61558678	61570539	9
chr18	61575223	61603345	SERPINB10	28122	+	NM_005024	61582744	61602476	8
chr18	61616587	61627645	HMSD	11058	+	NM_001123366	61620689	61627589	4
chr18	61637262	61656608	SERPINB8	19346	+	NM_002640	61645542	61654512	7
chr18	61747242	61816260	LINC00305	69018	-	NR_027245	61816260	61816260	4
chr18	61771324	62090827	LOC284294	319503	+	NR_033881	62090827	62090827	10
chr18	61880317	61927290	LINC01538	46973	-	NR_033983	61927290	61927290	3
chr18	63417487	63549202	CDH7	131715	+	NM_033646	63430078	63548130	12
chr18	64168423	64271375	CDH19	102952	-	NR_073130	64271375	64271375	12
chr18	64748820	64748923	MIR5011	103	+	NR_049809	64748923	64748923	1
chr18	65173818	65183967	DSEL	10149	-	NM_032160	65178206	65181875	2
chr18	65183782	65566856	LOC643542	383074	+	NR_033921	65566856	65566856	5
chr18	66340924	66382353	TMX3	41429	-	NM_019022	66344169	66382218	16
chr18	66382490	66722426	CCDC102B	339936	+	NM_001093729	66504000	66721374	10
chr18	67068283	67516322	DOK6	448039	+	NM_152721	67068480	67508619	8
chr18	67530192	67624412	CD226	94220	-	NM_006566	67531549	67614642	7
chr18	67671042	67872962	RTTN	201920	-	NM_173630	67671386	67872894	49
chr18	67956136	67997434	SOCS6	41298	+	NM_004232	67991904	67993512	2
chr18	68002674	68019695	LOC101927481	17021	+	NR_126336	68019695	68019695	4
chr18	68047375	68051827	LOC101060542	4452	-	NR_110764	68051827	68051827	3
chr18	68297754	68318093	GTSCR1	20339	-	NM_001278515	68297795	68317947	3
chr18	69187199	69246192	LINC01541	58993	-	NR_038325	69246192	69246192	7
chr18	69399851	69449462	LOC102724913	49611	-	NR_126324	69449462	69449462	5
chr18	70203914	70211723	CBLN2	7809	-	NM_182511	70205410	70209395	5
chr18	70409548	70534810	NETO1	125262	-	NM_001201465	70416262	70534526	11
chr18	70821292	70931733	LOC400655	110441	-	NR_034133	70931733	70931733	6
chr18	70992175	71017124	LOC100505817	24949	+	NR_038340	71017124	71017124	3
chr18	71740587	71815100	FBXO15	74513	-	NM_001142958	71740695	71815020	10
chr18	71815745	71826204	TIMM21	10459	+	NM_014177	71816043	71825715	6
chr18	71920526	71959251	CYB5A	38725	-	NM_001914	71924079	71959110	6
chr18	71983109	72026422	C18orf63	43313	+	NM_001174123	71985100	72021748	14
chr18	72076682	72080443	LOC101927606	3761	+	NR_131977	72080443	72080443	2
chr18	72102962	72124503	FAM69C	21541	-	NM_001044369	72103735	72124494	4
chr18	72163499	72190689	CNDP2	27190	+	NM_018235	72167208	72187303	12
chr18	72201691	72252261	CNDP1	50570	+	NM_032649	72201902	72251798	12
chr18	72259009	72265071	LINC00909	6062	-	NR_024484	72265071	72265071	2
chr18	72342918	72777628	ZNF407	434710	+	NM_017757	72342975	72776424	8
chr18	72907064	72921303	ZADH2	14239	-	NM_175907	72913370	72921013	2
chr18	72922709	73001905	TSHZ1	79196	+	NM_005786	72997497	73000596	2
chr18	73121430	73139658	SMIM21	18228	-	NM_001037331	73122818	73139518	3
chr18	73834952	73857210	LOC339298	22258	+	NR_040034	73857210	73857210	6
chr18	74069636	74207146	ZNF516	137510	-	NM_014643	74074452	74155010	8
chr18	74207476	74210045	C18orf65	2569	+	NM_001272093	74207664	74208649	3
chr18	74240611	74271784	LINC00908	31173	+	NR_015417	74271784	74271784	3
chr18	74331733	74335516	LINC00683	3783	+	NR_120419	74335516	74335516	2
chr18	74334737	74350968	LOC101927651	16231	-	NR_110784	74350968	74350968	5
chr18	74401985	74405592	LOC400661	3607	+	NR_122073	74405592	74405592	2
chr18	74506687	74534251	LOC100131655	27564	-	NR_040024	74534251	74534251	3
chr18	74534562	74682682	ZNF236	148120	+	NM_001306089	74534563	74680295	31
chr18	74690788	74844774	MBP	153986	-	NM_001025101	74692382	74817217	9
chr18	74962007	74982096	GALR1	20089	+	NM_001480	74962504	74980858	3
chr18	75683252	75705683	LINC01029	22431	-	NR_104127	75705683	75705683	2
chr18	76740274	76758969	SALL3	18695	+	NM_171999	76740274	76757322	3
chr18	76829274	77138282	ATP9B	309008	+	NM_198531	76829410	77137383	30
chr18	77155771	77289323	NFATC1	133552	+	NM_006162	77156224	77287530	10
chr18	77439800	77514510	CTDP1	74710	+	NM_004715	77439947	77513790	13
chr18	77623667	77659816	KCNG2	36149	+	NM_012283	77623667	77659816	2
chr18	77662419	77711653	PQLC1	49234	-	NM_025078	77663975	77710926	6
chr18	77724581	77730822	HSBP1L1	6241	+	NM_001136180	77724735	77730451	4
chr18	77732866	77793935	TXNL4A	61069	-	NM_001305563	77733684	77737641	4
chr18	77794345	77810652	RBFA	16307	+	NM_024805	77794495	77806155	7
chr18	77827255	77839206	RBFADN	11951	+	NR_103445	77839206	77839206	4
chr18	77866914	77898228	ADNP2	31314	+	NM_014913	77875425	77896692	4
chr18	77905806	77936315	PARD6G-AS1	30509	+	NR_028340	77936315	77936315	3
chr18	77915116	78005397	PARD6G	90281	-	NM_032510	77917653	78005231	3
chr19	60950	70966	WASH5P	10016	-	NR_033266	70966	70966	3
chr19	110678	111596	OR4F17	918	+	NM_001005240	110678	111596	1
chr19	197015	202209	LINC01002	5194	-	NR_028324	202209	202209	3
chr19	281039	291435	PLPP2	10396	-	NM_003712	281387	291336	6
chr19	305574	344791	MIER2	39217	-	NM_017550	306689	344782	14
chr19	362056	376013	THEG	13957	-	NM_016585	362199	375970	8
chr19	405442	409170	C2CD4C	3728	-	NM_001136263	407095	408361	2
chr19	416582	460996	SHC2	44414	-	NM_012435	418927	460996	13
chr19	463345	474983	ODF3L2	11638	-	NM_182577	463843	474747	4
chr19	496489	505343	MADCAM1	8854	+	NM_130760	496499	504965	5
chr19	507496	519654	TPGS1	12158	+	NM_033513	507506	519423	2
chr19	531732	542087	CDC34	10355	+	NM_004359	531931	541552	5
chr19	544033	549920	GZMM	5887	+	NM_005317	544071	549791	5
chr19	571276	583493	BSG	12217	+	NM_198590	580433	582577	8
chr19	589892	617159	HCN2	27267	+	NM_001194	589945	616474	8
chr19	617222	633568	POLRMT	16346	-	NM_005035	617273	633512	21
chr19	639894	643703	FGF22	3809	+	NM_001300812	639925	643612	3
chr19	647525	663233	RNF126	15708	-	NM_194460	648127	663121	9
chr19	676388	683392	FSTL3	7004	+	NM_005860	676423	681708	5
chr19	685520	695461	PRSS57	9941	-	NM_001308209	685715	695430	5
chr19	708952	748330	PALM	39378	+	NM_002579	709146	746814	9
chr19	751145	764318	MISP	13173	+	NM_173481	756946	763590	5
chr19	797391	812327	PTBP1	14936	+	NM_002819	797497	810826	15
chr19	804939	805001	MIR4745	62	+	NR_039900	805001	805001	1
chr19	812487	821952	PLPPR3	9465	-	NM_001270366	812569	821559	8
chr19	813583	813653	MIR3187	70	+	NR_036154	813653	813653	1
chr19	827825	832018	AZU1	4193	+	NM_001700	827846	831877	5
chr19	840984	848175	PRTN3	7191	+	NM_002777	841008	847969	5
chr19	852290	856246	ELANE	3956	+	NM_001972	852328	856164	5
chr19	859658	863569	CFD	3911	+	NM_001317335	859689	863238	5
chr19	867961	893218	MED16	25257	-	NM_005481	868100	891131	16
chr19	896502	913225	R3HDM4	16723	-	NM_138774	897436	913157	8
chr19	917341	921015	KISS1R	3674	+	NM_032551	917502	920748	5
chr19	926036	972803	ARID3A	46767	+	NM_005224	929528	972065	9
chr19	984327	994569	WDR18	10242	+	NM_024100	984353	994343	10
chr19	1000417	1009731	GRIN3B	9314	+	NM_138690	1000436	1009601	9
chr19	1009649	1021141	TMEM259	11492	-	NM_001033026	1010348	1020995	11
chr19	1026273	1039067	CNN2	12794	+	NM_004368	1026660	1037899	7
chr19	1040101	1065570	ABCA7	25469	+	NM_019112	1041360	1065424	47
chr19	1065921	1087830	HMHA1	21909	+	NM_001258328	1066024	1086005	23
chr19	1086577	1095391	POLR2E	8814	-	NM_002695	1089484	1095314	8
chr19	1103924	1106788	GPX4	2864	+	NM_002085	1104042	1106571	7
chr19	1107632	1174282	SBNO2	66650	-	NM_014963	1108218	1154275	32
chr19	1205797	1228434	STK11	22637	+	NM_000455	1206912	1226646	10
chr19	1229946	1237990	CBARP	8044	-	NM_152769	1230891	1236099	9
chr19	1241748	1244824	ATP5D	3076	+	NM_001001975	1241849	1244436	5
chr19	1248551	1259142	MIDN	10591	+	NM_177401	1250295	1257271	8
chr19	1267469	1270259	CIRBP-AS1	2790	-	NR_027271	1270259	1270259	2
chr19	1269264	1274808	CIRBP	5544	+	NM_001300815	1270932	1274310	7
chr19	1275519	1279243	C19orf24	3724	+	NM_017914	1275548	1278776	3
chr19	1286152	1301429	EFNA2	15277	+	NM_001405	1286167	1299944	4
chr19	1354975	1378430	MUM1	23455	+	NM_032853	1356388	1376575	14
chr19	1383882	1395588	NDUFS7	11706	+	NM_024407	1383925	1395487	8
chr19	1397024	1401569	GAMT	4545	-	NM_000156	1397357	1401475	6
chr19	1407567	1435686	DAZAP1	28119	+	NM_170711	1407772	1433826	13
chr19	1438362	1440496	RPS15	2134	+	NM_001018	1438424	1440461	4
chr19	1450147	1473243	APC2	23096	+	NM_005883	1453000	1470212	15
chr19	1473199	1479228	C19orf25	6029	-	NM_152482	1475030	1478902	3
chr19	1481426	1490449	PCSK4	9023	-	NM_017573	1481757	1490345	15
chr19	1491164	1497924	REEP6	6760	+	NM_138393	1491268	1497210	5
chr19	1505016	1513188	ADAMTSL5	8172	-	NM_213604	1506013	1510942	12
chr19	1524072	1535455	PLK5	11383	+	NM_001243079	1526995	1535249	14
chr19	1554667	1568057	MEX3D	13390	-	NM_001174118	1555329	1568057	3
chr19	1576669	1592760	MBD3	16091	-	NM_001281454	1578338	1592630	7
chr19	1597153	1605483	UQCR11	8330	-	NM_006830	1599438	1605408	3
chr19	1609288	1652328	TCF3	43040	-	NM_003200	1611705	1650247	19
chr19	1753661	1775444	ONECUT3	21783	+	NM_001080488	1753661	1775444	2
chr19	1782073	1812275	ATP8B3	30202	-	NM_138813	1783026	1811735	29
chr19	1815244	1848452	REXO1	33208	-	NM_020695	1816064	1848357	16
chr19	1816157	1816237	MIR1909	80	-	NR_031730	1816237	1816237	1
chr19	1822087	1824542	LOC100288123	2455	+	NR_034114	1824542	1824542	3
chr19	1852397	1863564	KLF16	11167	-	NM_031918	1854457	1863496	2
chr19	1876974	1885518	ABHD17A	8544	-	NM_031213	1877198	1881565	6
chr19	1905370	1913446	ADAT3	8076	+	NM_138422	1912046	1913150	2
chr19	1905372	1926012	SCAMP4	20640	+	NM_079834	1915018	1924283	7
chr19	1941160	1981336	CSNK1G2	40176	+	NM_001319	1969771	1980202	12
chr19	1952525	1954548	CSNK1G2-AS1	2023	-	NR_033400	1954548	1954548	3
chr19	1985446	2015702	BTBD2	30256	-	NM_017797	1986486	2015702	9
chr19	2037469	2051243	MKNK2	13774	-	NM_199054	2039611	2050850	14
chr19	2071034	2096269	MOB3A	25235	-	NM_130807	2073393	2078559	5
chr19	2096867	2099583	IZUMO4	2716	+	NM_001039846	2096944	2099344	10
chr19	2100986	2151556	AP3D1	50570	-	NM_001261826	2102171	2151333	32
chr19	2164147	2232577	DOT1L	68430	+	NM_032482	2164183	2229791	28
chr19	2229950	2236352	PLEKHJ1	6402	-	NM_001300836	2230161	2236247	6
chr19	2234060	2234148	MIR1227	88	-	NR_031596	2234148	2234148	1
chr19	2235827	2235925	MIR6789	98	-	NR_106847	2235925	2235925	1
chr19	2236815	2248678	SF3A2	11863	+	NM_007165	2243417	2248545	9
chr19	2249112	2252072	AMH	2960	+	NM_000479	2249331	2251956	5
chr19	2250637	2250717	MIR4321	80	+	NR_036207	2250717	2250717	1
chr19	2252249	2256422	JSRP1	4173	-	NM_144616	2252327	2255313	7
chr19	2269484	2273487	OAZ1	4003	+	NM_004152	2269597	2273107	5
chr19	2274630	2282181	C19orf35	7551	-	NM_198532	2275678	2280930	4
chr19	2289773	2308156	LINGO3	18383	-	NM_001101391	2289996	2291775	2
chr19	2321519	2328614	LSM7	7095	-	NM_016199	2321678	2328565	4
chr19	2328628	2355100	SPPL2B	26472	+	NM_001077238	2328708	2351613	15
chr19	2389783	2426086	TMPRSS9	36303	+	NM_182973	2389783	2426086	17
chr19	2425621	2427914	TIMM13	2293	-	NM_012458	2426945	2427531	3
chr19	2428162	2456966	LMNB2	28804	-	NM_032737	2430908	2456931	12
chr19	2434911	2434998	MIR7108	87	-	NR_106958	2434998	2434998	1
chr19	2476122	2478257	GADD45B	2135	+	NM_015675	2476356	2477599	4
chr19	2511217	2702746	GNG7	191529	-	NM_052847	2515019	2520686	5
chr19	2630712	2630791	MIR7850	79	+	NR_107004	2630791	2630791	1
chr19	2714564	2721390	DIRAS1	6826	-	NM_145173	2717207	2717804	2
chr19	2732522	2740074	SLC39A3	7552	-	NM_144564	2732748	2737255	3
chr19	2754711	2783354	SGTA	28643	-	NM_003021	2757340	2769066	12
chr19	2785457	2813602	THOP1	28145	+	NM_003249	2785660	2813274	13
chr19	2819871	2836733	ZNF554	16862	+	NM_001102651	2820069	2834850	5
chr19	2841432	2860472	ZNF555	19040	+	NM_001172775	2841570	2853950	4
chr19	2867332	2878503	ZNF556	11171	+	NM_001300843	2867419	2878327	4
chr19	2900895	2918474	ZNF57	17579	+	NM_173480	2901043	2918287	4
chr19	2933215	2944969	ZNF77	11754	-	NM_021217	2933486	2944838	4
chr19	2977535	2995182	TLE6	17647	+	NM_001143986	2978231	2995002	17
chr19	2997635	3047633	TLE2	49998	-	NM_001144761	2997921	3045786	20
chr19	3052907	3062964	AES	10057	-	NM_198969	3053816	3062925	7
chr19	3094407	3124000	GNA11	29593	+	NM_002067	3094649	3121177	7
chr19	3136029	3163767	GNA15	27738	+	NM_002068	3136448	3163017	7
chr19	3141573	3155173	LOC100996351	13600	-	NR_110670	3155173	3155173	4
chr19	3178735	3180330	S1PR4	1595	+	NM_003775	3178790	3179945	1
chr19	3185874	3209573	NCLN	23699	+	NM_020170	3186028	3207686	15
chr19	3224700	3297073	CELF5	72373	+	NM_021938	3224737	3293444	13
chr19	3359560	3469215	NFIC	109655	+	NM_205843	3359680	3462767	11
chr19	3474404	3480540	SMIM24	6136	-	NM_001136503	3474840	3480461	4
chr19	3490818	3500938	DOHH	10120	-	NM_001145165	3491489	3496812	5
chr19	3506294	3536755	FZR1	30461	+	NM_016263	3522987	3534834	14
chr19	3539154	3544028	C19orf71	4874	+	NM_001135580	3539175	3544008	4
chr19	3544196	3557582	MFSD12	13386	-	NM_174983	3544707	3557401	10
chr19	3572942	3579081	HMG20B	6139	+	NM_006339	3573307	3578519	10
chr19	3585568	3593539	GIPC3	7971	+	NM_133261	3585595	3590188	6
chr19	3594503	3606831	TBXA2R	12328	-	NM_201636	3594833	3600632	4
chr19	3607244	3613928	CACTIN-AS1	6684	+	NR_038865	3613928	3613928	4
chr19	3610626	3626813	CACTIN	16187	-	NM_001080543	3611920	3626760	10
chr19	3630178	3700477	PIP5K1C	70299	-	NM_012398	3633164	3700388	18
chr19	3708334	3750811	TJP3	42477	+	NM_001267560	3728430	3750682	21
chr19	3750770	3761673	APBA3	10903	-	NM_004886	3751023	3760262	11
chr19	3762664	3767563	MRPL54	4899	+	NM_172251	3762698	3767391	3
chr19	3769088	3772219	RAX2	3131	-	NM_032753	3770618	3771740	3
chr19	3777966	3801810	MATK	23844	-	NM_002378	3778180	3789345	14
chr19	3804021	3869027	ZFR2	65006	-	NM_015174	3805946	3869015	19
chr19	3880617	3928080	ATCAY	47463	+	NM_033064	3885765	3924590	13
chr19	3933100	3942414	NMRK2	9314	+	NM_170678	3933669	3942271	8
chr19	3958450	3971121	DAPK3	12671	-	NM_001348	3959098	3969733	9
chr19	3961411	3961510	MIR637	99	-	NR_030367	3961510	3961510	1
chr19	3976053	3985461	EEF2	9408	-	NM_001961	3976551	3985378	15
chr19	3982504	3982570	SNORD37	66	-	NR_002602	3982570	3982570	1
chr19	4007595	4039384	PIAS4	31789	+	NM_015897	4007758	4037873	11
chr19	4043301	4066943	ZBTB7A	23642	-	NM_015898	4047749	4055230	3
chr19	4090319	4124126	MAP2K2	33807	-	NM_030662	4090595	4123872	11
chr19	4153597	4173051	CREB3L3	19454	+	NM_001271996	4153744	4171966	10
chr19	4174105	4182596	SIRT6	8491	-	NM_016539	4174613	4182536	8
chr19	4183350	4224811	ANKRD24	41461	+	NM_133475	4186422	4224502	22
chr19	4229539	4237524	EBI3	7985	+	NM_005755	4229547	4237085	5
chr19	4247110	4269085	CCDC94	21975	+	NM_018074	4247143	4268693	8
chr19	4278597	4290720	SHD	12123	+	NM_020209	4280060	4290630	6
chr19	4292224	4302428	TMIGD2	10204	-	NM_144615	4292595	4302382	5
chr19	4304590	4323843	FSD1	19253	+	NM_024333	4304743	4323640	13
chr19	4324039	4338847	STAP2	14808	-	NM_001013841	4324129	4338750	13
chr19	4343523	4360083	MPND	16560	+	NM_001300862	4343590	4359999	13
chr19	4360363	4400565	SH3GL1	40202	-	NM_003025	4361596	4400365	10
chr19	4402659	4443394	CHAF1A	40735	+	NM_005483	4402759	4443022	15
chr19	4445002	4457791	UBXN6	12789	-	NM_025241	4445494	4457694	11
chr19	4445974	4446045	MIR4746	71	+	NR_039901	4446045	4446045	1
chr19	4472192	4502232	HDGFRP2	30040	+	NM_032631	4472347	4502022	17
chr19	4502191	4517716	PLIN4	15525	-	NM_001080400	4504470	4517716	6
chr19	4522543	4535208	PLIN5	12665	-	NM_001013706	4523539	4534086	8
chr19	4537226	4540036	LRG1	2810	-	NM_052972	4537951	4540025	2
chr19	4542599	4559771	SEMA6B	17172	-	NM_032108	4543612	4558469	17
chr19	4639526	4655580	TNFAIP8L1	16054	+	NM_152362	4651881	4652442	2
chr19	4657556	4670415	MYDGF	12859	-	NM_019107	4658016	4670346	6
chr19	4675243	4723855	DPP9	48612	-	NM_139159	4676575	4719918	22
chr19	4679293	4685960	DPP9-AS1	6667	+	NM_001242901	4682870	4683856	3
chr19	4769116	4772568	MIR7-3HG	3452	+	NR_027148	4772568	4772568	3
chr19	4770681	4770791	MIR7-3	110	+	NR_029607	4770791	4770791	1
chr19	4791727	4795571	FEM1A	3844	+	NM_018708	4791866	4793876	1
chr19	4815935	4831754	TICAM1	15819	-	NM_182919	4816250	4818389	2
chr19	4838345	4867780	PLIN3	29435	-	NM_001164189	4839203	4861406	8
chr19	4890448	4902879	ARRDC5	12431	-	NM_001080523	4891057	4902879	3
chr19	4903091	4962165	UHRF1	59074	+	NM_001290050	4910897	4960814	17
chr19	4932698	4932752	MIR4747	54	+	NR_039902	4932752	4932752	1
chr19	4969123	5153608	KDM4B	184485	+	NM_015015	5032901	5151522	23
chr19	5205518	5340814	PTPRS	135296	-	NM_002850	5206784	5286151	38
chr19	5455425	5456867	ZNRF4	1442	+	NM_181710	5455502	5456792	1
chr19	5558177	5568045	TINCR	9868	-	NR_027064	5568045	5568045	3
chr19	5587009	5622938	SAFB2	35929	-	NM_014649	5587253	5622726	21
chr19	5623045	5668489	SAFB	45444	+	NM_002967	5623216	5668302	21
chr19	5678424	5680907	C19orf70	2483	-	NM_001308240	5678561	5680160	5
chr19	5680775	5688534	HSD11B1L	7759	+	NM_001267868	5684043	5687956	9
chr19	5690271	5691678	RPL36	1407	+	NM_033643	5690518	5691632	4
chr19	5691844	5720463	LONP1	28619	-	NM_001276480	5692042	5713194	18
chr19	5720687	5778742	CATSPERD	58055	+	NM_152784	5720748	5778687	22
chr19	5782970	5784776	PRR22	1806	-	NM_001134316	5782988	5784671	3
chr19	5785152	5791249	DUS3L	6097	-	NM_020175	5785213	5791152	13
chr19	5823817	5828335	NRTN	4518	+	NM_004558	5824176	5828184	2
chr19	5830636	5839742	FUT6	9106	-	NM_000150	5831498	5832578	3
chr19	5842898	5851485	FUT3	8587	-	NM_001097639	5843764	5844850	3
chr19	5847477	5858250	LOC101928844	10773	+	NR_110740	5858250	5858250	4
chr19	5865836	5870551	FUT5	4715	-	NM_002034	5866611	5867736	2
chr19	5891286	5904024	NDUFA11	12738	-	NM_001193375	5892927	5903719	4
chr19	5904851	5910263	VMAC	5412	+	NM_001017921	5904901	5909153	2
chr19	5913654	5916222	CAPS	2568	+	NM_004058	5914084	5915333	5
chr19	5916150	5978320	RANBP3	62170	-	NM_001300865	5917620	5978093	16
chr19	5978413	6020374	LOC100128568	41961	+	NR_046376	6020374	6020374	4
chr19	5993174	6110664	RFX2	117490	-	NM_000635	5994845	6047507	18
chr19	6135643	6193114	ACSBG2	57471	+	NM_001289179	6141554	6190668	15
chr19	6210391	6279959	MLLT1	69568	-	NM_005934	6213052	6279795	12
chr19	6306509	6333640	ACER1	27131	-	NM_133492	6306724	6333562	6
chr19	6361462	6368915	CLPP	7453	+	NM_006012	6361585	6368721	6
chr19	6372443	6375261	ALKBH7	2818	+	NM_032306	6372831	6374984	4
chr19	6375304	6375860	PSPN	556	-	NM_004158	6375304	6375860	2
chr19	6379579	6393291	GTF2F1	13712	-	NM_002096	6380291	6393006	13
chr19	6389648	6389714	MIR6885	66	-	NR_106945	6389714	6389714	1
chr19	6392931	6392994	MIR6790	63	-	NR_106848	6392994	6392994	1
chr19	6413118	6424822	KHSRP	11704	-	NM_003685	6414122	6424712	20
chr19	6416420	6416522	MIR3940	102	-	NR_037505	6416522	6416522	1
chr19	6426047	6433790	SLC25A41	7743	-	NM_173637	6426399	6433704	7
chr19	6440074	6459781	SLC25A23	19707	-	NM_024103	6441985	6459639	10
chr19	6464259	6467230	CRB3	2971	+	NM_174881	6464712	6467033	5
chr19	6467214	6481819	DENND1C	14605	-	NM_024898	6467514	6481706	23
chr19	6494329	6502859	TUBB4A	8530	-	NM_001289123	6495174	6502722	5
chr19	6531009	6535939	TNFSF9	4930	+	NM_003811	6531047	6535077	3
chr19	6585849	6591163	CD70	5314	-	NM_001252	6586030	6591013	3
chr19	6663147	6670599	TNFSF14	7452	-	NM_003807	6664936	6670080	5
chr19	6677845	6720693	C3	42848	-	NM_000064	6677892	6720600	41
chr19	6729924	6737633	GPR108	7709	-	NM_001080452	6730322	6737587	18
chr19	6736722	6736789	MIR6791	67	-	NR_106849	6736789	6736789	1
chr19	6739692	6751537	TRIP10	11845	+	NM_001288962	6739772	6751222	15
chr19	6752172	6767523	SH2D3A	15351	-	NM_005490	6752603	6763759	10
chr19	6772678	6857377	VAV1	84699	+	NM_005428	6772818	6857118	27
chr19	6887559	6940464	ADGRE1	52905	+	NM_001974	6887619	6940040	21
chr19	6952510	6990857	ADGRE4P	38347	-	NR_024075	6990857	6990857	16
chr19	7004963	7006426	FLJ25758	1463	-	NR_024372	7006426	7006426	1
chr19	7030593	7033022	MBD3L5	2429	+	NM_001136507	7030622	7032905	2
chr19	7037754	7040184	MBD3L4	2430	-	NM_001164419	7037871	7040155	2
chr19	7049350	7051746	MBD3L2	2396	+	NM_144614	7049384	7051633	2
chr19	7056215	7058645	MBD3L3	2430	-	NM_001164425	7056332	7058616	2
chr19	7069470	7087978	ZNF557	18508	+	NM_001044387	7075085	7083755	8
chr19	7112265	7294313	INSR	182048	-	NM_000208	7117066	7293902	22
chr19	7459998	7537371	ARHGEF18	77373	+	NM_015318	7505300	7535184	21
chr19	7537722	7538247	LOC100128573	525	-	NR_024491	7538247	7538247	1
chr19	7541760	7554286	PEX11G	12526	-	NM_001300881	7542087	7550762	5
chr19	7562444	7573336	C19orf45	10892	+	NM_198534	7565708	7573316	9
chr19	7581003	7585911	ZNF358	4908	+	NM_018083	7584128	7585835	2
chr19	7587495	7598895	MCOLN1	11400	+	NM_020533	7587636	7598681	14
chr19	7599037	7626653	PNPLA6	27616	+	NM_006702	7600436	7626448	35
chr19	7660787	7683196	CAMSAP3	22409	+	NM_001080429	7660888	7682943	19
chr19	7682324	7682391	MIR6792	67	+	NR_106850	7682391	7682391	1
chr19	7684410	7694439	XAB2	10029	-	NM_020196	7684471	7694413	19
chr19	7694670	7696510	PET100	1840	+	NR_033242	7696510	7696510	5
chr19	7696500	7698634	PCP2	2134	-	NM_174895	7696574	7698343	4
chr19	7701986	7712760	STXBP2	10774	+	NM_001127396	7702035	7712696	19
chr19	7733971	7735340	RETN	1369	+	NM_001193374	7734212	7735235	4
chr19	7741942	7744719	MCEMP1	2777	+	NM_174918	7741967	7744000	7
chr19	7745706	7747748	TRAPPC5	2042	+	NM_174894	7747139	7747706	2
chr19	7753642	7767032	FCER2	13390	-	NM_002002	7754078	7764646	11
chr19	7793842	7797057	CLEC4G	3215	-	NM_001244856	7794251	7796988	9
chr19	7804880	7812464	CD209	7584	-	NM_001144895	7807924	7812397	7
chr19	7828034	7834491	CLEC4M	6457	+	NM_001144905	7828152	7833874	8
chr19	7852369	7855898	CLEC4GP1	3529	+	NR_002931	7855898	7855898	7
chr19	7895160	7929862	EVI5L	34702	+	NM_145245	7911428	7928588	19
chr19	7933604	7939326	PRR36	5722	-	NR_104345	7939326	7939326	7
chr19	7943516	7945117	LYPLA2P2	1601	-	NR_033250	7945117	7945117	1
chr19	7953389	7966908	LRRC8E	13519	+	NM_001268284	7960488	7965798	4
chr19	7968664	7979368	MAP2K7	10704	+	NM_001297555	7968829	7977316	12
chr19	7981031	7983980	TGFBR3L	2949	+	NM_001195259	7981152	7983009	6
chr19	7985193	7988136	SNAPC2	2943	+	NM_003083	7985251	7987649	5
chr19	7989380	7991051	CTXN1	1671	-	NM_206833	7990174	7990423	2
chr19	7991602	8008708	TIMM44	17106	-	NM_006351	7992071	8008536	13
chr19	8023456	8070529	ELAVL1	47073	-	NM_001419	8028366	8056699	6
chr19	8117645	8127547	CCL25	9902	+	NM_001201359	8117933	8127109	6
chr19	8130286	8212385	FBN3	82099	-	NM_032447	8130802	8212364	63
chr19	8274216	8327304	CERS4	53088	+	NM_024552	8315960	8326993	12
chr19	8367010	8373240	CD320	6230	-	NM_016579	8367346	8373174	5
chr19	8376183	8386280	NDUFA7	10097	-	NM_005001	8376388	8386242	4
chr19	8386383	8387280	RPS28	897	+	NM_001031	8386414	8386959	4
chr19	8387467	8408146	KANK3	20679	-	NM_198471	8387722	8402712	11
chr19	8429010	8439259	ANGPTL4	10249	+	NM_139314	8429205	8438770	7
chr19	8439259	8455575	RAB11B-AS1	16316	-	NR_038237	8455575	8455575	3
chr19	8454173	8454264	MIR4999	91	-	NR_049795	8454264	8454264	1
chr19	8455204	8469317	RAB11B	14113	+	NM_004218	8455300	8468442	5
chr19	8478186	8503899	MARCH2	25713	+	NM_016496	8486724	8503430	6
chr19	8509711	8554002	HNRNPM	44291	+	NM_001297418	8528492	8553738	14
chr19	8554939	8567538	PRAM1	12599	-	NM_032152	8555072	8567475	10
chr19	8575461	8579048	ZNF414	3587	-	NM_001146175	8575574	8578930	8
chr19	8585673	8642331	MYO1F	56658	-	NM_012335	8586411	8642193	28
chr19	8645123	8675620	ADAMTS10	30497	-	NM_030957	8645776	8670595	26
chr19	8807746	8809180	ACTL9	1434	-	NM_178525	8807800	8809051	1
chr19	8841315	8842371	OR2Z1	1056	+	NM_001004699	8841390	8842335	1
chr19	8920251	8942980	ZNF558	22729	-	NM_144693	8921956	8933335	10
chr19	8953268	8954016	MBD3L1	748	+	NM_145208	8953354	8953939	1
chr19	8959519	9092018	MUC16	132499	-	NM_024690	8959607	9091814	84
chr19	9203920	9204862	OR1M1	942	+	NM_001004456	9203920	9204862	1
chr19	9212944	9213982	OR7G2	1038	-	NM_001005193	9212944	9213982	1
chr19	9225503	9226439	OR7G1	936	-	NM_001005192	9225503	9226439	1
chr19	9236687	9237626	OR7G3	939	-	NM_001001958	9236687	9237626	1
chr19	9251055	9274091	ZNF317	23036	+	NR_102435	9274091	9274091	7
chr19	9296269	9299493	OR7D2	3224	+	NM_175883	9296457	9297396	1
chr19	9324525	9325547	OR7D4	1022	-	NM_001005191	9324574	9325513	1
chr19	9361719	9362739	OR7E24	1020	+	NM_001079935	9361719	9362739	1
chr19	9405985	9415795	ZNF699	9810	-	NM_198535	9406150	9415795	5
chr19	9434447	9454521	ZNF559	20074	+	NM_032497	9449225	9453744	7
chr19	9434901	9493293	ZNF559-ZNF177	58392	+	NM_001172650	9488987	9492453	12
chr19	9473695	9493293	ZNF177	19598	+	NM_003451	9488987	9492453	9
chr19	9523101	9546254	ZNF266	23153	-	NM_006631	9523950	9529214	11
chr19	9577030	9609279	ZNF560	32249	-	NM_152476	9577249	9585989	10
chr19	9638680	9649321	ZNF426	10641	-	NM_001300883	9639055	9646886	6
chr19	9676403	9695209	ZNF121	18806	-	NM_001308269	9676615	9678326	5
chr19	9718001	9731916	ZNF561	13915	-	NM_152289	9720875	9730132	6
chr19	9732157	9745538	ZNF561-AS1	13381	+	NR_122038	9745538	9745538	4
chr19	9759337	9785776	ZNF562	26439	-	NM_001130031	9763624	9771420	6
chr19	9800813	9811493	ZNF812	10680	-	NM_001199814	9800813	9806794	6
chr19	9868150	9879410	ZNF846	11260	-	NM_001077624	9868150	9875626	6
chr19	9920942	9929779	FBXL12	8837	-	NM_001316939	9921571	9922393	4
chr19	9938555	9940797	UBL5	2242	+	NM_001048241	9939013	9940684	5
chr19	9945882	9960365	PIN1	14483	+	NR_038830	9960365	9960365	6
chr19	9964393	10047228	OLFM2	82835	-	NM_058164	9964861	10047042	6
chr19	10070236	10121147	COL5A3	50911	-	NM_015719	10071086	10121061	67
chr19	10123924	10132954	RDH8	9030	+	NM_015725	10124113	10132425	6
chr19	10149029	10149089	MIR5589	60	+	NR_049855	10149089	10149089	1
chr19	10152031	10184813	C3P1	32782	+	NR_027300	10184813	10184813	30
chr19	10196794	10203928	C19orf66	7134	+	NM_018381	10197103	10202978	8
chr19	10203012	10213425	ANGPTL6	10413	-	NM_031917	10203264	10207239	6
chr19	10216898	10221975	PPAN	5077	+	NM_020230	10217070	10221841	12
chr19	10216898	10226064	PPAN-P2RY11	9166	+	NM_001040664	10217070	10225414	13
chr19	10218326	10218411	SNORD105	85	+	NR_004381	10218411	10218411	1
chr19	10220424	10220516	SNORD105B	92	+	NR_003688	10220516	10220516	1
chr19	10222196	10226064	P2RY11	3868	+	NM_002566	10222397	10225414	2
chr19	10225689	10230599	EIF3G	4910	-	NM_003755	10225789	10230535	11
chr19	10244021	10305755	DNMT1	61734	-	NM_001130823	10244342	10305575	41
chr19	10332108	10341948	S1PR2	9840	-	NM_004230	10334519	10335581	2
chr19	10341088	10341161	MIR4322	73	+	NR_036206	10341161	10341161	1
chr19	10362639	10370736	MRPL4	8097	+	NM_146388	10362929	10369414	8
chr19	10381516	10397291	ICAM1	15775	+	NM_000201	10381835	10395963	7
chr19	10397642	10399260	ICAM4	1618	+	NM_001544	10397688	10398780	3
chr19	10400654	10407454	ICAM5	6800	+	NM_003259	10400719	10407292	11
chr19	10415478	10420233	ZGLP1	4755	-	NM_001103167	10415766	10419357	4
chr19	10420886	10426691	FDX1L	5805	-	NM_001031734	10421161	10426681	5
chr19	10426888	10444314	RAVER1	17426	-	NM_133452	10428129	10444234	13
chr19	10444451	10450345	ICAM3	5894	-	NM_002162	10444532	10450290	7
chr19	10461203	10491248	TYK2	30045	-	NM_003331	10461509	10489082	25
chr19	10501808	10514271	CDC37	12463	-	NM_007065	10502226	10514155	8
chr19	10514133	10514214	MIR1181	81	-	NR_031592	10514214	10514214	1
chr19	10527448	10580307	PDE4A	52859	+	NM_001243121	10527618	10578297	17
chr19	10596795	10614054	KEAP1	17259	-	NM_203500	10597327	10610709	6
chr19	10623417	10628668	S1PR5	5251	-	NM_001166215	10624490	10625687	2
chr19	10654569	10664099	ATG4D	9530	+	NM_001281504	10655412	10663743	10
chr19	10662797	10662880	MIR1238	83	+	NR_031603	10662880	10662880	1
chr19	10663760	10676702	KRI1	12942	-	NM_023008	10664626	10676693	19
chr19	10677137	10679655	CDKN2D	2518	-	NM_079421	10677733	10679329	3
chr19	10683346	10697991	AP1M2	14645	-	NM_001300887	10683741	10697907	12
chr19	10713120	10755235	SLC44A2	42115	+	NM_001145056	10713206	10754061	22
chr19	10762537	10764548	ILF3-AS1	2011	-	NR_024333	10764548	10764548	1
chr19	10764936	10803095	ILF3	38159	+	NM_012218	10781281	10799988	20
chr19	10812111	10824043	QTRT1	11932	+	NM_031209	10812136	10823946	10
chr19	10828728	10942586	DNM2	113858	+	NM_001190716	10828918	10941723	21
chr19	10829079	10829179	MIR638	100	+	NR_030368	10829179	10829179	1
chr19	10890929	10891011	MIR4748	82	+	NR_039903	10891011	10891011	1
chr19	10928101	10928172	MIR199A1	71	-	NR_029586	10928172	10928172	1
chr19	10939648	10939711	MIR6793	63	+	NR_106851	10939711	10939711	1
chr19	10942742	10946983	TMED1	4241	-	NM_006858	10943670	10946867	4
chr19	10959105	10980360	C19orf38	21255	+	NM_001136482	10959184	10980043	7
chr19	10982252	11033448	CARM1	51196	+	NM_199141	10982378	11032433	16
chr19	11033443	11039688	YIPF2	6245	-	NM_024029	11033966	11039086	10
chr19	11039423	11040916	C19orf52	1493	+	NM_138358	11039498	11040378	2
chr19	11071597	11172958	SMARCA4	101361	+	NM_001128844	11094827	11172492	36
chr19	11200037	11244505	LDLR	44468	+	NM_000527	11200224	11241992	18
chr19	11224149	11224210	MIR6886	61	+	NR_106946	11224210	11224210	1
chr19	11256169	11266488	SPC24	10319	-	NM_001317031	11257013	11266452	5
chr19	11274942	11308243	KANK2	33301	-	NM_001136191	11277233	11305187	13
chr19	11309968	11373168	DOCK6	63200	-	NM_020812	11310172	11373116	48
chr19	11350294	11352619	ANGPTL8	2325	+	NM_018687	11350313	11352363	4
chr19	11406814	11437672	TSPAN16	30858	+	NM_012466	11406973	11437520	7
chr19	11432721	11450344	RAB3D	17623	-	NM_004283	11436073	11448075	5
chr19	11453451	11456981	TMEM205	3530	-	NM_001145416	11453490	11456295	4
chr19	11457180	11465620	CCDC159	8440	+	NM_001080503	11457282	11465553	11
chr19	11466061	11476374	PLPPR2	10313	+	NM_001170635	11468349	11475366	10
chr19	11485382	11487627	SWSAP1	2245	+	NM_175871	11485419	11486692	2
chr19	11487880	11495018	EPOR	7138	-	NR_033663	11495018	11495018	8
chr19	11504731	11530018	RGL3	25287	-	NM_001161616	11505077	11529954	19
chr19	11531272	11546603	CCDC151	15331	-	NM_001302453	11531502	11546592	13
chr19	11546077	11561782	PRKCSH	15705	+	NM_001289103	11546938	11560227	18
chr19	11562142	11591803	ELAVL3	29661	-	NM_032281	11565340	11591423	7
chr19	11594241	11616738	ZNF653	22497	-	NM_138783	11594496	11616601	9
chr19	11606358	11606437	MIR7974	79	-	NR_107014	11606437	11606437	1
chr19	11616730	11639987	ECSIT	23257	-	NM_016581	11616998	11629985	8
chr19	11649531	11661138	CNN1	11607	+	NM_001308341	11651977	11660610	8
chr19	11663857	11670051	ELOF1	6194	-	NM_032377	11664560	11665162	4
chr19	11685474	11689801	ACP5	4327	-	NM_001111035	11685824	11688132	7
chr19	11708234	11729974	ZNF627	21740	+	NM_001290083	11725434	11728704	5
chr19	11784812	11797384	ZNF833P	12572	+	NR_028594	11797384	11797384	3
chr19	11832079	11849824	ZNF823	17745	-	NM_001080493	11832515	11849634	4
chr19	11877814	11894893	ZNF441	17079	+	NM_152355	11878008	11892721	4
chr19	11909390	11919306	ZNF491	9916	+	NM_152356	11916768	11918082	3
chr19	11925106	11946016	ZNF440	20910	+	NM_152357	11925262	11943779	4
chr19	11976843	11980306	ZNF439	3463	+	NM_152262	11976971	11979384	3
chr19	11998669	12025365	ZNF69	26696	+	NM_021915	11998738	12024225	5
chr19	12035882	12061588	ZNF700	25706	+	NM_144566	12036025	12061068	4
chr19	12075868	12091198	ZNF763	15330	+	NM_001012753	12076023	12089924	4
chr19	12125531	12146556	ZNF433	21025	-	NM_001308351	12125659	12129014	6
chr19	12154619	12163782	ZNF878	9163	-	NM_001080404	12154619	12163616	4
chr19	12175513	12188631	ZNF844	13118	+	NM_001136501	12175688	12187936	4
chr19	12203077	12225494	ZNF788	22417	+	NR_027049	12225494	12225494	3
chr19	12242167	12251222	ZNF20	9055	-	NM_021143	12243401	12250997	4
chr19	12242167	12267546	ZNF625-ZNF20	25379	-	NR_037802	12267546	12267546	8
chr19	12255708	12267546	ZNF625	11838	-	NM_145233	12256111	12267373	4
chr19	12273871	12300064	ZNF136	26193	+	NM_003437	12274018	12298816	4
chr19	12305829	12318391	LOC100289333	12562	+	NR_104179	12318391	12318391	2
chr19	12382624	12405714	ZNF44	23090	-	NM_001164276	12383221	12405509	5
chr19	12428303	12444534	ZNF563	16231	-	NM_145276	12429407	12444296	4
chr19	12460184	12476475	ZNF442	16291	-	NM_030824	12460514	12474445	6
chr19	12500827	12512088	ZNF799	11261	-	NM_001080821	12501279	12511884	4
chr19	12540519	12551926	ZNF443	11407	-	NM_005815	12540969	12551728	4
chr19	12571997	12595632	ZNF709	23635	-	NM_152601	12574809	12595471	4
chr19	12636183	12662356	ZNF564	26173	-	NM_144976	12637259	12662146	4
chr19	12686919	12721623	ZNF490	34704	-	NM_020714	12691298	12721494	5
chr19	12721731	12740676	ZNF791	18945	+	NM_153358	12721893	12740074	4
chr19	12757321	12777591	MAN2B1	20270	-	NM_000528	12757433	12777515	24
chr19	12777617	12786646	WDR83	9029	+	NM_001099737	12780604	12786486	11
chr19	12778880	12780465	WDR83OS	1585	-	NM_016145	12779172	12780217	4
chr19	12786530	12792701	DHPS	6171	-	NM_001930	12786651	12792580	9
chr19	12798811	12799234	LOC105372280	423	+	NM_001316692	12798862	12799186	1
chr19	12799729	12807455	FBXW9	7726	-	NM_032301	12800029	12807395	10
chr19	12810007	12834810	TNPO2	24803	-	NM_001136195	12812159	12831791	26
chr19	12814410	12814485	SNORD135	75	-	NR_132756	12814485	12814485	1
chr19	12817262	12817332	SNORD41	70	-	NR_002751	12817332	12817332	1
chr19	12841453	12845529	C19orf43	4076	-	NM_024038	12841774	12845471	3
chr19	12848305	12859137	ASNA1	10832	+	NM_004317	12848319	12858918	7
chr19	12863406	12869271	BEST2	5865	+	NM_017682	12863406	12868891	9
chr19	12873816	12886434	HOOK2	12618	-	NM_013312	12874095	12886263	23
chr19	12902309	12904125	JUNB	1816	+	NM_002229	12902585	12903629	1
chr19	12907633	12912724	PRDX2	5091	-	NM_005809	12907894	12912075	6
chr19	12917427	12924462	RNASEH2A	7035	+	NM_006397	12917487	12924280	8
chr19	12936290	12946242	RTBDN	9952	-	NM_001270440	12937420	12945912	7
chr19	12949258	12985766	MAST1	36508	+	NM_014975	12949386	12985684	26
chr19	12963073	12963141	MIR6794	68	+	NR_106852	12963141	12963141	1
chr19	12986024	12992335	DNASE2	6311	-	NM_001375	12986803	12992189	6
chr19	12995236	12998017	KLF1	2781	-	NM_006563	12995698	12997954	3
chr19	13001942	13010813	GCDH	8871	+	NM_013976	13002118	13010557	12
chr19	13009893	13030086	SYCE2	20193	-	NM_001105578	13010154	13030071	6
chr19	13033283	13044558	FARSA	11275	-	NM_004461	13033561	13044510	13
chr19	13049413	13055304	CALR	5891	+	NM_004343	13049493	13054727	9
chr19	13051297	13051354	MIR6515	57	+	NR_106770	13051354	13051354	1
chr19	13056627	13064457	RAD23A	7830	+	NM_001270362	13056762	13063863	9
chr19	13064969	13068068	GADD45GIP1	3099	-	NM_052850	13065021	13068026	2
chr19	13080431	13085567	DAND5	5136	+	NM_152654	13080474	13084448	2
chr19	13106583	13209610	NFIX	103027	+	NM_002501	13106651	13201184	10
chr19	13209841	13213974	LYL1	4133	-	NM_005583	13210132	13211985	4
chr19	13215713	13227563	TRMT1	11850	-	NM_001136035	13215748	13227213	17
chr19	13229101	13251961	NACC1	22860	+	NM_052876	13246021	13249220	6
chr19	13254871	13261188	STX10	6317	-	NM_001271609	13255396	13260987	8
chr19	13261281	13265718	IER2	4437	+	NM_004907	13264000	13264672	2
chr19	13317255	13617274	CACNA1A	300019	-	NM_001127221	13318859	13617038	47
chr19	13858752	13874106	CCDC130	15354	+	NM_030818	13862622	13873882	10
chr19	13875336	13885096	MRI1	9760	+	NM_032285	13875402	13883095	6
chr19	13885256	13889586	C19orf53	4330	+	NM_014047	13885291	13889012	3
chr19	13906273	13943044	ZSWIM4	36771	+	NM_023072	13906462	13941864	13
chr19	13945329	13947103	LOC284454	1774	-	NR_036515	13947103	13947103	1
chr19	13947100	13947173	MIR24-2	73	-	NR_029497	13947173	13947173	1
chr19	13947253	13947331	MIR27A	78	-	NR_029501	13947331	13947331	1
chr19	13947400	13947473	MIR23A	73	-	NR_029495	13947473	13947473	1
chr19	13985512	13985622	MIR181C	110	+	NR_029613	13985622	13985622	1
chr19	13985688	13985825	MIR181D	137	+	NR_030179	13985825	13985825	1
chr19	13988062	13991571	NANOS3	3509	+	NM_001098622	13988062	13991317	2
chr19	13993167	14016909	C19orf57	23742	-	NM_024323	13993614	14015705	8
chr19	14016955	14041693	CC2D1A	24738	+	NM_017721	14017254	14041208	29
chr19	14041999	14064204	PODNL1	22205	-	NM_001146254	14043517	14063948	8
chr19	14063318	14072256	DCAF15	8938	+	NM_138353	14063324	14071807	13
chr19	14072341	14117134	RFX1	44793	-	NM_002918	14073506	14104655	21
chr19	14138959	14142370	RLN3	3411	+	NM_001311197	14139016	14141549	3
chr19	14142551	14163717	IL27RA	21166	+	NM_004843	14142684	14163102	14
chr19	14164178	14169971	PALM3	5793	-	NM_001145028	14164416	14169971	6
chr19	14183820	14185874	LOC113230	2054	+	NR_111941	14185874	14185874	3
chr19	14184172	14184291	MIR1199	119	+	NR_106715	14184291	14184291	1
chr19	14192443	14196607	C19orf67	4164	-	NM_001277378	14192645	14196439	6
chr19	14199228	14201232	SAMD1	2004	-	NM_138352	14199228	14201232	5
chr19	14202506	14228559	PRKACA	26053	-	NM_002730	14203923	14228359	10
chr19	14230320	14247440	ASF1B	17120	-	NM_018154	14231270	14247268	4
chr19	14247963	14282075	LOC100507373	34112	+	NR_045214	14282075	14282075	3
chr19	14258548	14316997	ADGRL1	58449	-	NM_001008701	14261684	14294414	24
chr19	14491955	14519537	ADGRE5	27582	+	NM_078481	14492335	14518933	20
chr19	14519609	14530195	DDX39A	10586	-	NM_005804	14519747	14524032	11
chr19	14544165	14582679	PKN1	38514	+	NM_002741	14544333	14582596	22
chr19	14583277	14586174	PTGER1	2897	-	NM_000955	14583371	14585132	3
chr19	14588570	14606961	GIPC1	18391	-	NM_005716	14589227	14593788	9
chr19	14625575	14640134	DNAJB1	14559	-	NM_001313964	14626751	14627769	4
chr19	14640354	14640452	MIR639	98	+	NR_030369	14640452	14640452	1
chr19	14640378	14676792	TECR	36414	+	NM_138501	14640508	14676683	13
chr19	14676889	14682889	NDUFB7	6000	-	NM_004146	14676944	14682812	3
chr19	14693895	14721956	CLEC17A	28061	+	NR_109784	14721956	14721956	14
chr19	14729928	14785730	ADGRE3	55802	-	NM_032571	14730244	14785582	16
chr19	14733024	14733163	SNORA104	139	+	NR_132784	14733163	14733163	1
chr19	14800851	14844558	ZNF333	43707	+	NM_001300912	14804303	14841998	12
chr19	14843508	14889353	ADGRE2	45845	-	NM_013447	14847047	14887568	21
chr19	14909985	14910948	OR7C1	963	-	NM_198944	14909985	14910948	1
chr19	14937138	14939276	OR7A5	2138	-	NM_017506	14938093	14939053	1
chr19	14951759	14952689	OR7A10	930	-	NM_001005190	14951759	14952689	1
chr19	14991237	14992167	OR7A17	930	-	NM_030901	14991237	14992167	1
chr19	15052300	15053260	OR7C2	960	+	NM_012377	15052300	15053260	1
chr19	15060844	15121455	SLC1A6	60611	-	NR_073589	15121455	15121455	9
chr19	15121538	15134083	CCDC105	12545	+	NM_173482	15121637	15133931	7
chr19	15160290	15169103	CASP14	8813	+	NM_012114	15163062	15166900	7
chr19	15197876	15198944	OR1I1	1068	+	NM_001004713	15197876	15198944	1
chr19	15218174	15225799	SYDE1	7625	+	NM_033025	15218244	15224774	8
chr19	15225784	15236610	ILVBL	10826	-	NM_006844	15226062	15235870	16
chr19	15270443	15311792	NOTCH3	41349	-	NM_000435	15271472	15311716	33
chr19	15290093	15290161	MIR6795	68	-	NR_106853	15290161	15290161	1
chr19	15337732	15343858	EPHX3	6126	-	NM_001142886	15338247	15343022	8
chr19	15348300	15391262	BRD4	42962	-	NM_058243	15349187	15383910	20
chr19	15464331	15490612	AKAP8	26281	-	NM_005858	15465725	15490542	14
chr19	15490858	15529932	AKAP8L	39074	-	NR_111971	15529932	15529932	16
chr19	15532317	15560762	WIZ	28445	-	NM_021241	15533886	15559118	8
chr19	15560358	15560419	MIR1470	61	+	NR_031716	15560419	15560419	1
chr19	15562437	15575382	RASAL3	12945	-	NM_022904	15562605	15575169	18
chr19	15579456	15590315	PGLYRP2	10859	-	NM_052890	15579473	15590182	5
chr19	15619335	15663128	CYP4F22	43793	+	NM_173483	15636147	15662282	14
chr19	15726028	15740447	CYP4F8	14419	+	NM_007253	15726427	15740168	13
chr19	15751706	15771570	CYP4F3	19864	+	NM_001199209	15752225	15770195	13
chr19	15783827	15807984	CYP4F12	24157	+	NM_023944	15784339	15807895	13
chr19	15838833	15839862	OR10H2	1029	+	NM_013939	15838853	15839801	1
chr19	15852202	15853153	OR10H3	951	+	NM_013938	15852202	15853153	1
chr19	15870143	15890798	CYP4F24P	20655	-	NR_033864	15890798	15890798	10
chr19	15904858	15905806	OR10H5	948	+	NM_001004466	15904858	15905806	1
chr19	15917816	15918936	OR10H1	1120	-	NM_013940	15917890	15918847	1
chr19	15939756	15947131	UCA1	7375	+	NR_015379	15947131	15947131	3
chr19	15962803	15975714	LOC102724279	12911	-	NM_001302493	15962920	15975697	3
chr19	15988833	16008930	CYP4F2	20097	-	NM_001082	15989580	16008421	13
chr19	16023179	16045676	CYP4F11	22497	-	NM_001128932	16024541	16045218	13
chr19	16059817	16060768	OR10H4	951	+	NM_001004465	16059817	16060768	1
chr19	16126443	16138272	LINC00661	11829	+	NR_026828	16138272	16138272	9
chr19	16144522	16152945	LINC00905	8423	+	NR_024335	16152945	16152945	5
chr19	16178316	16213813	TPM4	35497	+	NM_001145160	16178434	16212156	9
chr19	16222489	16244445	RAB8A	21956	+	NM_005370	16222711	16243114	8
chr19	16244837	16269384	HSH2D	24547	+	NM_032855	16259560	16268605	9
chr19	16272178	16284336	CIB3	12158	-	NM_054113	16272275	16284286	6
chr19	16296211	16302857	FAM32A	6646	+	NM_014077	16296253	16301766	4
chr19	16308664	16346156	AP1M1	37492	+	NM_001130524	16308837	16345246	13
chr19	16435650	16438339	KLF2	2689	+	NM_016270	16435734	16437842	3
chr19	16466054	16582823	EPS15L1	116769	-	NM_001258374	16466515	16582756	24
chr19	16589867	16607003	CALR3	17136	-	NM_145046	16589941	16606940	9
chr19	16607121	16632180	C19orf44	25059	+	NM_032207	16611603	16628112	9
chr19	16628699	16653263	CHERP	24564	-	NM_006387	16629969	16653189	17
chr19	16660647	16683193	SLC35E1	22546	-	NM_024881	16664489	16683175	6
chr19	16685717	16739015	MED26	53298	-	NM_004831	16686837	16738754	3
chr19	16756958	16770968	SMIM7	14010	-	NM_024104	16758056	16770921	5
chr19	16771937	16799816	TMEM38A	27879	+	NM_024074	16772028	16799182	6
chr19	16830786	16928774	NWD1	97988	+	NM_001290355	16855867	16926140	21
chr19	16940197	16991164	SIN3B	50967	+	NM_015260	16940231	16989538	20
chr19	16999825	17002830	F2RL3	3005	+	NM_003950	17000000	17001432	2
chr19	17003761	17137625	CPAMD8	133864	-	NM_015692	17003918	17137593	42
chr19	17160570	17186343	HAUS8	25773	-	NM_033417	17160682	17186232	11
chr19	17186590	17324104	MYO9B	137514	+	NM_001130065	17212527	17322594	40
chr19	17326154	17330638	USE1	4484	+	NM_018467	17326214	17330622	8
chr19	17337012	17340028	OCEL1	3016	+	NM_024578	17337056	17339734	6
chr19	17342693	17356151	NR2F6	13458	-	NM_005234	17343160	17356029	4
chr19	17360829	17375605	USHBP1	14776	-	NM_001297703	17361033	17375065	12
chr19	17378184	17390162	BABAM1	11978	+	NM_014173	17379615	17389857	9
chr19	17392453	17398455	ANKLE1	6002	+	NM_001278445	17392658	17397361	9
chr19	17402939	17414282	ABHD8	11343	-	NM_024527	17403469	17412425	5
chr19	17416476	17417652	MRPL34	1176	+	NM_023937	17416701	17417188	2
chr19	17420336	17434106	DDA1	13770	+	NM_024050	17420463	17430465	5
chr19	17434031	17445638	ANO8	11607	-	NM_020959	17434325	17445479	18
chr19	17445790	17453540	GTPBP3	7750	+	NM_001195422	17445812	17452512	9
chr19	17462256	17488158	PLVAP	25902	-	NM_031310	17463170	17488097	6
chr19	17513747	17516457	BST2	2710	-	NM_004335	17514503	17516384	5
chr19	17516494	17526545	BISPR	10051	+	NR_130765	17526545	17526545	5
chr19	17516494	17536148	MVB12A	19654	+	NM_001304547	17531433	17535802	10
chr19	17546317	17559376	TMEM221	13059	-	NM_001190844	17547266	17559271	3
chr19	17566233	17571725	NXNL1	5492	-	NM_138454	17566455	17571678	2
chr19	17581252	17616977	SLC27A1	35725	+	NM_198580	17581349	17615421	12
chr19	17622431	17632097	PGLS	9666	+	NM_012088	17622481	17631890	5
chr19	17634109	17664648	FAM129C	30539	+	NM_173544	17634247	17664372	16
chr19	17666402	17693971	COLGALT1	27569	+	NM_024656	17666522	17692253	12
chr19	17712136	17799008	UNC13A	86872	-	NM_001080421	17716862	17799008	42
chr19	17830260	17845324	MAP1S	15064	+	NM_018174	17830311	17845237	7
chr19	17858526	17899377	FCHO1	40851	+	NM_001161357	17865973	17899107	29
chr19	17905918	17924385	B3GNT3	18467	+	NM_014256	17918616	17922931	3
chr19	17927321	17932383	INSL3	5062	-	NM_001265587	17927679	17932315	3
chr19	17935592	17958841	JAK3	23249	-	NM_000215	17937551	17955226	24
chr19	17970686	17974133	RPL18A	3447	+	NM_000980	17970765	17974072	5
chr19	17973396	17973529	SNORA68	133	+	NR_000012	17973529	17973529	1
chr19	17982781	18005983	SLC5A5	23202	+	NM_000453	17983128	18004686	15
chr19	18043823	18054794	CCDC124	10971	+	NM_001136203	18047229	18054524	5
chr19	18062110	18109930	KCNN1	47820	+	NM_002248	18084697	18109215	11
chr19	18111940	18124911	ARRDC2	12971	+	NM_001025604	18112123	18123775	8
chr19	18169804	18209626	IL12RB1	39822	-	NM_001290024	18170417	18209575	18
chr19	18208602	18262499	MAST3	53897	+	NM_015016	18208602	18260536	27
chr19	18263987	18281343	PIK3R2	17356	+	NM_005027	18266689	18280104	16
chr19	18284589	18288934	IFI30	4345	+	NM_006332	18284651	18288721	7
chr19	18304039	18307550	MPV17L2	3511	+	NM_032683	18304091	18306865	5
chr19	18307610	18314874	RAB3A	7264	-	NM_002866	18308279	18313550	5
chr19	18318770	18359010	PDE4C	40240	-	NM_000923	18321738	18344001	16
chr19	18360759	18366229	LOC729966	5470	-	NR_036575	18366229	18366229	4
chr19	18367905	18385319	KIAA1683	17414	-	NM_001145305	18367989	18378211	4
chr19	18390503	18392466	JUND	1963	-	NM_005354	18391250	18392294	1
chr19	18392886	18392971	MIR3188	85	+	NR_036155	18392971	18392971	1
chr19	18417039	18434001	LSM4	16962	-	NM_012321	18418273	18433830	5
chr19	18451396	18480763	PGPEP1	29367	+	NM_017712	18451491	18474393	5
chr19	18496967	18499986	GDF15	3019	+	NM_004864	18496999	18499745	2
chr19	18497371	18497444	MIR3189	73	+	NR_036156	18497444	18497444	1
chr19	18501953	18508415	LRRC25	6462	-	NM_145256	18502796	18507773	2
chr19	18530145	18545372	SSBP4	15227	+	NM_032627	18530458	18545056	18
chr19	18545197	18549111	ISYNA1	3914	-	NM_016368	18545722	18548789	11
chr19	18553472	18632937	ELL	79465	-	NM_006532	18555561	18632865	12
chr19	18642561	18654406	FKBP8	11845	-	NM_012181	18642978	18652780	9
chr19	18668571	18680197	KXD1	11626	+	NM_001171948	18672866	18679441	6
chr19	18682613	18688270	UBA52	5657	+	NM_003333	18684110	18685960	5
chr19	18699494	18703147	C19orf60	3653	+	NM_001100419	18699611	18702990	5
chr19	18704034	18717660	CRLF1	13626	-	NM_004750	18704375	18717466	9
chr19	18723681	18731849	TMEM59L	8168	+	NM_012109	18723768	18731346	8
chr19	18747837	18781302	KLHL26	33465	+	NM_018316	18747864	18780055	3
chr19	18794424	18893143	CRTC1	98719	+	NM_001098482	18794512	18888192	15
chr19	18893582	18902114	COMP	8532	-	NM_000095	18893724	18902078	19
chr19	18942743	18979041	UPF1	36298	+	NM_001297549	18943018	18976972	24
chr19	18979354	19006953	CERS1	27599	-	NM_021267	18981385	19006881	8
chr19	18979354	19006953	GDF1	27599	-	NM_001492	18979405	18981116	8
chr19	19010322	19030199	COPE	19877	-	NM_007263	19010487	19030157	10
chr19	19030483	19039442	DDX49	8959	+	NM_019070	19030550	19039125	13
chr19	19040009	19052041	HOMER3	12032	-	NM_004838	19040251	19049791	10
chr19	19101696	19144380	SUGP2	42684	-	NM_014884	19105174	19141880	11
chr19	19144386	19168987	ARMC6	24601	+	NM_001199196	19145018	19168437	9
chr19	19174802	19223841	SLC25A42	49039	+	NM_178526	19206933	19221685	8
chr19	19230424	19249310	TMEM161A	18886	-	NM_017814	19230738	19249237	12
chr19	19256375	19281098	MEF2B	24723	-	NM_001145785	19256605	19261544	9
chr19	19256375	19303400	MEF2BNB-MEF2B	47025	-	NR_027307	19303400	19303400	13
chr19	19287712	19303400	BORCS8	15688	-	NM_001145784	19291536	19302926	6
chr19	19303007	19312678	RFXANK	9671	+	NM_003721	19304755	19312528	10
chr19	19312219	19314238	NR2C2AP	2019	-	NM_001300945	19312282	19313869	6
chr19	19322781	19363061	NCAN	40280	+	NM_004386	19327762	19360720	15
chr19	19366451	19373596	HAPLN4	7145	-	NM_023002	19368625	19373541	5
chr19	19375173	19384074	TM6SF2	8901	-	NM_001001524	19375472	19384024	10
chr19	19387321	19431321	SUGP1	44000	-	NM_172231	19387456	19431305	14
chr19	19431629	19469563	MAU2	37934	+	NM_015329	19431668	19466591	19
chr19	19496641	19619741	GATAD2A	123100	+	NM_017660	19576154	19616283	12
chr19	19545871	19545967	MIR640	96	+	NR_030370	19545967	19545967	1
chr19	19625027	19626469	TSSK6	1442	-	NM_032037	19625414	19626236	1
chr19	19627018	19639013	NDUFA13	11995	+	NM_015965	19627047	19638935	5
chr19	19639669	19648393	YJEFN3	8724	+	NM_198537	19639741	19648333	7
chr19	19649073	19657468	CILP2	8395	+	NM_153221	19649158	19656825	8
chr19	19672515	19729725	PBX4	57210	-	NM_025245	19672833	19729438	8
chr19	19734465	19739039	LPAR2	4574	-	NM_004720	19735064	19738093	3
chr19	19740281	19754476	GMIP	14195	-	NM_016573	19740771	19754338	21
chr19	19756009	19774503	ATP13A1	18494	-	NM_020410	19756230	19774475	26
chr19	19778961	19794315	ZNF101	15354	+	NM_001300949	19790158	19791109	4
chr19	19821280	19843921	ZNF14	22641	-	NM_021030	19822160	19843767	4
chr19	19867180	19887222	LINC00663	20042	-	NR_026956	19887222	19887222	3
chr19	19903519	19932560	ZNF506	29041	-	NM_001099269	19905360	19932412	4
chr19	19976713	20004293	ZNF253	27580	+	NM_021047	19976805	20003556	4
chr19	20011721	20046382	ZNF93	34661	+	NM_031218	20011897	20045627	4
chr19	20115226	20150277	ZNF682	35051	-	NM_033196	20116813	20150154	4
chr19	20188802	20231977	ZNF90	43175	+	NM_007138	20188941	20230169	4
chr19	20278022	20311299	ZNF486	33277	+	NM_052852	20278139	20308911	4
chr19	20510080	20510163	MIR1270	83	-	NR_036053	20510163	20510163	1
chr19	20578625	20607771	ZNF826P	29146	-	NR_036455	20607771	20607771	3
chr19	20720797	20748626	ZNF737	27829	-	NM_001159293	20727397	20748446	4
chr19	20802744	20844402	ZNF626	41658	-	NM_001076675	20807095	20844252	4
chr19	21106058	21133503	ZNF85	27445	+	NM_001256171	21106206	21133108	5
chr19	21203425	21242852	ZNF430	39427	+	NM_001172671	21203606	21240827	5
chr19	21264952	21307883	ZNF714	42931	+	NR_117086	21307883	21307883	7
chr19	21324839	21368805	ZNF431	43966	+	NM_133473	21324986	21366837	5
chr19	21473961	21512241	ZNF708	38280	-	NM_001297560	21476075	21492081	4
chr19	21541734	21571384	ZNF738	29650	+	NR_027130	21571384	21571384	5
chr19	21579920	21610296	ZNF493	30376	+	NM_001076678	21580039	21607786	4
chr19	21666516	21686040	LINC00664	19524	+	NR_037194	21686040	21686040	11
chr19	21688436	21721079	ZNF429	32643	+	NM_001001415	21688573	21720880	4
chr19	21906842	21950430	ZNF100	43588	-	NM_173531	21909484	21950231	5
chr19	21933546	21936240	LOC641367	2694	+	NR_024523	21936240	21936240	1
chr19	21987750	22034870	ZNF43	47120	-	NM_001256649	21990408	22002008	7
chr19	22148896	22193745	ZNF208	44849	-	NM_007153	22153992	22193596	4
chr19	22235249	22273903	ZNF257	38654	+	NM_001316997	22270780	22272244	5
chr19	22361902	22379753	ZNF676	17851	-	NM_001001411	22362751	22379435	3
chr19	22469251	22499978	ZNF729	30727	+	NM_001242680	22469327	22499978	4
chr19	22573898	22605148	ZNF98	31250	-	NM_001098626	22574317	22605026	4
chr19	22703796	22710751	LOC101929124	6955	-	NR_110427	22710751	22710751	5
chr19	22715427	22716296	LINC01233	869	+	NR_110664	22716296	22716296	2
chr19	22779058	22786352	GOLGA2P9	7294	+	NR_033899	22786352	22786352	10
chr19	22790817	22791303	LOC100996349	486	+	NR_103470	22791303	22791303	1
chr19	22817125	22850472	ZNF492	33347	+	NM_020855	22836201	22848067	4
chr19	22934984	22966973	ZNF99	31989	-	NM_001080409	22940115	22966818	4
chr19	23157684	23186010	ZNF728	28326	-	NM_001267716	23158269	23185832	4
chr19	23197876	23206499	LOC101929164	8623	-	NR_110746	23206499	23206499	4
chr19	23237624	23244067	LOC101929144	6443	-	NR_110745	23244067	23244067	8
chr19	23299776	23330014	ZNF730	30238	+	NM_001277403	23299975	23329358	4
chr19	23406606	23433172	ZNF724P	26566	-	NR_045525	23433172	23433172	4
chr19	23437855	23457053	IPO5P1	19198	-	NR_103741	23457053	23457053	5
chr19	23540497	23578362	ZNF91	37865	-	NM_003430	23542204	23578156	4
chr19	23582035	23598876	LINC01224	16841	-	NR_126448	23598876	23598876	6
chr19	23835707	23870017	ZNF675	34310	-	NM_138330	23836027	23869835	4
chr19	23921996	23941693	ZNF681	19697	-	NM_138286	23926413	23941551	4
chr19	23945815	24010919	RPSAP58	65104	+	NR_003662	24010919	24010919	4
chr19	24097683	24116769	ZNF726	19086	+	NM_001244038	24097796	24116769	4
chr19	24216206	24312769	ZNF254	96563	+	NM_001278677	24288834	24310782	6
chr19	24344994	24346249	HAVCR1P1	1255	-	NR_003603	24346249	24346249	1
chr19	28281400	28284848	LINC00662	3448	-	NR_027301	28284848	28284848	3
chr19	28284374	28297688	LOC101927151	13314	+	NR_110689	28297688	28297688	3
chr19	28926295	29218601	LOC100420587	292306	-	NR_110759	29218601	29218601	10
chr19	29456037	29460055	LINC00906	4018	+	NR_027318	29460055	29460055	2
chr19	29459374	29461579	LOC102724958	2205	+	NR_110760	29461579	29461579	4
chr19	29493461	29504862	LINC01532	11401	+	NR_040036	29504862	29504862	5
chr19	29698166	29704136	UQCRFS1	5970	-	NM_006003	29698454	29704025	2
chr19	29777917	30016659	LOC284395	238742	-	NR_040029	30016659	30016659	10
chr19	30017490	30055226	VSTM2B	37736	+	NM_001146339	30017490	30054841	5
chr19	30097169	30108162	POP4	10993	+	NM_006627	30097225	30106287	7
chr19	30156326	30166383	PLEKHF1	10057	+	NM_024310	30164746	30165586	2
chr19	30189792	30206696	C19orf12	16904	-	NM_001256047	30193618	30199320	3
chr19	30302900	30315215	CCNE1	12315	+	NM_001238	30303462	30314684	12
chr19	30414550	30507519	URI1	92969	+	NM_001252641	30414598	30506499	11
chr19	30863299	31048966	ZNF536	185667	+	NM_014717	30934469	31048071	5
chr19	31765850	31840190	TSHZ3	74340	-	NM_020856	31767452	31840125	2
chr19	32079094	32084456	THEG5	5362	+	NM_001278576	32083522	32083945	4
chr19	32516767	32539805	LINC01533	23038	+	NR_110675	32539805	32539805	5
chr19	32592997	32596822	LOC101927411	3825	-	NR_110694	32596822	32596822	4
chr19	32836513	32878573	ZNF507	42060	+	NM_001136156	32843736	32873989	7
chr19	32880955	32896445	LOC400684	15490	-	NR_046201	32896445	32896445	3
chr19	32896654	32976799	DPY19L3	80145	+	NM_001172774	32899159	32973146	19
chr19	33072093	33078358	PDCD5	6265	+	NM_004708	33072167	33078206	6
chr19	33087906	33166102	ANKRD27	78196	-	NM_032139	33089050	33149921	29
chr19	33166312	33169206	RGS9BP	2894	+	NM_207391	33167169	33167877	1
chr19	33182866	33204702	NUDT19	21836	+	NM_001105570	33182866	33202863	3
chr19	33210678	33281714	TDRD12	71036	+	NM_001110822	33210978	33281585	13
chr19	33321418	33360683	SLC7A9	39265	-	NM_014270	33321525	33359440	13
chr19	33369903	33462935	CEP89	93032	-	NM_032816	33370067	33462780	19
chr19	33463122	33468401	FAAP24	5279	+	NM_152266	33464102	33467588	5
chr19	33469497	33555824	RHPN2	86327	-	NM_033103	33470901	33555758	15
chr19	33571785	33621318	GPATCH1	49533	+	NM_018025	33572099	33621066	20
chr19	33622997	33666703	WDR88	43706	+	NM_173479	33623075	33666478	11
chr19	33685598	33699773	LRP3	14175	+	NM_002333	33685691	33698481	7
chr19	33699569	33716756	SLC7A10	17187	-	NM_019849	33699796	33716609	11
chr19	33790839	33793470	CEBPA	2631	-	NM_001287435	33792243	33793278	1
chr19	33793762	33795963	CEBPA-AS1	2201	+	NR_026887	33795963	33795963	1
chr19	33864574	33873592	CEBPG	9018	+	NM_001806	33870145	33870598	2
chr19	33877854	34012799	PEPD	134945	-	NM_000285	33878249	34012666	15
chr19	34112860	34264414	CHST8	151554	+	NM_001127895	34180167	34263968	5
chr19	34287750	34306666	KCTD15	18916	+	NM_001129995	34291359	34303853	7
chr19	34663351	34720420	LSM14A	57069	+	NM_001114093	34663547	34717336	11
chr19	34745455	34846471	KIAA0355	101016	+	NM_014686	34791378	34843860	14
chr19	34855644	34893318	GPI	37674	+	NM_001289789	34855814	34890941	19
chr19	34895302	34917072	PDCD2L	21770	+	NM_032346	34895335	34917025	7
chr19	34919267	34960798	UBA2	41531	+	NM_005499	34919337	34960126	17
chr19	34972879	34992085	WTIP	19206	+	NM_001080436	34972879	34991174	8
chr19	35067637	35068596	SCGB1B2P	959	-	NR_027620	35068596	35068596	3
chr19	35084345	35085490	SCGB2B2	1145	-	NM_001025591	35084459	35085468	3
chr19	35136777	35136957	SCGB2B3P	180	+	NR_045208	35136957	35136957	1
chr19	35168543	35177302	ZNF302	8759	+	NM_001289181	35169709	35176142	6
chr19	35225479	35233774	ZNF181	8295	+	NM_001029997	35225942	35233002	4
chr19	35248978	35264134	ZNF599	15156	-	NM_001007248	35249938	35263746	4
chr19	35307057	35323773	LOC400685	16716	-	NR_033982	35323773	35323773	6
chr19	35382932	35389847	LINC00904	6915	-	NR_046222	35389847	35389847	3
chr19	35413918	35417730	ZNF30-AS1	3812	-	NR_110749	35417730	35417730	3
chr19	35417806	35436076	ZNF30	18270	+	NR_024018	35436076	35436076	6
chr19	35447257	35454953	ZNF792	7696	-	NM_175872	35448859	35454566	4
chr19	35491245	35517373	GRAMD1A	26128	+	NM_020895	35491382	35517045	20
chr19	35521591	35531353	SCN1B	9762	+	NM_001037	35521724	35530605	6
chr19	35531409	35557477	HPN	26068	+	NM_002151	35533410	35557191	14
chr19	35549962	35597208	HPN-AS1	47246	-	NR_024562	35597208	35597208	4
chr19	35606731	35615228	FXYD3	8497	+	NM_001136007	35608209	35614361	11
chr19	35613603	35613668	MIR6887	65	+	NR_106947	35613668	35613668	1
chr19	35615416	35626178	LGI4	10762	-	NM_139284	35616096	35625584	9
chr19	35629692	35633959	FXYD1	4267	+	NM_021902	35630983	35633646	8
chr19	35634153	35645205	FXYD7	11052	+	NM_022006	35634237	35644819	6
chr19	35645624	35660788	FXYD5	15164	+	NM_014164	35646453	35660518	9
chr19	35715703	35719628	FAM187B	3925	-	NM_152481	35715727	35719583	2
chr19	35739558	35758867	LSR	19309	+	NM_205834	35739781	35758762	10
chr19	35759895	35770718	USF2	10823	+	NM_003367	35760004	35770159	10
chr19	35773248	35776045	HAMP	2797	+	NM_021175	35773480	35775945	3
chr19	35782988	35804709	MAG	21721	+	NM_080600	35786311	35803216	12
chr19	35820071	35838264	CD22	18193	+	NM_001771	35822943	35837600	14
chr19	35836415	35836530	MIR5196	115	+	NR_049828	35836530	35836530	1
chr19	35842444	35843367	FFAR1	923	+	NM_005303	35842454	35843357	1
chr19	35849487	35851389	FFAR3	1902	+	NM_005304	35849792	35850833	2
chr19	35896508	35907742	LINC01531	11234	+	NR_040046	35907742	35907742	5
chr19	35940616	35942669	FFAR2	2053	+	NM_005306	35940616	35941609	1
chr19	35978225	35981433	KRTDAP	3208	-	NM_207392	35978329	35981344	6
chr19	35988118	36004560	DMKN	16442	-	NM_001126056	35989617	36004377	18
chr19	36014268	36019253	SBSN	4985	-	NM_198538	36014411	36019183	5
chr19	36024313	36036221	GAPDHS	11908	+	NM_014364	36024429	36036072	11
chr19	36031639	36036931	TMEM147-AS1	5292	-	NR_038396	36036931	36036931	4
chr19	36036501	36038429	TMEM147	1928	+	NM_032635	36036641	36038349	7
chr19	36041094	36054560	ATP4A	13466	-	NM_000704	36041516	36054531	22
chr19	36088796	36092403	LOC102723617	3607	+	NR_110750	36092403	36092403	3
chr19	36103645	36116251	HAUS5	12606	+	NM_015302	36103696	36113895	19
chr19	36119979	36128587	RBM42	8608	+	NM_024321	36120055	36128456	10
chr19	36132638	36135773	ETV2	3135	+	NM_014209	36133362	36135754	7
chr19	36139124	36149686	COX6B1	10562	+	NM_001863	36142145	36149549	4
chr19	36157417	36169387	UPK1A	11970	+	NM_001281443	36157714	36168789	9
chr19	36158849	36164193	UPK1A-AS1	5344	-	NR_046420	36164193	36164193	2
chr19	36195388	36207940	ZBTB32	12552	+	NM_001316902	36203930	36207654	7
chr19	36208920	36229781	KMT2B	20861	+	NM_014727	36208920	36229458	37
chr19	36230150	36233351	IGFLR1	3201	-	NM_024660	36230180	36232081	5
chr19	36233427	36236343	U2AF1L4	2916	-	NR_110171	36236343	36236343	8
chr19	36236477	36238056	PSENEN	1579	+	NM_172341	36236831	36237748	4
chr19	36239261	36245420	LIN37	6159	+	NM_019104	36239625	36245375	9
chr19	36245466	36247930	HSPB6	2464	-	NM_144617	36246422	36247909	3
chr19	36249043	36260077	PROSER3	11034	+	NM_001039887	36249116	36259447	12
chr19	36266416	36279724	ARHGAP33	13308	+	NM_052948	36266560	36279331	21
chr19	36279777	36288811	LINC01529	9034	-	NR_104176	36288811	36288811	8
chr19	36290891	36304201	PRODH2	13310	-	NM_021232	36290939	36304183	11
chr19	36316273	36342895	NPHS1	26622	-	NM_004646	36317415	36342739	29
chr19	36347809	36358048	KIRREL2	10239	+	NM_199180	36348021	36357394	15
chr19	36359400	36370699	APLP1	11299	+	NM_005166	36359538	36370343	17
chr19	36379142	36391552	NFKBID	12410	-	NM_139239	36379460	36388558	12
chr19	36393381	36395173	HCST	1792	+	NM_014266	36393495	36395062	4
chr19	36395302	36399211	TYROBP	3909	-	NM_003332	36395470	36399130	5
chr19	36428021	36436097	LRFN3	8076	+	NM_024509	36430327	36435921	3
chr19	36486089	36487220	SDHAF1	1131	+	NM_001042631	36486176	36486524	1
chr19	36494200	36499695	SYNE4	5495	-	NM_001039876	36494238	36499583	8
chr19	36500017	36505145	ALKBH6	5128	-	NM_001297701	36500191	36504299	8
chr19	36505400	36536899	LOC101927572	31499	+	NM_001290056	36507814	36536819	4
chr19	36505561	36523797	CLIP3	18236	-	NM_015526	36507059	36523259	14
chr19	36525886	36545664	THAP8	19778	-	NM_152658	36526341	36545119	4
chr19	36545782	36596012	WDR62	50230	+	NM_173636	36545873	36595930	32
chr19	36602104	36604613	OVOL3	2509	+	NM_001302757	36602104	36604563	4
chr19	36604610	36606206	POLR2I	1596	-	NM_006233	36604656	36605758	6
chr19	36605887	36616849	TBCB	10962	+	NM_001281	36606462	36616684	6
chr19	36630827	36641255	CAPNS1	10428	+	NM_001749	36631913	36640741	11
chr19	36641823	36643771	COX7A1	1948	-	NM_001864	36641883	36643309	4
chr19	36672961	36705986	ZNF565	33025	-	NM_001042474	36673367	36692887	5
chr19	36705503	36729675	ZNF146	24172	+	NM_007145	36727342	36728221	4
chr19	36802244	36803570	LOC100134317	1326	+	NR_029389	36803570	36803570	2
chr19	36803962	36822620	LINC00665	18658	-	NR_038279	36822620	36822620	6
chr19	36825354	36870105	ZFP14	44751	-	NM_020917	36831125	36858794	5
chr19	36882860	36909550	ZFP82	26690	-	NM_133466	36883642	36900691	5
chr19	36912075	36913799	LOC644189	1724	+	NR_033748	36913799	36913799	1
chr19	36936020	36980804	ZNF566	44784	-	NM_001300970	36939878	36940823	4
chr19	36980528	36981942	LOC728752	1414	+	NR_036504	36981942	36981942	1
chr19	37001588	37019248	ZNF260	17660	-	NM_001166036	37004901	37006140	4
chr19	37034516	37096178	ZNF529	61662	-	NM_001145649	37037767	37063248	6
chr19	37063971	37085618	ZNF529-AS1	21647	+	NR_110705	37085618	37085618	5
chr19	37096206	37119499	ZNF382	23293	+	NM_032825	37100816	37118452	5
chr19	37128282	37157755	ZNF461	29473	-	NM_153257	37129554	37155608	6
chr19	37176340	37178351	LINC01534	2011	-	NR_110708	37178351	37178351	4
chr19	37178513	37212238	ZNF567	33725	+	NM_001300979	37185769	37211570	6
chr19	37234379	37263716	ZNF850	29337	-	NM_001193552	37238668	37253508	5
chr19	37264019	37267980	LOC728485	3961	+	NM_001294306	37264033	37266415	2
chr19	37288451	37319013	ZNF790-AS1	30562	+	NR_040027	37319013	37319013	6
chr19	37309223	37341689	ZNF790	32466	-	NM_001242800	37309334	37316521	5
chr19	37341787	37384120	ZNF345	42333	+	NR_038362	37384120	37384120	3
chr19	37379025	37407193	ZNF829	28168	-	NM_001037232	37382393	37406069	6
chr19	37407230	37488834	ZNF568	81604	+	NM_001204838	37413672	37488501	10
chr19	37569381	37620651	ZNF420	51270	+	NM_144689	37580020	37619960	5
chr19	37638339	37663643	ZNF585A	25304	-	NM_152655	37642490	37647164	6
chr19	37672480	37701451	ZNF585B	28971	-	NM_152279	37676128	37698013	5
chr19	37717365	37734574	ZNF383	17209	+	NM_152604	37721355	37734566	5
chr19	37742786	37756437	LINC01535	13651	+	NR_110720	37756437	37756437	6
chr19	37756840	37759912	LOC284412	3072	-	NR_029390	37759912	37759912	2
chr19	37825579	37855357	HKR1	29778	+	NM_181786	37835586	37854677	6
chr19	37862058	37883966	ZNF527	21908	+	NM_032453	37865100	37880781	5
chr19	37902059	37958339	ZNF569	56280	-	NM_152484	37903498	37935823	6
chr19	37958673	37976260	ZNF570	17587	+	NM_001300993	37958792	37976135	6
chr19	37988062	37997989	ZNF793-AS1	9927	-	NR_110723	37997989	37997989	3
chr19	37997840	38034239	ZNF793	36399	+	NM_001013659	38014341	38028781	8
chr19	38039850	38078248	ZNF571-AS1	38398	+	NR_038248	38078248	38078248	6
chr19	38042272	38105079	ZNF540	62807	+	NM_152606	38089348	38104164	5
chr19	38055154	38085693	ZNF571	30539	-	NM_001290314	38055499	38077577	5
chr19	38123388	38146313	ZFP30	22925	-	NM_014898	38125881	38138723	6
chr19	38158649	38183216	ZNF781	24567	-	NM_152605	38160065	38161049	4
chr19	38187263	38210691	ZNF607	23428	-	NM_032689	38188940	38202519	5
chr19	38229202	38270230	ZNF573	41028	-	NM_152360	38229392	38249236	8
chr19	38308050	38317278	LOC644554	9228	+	NR_040013	38317278	38317278	5
chr19	38314362	38345836	LOC100631378	31474	-	NR_040015	38345836	38345836	6
chr19	38375462	38397346	WDR87	21884	-	NM_001291088	38375571	38388879	6
chr19	38397860	38699012	SIPA1L3	301152	+	NM_015073	38572205	38696880	22
chr19	38701645	38720354	DPF1	18709	-	NM_001135156	38702702	38713212	12
chr19	38741876	38747231	PPP1R14A	5355	-	NM_033256	38741957	38746979	4
chr19	38755097	38783254	SPINT2	28157	+	NM_021102	38755532	38782646	7
chr19	38794199	38806606	YIF1B	12407	-	NM_001145463	38796128	38806557	9
chr19	38794800	38795646	C19orf33	846	+	NM_001317801	38794901	38795324	4
chr19	38810483	38819649	KCNK6	9166	+	NM_004823	38810590	38818043	3
chr19	38826442	38861589	CATSPERG	35147	+	NM_021185	38827874	38861432	29
chr19	38865189	38874464	PSMD8	9275	+	NM_002812	38865241	38874030	7
chr19	38874991	38878668	GGN	3677	-	NM_152657	38875051	38877901	4
chr19	38880839	38890523	SPRED3	9684	+	NM_001042522	38880942	38886785	5
chr19	38893774	38899728	FAM98C	5954	+	NM_174905	38893793	38899522	8
chr19	38899697	38916945	RASGRP4	17248	-	NM_001146205	38900679	38916731	17
chr19	38924339	39078204	RYR1	153865	+	NM_000540	38924469	39078060	106
chr19	39078279	39108675	MAP4K1	30396	-	NM_007181	39078449	39108535	32
chr19	39109711	39127599	EIF3K	17888	+	NM_001308393	39114819	39127560	8
chr19	39138266	39221171	ACTN4	82905	+	NM_004924	39138385	39220072	21
chr19	39220831	39235114	CAPN12	14283	-	NM_144691	39221491	39234805	21
chr19	39261607	39264157	LGALS7	2550	-	NM_002307	39261665	39264132	4
chr19	39279849	39282394	LGALS7B	2545	+	NM_001042507	39279866	39282333	4
chr19	39292310	39303740	LGALS4	11430	-	NM_006149	39292403	39303526	10
chr19	39306061	39322497	ECH1	16436	-	NM_001398	39306252	39322412	10
chr19	39327027	39342979	HNRNPL	15952	-	NM_001005335	39327361	39336717	13
chr19	39358471	39368919	RINL	10448	-	NM_001195833	39359743	39367382	12
chr19	39369194	39390502	SIRT2	21308	-	NM_030593	39369794	39384459	15
chr19	39390339	39399534	NFKBIB	9195	+	NM_001243116	39395733	39399472	6
chr19	39399619	39402798	CCER2	3179	-	NM_001243212	39399875	39402798	5
chr19	39405903	39421536	SARS2	15633	-	NM_001145901	39406245	39421376	17
chr19	39421347	39423659	MRPS12	2312	+	NM_033362	39421934	39423340	3
chr19	39432040	39466453	FBXO17	34413	-	NR_104026	39466453	39466453	6
chr19	39514662	39523236	FBXO27	8574	-	NM_178820	39516050	39522867	6
chr19	39574944	39602128	ACP7	27184	+	NM_001004318	39575909	39600758	13
chr19	39616419	39670046	PAK4	53627	+	NM_001014831	39660193	39669219	11
chr19	39687603	39692522	NCCRP1	4919	+	NM_001001414	39687622	39691396	6
chr19	39693561	39694906	SYCN	1345	-	NM_001080468	39693626	39694894	2
chr19	39734271	39735611	IFNL3	1340	-	NM_172139	39734271	39735607	5
chr19	39736953	39739496	IFNL4	2543	-	NM_001276254	39737772	39739219	6
chr19	39759156	39760732	IFNL2	1576	+	NM_172138	39759208	39760653	6
chr19	39786964	39789312	IFNL1	2348	+	NM_172140	39787061	39789156	5
chr19	39797456	39805976	LRFN1	8520	-	NM_020862	39798272	39805976	2
chr19	39818996	39826726	GMFG	7730	-	NM_004877	39819116	39826616	7
chr19	39833098	39875537	SAMD4B	42439	+	NM_018028	39847533	39874167	16
chr19	39876269	39881835	PAF1	5566	-	NM_019088	39876630	39881504	14
chr19	39881942	39891277	MED29	9335	+	NM_017592	39881999	39888339	4
chr19	39897486	39900052	ZFP36	2566	+	NM_003407	39897526	39899339	2
chr19	39900262	39900318	MIR4530	56	-	NR_039755	39900318	39900318	1
chr19	39903749	39919055	PLEKHG2	15306	+	NM_022835	39904726	39915934	19
chr19	39923846	39926618	RPS16	2772	-	NM_001020	39923912	39926535	5
chr19	39936185	39967308	SUPT5H	31123	+	NM_001111020	39936530	39967039	30
chr19	39971051	39983659	TIMM50	12608	+	NM_001001563	39971184	39980460	11
chr19	39989556	39999121	DLL3	9565	+	NM_203486	39989614	39998897	9
chr19	40005752	40011326	SELV	5574	+	NM_182704	40005852	40009788	6
chr19	40022172	40023507	EID2B	1335	-	NM_152361	40022956	40023442	1
chr19	40029446	40030838	EID2	1392	-	NM_153232	40030008	40030719	1
chr19	40093168	40098114	LGALS13	4946	+	NM_013268	40093208	40097979	4
chr19	40129324	40133041	LOC100129935	3717	+	NR_026870	40133041	40133041	4
chr19	40146533	40151287	LGALS16	4754	+	NM_001190441	40146601	40151160	4
chr19	40170013	40177013	LGALS17A	7000	+	NR_034156	40177013	40177013	8
chr19	40194945	40200088	LGALS14	5143	+	NM_203471	40196547	40199953	5
chr19	40221892	40228669	CLC	6777	-	NM_001828	40222019	40228592	4
chr19	40267233	40276775	LEUTX	9542	+	NM_001143832	40275249	40276775	3
chr19	40315986	40324873	DYRK1B	8887	-	NM_006484	40316354	40322507	12
chr19	40320355	40320442	MIR6719	87	-	NR_106777	40320442	40320442	1
chr19	40325092	40337054	FBL	11962	-	NM_001436	40325177	40336940	9
chr19	40353962	40440533	FCGBP	86571	-	NM_003890	40354126	40440525	36
chr19	40476911	40487671	PSMC4	10760	+	NM_006503	40477109	40487212	11
chr19	40502942	40526948	ZNF546	24006	+	NM_178544	40504233	40521688	7
chr19	40534166	40562115	ZNF780B	27949	-	NM_001005851	40540263	40556239	5
chr19	40575058	40596845	ZNF780A	21787	-	NM_001142579	40578763	40595169	9
chr19	40697650	40721482	MAP3K10	23832	+	NM_002446	40697938	40721199	10
chr19	40721964	40724306	TTC9B	2342	-	NM_152479	40722069	40724288	3
chr19	40728114	40732597	CNTD2	4483	-	NM_024877	40728958	40732548	5
chr19	40736223	40791302	AKT2	55079	-	NM_001626	40739778	40771174	14
chr19	40788449	40788548	MIR641	99	-	NR_030371	40788548	40788548	1
chr19	40826966	40854434	C19orf47	27468	-	NM_001256440	40827788	40854421	9
chr19	40854331	40884397	PLD3	30066	+	NM_001031696	40872390	40884080	13
chr19	40875752	40875814	MIR6796	62	+	NR_106854	40875814	40875814	1
chr19	40885177	40896128	HIPK4	10951	-	NM_144685	40885493	40895809	4
chr19	40899670	40919271	PRX	19601	-	NM_181882	40899872	40913839	7
chr19	40928408	40931932	SERTAD1	3524	-	NM_013376	40928742	40929453	2
chr19	40946747	40950282	SERTAD3	3535	-	NM_203344	40947396	40947987	2
chr19	40953690	40971725	BLVRB	18035	-	NM_000713	40953795	40971595	5
chr19	40973125	41082365	SPTBN4	109240	+	NM_020971	40978528	41081475	36
chr19	41082756	41097305	SHKBP1	14549	+	NM_138392	41082805	41097113	18
chr19	41099071	41135725	LTBP4	36654	+	NM_003573	41099071	41135455	33
chr19	41171811	41196563	NUMBL	24752	-	NM_004756	41173372	41196388	10
chr19	41197433	41222790	ADCK4	25357	-	NM_024876	41197939	41220537	15
chr19	41223007	41246765	ITPKC	23758	+	NM_025194	41223040	41245465	7
chr19	41246760	41255828	C19orf54	9068	-	NM_198476	41248337	41255708	6
chr19	41256758	41271297	SNRPA	14539	+	NM_004596	41257313	41271072	6
chr19	41281081	41283398	MIA	2317	+	NM_001202553	41281447	41283325	5
chr19	41281441	41302849	MIA-RAB4B	21408	+	NR_037775	41302849	41302849	10
chr19	41284123	41302849	RAB4B	18726	+	NM_016154	41284280	41292868	8
chr19	41284123	41314346	RAB4B-EGLN2	30223	+	NR_037791	41314346	41314346	12
chr19	41305047	41314346	EGLN2	9299	+	NM_080732	41306477	41313769	6
chr19	41349442	41356352	CYP2A6	6910	-	NM_000762	41349700	41356331	9
chr19	41381343	41388657	CYP2A7	7314	-	NM_000764	41381597	41388115	9
chr19	41396730	41406413	CYP2G1P	9683	+	NR_040249	41406413	41406413	5
chr19	41430169	41456565	CYP2B7P	26396	+	NR_001278	41456565	41456565	9
chr19	41497203	41524301	CYP2B6	27098	+	NM_000767	41497210	41522732	9
chr19	41594355	41602100	CYP2A13	7745	+	NM_000766	41594376	41601846	9
chr19	41620352	41634281	CYP2F1	13929	+	NM_000774	41622093	41633987	10
chr19	41699111	41713444	CYP2S1	14333	+	NM_030622	41699169	41712393	9
chr19	41725103	41767672	AXL	42569	+	NM_021913	41725297	41765809	20
chr19	41768380	41813597	HNRNPUL1	45217	+	NM_144732	41774132	41812470	15
chr19	41816093	41830788	CCDC97	14695	+	NM_052848	41816215	41828620	5
chr19	41836435	41859838	TGFB1	23403	-	NM_000660	41836956	41858949	7
chr19	41860321	41870078	B9D2	9757	-	NM_030578	41860604	41869424	4
chr19	41869870	41889987	TMEM91	20117	+	NM_001098825	41884214	41889809	4
chr19	41892275	41903256	EXOSC5	10981	-	NM_020158	41892537	41903233	6
chr19	41903693	41930910	BCKDHA	27217	+	NM_001164783	41903732	41930513	9
chr19	41931263	41934635	B3GNT8	3372	-	NM_198540	41931489	41932683	3
chr19	41937222	41945843	ATP5SL	8621	-	NM_018035	41938135	41945804	6
chr19	41949062	41950670	ERICH4	1608	+	NM_001130514	41949074	41950129	2
chr19	41960073	42006554	PCAT19	46481	-	NR_040109	42006554	42006554	4
chr19	42041859	42043266	LINC01480	1407	+	NR_110724	42043266	42043266	3
chr19	42055885	42093197	CEACAM21	37312	+	NM_001288773	42085665	42092224	8
chr19	42125343	42133442	CEACAM4	8099	-	NM_001817	42125702	42133331	7
chr19	42177234	42192206	CEACAM7	14972	-	NM_006890	42181339	42192094	5
chr19	42212503	42234341	CEACAM5	21838	+	NM_004363	42212650	42231236	10
chr19	42259427	42276113	CEACAM6	16686	+	NM_002483	42259546	42270167	6
chr19	42300521	42315591	CEACAM3	15070	+	NR_102333	42315591	42315591	8
chr19	42341147	42348736	LYPD4	7589	-	NM_173506	42341216	42343359	5
chr19	42349085	42356397	DMRTC2	7312	+	NM_001040283	42351496	42355764	9
chr19	42363987	42375484	RPS19	11497	+	NM_001022	42364844	42375445	6
chr19	42373696	42373768	MIR6797	72	+	NR_106855	42373768	42373768	1
chr19	42381189	42385439	CD79A	4250	+	NM_001783	42381374	42385047	5
chr19	42387266	42411604	ARHGEF1	24338	+	NM_004706	42392153	42410938	29
chr19	42460832	42463528	RABAC1	2696	-	NM_006423	42460997	42463444	5
chr19	42470733	42498428	ATP1A3	27695	-	NM_152296	42471088	42498228	23
chr19	42502467	42569957	GRIK5	67490	-	NM_002088	42503022	42569922	19
chr19	42580289	42585720	ZNF574	5431	+	NM_022752	42582758	42585449	2
chr19	42590261	42636625	POU2F2	46364	-	NM_002698	42595703	42636563	14
chr19	42636780	42641251	LOC100505622	4471	+	NR_038332	42641251	42641251	3
chr19	42637596	42637665	MIR4323	69	-	NR_036208	42637665	42637665	1
chr19	42702744	42724304	DEDD2	21560	-	NM_001270614	42703589	42721159	5
chr19	42724422	42731205	ZNF526	6783	+	NM_001314033	42728555	42730568	3
chr19	42734337	42746736	GSK3A	12399	-	NM_019884	42734945	42746617	11
chr19	42751712	42759316	ERF	7604	-	NM_006494	42752616	42759151	4
chr19	42772688	42799948	CIC	27260	+	NM_001304815	42775935	42799343	21
chr19	42801184	42806952	PAFAH1B3	5768	-	NM_001145940	42801229	42806461	6
chr19	42806283	42814973	PRR19	8690	+	NM_199285	42813736	42814892	3
chr19	42817476	42829214	TMEM145	11738	+	NM_173633	42817528	42828969	15
chr19	42829760	42882921	MEGF8	53161	+	NM_001271938	42830395	42880927	42
chr19	42855282	42855357	MIR8077	75	+	NR_107044	42855357	42855357	1
chr19	42891170	42894444	CNFN	3274	-	NM_032488	42891304	42893189	4
chr19	42901279	42912604	LOC101930071	11325	+	NR_126041	42912604	42912604	2
chr19	42901299	43156507	LIPE-AS1	255208	+	NR_073180	43156507	43156507	3
chr19	42905658	42931578	LIPE	25920	-	NM_005357	42905963	42931301	10
chr19	42932689	42947200	CXCL17	14511	-	NM_198477	42933035	42946984	4
chr19	43011457	43032661	CEACAM1	21204	-	NM_001184815	43013260	43032526	9
chr19	43084394	43099082	CEACAM8	14688	-	NM_001816	43087397	43098980	6
chr19	43225793	43244668	PSG3	18875	-	NM_021016	43228133	43244536	7
chr19	43256838	43269831	PSG8	12993	-	NM_001130167	43257511	43269733	6
chr19	43326014	43331030	LOC100289650	5016	+	NR_036584	43331030	43331030	4
chr19	43341148	43359870	PSG10P	18722	-	NR_026824	43359870	43359870	7
chr19	43370612	43383871	PSG1	13259	-	NM_001184825	43371285	43383733	6
chr19	43406233	43422076	PSG6	15843	-	NM_001031850	43406563	43421944	6
chr19	43428283	43441330	PSG7	13047	-	NM_002783	43428959	43441228	6
chr19	43511808	43530631	PSG11	18823	-	NM_002785	43514149	43530524	6
chr19	43568361	43586893	PSG2	18532	-	NM_031246	43570708	43586721	6
chr19	43671894	43690688	PSG5	18794	-	NM_001130014	43674246	43690557	6
chr19	43696853	43709926	PSG4	13073	-	NM_002780	43697523	43709688	6
chr19	43715942	43752798	LOC284344	36856	-	NR_033888	43752798	43752798	9
chr19	43757433	43773715	PSG9	16282	-	NM_002784	43757760	43773583	6
chr19	43853207	43853700	PRG1	493	+	NR_026881	43853700	43853700	1
chr19	43857810	43867324	CD177	9514	+	NM_020406	43857866	43866472	9
chr19	43892762	43922767	TEX101	30005	+	NM_031451	43910656	43922549	9
chr19	43964945	43969831	LYPD3	4886	-	NM_014400	43965502	43969723	5
chr19	43979254	44008985	PHLDB3	29731	-	NM_198850	43979561	44008270	16
chr19	44010870	44031396	ETHE1	20526	-	NM_014297	44011001	44031329	7
chr19	44037339	44040284	ZNF575	2945	+	NM_174945	44038574	44039839	4
chr19	44047463	44079730	XRCC1	32267	-	NM_006297	44047543	44079610	17
chr19	44080951	44086256	PINLYP	5305	+	NM_001193621	44081271	44086153	6
chr19	44088518	44100287	IRGQ	11769	-	NM_001007561	44096177	44099490	3
chr19	44100543	44104587	ZNF576	4044	+	NM_024327	44101260	44103410	3
chr19	44111375	44124014	ZNF428	12639	-	NM_182498	44111768	44118456	3
chr19	44116252	44118650	SRRM5	2398	+	NM_001145641	44116273	44118421	1
chr19	44126521	44143991	CADM4	17470	-	NM_145296	44127481	44143942	9
chr19	44150246	44174498	PLAUR	24252	-	NM_001005376	44150608	44174272	7
chr19	44220213	44224169	IRGC	3956	+	NM_019612	44222710	44224102	2
chr19	44235300	44259142	SMG9	23842	-	NM_019108	44235747	44254893	14
chr19	44270684	44285409	KCNN4	14725	-	NM_002250	44271694	44285013	9
chr19	44300078	44324808	LYPD5	24730	-	NM_182573	44301742	44303921	5
chr19	44331443	44353050	ZNF283	21607	+	NM_001297752	44351170	44352793	6
chr19	44376514	44384288	ZNF404	7774	-	NM_001033719	44376706	44384288	2
chr19	44395955	44405955	LOC100505715	10000	-	NR_038334	44405955	44405955	3
chr19	44416775	44439411	ZNF45	22636	-	NM_003425	44417538	44426337	10
chr19	44455374	44471752	ZNF221	16378	+	NM_001297588	44466878	44471508	5
chr19	44488321	44502477	ZNF155	14156	+	NM_001260488	44494216	44501626	6
chr19	44501047	44507022	LOC101928063	5975	-	NR_110727	44507022	44507022	3
chr19	44507076	44518072	ZNF230	10996	+	NM_006300	44511230	44515616	5
chr19	44529493	44537262	ZNF222	7769	+	NM_001129996	44529588	44537183	4
chr19	44556163	44572147	ZNF223	15984	+	NM_013361	44559329	44571430	5
chr19	44576296	44591623	ZNF284	15327	+	NM_001037813	44580542	44591413	5
chr19	44598481	44612479	ZNF224	13998	+	NM_013398	44602026	44612437	6
chr19	44609491	44617336	LOC100379224	7845	-	NR_033341	44617336	44617336	2
chr19	44617547	44637255	ZNF225	19708	+	NM_013362	44619980	44636888	5
chr19	44645709	44664462	ZNF234	18753	+	NM_006630	44648785	44662272	6
chr19	44669248	44681838	ZNF226	12590	+	NM_001032373	44674233	44681827	6
chr19	44716680	44741421	ZNF227	24741	+	NM_001289166	44721945	44740983	6
chr19	44764032	44779470	ZNF233	15438	+	NM_001207005	44768513	44778826	5
chr19	44790500	44809178	ZNF235	18678	-	NM_004234	44791370	44807557	5
chr19	44830705	44860856	ZNF112	30151	-	NM_001083335	44831585	44847420	5
chr19	44889807	44905777	ZNF285	15970	-	NM_001291490	44890633	44891941	5
chr19	44930422	44952766	ZNF229	22344	-	NM_001278510	44932477	44947031	6
chr19	44978644	45004575	ZNF180	25931	-	NM_001288760	44980618	44981668	7
chr19	45010210	45033548	CEACAM20	23338	-	NM_001102597	45010212	45033532	13
chr19	45041044	45060150	CEACAM22P	19106	-	NR_027754	45060150	45060150	8
chr19	45116939	45140081	IGSF23	23142	+	NM_001205280	45116955	45138734	5
chr19	45147097	45169428	PVR	22331	+	NM_006505	45147396	45165078	8
chr19	45156955	45157002	MIR4531	47	-	NR_039756	45157002	45157002	1
chr19	45174723	45187627	CEACAM19	12904	+	NM_001127893	45175203	45186762	8
chr19	45202420	45213986	CEACAM16	11566	+	NM_001039213	45204726	45213778	7
chr19	45251977	45263301	BCL3	11324	+	NM_005178	45252047	45262872	9
chr19	45261913	45261978	MIR8085	65	+	NR_107052	45261978	45261978	1
chr19	45281125	45303903	CBLC	22778	+	NM_012116	45281188	45303700	11
chr19	45312315	45324678	BCAM	12363	+	NM_005581	45312381	45324178	15
chr19	45349392	45392485	PVRL2	43093	+	NM_001042724	45349782	45391636	9
chr19	45394476	45406946	TOMM40	12470	+	NM_006114	45394672	45406426	10
chr19	45409005	45412652	APOE	3647	+	NM_000041	45409881	45412507	4
chr19	45417920	45422606	APOC1	4686	+	NM_001645	45418148	45422487	4
chr19	45430059	45434643	APOC1P1	4584	+	NR_028414	45434643	45434643	4
chr19	45445494	45448753	APOC4	3259	+	NM_001646	45445534	45448562	3
chr19	45445494	45452822	APOC4-APOC2	7328	+	NR_037932	45452822	45452822	6
chr19	45449238	45452822	APOC2	3584	+	NM_000483	45451735	45452506	4
chr19	45457841	45496604	CLPTM1	38763	+	NM_001282176	45476464	45496155	14
chr19	45504706	45541456	RELB	36750	+	NM_006509	45504837	45541048	11
chr19	45542297	45574214	CLASRP	31917	+	NM_007056	45543470	45574103	21
chr19	45574757	45579688	ZNF296	4931	-	NM_145288	45574858	45579631	3
chr19	45582517	45594782	GEMIN7	12265	+	NM_001007270	45593372	45593768	3
chr19	45596430	45650543	PPP1R37	54113	+	NM_019121	45596583	45649730	13
chr19	45653007	45663408	NKPD1	10401	-	NM_198478	45655195	45663408	4
chr19	45666185	45681501	TRAPPC6A	15316	-	NM_001270891	45666449	45681476	6
chr19	45682002	45685059	BLOC1S3	3057	+	NM_212550	45682554	45683163	2
chr19	45715878	45737469	EXOC3L2	21591	-	NM_138568	45716326	45735110	10
chr19	45754515	45808541	MARK4	54026	+	NM_031417	45754846	45805696	18
chr19	45809670	45826235	CKM	16565	-	NM_001824	45810007	45822971	8
chr19	45843997	45854778	KLC3	10781	+	NM_177417	45848799	45854615	13
chr19	45854648	45873845	ERCC2	19197	-	NM_000400	45854886	45873798	23
chr19	45882891	45909607	PPP1R13L	26716	-	NM_001142502	45883447	45901576	13
chr19	45909466	45914024	CD3EAP	4558	+	NM_001297590	45909954	45912759	3
chr19	45910590	45927177	ERCC1	16587	-	NM_001983	45912932	45926632	10
chr19	45939911	45939962	MIR6088	51	+	NR_106736	45939962	45939962	1
chr19	45971252	45978437	FOSB	7185	+	NM_006732	45971844	45976270	4
chr19	45988545	46000313	RTN2	11768	-	NM_005619	45988965	46000083	11
chr19	46001730	46005764	PPM1N	4034	+	NM_001080401	46001730	46005343	5
chr19	46010687	46030240	VASP	19553	+	NM_003370	46011029	46029435	13
chr19	46031024	46088122	OPA3	57098	-	NM_001017989	46032313	46088022	2
chr19	46093022	46105466	GPR4	12444	-	NM_005282	46094035	46095124	2
chr19	46112657	46148775	EML2	36118	-	NM_001193268	46112920	46148702	22
chr19	46142251	46142345	MIR330	94	-	NR_029886	46142345	46142345	1
chr19	46144751	46146092	EML2-AS1	1341	+	NR_130728	46146092	46146092	3
chr19	46171501	46186982	GIPR	15481	+	NM_000164	46172778	46185193	14
chr19	46178185	46178282	MIR642A	97	+	NR_030372	46178282	46178282	1
chr19	46178189	46178266	MIR642B	77	-	NR_037512	46178266	46178266	1
chr19	46190711	46195443	SNRPD2	4732	-	NM_177542	46190810	46191796	4
chr19	46195740	46207248	QPCTL	11508	+	NM_017659	46195961	46206307	7
chr19	46213886	46234151	FBXO46	20265	-	NM_001080469	46214941	46216753	2
chr19	46236508	46267797	BHMG1	31289	+	NM_001310124	46238634	46267376	15
chr19	46268042	46272497	SIX5	4455	-	NM_175875	46268758	46272102	3
chr19	46272966	46285815	DMPK	12849	-	NM_001288764	46273745	46285629	16
chr19	46286263	46296060	DMWD	9797	-	NM_004943	46287500	46296014	5
chr19	46298967	46318605	RSPH6A	19638	-	NM_030785	46299126	46318434	6
chr19	46318699	46366548	SYMPK	47849	-	NM_004819	46318817	46357753	27
chr19	46367517	46377055	FOXA3	9538	+	NM_004497	46367714	46376316	2
chr19	46386864	46389428	IRF2BP1	2564	-	NM_015649	46387277	46389032	1
chr19	46393280	46405862	MYPOP	12582	-	NM_001012643	46393880	46405031	3
chr19	46416472	46418036	NANOS2	1564	-	NM_001029861	46417534	46417951	1
chr19	46442770	46476657	NOVA2	33887	-	NM_002516	46443120	46476609	4
chr19	46498718	46521874	CCDC61	23156	+	NM_001267723	46506276	46521645	14
chr19	46522189	46522307	MIR769	118	+	NR_030412	46522307	46522307	1
chr19	46522411	46526556	PGLYRP1	4145	-	NM_005091	46522495	46526279	3
chr19	46543005	46544274	IGFL4	1269	-	NM_001002923	46543149	46544220	4
chr19	46560935	46580887	LOC400706	19952	-	NR_125344	46580887	46580887	2
chr19	46623327	46627931	IGFL3	4604	-	NM_207393	46623586	46627906	4
chr19	46651038	46664561	IGFL2	13523	+	NM_001002915	46652242	46664345	5
chr19	46713498	46718094	DKFZp434J0226	4596	+	NR_027003	46718094	46718094	6
chr19	46733008	46734500	IGFL1	1492	+	NM_198541	46733031	46734087	4
chr19	46800302	46846690	HIF3A	46388	+	NM_152795	46800333	46842879	15
chr19	46850250	46894232	PPP5C	43982	+	NM_006247	46850353	46893603	13
chr19	46913585	46916919	CCDC8	3334	-	NM_032040	46914450	46916067	1
chr19	46969747	46974820	PNMAL1	5073	-	NM_001103149	46971795	46974292	3
chr19	46984044	47104457	PPP5D1	120413	-	NM_001205281	46984640	47104226	4
chr19	46994447	46999169	PNMAL2	4722	-	NM_020709	46996814	46998722	1
chr19	47104511	47114039	CALM3	9528	+	NM_005184	47104691	47112410	6
chr19	47123724	47128354	PTGIR	4630	-	NM_000960	47124536	47127482	3
chr19	47137332	47137939	GNG8	607	-	NM_033258	47137332	47137939	2
chr19	47150868	47164395	DACT3	13527	-	NM_145056	47151738	47164321	4
chr19	47163620	47180713	DACT3-AS1	17093	+	NR_040042	47180713	47180713	3
chr19	47177572	47220384	PRKD2	42812	-	NM_001079880	47177779	47219627	19
chr19	47212549	47212602	MIR320E	53	-	NR_036157	47212602	47212602	1
chr19	47222767	47249720	STRN4	26953	-	NM_001039877	47223858	47249687	18
chr19	47249302	47261832	FKRP	12530	+	NM_001039885	47258707	47260195	4
chr19	47278139	47291842	SLC1A5	13703	-	NM_005628	47278766	47291222	8
chr19	47333841	47333961	SNAR-E	120	-	NR_024258	47333961	47333961	1
chr19	47341414	47354252	AP2S1	12838	-	NM_001301078	47341703	47354023	5
chr19	47421932	47508333	ARHGAP35	86401	+	NM_004491	47421932	47503945	6
chr19	47524142	47549017	NPAS1	24875	+	NM_002517	47524304	47548909	11
chr19	47549166	47551882	TMEM160	2716	-	NM_017854	47549244	47551872	3
chr19	47567446	47617009	ZC3H4	49563	-	NM_015168	47569612	47615841	15
chr19	47634079	47713893	SAE1	79814	+	NM_005500	47634187	47712508	9
chr19	47724078	47736023	BBC3	11945	-	NM_001127240	47724957	47735859	4
chr19	47730198	47730278	MIR3190	80	+	NR_036158	47730278	47730278	1
chr19	47730200	47730276	MIR3191	76	-	NR_036159	47730276	47730276	1
chr19	47759730	47775210	CCDC9	15480	+	NM_015603	47761657	47774935	12
chr19	47777658	47778980	INAFM1	1322	+	NR_037675	47778980	47778980	2
chr19	47813103	47825327	C5AR1	12224	+	NM_001736	47813152	47824087	2
chr19	47835403	47845272	C5AR2	9869	+	NM_001271749	47844056	47845070	2
chr19	47852537	47885961	DHX34	33424	+	NM_014681	47856287	47885370	17
chr19	47906374	47922785	MEIS3	16411	-	NM_001009813	47909733	47922338	13
chr19	47931278	47975307	SLC8A2	44029	-	NM_015063	47933345	47969660	10
chr19	47978397	47987521	KPTN	9124	-	NR_111923	47987521	47987521	13
chr19	47987538	48004854	NAPA-AS1	17316	+	NR_038452	48004854	48004854	4
chr19	47990890	48018515	NAPA	27625	-	NR_038456	48018515	48018515	12
chr19	48023941	48059113	ZNF541	35172	-	NM_001277075	48024480	48059113	15
chr19	48111452	48206534	GLTSCR1	95082	+	NM_015711	48176831	48205672	15
chr19	48216600	48246391	EHD2	29791	+	NM_014601	48219869	48244689	6
chr19	48248792	48260323	GLTSCR2	11531	+	NM_015710	48248816	48260262	13
chr19	48259109	48259219	SNORD23	110	+	NR_003048	48259219	48259219	1
chr19	48260292	48272097	GLTSCR2-AS1	11805	-	NR_132382	48272097	48272097	3
chr19	48281841	48287943	SEPW1	6102	+	NM_003009	48282042	48284627	6
chr19	48304499	48306861	TPRX1	2362	-	NM_198479	48305031	48306790	2
chr19	48325098	48346586	CRX	21488	+	NM_000554	48337700	48343224	4
chr19	48373722	48389654	SULT2A1	15932	-	NM_003167	48374711	48389514	6
chr19	48410934	48411056	SNAR-A12	122	+	NR_004437	48411056	48411056	1
chr19	48410934	48411056	SNAR-A13	122	+	NR_024216	48411056	48411056	1
chr19	48416307	48416427	SNAR-C1	120	+	NR_024220	48416427	48416427	1
chr19	48416307	48416427	SNAR-C5	120	+	NR_024219	48416427	48416427	1
chr19	48421685	48421807	SNAR-A2	122	+	NR_004436	48421807	48421807	1
chr19	48427035	48427156	SNAR-A3	121	+	NR_024214	48427156	48427156	1
chr19	48427035	48427156	SNAR-A4	121	+	NR_024215	48427156	48427156	1
chr19	48427035	48427156	SNAR-A5	121	+	NR_024223	48427156	48427156	1
chr19	48427035	48427156	SNAR-A6	121	+	NR_024227	48427156	48427156	1
chr19	48427035	48427156	SNAR-A7	121	+	NR_024224	48427156	48427156	1
chr19	48427035	48427156	SNAR-A8	121	+	NR_024228	48427156	48427156	1
chr19	48427035	48427156	SNAR-A9	121	+	NR_024226	48427156	48427156	1
chr19	48427035	48427156	SNAR-A10	121	+	NR_024229	48427156	48427156	1
chr19	48427035	48427156	SNAR-A11	121	+	NR_024225	48427156	48427156	1
chr19	48427035	48427156	SNAR-A14	121	+	NR_024242	48427156	48427156	1
chr19	48432074	48432194	SNAR-C2	120	+	NR_024217	48432194	48432194	1
chr19	48437437	48437559	SNAR-A1	122	+	NR_004435	48437559	48437559	1
chr19	48442797	48442917	SNAR-C4	120	+	NR_024218	48442917	48442917	1
chr19	48453552	48453671	SNAR-C3	119	+	NR_024221	48453671	48453671	1
chr19	48471302	48495427	BSPH1	24125	-	NM_001128326	48479968	48495338	6
chr19	48497907	48528410	ELSPBP1	30503	+	NM_022142	48511924	48525584	7
chr19	48532639	48547311	CABP5	14672	-	NM_019855	48533813	48547179	6
chr19	48551099	48614109	PLA2G4C	63010	-	NM_001159322	48551599	48613772	17
chr19	48564627	48568202	PLA2G4C-AS1	3575	+	NR_132363	48568202	48568202	5
chr19	48618701	48673860	LIG1	55159	-	NM_000234	48618905	48668823	28
chr19	48673948	48700877	C19orf68	26929	+	NM_199341	48675059	48700084	4
chr19	48711342	48759203	CARD8	47861	-	NM_001184902	48718623	48744277	13
chr19	48758931	48761450	CARD8-AS1	2519	+	NR_040599	48761450	48761450	2
chr19	48773355	48790865	ZNF114	17510	+	NM_153608	48783056	48790135	6
chr19	48799708	48823332	CCDC114	23624	-	NM_144577	48800232	48822028	14
chr19	48828628	48833810	EMP3	5182	+	NM_001425	48830101	48833727	5
chr19	48835612	48867494	TMEM143	31882	-	NM_018273	48836475	48867177	8
chr19	48867650	48879634	SYNGR4	11984	+	NM_012451	48869099	48879575	5
chr19	48885826	48894810	KDELR1	8984	-	NM_006801	48886549	48894615	5
chr19	48898131	48948188	GRIN2D	50057	+	NM_000836	48901649	48947194	13
chr19	48949029	48957164	GRWD1	8135	+	NM_031485	48949262	48956282	7
chr19	48958963	48969367	KCNJ14	10404	+	NM_013348	48964981	48968034	3
chr19	48972464	48985571	CYTH2	13107	+	NM_004228	48972764	48982467	12
chr19	48988527	49016446	LMTK3	27919	-	NM_001080434	48989029	49016446	16
chr19	49055428	49102684	SULT2B1	47256	+	NM_177973	49055509	49102663	7
chr19	49103856	49116694	FAM83E	12838	-	NM_017708	49104365	49116629	5
chr19	49109999	49110971	SPACA4	972	+	NM_133498	49110235	49110610	1
chr19	49118583	49122675	RPL18	4092	-	NM_000979	49118628	49122400	7
chr19	49122547	49133663	SPHK2	11116	+	NM_001204158	49123771	49133030	7
chr19	49133816	49140807	DBP	6991	-	NM_001352	49134093	49140251	4
chr19	49141271	49149451	CA11	8180	-	NM_001217	49141375	49148889	9
chr19	49141295	49185502	SEC1P	44207	+	NR_004401	49185502	49185502	5
chr19	49164663	49176338	NTN5	11675	-	NM_145807	49164933	49174243	7
chr19	49199227	49209191	FUT2	9964	+	NM_001097638	49206213	49207245	2
chr19	49205706	49207105	LOC105447645	1399	-	NR_131188	49207105	49207105	1
chr19	49216254	49222976	MAMSTR	6722	-	NM_001130915	49216523	49222288	10
chr19	49223841	49243970	RASIP1	20129	-	NM_017805	49224054	49243539	12
chr19	49244144	49250166	IZUMO1	6022	-	NM_182575	49244164	49249116	10
chr19	49251267	49258647	FUT1	7380	-	NM_000148	49253440	49254538	4
chr19	49259343	49261582	FGF21	2239	+	NM_019113	49259493	49261477	3
chr19	49298318	49314320	BCAT2	16002	-	NM_001284325	49298682	49309953	12
chr19	49316273	49339934	HSD17B14	23661	-	NM_016246	49316431	49339668	9
chr19	49340353	49371884	PLEKHA4	31531	-	NM_020904	49340545	49370877	20
chr19	49375648	49379319	PPP1R15A	3671	+	NM_014330	49376490	49379230	3
chr19	49384221	49401996	TULP2	17775	-	NM_003323	49384267	49401125	13
chr19	49403306	49426540	NUCB1	23234	+	NM_006184	49404053	49425681	13
chr19	49414186	49422148	NUCB1-AS1	7962	-	NR_046633	49422148	49422148	2
chr19	49436938	49448226	DHDH	11288	+	NM_014475	49436978	49448190	7
chr19	49458116	49465055	BAX	6939	+	NR_027882	49465055	49465055	7
chr19	49468565	49470136	FTL	1571	+	NM_000146	49468764	49469992	4
chr19	49471381	49496610	GYS1	25229	-	NM_002103	49472544	49496369	16
chr19	49497155	49519182	RUVBL2	22027	+	NM_006666	49497168	49519099	15
chr19	49513162	49513229	MIR6798	67	+	NR_106856	49513229	49513229	1
chr19	49519236	49520347	LHB	1111	-	NM_000894	49519324	49520338	3
chr19	49521504	49522741	LOC101059948	1237	-	NR_073552	49522741	49522741	3
chr19	49526125	49527632	CGB	1507	-	NM_000737	49526142	49527228	3
chr19	49534925	49535044	SNAR-G2	119	-	NR_024244	49535044	49535044	1
chr19	49535129	49536495	CGB2	1366	+	NM_033378	49535352	49536478	3
chr19	49538825	49540191	CGB1	1366	-	NM_033377	49538866	49539968	3
chr19	49540276	49540404	SNAR-G1	128	+	NR_004383	49540404	49540404	1
chr19	49547101	49548568	CGB5	1467	+	NM_033043	49547466	49548551	3
chr19	49550894	49552368	CGB8	1474	-	NM_033183	49550911	49551996	3
chr19	49557530	49558997	CGB7	1467	-	NM_033142	49557547	49558632	3
chr19	49564396	49567124	NTF4	2728	-	NM_006179	49564621	49565254	2
chr19	49570674	49576198	KCNA7	5524	-	NM_031886	49573319	49575842	2
chr19	49588396	49611870	SNRNP70	23474	+	NM_001301069	49589671	49611700	10
chr19	49617617	49621717	LIN7B	4100	+	NM_022165	49617661	49621630	6
chr19	49621653	49622397	C19orf73	744	-	NM_018111	49621889	49622279	1
chr19	49622645	49654287	PPFIA3	31642	+	NM_003660	49631130	49653395	30
chr19	49654455	49658681	HRC	4226	-	NM_002152	49654552	49658494	6
chr19	49661015	49715098	TRPM4	54083	+	NM_017636	49661123	49714755	25
chr19	49792891	49828474	SLC6A16	35583	-	NM_014037	49793379	49814604	12
chr19	49812053	49812125	MIR4324	72	-	NR_036209	49812125	49812125	1
chr19	49838676	49843861	CD37	5185	+	NM_001774	49838797	49843585	8
chr19	49843852	49865714	TEAD2	21862	-	NM_001256660	49844580	49863332	13
chr19	49866986	49878373	DKKL1	11387	+	NM_001197302	49868807	49878285	5
chr19	49871961	49891338	LOC101928295	19377	-	NR_110729	49891338	49891338	3
chr19	49891474	49921256	CCDC155	29782	+	NM_144688	49894140	49920767	20
chr19	49925670	49926698	PTH2	1028	-	NM_178449	49925724	49926596	2
chr19	49929687	49932075	GFY	2388	+	NM_001195256	49929687	49932075	3
chr19	49932654	49944808	SLC17A7	12154	-	NM_020309	49933775	49944636	12
chr19	49949549	49955115	PIH1D1	5566	-	NM_017916	49949638	49954831	9
chr19	49956472	49974305	ALDH16A1	17833	+	NM_153329	49956588	49973724	17
chr19	49977465	49989488	FLT3LG	12023	+	NM_001278638	49979727	49983856	9
chr19	49990810	49995564	RPL13A	4754	+	NM_012423	49990886	49995072	8
chr19	49990864	49995096	RPL13AP5	4232	+	NR_026712	49995096	49995096	8
chr19	49993222	49993304	SNORD32A	82	+	NR_000021	49993304	49993304	1
chr19	49993873	49993956	SNORD33	83	+	NR_000020	49993956	49993956	1
chr19	49994163	49994229	SNORD34	66	+	NR_000019	49994229	49994229	1
chr19	49994431	49994517	SNORD35A	86	+	NR_000018	49994517	49994517	1
chr19	49999621	50002969	RPS11	3348	+	NM_001015	49999713	50002892	5
chr19	50000975	50001062	SNORD35B	87	+	NR_001285	50001062	50001062	1
chr19	50004041	50004125	MIR150	84	-	NR_029703	50004125	50004125	1
chr19	50015535	50029685	FCGRT	14150	+	NM_001136019	50016657	50029376	7
chr19	50030874	50046890	RCN3	16016	+	NM_020650	50031729	50046470	7
chr19	50058724	50083829	NOSIP	25105	-	NM_015953	50059007	50063948	10
chr19	50084586	50094265	PRRG2	9679	+	NM_000951	50086476	50093646	7
chr19	50094911	50129696	PRR12	34785	+	NM_020719	50094911	50128864	14
chr19	50138548	50143400	RRAS	4852	-	NM_006270	50138832	50143355	6
chr19	50145381	50161906	SCAF1	16525	+	NM_021228	50148283	50161656	11
chr19	50162825	50169132	IRF3	6307	-	NM_001571	50162904	50168095	8
chr19	50168398	50177173	BCL2L12	8775	+	NM_001040668	50169080	50177005	7
chr19	50180408	50191707	PRMT1	11299	+	NR_033397	50191707	50191707	12
chr19	50185373	50185452	MIR5088	79	+	NR_049811	50185452	50185452	1
chr19	50191941	50194247	ADM5	2306	+	NM_001101340	50193094	50193750	2
chr19	50194364	50216988	CPT1C	22624	+	NR_108072	50216988	50216988	21
chr19	50243010	50266515	TSKS	23505	-	NM_021733	50243032	50266504	11
chr19	50270179	50310369	AP2A1	40190	+	NM_014203	50270390	50310015	24
chr19	50295122	50295191	MIR6799	69	+	NR_106857	50295191	50295191	1
chr19	50310123	50316567	FUZ	6444	-	NM_025129	50310407	50316363	11
chr19	50321535	50340237	MED25	18702	+	NM_030973	50321598	50340201	18
chr19	50335274	50335356	MIR6800	82	+	NR_106858	50335356	50335356	1
chr19	50341902	50354933	PTOV1-AS1	13031	-	NR_040037	50354933	50354933	4
chr19	50353991	50364001	PTOV1	10010	+	NM_001305108	50354137	50363576	13
chr19	50357847	50357908	MIR4749	61	+	NR_039904	50357908	50357908	1
chr19	50359721	50362546	PTOV1-AS2	2825	-	NR_110730	50362546	50362546	5
chr19	50364459	50370822	PNKP	6363	-	NM_007254	50364504	50370461	17
chr19	50372289	50381613	AKT1S1	9324	-	NM_001278160	50373173	50376552	5
chr19	50380681	50392007	TBC1D17	11326	+	NM_024682	50380980	50391881	17
chr19	50391431	50391487	MIR4750	56	+	NR_039905	50391487	50391487	1
chr19	50392912	50432796	IL4I1	39884	-	NR_047577	50432796	50432796	11
chr19	50410083	50432988	NUP62	22905	-	NM_016553	50411495	50413064	3
chr19	50431958	50437193	ATF5	5235	+	NM_012068	50434107	50436349	4
chr19	50436320	50436394	MIR4751	74	+	NR_039906	50436394	50436394	1
chr19	50452249	50464429	SIGLEC11	12180	-	NM_052884	50453226	50464338	11
chr19	50472856	50476788	SIGLEC16	3932	+	NR_002825	50476788	50476788	9
chr19	50479723	50528805	VRK3	49082	-	NM_016440	50482350	50519419	15
chr19	50529062	50552031	ZNF473	22969	+	NM_015428	50534339	50550316	5
chr19	50553936	50570052	FLJ26850	16116	+	NR_027257	50570052	50570052	3
chr19	50637001	50637121	SNAR-B2	120	-	NR_024230	50637121	50637121	1
chr19	50642374	50642494	SNAR-B1	120	-	NR_024231	50642494	50642494	1
chr19	50643458	50643577	SNAR-D	119	-	NR_024243	50643577	50643577	1
chr19	50655804	50666538	IZUMO2	10734	-	NM_152358	50655865	50666451	7
chr19	50706884	50813801	MYH14	106917	+	NM_001145809	50713622	50813047	43
chr19	50815198	50836772	KCNC3	21574	-	NR_110912	50836772	50836772	4
chr19	50837056	50848005	NAPSB	10949	-	NR_002798	50848005	50848005	9
chr19	50861733	50868931	NAPSA	7198	-	NM_004851	50861809	50868878	9
chr19	50879679	50886285	NR1H2	6606	+	NM_007121	50880862	50885859	10
chr19	50887579	50921275	POLD1	33696	+	NM_002691	50902108	50921204	27
chr19	50922194	50934309	SPIB	12115	+	NM_001244000	50925736	50931593	6
chr19	50936159	50969583	MYBPC2	33424	+	NM_004533	50936210	50969462	28
chr19	50970041	50980003	FAM71E1	9962	-	NM_001308429	50970881	50979645	5
chr19	50979733	50986783	EMC10	7050	+	NM_175063	50979801	50985204	8
chr19	51009253	51014612	JOSD2	5359	-	NM_001270639	51009429	51013688	5
chr19	51014856	51017947	ASPDH	3091	-	NM_001024656	51014986	51017766	5
chr19	51020149	51071302	LRRC4B	51153	-	NM_001080457	51020827	51052095	3
chr19	51108219	51108342	SNAR-F	123	+	NR_004384	51108342	51108342	1
chr19	51125233	51143092	SYT3	17859	-	NM_001160328	51125946	51140668	11
chr19	51152701	51162567	C19orf81	9866	+	NM_001195076	51152701	51162399	5
chr19	51165083	51220195	SHANK1	55112	-	NM_016148	51165221	51220176	23
chr19	51226604	51228981	CLEC11A	2377	+	NM_002975	51226782	51228724	4
chr19	51273720	51274989	GPR32	1269	+	NM_001506	51273857	51274928	1
chr19	51293671	51298481	ACPT	4810	+	NM_033068	51293671	51298415	11
chr19	51300949	51308110	C19orf48	7161	-	NM_001290149	51301351	51301705	6
chr19	51302285	51302382	SNORD88B	97	-	NR_003068	51302382	51302382	1
chr19	51302695	51302792	SNORD88A	97	-	NR_003067	51302792	51302792	1
chr19	51305581	51305678	SNORD88C	97	-	NR_003069	51305678	51305678	1
chr19	51320936	51322134	MGC45922	1198	+	NR_038359	51322134	51322134	3
chr19	51322401	51327043	KLK1	4642	-	NM_002257	51322449	51327004	5
chr19	51328544	51334779	KLK15	6235	-	NM_001277081	51329051	51334748	5
chr19	51333785	51354399	LOC105372441	20614	+	NR_131205	51354399	51354399	3
chr19	51358170	51364020	KLK3	5850	+	NM_001030048	51358211	51363383	5
chr19	51376688	51383823	KLK2	7135	+	NR_045763	51383823	51383823	5
chr19	51385351	51399654	KLKP1	14303	-	NR_002948	51399654	51399654	5
chr19	51409607	51413994	KLK4	4387	-	NM_004917	51410189	51413994	5
chr19	51446558	51456344	KLK5	9786	-	NM_001077491	51446886	51455913	7
chr19	51461886	51472929	KLK6	11043	-	NM_002774	51462419	51471360	7
chr19	51479734	51487320	KLK7	7586	-	NM_005046	51480791	51485655	6
chr19	51499263	51504958	KLK8	5695	-	NM_007196	51499314	51504423	6
chr19	51505768	51512890	KLK9	7122	-	NM_012315	51506366	51512803	5
chr19	51515999	51523431	KLK10	7432	-	NM_001077500	51518055	51522386	6
chr19	51525486	51531290	KLK11	5804	-	NM_001167605	51525800	51528887	6
chr19	51532347	51538148	KLK12	5801	-	NM_019598	51532410	51537877	7
chr19	51559462	51568367	KLK13	8905	-	NM_015596	51559843	51568324	5
chr19	51580751	51587467	KLK14	6716	-	NM_001311182	51581263	51586004	8
chr19	51600862	51611647	CTU1	10785	-	NM_145232	51601857	51607826	3
chr19	51628136	51639520	SIGLEC9	11384	+	NM_001198558	51628231	51639455	7
chr19	51645557	51656783	SIGLEC7	11226	+	NM_014385	51645626	51656502	7
chr19	51656179	51685222	LOC101928517	29043	-	NR_110732	51685222	51685222	5
chr19	51670584	51676780	SIGLEC17P	6196	+	NR_047529	51676780	51676780	7
chr19	51710184	51710265	MIR8074	81	-	NR_107041	51710265	51710265	1
chr19	51728334	51743274	CD33	14940	+	NM_001772	51728374	51742943	7
chr19	51754331	51772582	SIGLECL1	18251	+	NR_102324	51772582	51772582	5
chr19	51815101	51834102	IGLON5	19001	+	NM_001101372	51815101	51832013	8
chr19	51834794	51845378	VSIG10L	10584	-	NM_001163922	51835864	51845378	10
chr19	51848408	51869672	ETFB	21264	-	NM_001985	51848464	51869580	6
chr19	51870351	51872257	CLDND2	1906	-	NM_152353	51870395	51871831	4
chr19	51874873	51875960	NKG7	1087	-	NM_005601	51875030	51875789	4
chr19	51883162	51891210	LIM2	8048	-	NM_001161748	51883454	51890697	5
chr19	51891542	51893828	C19orf84	2286	-	NM_001193623	51892237	51893766	2
chr19	51913274	51921057	SIGLEC10	7783	-	NM_001171156	51914352	51920835	11
chr19	51919159	51920679	LOC100129083	1520	+	NM_001256795	51919278	51920417	3
chr19	51954250	51961708	SIGLEC8	7458	-	NM_014442	51955632	51961641	7
chr19	51981896	51993859	CEACAM18	11963	+	NM_001278392	51981896	51993859	6
chr19	51994480	52005043	SIGLEC12	10563	-	NM_053003	51994894	52004987	8
chr19	52022783	52035110	SIGLEC6	12327	-	NM_001245	52023335	52034902	8
chr19	52074530	52092991	ZNF175	18461	+	NM_007147	52076582	52091720	5
chr19	52095035	52097633	LINC01530	2598	-	NR_034159	52097633	52097633	2
chr19	52114755	52133727	SIGLEC5	18972	-	NM_003830	52115483	52133588	9
chr19	52145805	52150132	SIGLEC14	4327	-	NM_001098612	52146607	52150012	7
chr19	52188615	52196709	SPACA6P-AS	8094	-	NR_108100	52196709	52196709	2
chr19	52192686	52208443	SPACA6	15757	+	NM_001316994	52192744	52208376	9
chr19	52195864	52195934	MIR99B	70	+	NR_029843	52195934	52195934	1
chr19	52196038	52196117	MIRLET7E	79	+	NR_029482	52196117	52196117	1
chr19	52196506	52196592	MIR125A	86	+	NR_029693	52196592	52196592	1
chr19	52216364	52227245	HAS1	10881	-	NM_001523	52216679	52227186	5
chr19	52249022	52255150	FPR1	6128	-	NM_001193306	52249194	52250247	3
chr19	52264452	52273779	FPR2	9327	+	NM_001005738	52271911	52272967	2
chr19	52298398	52329443	FPR3	31045	+	NM_002030	52327001	52328063	2
chr19	52359055	52391189	ZNF577	32134	-	NR_024181	52391189	52391189	8
chr19	52391277	52403717	ZNF649-AS1	12440	+	NR_110733	52403717	52403717	3
chr19	52392487	52408305	ZNF649	15818	-	NM_023074	52393870	52403360	5
chr19	52430687	52449011	ZNF613	18324	+	NM_001031721	52439473	52448990	6
chr19	52452386	52484620	ZNF350-AS1	32234	+	NR_103847	52484620	52484620	3
chr19	52467592	52490079	ZNF350	22487	-	NM_021632	52468106	52477613	5
chr19	52494586	52511483	ZNF615	16897	-	NM_001199324	52496132	52506964	7
chr19	52516576	52531680	ZNF614	15104	-	NM_025040	52519092	52528998	5
chr19	52536676	52552073	ZNF432	15397	-	NM_014650	52536972	52550121	5
chr19	52567718	52599018	ZNF841	31300	-	NM_001136499	52568359	52588054	7
chr19	52617652	52643191	ZNF616	25539	-	NM_178523	52618070	52633765	4
chr19	52658124	52674896	ZNF836	16772	-	NM_001102657	52658124	52671325	5
chr19	52693054	52729678	PPP2R1A	36624	+	NM_014225	52693349	52729234	15
chr19	52725272	52725351	MIR6801	79	+	NR_106859	52725351	52725351	1
chr19	52772823	52795976	ZNF766	23153	+	NM_001010851	52772866	52794451	4
chr19	52785049	52785143	MIR643	94	+	NR_030373	52785143	52785143	1
chr19	52800421	52829180	ZNF480	28759	+	NM_144684	52803665	52826111	5
chr19	52839497	52870376	ZNF610	30879	+	NM_001161426	52852425	52870020	6
chr19	52873169	52889046	ZNF880	15877	+	NM_001145434	52873218	52888567	4
chr19	52892092	52901010	ZNF528-AS1	8918	-	NR_125345	52901010	52901010	7
chr19	52901120	52921657	ZNF528	20537	+	NM_032423	52905266	52919992	7
chr19	52934666	52955192	ZNF534	20526	+	NM_001291368	52934727	52954750	4
chr19	52956828	53020131	ZNF578	63303	+	NM_001099694	53005098	53015407	6
chr19	53030908	53059303	ZNF808	28395	+	NM_001039886	53046537	53058881	5
chr19	53073525	53090427	ZNF701	16902	+	NM_018260	53077400	53086710	4
chr19	53099936	53103405	ZNF137P	3469	+	NR_023311	53103405	53103405	3
chr19	53115617	53193834	ZNF83	78217	-	NM_001277947	53116266	53117817	6
chr19	53206065	53238307	ZNF611	32242	-	NM_001161499	53208189	53219147	6
chr19	53268747	53290034	ZNF600	21287	-	NM_198457	53268839	53271008	3
chr19	53300660	53324922	ZNF28	24262	-	NR_036599	53324922	53324922	5
chr19	53341784	53360902	ZNF468	19118	-	NR_102300	53360902	53360902	6
chr19	53379424	53394599	ZNF320	15175	-	NM_207333	53383848	53393508	4
chr19	53409145	53421184	ZNF888	12039	-	NM_001310127	53409417	53421126	3
chr19	53430387	53445847	ZNF321P	15460	-	NR_037805	53445847	53445847	2
chr19	53430387	53466164	ZNF816-ZNF321P	35777	-	NM_001202473	53432155	53459342	4
chr19	53452631	53466164	ZNF816	13533	-	NM_001031665	53453071	53459342	5
chr19	53471503	53496784	ZNF702P	25281	-	NR_003578	53496784	53496784	4
chr19	53517343	53519833	ERVV-1	2490	+	NM_152473	53517343	53518777	1
chr19	53547990	53554380	ERVV-2	6390	+	NM_001191055	53552504	53554112	2
chr19	53569866	53606687	ZNF160	36821	-	NM_001102603	53571329	53589529	7
chr19	53611131	53636173	ZNF415	25042	-	NR_028343	53636173	53636173	7
chr19	53641956	53662322	ZNF347	20366	-	NM_032584	53643560	53657000	5
chr19	53666551	53696619	ZNF665	30068	-	NM_024733	53667705	53686151	4
chr19	53716200	53719355	ZNF818P	3155	+	NR_073396	53719355	53719355	1
chr19	53738633	53758156	ZNF677	19523	-	NM_182609	53740224	53754803	5
chr19	53761544	53762855	VN1R2	1311	+	NM_173856	53761628	53762816	1
chr19	53770012	53770918	VN1R4	906	-	NM_173857	53770012	53770918	1
chr19	53785542	53787602	FAM90A27P	2060	+	NR_046365	53787602	53787602	3
chr19	53792853	53794875	BIRC8	2022	-	NM_033341	53792916	53793627	1
chr19	53837001	53858122	ZNF845	21121	+	NM_138374	53844560	53856841	4
chr19	53868967	53889841	ZNF525	20874	+	NR_003699	53889841	53889841	4
chr19	53898396	53915262	ZNF765	16866	+	NM_001040185	53901268	53912380	4
chr19	53935226	53947925	TPM3P9	12699	+	NR_003148	53947925	53947925	2
chr19	53935226	53961515	ZNF761	26289	+	NM_001008401	53950521	53960002	7
chr19	53970988	53997546	ZNF813	26558	+	NM_001004301	53987076	53995340	4
chr19	54024176	54083523	ZNF331	59347	+	NM_018555	54072630	54081206	7
chr19	54102884	54106751	LOC284379	3867	-	NR_002938	54106751	54106751	4
chr19	54135309	54140263	DPRX	4954	+	NM_001012728	54135360	54140242	3
chr19	54169926	54170024	MIR512-2	98	+	NR_030181	54170024	54170024	1
chr19	54169932	54170016	MIR512-1	84	+	NR_030180	54170016	54170016	1
chr19	54175221	54175294	MIR1323	73	+	NR_031568	54175294	54175294	1
chr19	54177450	54177574	MIR498	124	+	NR_030182	54177574	54177574	1
chr19	54178964	54179051	MIR520E	87	+	NR_030183	54179051	54179051	1
chr19	54182256	54182339	MIR515-1	83	+	NR_030184	54182339	54182339	1
chr19	54183193	54183277	MIR519E	84	+	NR_030185	54183277	54183277	1
chr19	54185412	54185499	MIR520F	87	+	NR_030186	54185499	54185499	1
chr19	54188262	54188345	MIR515-2	83	+	NR_030187	54188345	54188345	1
chr19	54189722	54189809	MIR519C	87	+	NR_030188	54189809	54189809	1
chr19	54191734	54191821	MIR1283-1	87	+	NR_031573	54191821	54191821	1
chr19	54194134	54194219	MIR520A	85	+	NR_030189	54194219	54194219	1
chr19	54197646	54197729	MIR526B	83	+	NR_030190	54197729	54197729	1
chr19	54198466	54198547	MIR519B	81	+	NR_030191	54198547	54198547	1
chr19	54200786	54200871	MIR525	85	+	NR_030192	54200871	54200871	1
chr19	54201638	54201725	MIR523	87	+	NR_030193	54201725	54201725	1
chr19	54203268	54203355	MIR518F	87	+	NR_030194	54203355	54203355	1
chr19	54204480	54204541	MIR520B	61	+	NR_030195	54204541	54204541	1
chr19	54205990	54206073	MIR518B	83	+	NR_030196	54206073	54206073	1
chr19	54209505	54209590	MIR526A1	85	+	NR_030197	54209590	54209590	1
chr19	54210706	54210793	MIR520C	87	+	NR_030198	54210793	54210793	1
chr19	54211988	54212089	MIR518C	101	+	NR_030199	54212089	54212089	1
chr19	54214255	54214342	MIR524	87	+	NR_030200	54214342	54214342	1
chr19	54215521	54215608	MIR517A	87	+	NR_030201	54215608	54215608	1
chr19	54216600	54216688	MIR519D	88	+	NR_030202	54216688	54216688	1
chr19	54219847	54219934	MIR521-2	87	+	NR_030203	54219934	54219934	1
chr19	54223349	54223436	MIR520D	87	+	NR_030204	54223436	54223436	1
chr19	54224329	54224396	MIR517B	67	+	NR_030205	54224396	54224396	1
chr19	54225419	54225509	MIR520G	90	+	NR_030206	54225509	54225509	1
chr19	54228695	54228780	MIR516B2	85	+	NR_030207	54228780	54228780	1
chr19	54230175	54230240	MIR526A2	65	+	NR_030208	54230240	54230240	1
chr19	54233091	54233179	MIR518E	88	+	NR_030209	54233179	54233179	1
chr19	54234259	54234344	MIR518A1	85	+	NR_030210	54234344	54234344	1
chr19	54238130	54238217	MIR518D	87	+	NR_030211	54238217	54238217	1
chr19	54240098	54240188	MIR516B1	90	+	NR_030212	54240188	54240188	1
chr19	54242586	54242673	MIR518A2	87	+	NR_030213	54242673	54242673	1
chr19	54244566	54244661	MIR517C	95	+	NR_030214	54244661	54244661	1
chr19	54245765	54245853	MIR520H	88	+	NR_030215	54245853	54245853	1
chr19	54251889	54251976	MIR521-1	87	+	NR_030216	54251976	54251976	1
chr19	54254464	54254551	MIR522	87	+	NR_030217	54254551	54254551	1
chr19	54255650	54255735	MIR519A1	85	+	NR_030218	54255735	54255735	1
chr19	54257271	54257356	MIR527	85	+	NR_030219	54257356	54257356	1
chr19	54259994	54260084	MIR516A1	90	+	NR_030220	54260084	54260084	1
chr19	54261485	54261572	MIR1283-2	87	+	NR_031696	54261572	54261572	1
chr19	54264386	54264476	MIR516A2	90	+	NR_030221	54264476	54264476	1
chr19	54265597	54265684	MIR519A2	87	+	NR_030222	54265684	54265684	1
chr19	54290928	54290995	MIR371A	67	+	NR_029864	54290995	54290995	1
chr19	54290930	54290996	MIR371B	66	-	NR_039909	54290996	54290996	1
chr19	54291143	54291210	MIR372	67	+	NR_029865	54291210	54291210	1
chr19	54291958	54292027	MIR373	69	+	NR_029866	54292027	54292027	1
chr19	54296854	54327657	NLRP12	30803	-	NM_001277126	54297302	54327428	10
chr19	54368837	54379689	MYADM	10852	+	NM_001290193	54376783	54377752	3
chr19	54385437	54410901	PRKCG	25464	+	NM_001316329	54385748	54410290	19
chr19	54415990	54446969	CACNG7	30979	+	NM_031896	54416085	54445547	5
chr19	54466289	54493469	CACNG8	27180	+	NM_031895	54466396	54486103	4
chr19	54485560	54485651	MIR935	91	+	NR_030632	54485651	54485651	1
chr19	54494402	54515920	CACNG6	21518	+	NR_102308	54515920	54515920	3
chr19	54544079	54567207	VSTM1	23128	-	NR_110142	54567207	54567207	10
chr19	54573200	54584634	TARM1	11434	-	NM_001135686	54573256	54584609	5
chr19	54597932	54605994	OSCAR	8062	-	NM_130771	54598485	54604083	7
chr19	54606159	54610281	NDUFA3	4122	+	NM_004542	54606186	54610209	4
chr19	54610319	54619055	TFPT	8736	-	NM_013342	54610356	54618649	6
chr19	54618789	54635150	PRPF31	16361	+	NM_015629	54621658	54634863	14
chr19	54641435	54659446	CNOT3	18011	+	NM_014516	54646714	54659145	18
chr19	54659377	54663481	LENG1	4104	-	NM_024316	54659458	54663433	4
chr19	54663832	54676944	TMC4	13112	-	NM_144686	54664042	54676812	15
chr19	54677105	54693733	MBOAT7	16628	-	NM_024298	54677737	54692362	8
chr19	54694118	54698394	TSEN34	4276	+	NM_001282333	54694217	54697526	6
chr19	54704725	54711515	RPS9	6790	+	NM_001013	54705052	54711443	5
chr19	54720146	54746711	LILRB3	26565	-	NM_006864	54720961	54746600	13
chr19	54740467	54746617	LILRA6	6150	-	NR_104098	54746617	54746617	10
chr19	54754268	54761171	LILRB5	6903	-	NM_006840	54754649	54761056	13
chr19	54777674	54785033	LILRB2	7359	-	NM_005874	54778536	54784351	14
chr19	54785963	54786035	MIR4752	72	+	NR_039907	54786035	54786035	1
chr19	54799849	54804265	LILRA3	4416	-	NM_006865	54800045	54804173	7
chr19	54818352	54824409	LILRA5	6057	-	NM_021250	54818697	54824289	7
chr19	54844455	54850440	LILRA4	5985	-	NM_012276	54844842	54850364	8
chr19	54865232	54882163	LAIR1	16931	-	NM_001289026	54866876	54881884	10
chr19	54926604	54947899	TTYH1	21295	+	NM_020659	54926726	54947309	14
chr19	54955993	54960216	LENG8-AS1	4223	-	NR_126418	54960216	54960216	3
chr19	54960339	54973226	LENG8	12887	+	NM_052925	54962521	54972108	16
chr19	54972977	54974894	LENG9	1917	-	NM_001301782	54973269	54974709	1
chr19	54976208	54984437	CDC42EP5	8229	-	NM_145057	54976284	54976731	3
chr19	55014012	55021900	LAIR2	7888	+	NM_002288	55014134	55021779	5
chr19	55043908	55057024	KIR3DX1	13116	+	NR_026716	55057024	55057024	10
chr19	55084463	55099028	LILRA2	14565	+	NM_001290271	55085345	55089149	9
chr19	55105040	55113846	LILRA1	8806	+	NM_006863	55105709	55112282	10
chr19	55128383	55148981	LILRB1	20598	+	NM_006669	55142524	55148329	16
chr19	55156759	55156834	MIR8061	75	+	NR_107028	55156834	55156834	1
chr19	55174270	55181810	LILRB4	7540	+	NM_001278426	55174485	55179470	12
chr19	55219699	55224955	LILRP2	5256	+	NR_003061	55224955	55224955	7
chr19	55235951	55248003	KIR3DL3	12052	+	NM_153443	55236001	55247563	8
chr19	55249973	55264504	KIR2DL3	14531	+	NM_015868	55250010	55263971	8
chr19	55280873	55282516	LOC101928804	1643	-	NR_110738	55282516	55282516	3
chr19	55281264	55295778	KIR2DL1	14514	+	NM_014218	55281302	55295265	8
chr19	55327892	55342233	KIR3DL1	14341	+	NM_013289	55327955	55341730	9
chr19	55344130	55360024	KIR2DS4	15894	+	NM_012314	55344219	55359398	8
chr19	55361897	55378670	KIR3DL2	16773	+	NM_006737	55361930	55378186	9
chr19	55385548	55402786	FCAR	17238	+	NM_002000	55385745	55401229	5
chr19	55417507	55424439	NCR1	6932	+	NM_004829	55417545	55424239	7
chr19	55434876	55458873	NLRP7	23997	-	NM_001127255	55435107	55453079	11
chr19	55476651	55512510	NLRP2	35859	+	NM_001174081	55481383	55512266	13
chr19	55525074	55549632	GP6	24558	-	NM_001083899	55525449	55549604	8
chr19	55555691	55580914	RDH13	25223	-	NM_138412	55556441	55568147	8
chr19	55587220	55599291	EPS8L1	12071	+	NM_133180	55587812	55598982	20
chr19	55602280	55628968	PPP1R12C	26688	-	NM_001271618	55602839	55628911	22
chr19	55634592	55634660	MIR7975	68	-	NR_107015	55634660	55634660	1
chr19	55644065	55660722	TNNT1	16657	-	NM_001126132	55644282	55658525	14
chr19	55663135	55669100	TNNI3	5965	-	NM_000363	55663201	55668957	7
chr19	55670028	55678090	DNAAF3	8062	-	NM_001256716	55670429	55677215	12
chr19	55684468	55691720	SYT5	7252	-	NM_003180	55684851	55690409	9
chr19	55692614	55720874	PTPRH	28260	-	NM_002842	55693121	55720801	20
chr19	55738001	55740632	TMEM86B	2631	-	NM_173804	55738548	55740109	3
chr19	55741146	55770038	PPP6R1	28892	-	NM_014931	55741895	55758471	24
chr19	55742252	55742320	MIR6804	68	-	NR_106862	55742320	55742320	1
chr19	55751279	55751344	MIR6802	65	-	NR_106860	55751344	55751344	1
chr19	55756553	55756618	MIR6803	65	-	NR_106861	55756618	55756618	1
chr19	55773590	55791751	HSPBP1	18161	-	NM_001130106	55773975	55790976	9
chr19	55795533	55823903	BRSK1	28370	+	NM_032430	55795810	55823436	19
chr19	55824168	55836708	TMEM150B	12540	-	NM_001085488	55824226	55832404	8
chr19	55851220	55859489	KMT5C	8269	+	NM_032701	55853304	55858817	9
chr19	55861069	55866182	COX6B2	5113	-	NM_144613	55865088	55865889	5
chr19	55866275	55874620	FAM71E2	8345	-	NM_001145402	55866667	55874434	11
chr19	55875749	55881831	IL11	6082	-	NM_000641	55877374	55881678	5
chr19	55888203	55889612	TMEM190	1409	+	NM_139172	55888221	55889571	5
chr19	55890611	55895627	TMEM238	5016	-	NM_001190764	55895096	55895627	2
chr19	55897299	55903451	RPL28	6152	+	NM_001136135	55897725	55903107	5
chr19	55899548	55899610	MIR6805	62	+	NR_106863	55899610	55899610	1
chr19	55912649	55919325	UBE2S	6676	-	NM_014501	55912803	55918957	4
chr19	55940104	55954230	SHISA7	14126	-	NM_001145176	55944522	55954230	4
chr19	55964345	55973049	ISOC2	8704	-	NM_001136201	55964674	55967853	6
chr19	55987698	55995854	ZNF628	8156	+	NM_033113	55991277	55995740	3
chr19	55996556	55998935	NAT14	2379	+	NM_020378	55997075	55998323	3
chr19	55999869	56030466	SSC5D	30597	+	NM_001144950	55999956	56030365	14
chr19	56041099	56048435	SBK2	7336	-	NM_001101401	56041099	56047661	4
chr19	56052022	56056909	SBK3	4887	-	NM_001199824	56052212	56056909	4
chr19	56088890	56092211	ZNF579	3321	-	NM_152600	56089316	56091005	2
chr19	56102736	56110893	FIZ1	8157	-	NM_032836	56103815	56109231	3
chr19	56111705	56114504	ZNF524	2799	+	NM_153219	56113478	56114273	2
chr19	56124958	56129907	ZNF865	4949	+	NM_001195605	56124984	56128164	1
chr19	56132106	56135941	ZNF784	3835	-	NM_203374	56133116	56135927	2
chr19	56152391	56154836	ZNF580	2445	+	NM_207115	56153874	56154393	2
chr19	56154985	56156989	ZNF581	2004	+	NM_016535	56155937	56156531	2
chr19	56158953	56164526	CCDC106	5573	+	NM_013301	56160412	56164112	6
chr19	56165415	56186082	U2AF2	20667	+	NM_001012478	56166470	56185434	12
chr19	56186560	56207133	EPN1	20573	+	NM_001130072	56189993	56206722	11
chr19	56219797	56249768	NLRP9	29971	-	NM_176820	56220277	56249740	9
chr19	56270506	56274541	RFPL4A	4035	+	NM_001145014	56273166	56274541	3
chr19	56283170	56284545	RFPL4AL1	1375	+	NM_001277397	56283170	56284545	2
chr19	56296762	56348128	NLRP11	51366	-	NM_145007	56296990	56329540	12
chr19	56347943	56393220	NLRP4	45277	+	NM_134444	56363446	56392953	10
chr19	56407310	56443702	NLRP13	36392	-	NM_176810	56407310	56443677	11
chr19	56459197	56499995	NLRP8	40798	+	NM_176811	56459268	56499279	10
chr19	56511091	56573174	NLRP5	62083	+	NM_153447	56511091	56572894	15
chr19	56578049	56590166	LOC101928886	12117	+	NR_110741	56590166	56590166	4
chr19	56598728	56632742	ZNF787	34014	-	NM_001002836	56599388	56614586	3
chr19	56652534	56672262	ZNF444	19728	+	NM_018337	56658280	56671570	5
chr19	56687388	56697144	GALP	9756	+	NM_033106	56688477	56696639	6
chr19	56701057	56704421	ZSCAN5B	3364	-	NM_001080456	56701195	56704421	4
chr19	56732678	56739659	ZSCAN5A	6981	-	NM_024303	56732943	56736415	5
chr19	56879467	56891196	ZNF542P	11729	+	NR_003127	56891196	56891196	7
chr19	56894647	56904889	ZNF582	10242	-	NM_144690	56895231	56903121	5
chr19	56905044	56910544	ZNF582-AS1	5500	+	NR_037160	56910544	56910544	2
chr19	56915382	56936400	ZNF583	21018	+	NM_001159860	56918483	56935737	5
chr19	56950692	56988770	ZNF667	38078	-	NR_030740	56988770	56988770	7
chr19	56989242	57006805	ZNF667-AS1	17563	+	NR_036521	57006805	57006805	2
chr19	57019211	57040269	ZNF471	21058	+	NM_020813	57022940	57037317	5
chr19	57050316	57068170	ZFP28	17854	+	NM_020828	57050387	57066761	8
chr19	57078889	57094262	ZNF470	15373	+	NM_001001668	57081680	57089951	6
chr19	57106663	57135544	ZNF71	28881	+	NM_021216	57132655	57134125	3
chr19	57154526	57168614	SMIM17	14088	+	NM_001193628	57157035	57166581	4
chr19	57174019	57183123	ZNF835	9104	-	NM_001005850	57174952	57176566	2
chr19	57276689	57311014	ZIM2-AS1	34325	+	NR_110744	57311014	57311014	4
chr19	57285922	57352097	ZIM2	66175	-	NM_001146326	57286055	57335645	12
chr19	57321444	57352094	PEG3	30650	-	NM_006210	57325042	57336023	10
chr19	57323847	57325161	PEG3-AS1	1314	+	NR_023847	57325161	57325161	1
chr19	57352269	57359922	MIMT1	7653	+	NR_024059	57359922	57359922	2
chr19	57631508	57643293	USP29	11785	+	NM_020903	57640043	57642812	4
chr19	57645463	57656570	ZIM3	11107	-	NM_052882	57646285	57654011	5
chr19	57663093	57678856	DUXA	15763	-	NM_001012729	57665779	57678811	6
chr19	57702867	57734214	ZNF264	31347	+	NM_003417	57703281	57724349	4
chr19	57742376	57746916	AURKC	4540	+	NM_003160	57743153	57746785	7
chr19	57752052	57774106	ZNF805	22054	+	NM_001023563	57752259	57766071	4
chr19	57791852	57805436	ZNF460	13584	+	NM_006635	57792174	57803598	3
chr19	57831864	57842144	ZNF543	10280	+	NM_213598	57832221	57840633	4
chr19	57862641	57871265	ZNF304	8624	+	NM_001290319	57865185	57869217	4
chr19	57874802	57890925	ZNF547	16123	+	NM_173631	57879923	57889553	4
chr19	57874878	57876721	TRAPPC2B	1843	+	NR_002166	57876721	57876721	2
chr19	57901217	57913919	ZNF548	12702	+	NM_001172773	57901467	57911257	4
chr19	57922528	57933307	ZNF17	10779	+	NM_006959	57922759	57932849	3
chr19	57946692	57957191	ZNF749	10499	+	NM_001023561	57946946	57956853	3
chr19	57966541	57968107	VN1R1	1566	-	NM_020633	57966792	57967854	1
chr19	57980953	57988938	ZNF772	7985	-	NM_001024596	57984641	57988677	5
chr19	57999078	58006048	ZNF419	6970	+	NM_001098491	57999318	58005458	5
chr19	58011221	58027791	ZNF773	16570	+	NR_130705	58027791	58027791	6
chr19	58038692	58052244	ZNF549	13552	+	NM_001199295	58038941	58050295	4
chr19	58053203	58071231	ZNF550	18028	-	NM_001277091	58058342	58071050	6
chr19	58082933	58090243	ZNF416	7310	-	NM_017879	58083486	58090072	4
chr19	58095627	58103758	ZIK1	8131	+	NM_001010879	58095724	58102643	4
chr19	58111252	58119637	ZNF530	8385	+	NM_020880	58111472	58118693	3
chr19	58125829	58133636	ZNF134	7807	+	NM_003435	58130836	58132771	3
chr19	58144534	58154147	ZNF211	9613	+	NR_049752	58154147	58154147	6
chr19	58180302	58190520	ZSCAN4	10218	+	NM_152677	58187513	58190273	5
chr19	58193336	58201169	ZNF551	7833	+	NM_001270938	58196632	58199656	3
chr19	58207642	58220579	ZNF154	12937	-	NR_110975	58220579	58220579	5
chr19	58231118	58238995	ZNF671	7877	-	NM_024833	58231848	58238896	4
chr19	58258163	58269527	ZNF776	11364	+	NM_173632	58258426	58266055	3
chr19	58281019	58291984	ZNF586	10965	+	NM_001204814	58288003	58291164	4
chr19	58318449	58326281	ZNF552	7832	-	NM_024762	58319407	58326111	3
chr19	58336666	58338830	FKBP1AP1	2164	-	NR_024162	58338830	58338830	2
chr19	58341661	58357606	ZNF587B	15945	+	NM_001204818	58341896	58355710	4
chr19	58361180	58376491	ZNF587	15311	+	NM_032828	58361406	58371508	3
chr19	58380746	58400442	ZNF814	19696	-	NM_001144989	58384189	58400170	3
chr19	58417141	58427984	ZNF417	10843	-	NM_001297734	58419917	58427779	3
chr19	58433251	58446755	ZNF418	13504	-	NM_001317029	58437517	58445190	7
chr19	58452200	58459077	ZNF256	6877	-	NM_005773	58452291	58458842	3
chr19	58469804	58485902	C19orf18	16098	-	NM_152474	58469969	58485800	6
chr19	58488440	58514714	ZNF606	26274	-	NM_025027	58489668	58512687	7
chr19	58514261	58518574	LOC100128398	4313	+	NR_036508	58518574	58518574	4
chr19	58545433	58565999	ZSCAN1	20566	+	NM_182572	58549204	58565419	6
chr19	58570606	58581110	ZNF135	10504	+	NM_001289402	58573040	58579829	5
chr19	58595208	58629793	ZSCAN18	34585	-	NM_001145542	58596051	58629763	7
chr19	58637694	58662148	ZNF329	24454	-	NM_024620	58639244	58640870	4
chr19	58694355	58724928	ZNF274	30573	+	NM_001278734	58697171	58724509	8
chr19	58740069	58775008	ZNF544	34939	+	NM_014480	58755389	58774120	7
chr19	58790317	58807254	ZNF8	16937	+	NM_021089	58790447	58806902	4
chr19	58838384	58853712	ZSCAN22	15328	+	NM_181846	58846168	58850692	3
chr19	58846053	58846117	MIR6806	64	+	NR_106864	58846117	58846117	1
chr19	58858171	58864865	A1BG	6694	-	NM_130786	58858387	58864803	8
chr19	58863335	58866549	A1BG-AS1	3214	+	NR_015380	58866549	58866549	4
chr19	58865722	58874214	ZNF497	8492	-	NM_198458	58867504	58869001	3
chr19	58878989	58892389	ZNF837	13400	-	NR_049780	58892389	58892389	3
chr19	58898136	58898225	MIR4754	89	-	NR_039910	58898225	58898225	1
chr19	58898635	58906171	RPS5	7536	+	NM_001009	58899504	58906117	6
chr19	58907456	58908446	RNF225	990	+	NM_001195135	58907456	58908446	1
chr19	58920040	58929692	ZNF584	9652	+	NM_001318002	58920514	58928225	5
chr19	58944180	58951589	ZNF132	7409	-	NM_003433	58944689	58951188	3
chr19	58962970	58969199	ZNF324B	6229	+	NM_207395	58965068	58967946	4
chr19	58978411	58984945	ZNF324	6534	+	NM_014347	58980552	58983521	4
chr19	58988545	59000900	ZNF446	12355	+	NM_001304453	58988585	59000769	6
chr19	59009699	59023432	SLC27A5	13733	-	NM_012254	59009881	59023322	10
chr19	59024896	59053079	ZBTB45	28183	-	NM_001316980	59025420	59029040	3
chr19	59055835	59062082	TRIM28	6247	+	NM_005762	59056124	59061920	17
chr19	59061651	59061743	MIR6807	92	+	NR_106865	59061743	59061743	1
chr19	59062932	59066491	CHMP2A	3559	-	NM_014453	59063015	59065579	6
chr19	59067078	59070343	UBE2M	3265	-	NM_003969	59067455	59069748	6
chr19	59070552	59086164	MZF1-AS1	15612	+	NR_027334	59086164	59086164	6
chr19	59073283	59084942	MZF1	11659	-	NM_003422	59073438	59082756	6
chr19	59086765	59095762	CENPBD1P1	8997	+	NR_026052	59095762	59095762	2
chr19_gl000209_random	21904	129563	KIR2DS2	107659	+	NM_001291700	21939	128940	6
chr19_gl000209_random	21910	36449	KIR2DL2	14539	+	NM_014219	21939	35938	8
chr19_gl000209_random	57208	68123	KIR2DL4	10915	+	NM_002255	57248	67717	8
chr19_gl000209_random	70070	84658	KIR3DS1	14588	+	NM_001083539	70107	83979	9
chr19_gl000209_random	86690	96155	KIR2DL5A	9465	+	NM_020535	86745	95742	8
chr19_gl000209_random	86745	96246	KIR2DL5B	9501	+	NM_001018081	86745	95742	8
chr19_gl000209_random	98111	113132	KIR2DS5	15021	+	NM_014513	98145	112480	8
chr19_gl000209_random	98134	112667	KIR2DS3	14533	+	NM_012313	98145	112480	8
chr19_gl000209_random	115098	129113	KIR2DS1	14015	+	NM_014512	115111	128940	8
chr20	68312	77214	DEFB125	8902	+	NM_153325	68350	77058	2
chr20	123193	126392	DEFB126	3199	+	NM_030931	123269	126333	2
chr20	138110	139804	DEFB127	1694	+	NM_139074	138185	139665	2
chr20	168493	170322	DEFB128	1829	-	NM_001037732	168526	170264	2
chr20	207898	210527	DEFB129	2629	+	NM_080831	207929	210412	2
chr20	238376	241736	DEFB132	3360	+	NM_207469	238419	239947	2
chr20	251503	271419	C20orf96	19916	-	NM_153269	251847	271251	11
chr20	278203	280963	ZCCHC3	2760	+	NM_033089	278227	279442	1
chr20	300330	305896	NRSN2-AS1	5566	-	NR_109990	305896	305896	3
chr20	306214	310872	SOX12	4658	+	NM_006943	306568	307516	1
chr20	327369	335512	NRSN2	8143	+	NM_024958	330287	334279	4
chr20	361272	378203	TRIB3	16931	+	NM_021158	368654	377334	4
chr20	388708	411610	RBCK1	22902	+	NM_031229	389401	411074	12
chr20	416120	443197	TBC1D20	27077	-	NR_111901	443197	443197	10
chr20	463337	524482	CSNK2A1	61145	-	NM_177559	464604	489195	14
chr20	584636	590910	TCF15	6274	-	NM_004609	585234	590881	2
chr20	627267	634014	SRXN1	6747	-	NM_080725	629357	633829	2
chr20	642239	656823	SCRT2	14584	-	NM_033129	644314	656245	2
chr20	740723	749228	SLC52A3	8505	-	NM_033409	741669	746418	5
chr20	814339	826922	FAM110A	12583	+	NM_001289145	825447	826335	3
chr20	853296	896960	ANGPT4	43664	-	NM_015985	853602	896857	9
chr20	939095	982907	RSPO4	43812	-	NM_001029871	940999	982807	5
chr20	1093905	1148426	PSMF1	54521	+	NM_178578	1099416	1145724	8
chr20	1161204	1166077	TMEM74B	4873	-	NM_001304749	1161491	1162190	2
chr20	1184097	1188918	C20orf202	4821	+	NM_001009612	1184160	1187746	2
chr20	1206763	1235145	RAD21L1	28382	+	NM_001136566	1209097	1235101	14
chr20	1246959	1289971	SNPH	43012	+	NM_014723	1277015	1286698	6
chr20	1290554	1309879	SDCBP2	19325	-	NM_080489	1291084	1301060	9
chr20	1290554	1373816	FKBP1A-SDCBP2	83262	-	NR_037661	1373816	1373816	10
chr20	1305986	1359379	SDCBP2-AS1	53393	+	NR_040048	1359379	1359379	4
chr20	1349620	1373816	FKBP1A	24196	-	NM_000801	1352755	1373642	5
chr20	1373543	1373605	MIR6869	62	-	NR_106929	1373605	1373605	1
chr20	1422806	1448337	NSFL1C	25531	-	NM_001206736	1424393	1447469	9
chr20	1455235	1472233	SIRPB2	16998	-	NM_001134836	1456811	1472005	5
chr20	1514896	1538343	SIRPD	23447	-	NM_178460	1515070	1538299	4
chr20	1545028	1600689	SIRPB1	55661	-	NM_006065	1546800	1600590	6
chr20	1609797	1638425	SIRPG	28628	-	NM_018556	1610869	1638360	6
chr20	1614153	1629119	SIRPG-AS1	14966	+	NR_110090	1629119	1629119	3
chr20	1754010	1760392	LOC100289473	6382	-	NR_037142	1760392	1760392	4
chr20	1874812	1920540	SIRPA	45728	+	NM_001040022	1876093	1918214	9
chr20	1959401	1974931	PDYN	15530	-	NM_001190898	1960968	1963730	4
chr20	2082527	2129198	STK35	46671	+	NM_080836	2082527	2098024	4
chr20	2187573	2193797	LOC388780	6224	+	NM_001287682	2187790	2193566	2
chr20	2276612	2321725	TGM3	45113	+	NM_003245	2276709	2321227	13
chr20	2361553	2413399	TGM6	51846	+	NM_198994	2361614	2413289	13
chr20	2442280	2451499	SNRPB	9219	-	NM_198216	2442401	2451336	7
chr20	2443597	2443693	SNORD119	96	-	NR_003684	2443693	2443693	1
chr20	2462465	2505168	ZNF343	42703	-	NM_001282495	2463806	2474541	7
chr20	2517252	2622430	TMC2	105178	+	NM_080751	2517267	2621997	20
chr20	2633177	2639039	NOP56	5862	+	NR_027700	2639039	2639039	12
chr20	2633422	2633488	MIR1292	66	+	NR_031699	2633488	2633488	1
chr20	2634857	2634932	SNORD110	75	+	NR_003078	2634932	2634932	1
chr20	2635712	2635844	SNORA51	132	+	NR_002981	2635844	2635844	1
chr20	2636742	2636828	SNORD86	86	+	NR_004399	2636828	2636828	1
chr20	2637269	2637340	SNORD56	71	+	NR_002739	2637340	2637340	1
chr20	2637584	2637656	SNORD57	72	+	NR_002738	2637656	2637656	1
chr20	2639040	2644865	IDH3B	5825	-	NM_006899	2639396	2644834	12
chr20	2673523	2740754	EBF4	67231	+	NM_001110514	2673791	2739625	18
chr20	2774714	2781292	CPXM1	6578	-	NM_001184699	2774835	2781218	14
chr20	2795632	2796476	C20orf141	844	+	NM_001256538	2795830	2796421	3
chr20	2796975	2797804	TMEM239	829	+	NM_001167670	2797200	2797659	2
chr20	2815960	2821889	PCED1A	5929	-	NM_001271168	2816107	2820558	8
chr20	2821342	2847378	VPS16	26036	+	NM_022575	2821420	2847220	24
chr20	2844840	3019315	PTPRA	174475	+	NM_002836	2944923	3018779	28
chr20	3024267	3026391	GNRH2	2124	+	NM_178332	3025060	3026382	4
chr20	3026674	3028896	MRPS26	2222	+	NM_030811	3026714	3028515	4
chr20	3052265	3053163	OXT	898	+	NM_000915	3052301	3053064	3
chr20	3063201	3065370	AVP	2169	-	NM_000490	3063275	3065320	3
chr20	3087556	3131513	UBOX5-AS1	43957	+	NR_038395	3131513	3131513	7
chr20	3088218	3140556	UBOX5	52338	-	NM_014948	3090751	3104011	5
chr20	3127164	3140532	FASTKD5	13368	-	NM_021826	3127421	3129716	2
chr20	3143262	3154238	LZTS3	10976	-	NM_001282533	3145099	3147809	6
chr20	3170995	3185343	DDRGK1	14348	-	NM_023935	3171298	3185273	9
chr20	3189513	3204516	ITPA	15003	+	NR_052000	3204516	3204516	7
chr20	3208062	3219887	SLC4A11	11825	-	NM_001174089	3208432	3219783	20
chr20	3229947	3388309	C20orf194	158362	-	NM_001009984	3233217	3388204	37
chr20	3451664	3631769	ATRN	180105	+	NM_139321	3451754	3627494	29
chr20	3639938	3644046	GFRA4	4108	-	NM_022139	3640555	3644046	6
chr20	3648619	3662778	ADAM33	14159	-	NM_025220	3649609	3662651	22
chr20	3667616	3687775	SIGLEC1	20159	-	NM_023068	3669206	3687775	21
chr20	3713316	3733758	HSPA12B	20442	+	NM_001197327	3719321	3732813	13
chr20	3734145	3749035	C20orf27	14890	-	NR_047675	3749035	3749035	6
chr20	3758150	3762102	SPEF1	3952	-	NM_015417	3758858	3761934	7
chr20	3764497	3767337	CENPB	2840	-	NM_001810	3765330	3767130	1
chr20	3767418	3786768	CDC25B	19350	+	NM_001287517	3767778	3785608	16
chr20	3789140	3793081	LOC101929125	3941	+	NR_109859	3793081	3793081	4
chr20	3801170	3805954	AP5S1	4784	+	NM_018347	3802764	3804944	3
chr20	3827445	3856770	MAVS	29325	+	NM_020746	3835271	3846794	7
chr20	3869485	3904502	PANK2	35017	+	NM_024960	3888817	3903941	7
chr20	3898140	3898218	MIR103A2	78	+	NR_029519	3898218	3898218	1
chr20	3898148	3898210	MIR103B2	62	-	NR_031722	3898210	3898210	1
chr20	3912068	3996216	RNF24	84148	-	NM_001134338	3914709	3955034	7
chr20	4129425	4168394	SMOX	38969	+	NM_175842	4155702	4168054	9
chr20	4173736	4176600	LINC01433	2864	+	NR_033917	4176600	4176600	3
chr20	4201277	4229659	ADRA1D	28382	-	NM_000678	4202169	4229604	2
chr20	4666796	4682234	PRNP	15438	+	NM_183079	4679866	4680628	2
chr20	4702499	4709108	PRND	6609	+	NM_012409	4705197	4705728	2
chr20	4711927	4721314	PRNT	9387	-	NR_024269	4721314	4721314	2
chr20	4760669	4804291	RASSF2	43622	-	NM_014737	4764918	4781676	12
chr20	4833001	4990939	SLC23A2	157938	-	NM_203327	4837617	4913208	17
chr20	5080483	5093733	TMEM230	13250	-	NM_001009924	5081436	5090076	5
chr20	5095598	5107268	PCNA	11670	-	NM_002592	5095928	5100444	7
chr20	5100231	5100615	PCNA-AS1	384	+	NR_028370	5100615	5100615	1
chr20	5107406	5178533	CDS2	71127	+	NM_003818	5107738	5170880	13
chr20	5282685	5295015	PROKR2	12330	-	NM_144773	5282685	5295015	2
chr20	5412602	5426394	LINC00658	13792	-	NR_038240	5426394	5426394	5
chr20	5451841	5457780	LOC643406	5939	+	NR_029405	5457780	5457780	2
chr20	5479217	5485242	LINC00654	6025	-	NR_015406	5485242	5485242	2
chr20	5488520	5490648	LOC101929207	2128	-	NR_109860	5490648	5490648	3
chr20	5525079	5591672	GPCPD1	66593	-	NM_019593	5528306	5585058	20
chr20	5731032	5845053	C20orf196	114021	+	NM_001303478	5753677	5844109	4
chr20	5891973	5906005	CHGB	14032	+	NM_001819	5892279	5905695	5
chr20	5918478	5931204	TRMT6	12726	-	NM_015939	5919180	5931051	11
chr20	5931297	5975852	MCM8	44555	+	NM_182802	5932661	5975037	19
chr20	5971440	5986467	MCM8-AS1	15027	-	NR_110101	5986467	5986467	5
chr20	5986738	6020697	CRLS1	33959	+	NM_019095	5986892	6017804	7
chr20	6021191	6034726	LRRN4	13535	-	NM_152611	6021667	6033445	5
chr20	6055491	6104191	FERMT1	48700	-	NM_017671	6057819	6100201	15
chr20	6407378	6509106	CASC20	101728	+	NR_109953	6509106	6509106	4
chr20	6748744	6760925	BMP2	12181	+	NM_001200	6750773	6759736	3
chr20	7127113	7234849	LINC01428	107736	-	NR_110609	7234849	7234849	8
chr20	7328079	7349148	LOC101929312	21069	+	NR_110610	7349148	7349148	3
chr20	7352254	7352339	MIR8062	85	+	NR_107029	7352339	7352339	1
chr20	7863630	7921093	HAO1	57463	-	NM_017545	7864239	7921069	8
chr20	7957999	8000476	TMX4	42477	-	NM_021156	7962897	8000260	8
chr20	8112911	8865547	PLCB1	752636	+	NM_182734	8113298	8782801	33
chr20	9049700	9461462	PLCB4	411762	+	NM_001172646	9288461	9459636	38
chr20	9485826	9495645	LAMP5-AS1	9819	-	NR_109957	9495645	9495645	5
chr20	9495004	9511171	LAMP5	16167	+	NM_012261	9495499	9510467	6
chr20	9518036	9819687	PAK7	301651	-	NM_020341	9520108	9624976	11
chr20	9966980	9987764	LOC101929371	20784	+	NR_109861	9987764	9987764	2
chr20	10004459	10200154	SNAP25-AS1	195695	-	NR_040710	10200154	10200154	5
chr20	10015646	10037410	ANKEF1	21764	+	NM_022096	10018949	10036308	11
chr20	10199476	10288066	SNAP25	88590	+	NM_003081	10256139	10286845	8
chr20	10385427	10414887	MKKS	29460	-	NM_170784	10385894	10394162	6
chr20	10415950	10604027	SLX4IP	188077	+	NM_001009608	10438852	10604027	8
chr20	10618331	10654694	JAG1	36363	-	NM_000214	10620145	10654178	26
chr20	10630283	10630343	MIR6870	60	-	NR_106930	10630343	10630343	1
chr20	10733737	10734675	LOC101929395	938	+	NR_110611	10734675	10734675	2
chr20	10855980	10889920	LOC101929413	33940	-	NR_109866	10889920	10889920	7
chr20	11247306	11254031	LOC339593	6725	-	NR_038972	11254031	11254031	2
chr20	11790634	11851363	LINC00687	60729	-	NR_110635	11851363	11851363	2
chr20	11871370	11907243	BTBD3	35873	+	NM_181443	11871415	11904314	5
chr20	12845851	12933167	LOC101929486	87316	-	NR_109868	12933167	12933167	12
chr20	12915525	12917611	LOC102606466	2086	-	NR_109872	12917611	12917611	2
chr20	12930987	12932275	LOC100505515	1288	+	NR_109870	12932275	12932275	2
chr20	12989626	13147411	SPTLC3	157785	+	NM_018327	12989915	13145514	12
chr20	13202417	13281297	ISM1	78880	+	NM_080826	13202423	13280106	6
chr20	13218066	13220334	ISM1-AS1	2268	-	NR_040043	13220334	13220334	3
chr20	13370035	13619583	TASP1	249548	-	NM_017714	13371006	13610725	14
chr20	13694968	13765579	ESF1	70611	-	NM_001276380	13695520	13763786	14
chr20	13765671	13799067	NDUFAF5	33396	+	NR_029377	13799067	13799067	12
chr20	13830043	13975979	SEL1L2	145936	-	NR_073207	13975979	13975979	19
chr20	13976145	16033841	MACROD2	2057696	+	NM_080676	13976409	16030521	17
chr20	14304638	14318313	FLRT3	13675	-	NM_198391	14306202	14308152	3
chr20	14535029	14609554	MACROD2-IT1	74525	+	NR_104193	14609554	14609554	5
chr20	14864898	14910164	MACROD2-AS1	45266	-	NR_037841	14910164	14910164	3
chr20	15872978	15966527	LOC613266	93549	-	NR_130924	15966527	15966527	2
chr20	16252748	16554079	KIF16B	301331	-	NM_024704	16253897	16553920	26
chr20	16710608	16722417	SNRPB2	11809	+	NM_003092	16712347	16721650	7
chr20	16728997	16732809	OTOR	3812	+	NM_020157	16729046	16731763	4
chr20	17206751	17465222	PCSK2	258471	+	NM_001201528	17208007	17462715	13
chr20	17474549	17549865	BFSP1	75316	-	NM_001278608	17474718	17505513	10
chr20	17550598	17588652	DSTN	38054	+	NM_001011546	17581430	17587791	5
chr20	17594322	17662928	RRBP1	68606	-	NM_001042576	17594826	17641152	26
chr20	17674319	17716517	BANF2	42198	+	NM_001159495	17674333	17716456	3
chr20	17922239	17949634	SNX5	27395	-	NM_152227	17923000	17949068	14
chr20	17943352	17943589	SNORD17	237	-	NR_003045	17943589	17943589	1
chr20	17949533	17971765	MGME1	22232	+	NM_001310338	17950502	17970752	6
chr20	18004795	18039832	OVOL2	35037	-	NM_001303461	18005279	18022292	4
chr20	18118498	18123812	PET117	5314	+	NM_001164811	18118599	18123001	2
chr20	18122867	18169031	CSRP2BP	46164	+	NM_020536	18123304	18168103	10
chr20	18268926	18297640	ZNF133	28714	+	NM_003434	18286330	18297460	7
chr20	18359692	18362127	LINC00851	2435	+	NR_034167	18362127	18362127	2
chr20	18364010	18447829	DZANK1	83819	-	NM_001099407	18365042	18446002	21
chr20	18448032	18465292	POLR3F	17260	+	NR_104209	18465292	18465292	10
chr20	18451258	18451335	MIR3192	77	+	NR_036160	18451335	18451335	1
chr20	18467187	18477887	RBBP9	10700	-	NM_006606	18470407	18477811	5
chr20	18488187	18542050	SEC23B	53863	+	NM_032985	18491479	18541384	20
chr20	18548072	18550203	LINC00493	2131	+	NR_015432	18550203	18550203	2
chr20	18568555	18744560	DTD1	176005	+	NM_080820	18568716	18724896	6
chr20	18655038	18679352	LOC101929526	24314	-	NR_109955	18679352	18679352	4
chr20	18768614	18775228	LINC00652	6614	-	NR_026883	18775228	18775228	4
chr20	18774692	18776709	LOC100270804	2017	+	NR_026885	18776709	18776709	1
chr20	18789994	18810847	C20orf78	20853	-	NM_001302818	18790419	18810695	3
chr20	18794369	18795035	SCP2D1	666	+	NM_178483	18794459	18794930	1
chr20	19193289	19703541	SLC24A3	510252	+	NM_020689	19193486	19701784	17
chr20	19222945	19265240	LOC100130264	42295	-	NR_024564	19265240	19265240	8
chr20	19867164	19983103	RIN2	115939	+	NM_001242581	19867313	19981580	12
chr20	19997933	20014273	NAA20	16340	+	NM_016100	19998040	20013831	6
chr20	20015004	20036690	CRNKL1	21686	-	NM_016652	20016838	20036658	15
chr20	20033157	20341346	CFAP61	308189	+	NM_015585	20037297	20341054	27
chr20	20348764	20351592	INSM1	2828	+	NM_002196	20348911	20350444	1
chr20	20370271	20693266	RALGAPA2	322995	-	NM_020343	20377373	20693123	40
chr20	21106623	21227258	KIZ	120635	+	NM_018474	21106756	21227214	13
chr20	21175043	21198927	KIZ-AS1	23884	-	NR_109956	21198927	21198927	8
chr20	21283921	21370463	XRN2	86542	+	NM_012255	21284036	21369976	30
chr20	21376004	21378047	NKX2-4	2043	-	NM_033176	21376548	21378037	2
chr20	21491659	21494664	NKX2-2	3005	-	NM_002509	21492560	21494307	2
chr20	21550661	21596360	LOC101929625	45699	+	NR_109880	21596360	21596360	4
chr20	21591424	21684223	LOC101929608	92799	-	NR_109878	21684223	21684223	5
chr20	21686296	21699124	PAX1	12828	+	NM_006192	21686350	21695441	5
chr20	22034727	22055292	LINC01432	20565	+	NR_038394	22055292	22055292	4
chr20	22260865	22263439	LINC01427	2574	-	NR_110615	22263439	22263439	4
chr20	22380970	22401281	LOC284788	20311	-	NR_027090	22401281	22401281	3
chr20	22541191	22559280	LINC00261	18089	-	NR_001558	22559280	22559280	4
chr20	22561641	22566101	FOXA2	4460	-	NM_153675	22562487	22564898	3
chr20	22568159	22588155	LINC01384	19996	-	NR_109883	22588155	22588155	3
chr20	23016056	23017314	SSTR4	1258	+	NM_001052	23016120	23017287	1
chr20	23026269	23030301	THBD	4032	-	NM_000361	23028413	23030141	1
chr20	23059992	23066977	CD93	6985	-	NM_012072	23064586	23066829	2
chr20	23105704	23113273	LINC00656	7569	-	NR_034149	23113273	23113273	4
chr20	23331372	23335408	NXT1	4036	+	NM_013248	23334678	23335101	2
chr20	23337230	23338764	LINC01431	1534	-	NR_109884	23338764	23338764	3
chr20	23342768	23353698	GZF1	10930	+	NM_001317012	23345020	23351078	7
chr20	23355155	23402156	NAPB	47001	-	NM_022080	23358012	23402039	11
chr20	23420321	23425567	CSTL1	5246	+	NM_138283	23420904	23425515	4
chr20	23431040	23433482	CST11	2442	-	NM_130794	23431142	23433448	3
chr20	23471737	23476655	CST8	4918	+	NM_001281730	23472304	23476551	4
chr20	23499782	23522655	CST13P	22873	+	NR_001279	23522655	23522655	4
chr20	23545369	23549386	CST9L	4017	-	NM_080610	23545584	23549087	3
chr20	23583046	23586610	CST9	3564	-	NM_001008693	23584146	23586501	2
chr20	23608533	23618685	CST3	10152	-	NM_001288614	23614552	23618499	4
chr20	23666276	23669662	CST4	3386	-	NM_001899	23666530	23669606	3
chr20	23728189	23731574	CST1	3385	-	NM_001898	23728452	23731503	3
chr20	23804403	23807312	CST2	2909	-	NM_001322	23804656	23807297	3
chr20	23856571	23860380	CST5	3809	-	NM_001900	23856824	23860313	3
chr20	23965689	23969416	GGTLC1	3727	-	NM_178311	23965852	23967248	6
chr20	24180402	24205224	FLJ33581	24822	+	NR_040102	24205224	24205224	4
chr20	24449834	24647253	SYNDIG1	197419	+	NM_024893	24523733	24646140	4
chr20	24929865	24940564	CST7	10699	+	NM_003650	24930141	24940348	4
chr20	24943579	24973425	APMAP	29846	-	NM_020531	24944448	24973324	9
chr20	24986865	25038818	ACSS1	51953	-	NM_032501	24988397	25038738	14
chr20	25051520	25063015	VSX1	11495	-	NR_045948	25063015	25063015	6
chr20	25121433	25129426	LOC284798	7993	-	NR_027091	25129426	25129426	4
chr20	25165307	25177528	LOC101926889	12221	-	NR_109994	25177528	25177528	6
chr20	25176305	25207365	ENTPD6	31060	+	NM_001247	25187172	25206233	15
chr20	25228705	25278648	PYGB	49943	+	NM_002862	25228814	25277158	20
chr20	25275378	25371618	ABHD12	96240	-	NM_015600	25275608	25371339	13
chr20	25388322	25429191	GINS1	40869	+	NM_021067	25388456	25426627	7
chr20	25433337	25566153	NINL	132816	-	NM_025176	25434086	25507223	24
chr20	25593572	25604648	NANP	11076	-	NM_152667	25596560	25604584	2
chr20	25604680	25658708	ZNF337-AS1	54028	+	NR_126465	25658708	25658708	4
chr20	25653830	25677540	ZNF337	23710	-	NM_015655	25655667	25667053	5
chr20	25744101	25776878	FAM182B	32777	-	NR_027061	25776878	25776878	5
chr20	25825302	25834657	LOC101926935	9355	-	NR_110001	25834657	25834657	3
chr20	25936447	25949924	LOC101926955	13477	+	NR_110003	25949924	25949924	4
chr20	25990434	26002430	LOC100134868	11996	+	NR_004846	26002430	26002430	5
chr20	26035249	26067553	FAM182A	32304	+	NR_026713	26067553	26067553	5
chr20	26084051	26094677	NCOR1P1	10626	-	NR_003678	26094677	26094677	2
chr20	26167654	26189869	MIR663AHG	22215	-	NR_040095	26189869	26189869	5
chr20	26188821	26188914	MIR663A	93	-	NR_030386	26188914	26188914	1
chr20	29558487	29570363	LINC01598	11876	-	NR_133643	29570363	29570363	4
chr20	29611878	29634007	FRG1BP	22129	+	NR_003579	29634007	29634007	8
chr20	29612047	29628331	FRG1DP	16284	+	NR_132316	29628331	29628331	6
chr20	29637583	29638138	MLLT10P1	555	-	NR_045115	29638138	29638138	1
chr20	29845466	29847435	DEFB115	1969	+	NM_001037730	29845466	29847435	2
chr20	29891014	29896388	DEFB116	5374	-	NM_001037731	29891014	29896388	2
chr20	29956420	29961705	DEFB118	5285	+	NM_054112	29956453	29960973	2
chr20	29964965	29978452	DEFB119	13487	-	NR_073151	29978452	29978452	4
chr20	29992647	30000641	DEFB121	7994	-	NM_001171832	29992715	30000446	2
chr20	30009241	30016983	DEFB122	7742	-	NR_045677	30016983	30016983	3
chr20	30028321	30038060	DEFB123	9739	+	NM_153324	30028501	30037977	2
chr20	30053308	30060816	DEFB124	7508	-	NM_001037500	30053308	30060816	2
chr20	30063090	30072708	REM1	9618	+	NM_014012	30064248	30072233	5
chr20	30073580	30075377	LINC00028	1797	+	NR_024358	30075377	30075377	4
chr20	30102212	30157370	HM13	55158	+	NM_178581	30102354	30157022	13
chr20	30135184	30136019	MCTS2P	835	+	NR_003677	30136019	30136019	1
chr20	30155509	30161066	HM13-AS1	5557	-	NR_046853	30161066	30161066	3
chr20	30193085	30194317	ID1	1232	+	NM_002165	30193190	30193897	2
chr20	30194988	30195043	MIR3193	55	+	NR_036161	30195043	30195043	1
chr20	30225690	30232800	COX4I2	7110	+	NM_032609	30226820	30232707	5
chr20	30252254	30311802	BCL2L1	59548	-	NM_001317921	30253751	30310021	3
chr20	30309309	30311212	ABALON	1903	+	NR_131907	30311212	30311212	1
chr20	30326903	30389603	TPX2	62700	+	NM_012112	30345279	30388883	18
chr20	30407177	30422500	MYLK2	15323	+	NM_033118	30407383	30421600	13
chr20	30432102	30433420	FOXS1	1318	-	NM_004118	30432352	30433345	1
chr20	30448869	30458479	DUSP15	9610	-	NM_080611	30449205	30458140	7
chr20	30458504	30530858	TTLL9	72354	+	NM_001008409	30458929	30530824	15
chr20	30532757	30539883	PDRG1	7126	-	NM_030815	30533609	30539764	5
chr20	30555804	30586256	XKR7	30452	+	NM_001011718	30555978	30585260	3
chr20	30598244	30619984	CCM2L	21740	+	NM_080625	30598257	30617605	9
chr20	30639990	30689657	HCK	49667	+	NM_001172133	30659465	30689322	14
chr20	30697308	30755061	TM9SF4	57753	+	NM_014742	30697543	30753247	18
chr20	30776948	30778163	TSPY26P	1215	-	NR_002781	30778163	30778163	1
chr20	30780306	30795546	PLAGL2	15240	-	NM_002657	30784254	30789981	3
chr20	30795695	30826467	POFUT1	30772	+	NM_015352	30795744	30822464	7
chr20	30825597	30825650	MIR1825	53	+	NR_031726	30825650	30825650	1
chr20	30865453	30922811	KIF3B	57358	+	NM_004798	30897580	30919122	9
chr20	30946146	31027122	ASXL1	80976	+	NM_015338	30946578	31025141	12
chr20	31030861	31172875	NOL4L	142014	-	NM_001256798	31035398	31172692	11
chr20	31097761	31108088	LOC101929698	10327	+	NR_110619	31108088	31108088	3
chr20	31175280	31196694	LOC149950	21414	+	NR_034152	31196694	31196694	3
chr20	31219426	31239783	C20orf203	20357	-	NM_182584	31238233	31238954	5
chr20	31290492	31331814	COMMD7	41322	-	NM_053041	31291183	31331197	9
chr20	31350190	31397162	DNMT3B	46972	+	NM_006892	31368129	31395709	23
chr20	31407698	31438211	MAPRE1	30513	+	NM_012325	31413733	31436534	7
chr20	31571580	31592239	SUN5	20659	-	NM_080675	31571599	31592146	13
chr20	31595383	31611515	BPIFB2	16132	+	NM_025227	31596380	31611189	16
chr20	31619453	31631853	BPIFB6	12400	+	NM_174897	31619453	31631853	15
chr20	31643136	31661443	BPIFB3	18307	+	NM_182658	31643229	31661411	15
chr20	31669317	31699557	BPIFB4	30240	+	NM_182519	31669332	31699243	16
chr20	31755959	31769223	BPIFA2	13264	+	NM_080574	31756951	31768366	9
chr20	31781410	31798268	BPIFA4P	16858	+	NR_026760	31798268	31798268	9
chr20	31805115	31815612	BPIFA3	10497	+	NM_178466	31805342	31815423	7
chr20	31823801	31831115	BPIFA1	7314	+	NM_130852	31825517	31830333	9
chr20	31870940	31897684	BPIFB1	26744	+	NM_033197	31873879	31897573	16
chr20	31946644	31989375	CDK5RAP1	42731	-	NM_016408	31946848	31984870	14
chr20	31995762	32031698	SNTA1	35936	-	NM_003098	31996312	32031426	8
chr20	32077927	32237837	CBFA2T2	159910	+	NM_001032999	32078073	32232452	11
chr20	32244892	32262264	NECAB3	17372	-	NM_031231	32245634	32262158	13
chr20	32250091	32251721	C20orf144	1630	+	NM_080825	32250151	32251673	2
chr20	32254303	32256331	ACTL10	2028	+	NM_001024675	32255303	32256041	1
chr20	32263291	32274210	E2F1	10919	-	NM_005225	32264537	32274070	7
chr20	32290549	32308136	PXMP4	17587	-	NM_007238	32295511	32308013	4
chr20	32319565	32380075	ZNF341	60510	+	NM_001282933	32319827	32379323	15
chr20	32375178	32398905	ZNF341-AS1	23727	-	NR_110623	32398905	32398905	4
chr20	32399109	32442173	CHMP4B	43064	+	NM_176812	32399274	32441366	5
chr20	32580293	32582173	RALY-AS1	1880	-	NR_109885	32582173	32582173	3
chr20	32581457	32670991	RALY	89534	+	NM_016732	32659880	32666355	10
chr20	32636924	32636996	MIR4755	72	+	NR_039911	32636996	32636996	1
chr20	32676103	32700162	EIF2S2	24059	-	NM_003908	32677535	32699916	9
chr20	32848170	32857148	ASIP	8978	+	NM_001672	32848180	32856973	3
chr20	32868070	32899608	AHCY	31538	-	NM_001161766	32868839	32883335	10
chr20	32951040	33099198	ITCH	148158	+	NM_001257137	32981617	33095599	26
chr20	33054129	33054223	MIR644A	94	+	NR_030374	33054223	33054223	1
chr20	33104188	33128762	DYNLRB1	24574	+	NM_001281728	33122451	33128428	5
chr20	33134687	33148149	MAP1LC3A	13462	+	NM_181509	33137781	33147702	5
chr20	33148345	33265089	PIGU	116744	-	NM_080476	33148669	33264889	12
chr20	33292147	33301237	TP53INP2	9090	+	NM_021202	33296543	33298111	5
chr20	33302577	33413433	NCOA6	110856	-	NM_014071	33303125	33370158	15
chr20	33421377	33422265	HMGB3P1	888	-	NR_002165	33422265	33422265	1
chr20	33432522	33460661	GGT7	28139	-	NM_178026	33433130	33460618	15
chr20	33462765	33515769	ACSS2	53004	+	NM_001242393	33470703	33515017	18
chr20	33516235	33543601	GSS	27366	-	NM_000178	33516630	33539655	13
chr20	33543637	33590240	MYH7B	46603	+	NM_020884	33563297	33589991	45
chr20	33578178	33578300	MIR499A	122	+	NR_030223	33578300	33578300	1
chr20	33578202	33578275	MIR499B	73	-	NR_039912	33578275	33578275	1
chr20	33590206	33680618	TRPC4AP	90412	-	NM_015638	33590948	33680584	19
chr20	33703159	33735161	EDEM2	32002	-	NM_018217	33703235	33735061	11
chr20	33759739	33765165	PROCR	5426	+	NM_006404	33759957	33764616	4
chr20	33814538	33864804	MMP24	50266	+	NM_006690	33814541	33862412	9
chr20	33864135	33865960	MMP24-AS1	1825	-	NR_102705	33865960	33865960	2
chr20	33866708	33872619	EIF6	5911	-	NM_002212	33866999	33872290	7
chr20	33873053	33873575	FAM83C-AS1	522	+	NR_109815	33873575	33873575	2
chr20	33873533	33880225	FAM83C	6692	-	NM_178468	33874337	33880107	4
chr20	33890368	33999945	UQCC1	109577	-	NM_018244	33891737	33999766	10
chr20	34021144	34025970	GDF5	4826	-	NM_000557	34021706	34025708	2
chr20	34041775	34041919	MIR1289-1	144	-	NR_031620	34041919	34041919	1
chr20	34043222	34099803	CEP250	56581	+	NM_007186	34050192	34099455	35
chr20	34108569	34117481	C20orf173	8912	-	NR_026933	34117481	34117481	11
chr20	34129777	34145405	ERGIC3	15628	+	NM_198398	34129846	34145275	14
chr20	34146506	34195484	FER1L4	48978	-	NR_119376	34195484	34195484	44
chr20	34203805	34209016	SPAG4	5211	+	NM_001317931	34204137	34208944	12
chr20	34213952	34252878	CPNE1	38926	-	NM_152928	34214162	34220845	17
chr20	34236846	34252878	RBM12	16032	-	NM_152838	34240445	34243244	3
chr20	34256609	34287287	NFS1	30678	-	NR_037570	34287287	34287287	14
chr20	34287231	34288902	ROMO1	1671	+	NM_080748	34287554	34288828	3
chr20	34291530	34330258	RBM39	38728	-	NR_040724	34330258	34330258	18
chr20	34359922	34538288	PHF20	178366	+	NM_016436	34389444	34535549	18
chr20	34541538	34543281	SCAND1	1743	-	NM_016558	34541666	34542206	3
chr20	34556502	34618622	CNBD2	62120	+	NM_080834	34556684	34618570	12
chr20	34633539	34638882	LINC00657	5343	-	NR_027451	34638882	34638882	1
chr20	34679425	34820721	EPB41L1	141296	+	NM_001258331	34763481	34817262	20
chr20	34824338	34844863	AAR2	20525	+	NM_015511	34827790	34843667	4
chr20	34894244	35157040	DLGAP4	262796	+	NM_014902	35060120	35155434	13
chr20	35136104	35201678	DLGAP4-AS1	65574	-	NR_109939	35201678	35201678	5
chr20	35169886	35178226	MYL9	8340	+	NM_006097	35173287	35177652	4
chr20	35201875	35222355	TGIF2	20480	+	NM_001199514	35207177	35219834	3
chr20	35202956	35240960	TGIF2-C20orf24	38004	+	NM_001199535	35207177	35240454	5
chr20	35234136	35240960	C20orf24	6824	+	NR_026562	35240960	35240960	5
chr20	35240923	35274619	SLA2	33696	-	NM_175077	35242371	35269738	8
chr20	35280168	35374541	NDRG3	94373	-	NM_032013	35281922	35350138	16
chr20	35380193	35402230	DSN1	22037	-	NM_001145315	35381190	35399861	11
chr20	35405844	35488276	SOGA1	82432	-	NM_199181	35406176	35467817	15
chr20	35504523	35522634	TLDC2	18111	+	NM_080628	35504577	35517789	7
chr20	35520226	35580246	SAMHD1	60020	-	NM_015474	35521334	35580046	16
chr20	35624754	35724403	RBL1	99649	-	NM_002895	35627161	35724331	22
chr20	35729628	35807991	MROH8	78363	-	NM_152503	35731089	35807883	24
chr20	35807455	35870025	RPN2	62570	+	NM_002951	35807759	35869718	17
chr20	35879489	35885299	GHRH	5810	-	NM_021081	35879615	35885292	4
chr20	35918050	35945663	MANBAL	27613	+	NM_022077	35929666	35944818	4
chr20	35973087	36033835	SRC	60748	+	NM_005417	36012556	36031782	14
chr20	36145818	36156333	BLCAP	10515	-	NM_001167820	36147312	36147576	3
chr20	36149606	36152090	NNAT	2484	+	NM_005386	36149733	36151161	3
chr20	36247699	36251521	LINC00489	3822	-	NR_047461	36251521	36251521	3
chr20	36305311	36311636	LOC100287792	6325	+	NR_040021	36311636	36311636	4
chr20	36322356	36500531	CTNNBL1	178175	+	NM_001281495	36361331	36500415	17
chr20	36531498	36573747	VSTM2L	42249	+	NM_080607	36531752	36572655	4
chr20	36611408	36661870	TTI1	50462	-	NM_014657	36611857	36642218	9
chr20	36661947	36720766	RPRD1B	58819	+	NM_021215	36662349	36718277	7
chr20	36756863	36793700	TGM2	36837	-	NM_004613	36758620	36793600	13
chr20	36838906	36889174	KIAA1755	50268	-	NM_001029864	36841443	36888902	14
chr20	36888576	36917348	LOC149684	28772	+	NR_104170	36917348	36917348	2
chr20	36932551	36965905	BPI	33354	+	NM_001725	36932613	36965586	15
chr20	36974813	37005653	LBP	30840	+	NM_004139	36974919	37005311	15
chr20	37049238	37064018	SNHG17	14780	-	NR_027241	37064018	37064018	7
chr20	37053842	37053978	SNORA71B	136	-	NR_002910	37053978	37053978	1
chr20	37055948	37056086	SNORA71A	138	-	NR_002911	37056086	37056086	1
chr20	37058309	37058447	SNORA71C	138	-	NR_003017	37058447	37058447	1
chr20	37062504	37062642	SNORA71D	138	-	NR_003018	37062642	37062642	1
chr20	37075296	37079564	SNHG11	4268	+	NR_003239	37079564	37079564	5
chr20	37076725	37076861	SNORA71E	136	+	NR_002972	37076861	37076861	1
chr20	37078011	37078147	SNORA60	136	+	NR_002986	37078147	37078147	1
chr20	37101448	37207504	RALGAPB	106056	+	NM_020336	37117075	37203610	30
chr20	37209837	37217106	ADIG	7269	+	NM_001018082	37209893	37214790	3
chr20	37230576	37279295	ARHGAP40	48719	+	NM_001164431	37230585	37278491	15
chr20	37353104	37358015	SLC32A1	4911	+	NM_080552	37353367	37357282	2
chr20	37377096	37401089	ACTR5	23993	+	NM_024855	37377121	37400459	9
chr20	37434335	37551667	PPP1R16B	117332	+	NM_015568	37464568	37547309	11
chr20	37554954	37581703	FAM83D	26749	+	NM_030919	37554995	37581163	4
chr20	37590980	37668366	DHX35	77386	+	NR_033905	37668366	37668366	22
chr20	37842423	37853391	LOC339568	10968	-	NR_027124	37853391	37853391	4
chr20	38633102	38637171	LINC01370	4069	+	NR_109937	38637171	38637171	3
chr20	39314487	39317880	MAFB	3393	-	NM_005461	39316518	39317490	1
chr20	39657461	39753126	TOP1	95665	+	NM_003286	39657707	39751937	21
chr20	39726633	39766640	PLCG1-AS1	40007	-	NR_109889	39766640	39766640	7
chr20	39766160	39804357	PLCG1	38197	+	NM_002660	39766281	39803149	32
chr20	39797662	39797718	MIR6871	56	+	NR_106931	39797718	39797718	1
chr20	39807088	39928739	ZHX3	121651	-	NM_015035	39813830	39833556	4
chr20	39969492	39989225	LPIN3	19733	+	NM_001301860	39974443	39987506	20
chr20	39988605	39995498	EMILIN3	6893	-	NM_052846	39989907	39995274	4
chr20	40030742	40247133	CHD6	216391	-	NM_032221	40033232	40179976	37
chr20	40701391	41818557	PTPRT	1117166	-	NM_133170	40709518	41818373	32
chr20	41314122	41317202	LOC101927159	3080	+	NR_110004	41317202	41317202	4
chr20	42086503	42092244	SRSF6	5741	+	NR_034009	42092244	42092244	7
chr20	42136319	42170535	L3MBTL1	34216	+	NM_032107	42142209	42169768	22
chr20	42187634	42214273	SGK2	26639	+	NM_170693	42195135	42213656	13
chr20	42219252	42275862	IFT52	56610	+	NM_016004	42223338	42275623	14
chr20	42295658	42345136	MYBL2	49478	+	NM_002466	42295923	42344727	14
chr20	42354800	42355642	GTSF1L	842	-	NM_001008901	42354887	42355334	2
chr20	42543491	42698254	TOX2	154763	+	NM_001098797	42543531	42697326	9
chr20	42740336	42816218	JPH2	75882	-	NM_020433	42743435	42815345	6
chr20	42824580	42839546	OSER1	14966	-	NM_016470	42825691	42835597	4
chr20	42839599	42854667	OSER1-AS1	15068	+	NR_038339	42854667	42854667	3
chr20	42875738	42909557	GDAP1L1	33819	+	NM_001256738	42885879	42907940	6
chr20	42935196	42939889	FITM2	4693	-	NM_001080472	42935264	42939788	2
chr20	42965797	42979432	R3HDML	13635	+	NM_178491	42965797	42979432	5
chr20	42984440	43061485	HNF4A	77045	+	NM_001287183	43019279	43058305	11
chr20	43006382	43024346	HNF4A-AS1	17964	-	NR_109949	43024346	43024346	4
chr20	43036759	43036843	MIR3646	84	+	NR_037419	43036843	43036843	1
chr20	43077416	43079197	LINC01430	1781	-	NR_109893	43079197	43079197	3
chr20	43080623	43093984	LINC01620	13361	-	NR_132343	43093984	43093984	3
chr20	43104525	43123244	TTPAL	18719	+	NM_024331	43108639	43118182	6
chr20	43124863	43150726	SERINC3	25863	-	NM_198941	43128936	43150592	11
chr20	43160421	43247678	PKIG	87257	+	NM_001281444	43243197	43247005	6
chr20	43248162	43280376	ADA	32214	-	NM_000022	43248474	43280248	12
chr20	43285091	43300380	LINC01260	15289	-	NR_034104	43300380	43300380	5
chr20	43340502	43374868	KCNK15-AS1	34366	-	NR_132377	43374868	43374868	5
chr20	43343884	43356452	WISP2	12568	+	NM_003881	43344031	43355948	4
chr20	43374487	43380954	KCNK15	6467	+	NM_022358	43374551	43379479	2
chr20	43380444	43438979	RIMS4	58535	-	NM_001205317	43384774	43438912	6
chr20	43514239	43537175	YWHAB	22936	+	NM_003404	43530174	43535079	7
chr20	43538702	43567962	PABPC1L	29260	+	NM_001124756	43538784	43567383	15
chr20	43570770	43589114	TOMM34	18344	-	NM_006809	43571749	43588974	7
chr20	43592439	43595099	STK4-AS1	2660	-	NR_038341	43595099	43595099	3
chr20	43595119	43708593	STK4	113474	+	NM_006282	43595209	43703817	11
chr20	43720949	43729753	KCNS1	8804	-	NM_002251	43723510	43727877	5
chr20	43738092	43743813	WFDC5	5721	-	NM_145652	43738649	43743724	4
chr20	43752066	43753106	WFDC12	1040	-	NM_080869	43752486	43753088	3
chr20	43803539	43805185	PI3	1646	+	NM_002638	43803563	43804776	3
chr20	43835637	43838414	SEMG1	2777	+	NM_003007	43835694	43837327	3
chr20	43850009	43853099	SEMG2	3090	+	NM_003008	43850030	43852022	3
chr20	43880879	43883205	SLPI	2326	-	NM_003064	43881055	43883184	4
chr20	43922085	43937169	MATN4	15084	-	NM_003833	43922406	43934222	11
chr20	43935482	43946464	RBPJL	10982	+	NM_001281449	43935562	43945599	12
chr20	43953928	43977064	SDC4	23136	-	NM_002999	43955903	43977024	5
chr20	43991739	44005442	SYS1	13703	+	NM_001099791	43992171	44002934	4
chr20	43991808	44039250	SYS1-DBNDD2	47442	+	NR_003189	44039250	44039250	6
chr20	44002519	44006957	TP53TG5	4438	-	NM_014477	44002546	44006876	5
chr20	44034632	44039250	DBNDD2	4618	+	NM_001197139	44037107	44038780	4
chr20	44044706	44054885	PIGT	10179	+	NM_015937	44044796	44054466	12
chr20	44054149	44054213	MIR6812	64	+	NR_106870	44054213	44054213	1
chr20	44098393	44110172	WFDC2	11779	+	NM_006103	44098421	44108733	4
chr20	44141100	44144264	SPINT3	3164	-	NM_006652	44141290	44144248	2
chr20	44162835	44168134	WFDC6	5299	-	NM_080827	44163105	44168046	3
chr20	44164918	44176065	EPPIN-WFDC6	11147	-	NM_001198986	44166171	44175996	5
chr20	44169264	44176065	EPPIN	6801	-	NM_020398	44170782	44175996	4
chr20	44179790	44207965	WFDC8	28175	-	NM_181510	44180664	44207886	7
chr20	44236577	44259907	WFDC9	23330	-	NM_147198	44236748	44238820	5
chr20	44258384	44259831	WFDC10A	1447	+	NM_080753	44258452	44259657	2
chr20	44277201	44298878	WFDC11	21677	-	NM_147197	44277357	44279239	5
chr20	44313289	44333658	WFDC10B	20369	-	NM_172006	44313468	44314631	4
chr20	44330654	44337456	WFDC13	6802	+	NM_172005	44330762	44334544	4
chr20	44333740	44333819	MIR3617	79	-	NR_037411	44333819	44333819	1
chr20	44350987	44354335	SPINT4	3348	+	NM_178455	44351006	44354274	3
chr20	44402846	44420547	WFDC3	17701	-	NM_080614	44403066	44418614	7
chr20	44420575	44440066	DNTTIP1	19491	+	NM_052951	44420643	44439834	13
chr20	44441214	44445596	UBE2C	4382	+	NM_181799	44441334	44445406	6
chr20	44451854	44455953	TNNC2	4099	-	NM_003279	44451986	44455887	6
chr20	44462469	44471914	SNX21	9445	+	NM_152897	44462558	44470682	5
chr20	44470359	44486048	ACOT8	15689	-	NM_005469	44470476	44485954	6
chr20	44486219	44507769	ZSWIM3	21550	+	NR_037628	44507769	44507769	3
chr20	44509847	44513905	ZSWIM1	4058	+	NM_080603	44511231	44512689	2
chr20	44515129	44516238	SPATA25	1109	-	NM_080608	44515155	44516229	2
chr20	44517110	44519926	NEURL2	2816	-	NM_080749	44517396	44519630	2
chr20	44518782	44527458	CTSA	8676	+	NM_000308	44519964	44527089	15
chr20	44527258	44541003	PLTP	13745	-	NM_006227	44527579	44540091	16
chr20	44563316	44576662	PCIF1	13346	+	NM_022104	44567638	44576394	17
chr20	44577291	44600833	ZNF335	23542	-	NM_022095	44577591	44600049	28
chr20	44637546	44645200	MMP9	7654	+	NM_004994	44637565	44645007	13
chr20	44650328	44688789	SLC12A5	38461	+	NM_001134771	44650404	44686244	26
chr20	44689625	44718580	NCOA5	28955	-	NM_020967	44690938	44708063	8
chr20	44746892	44758384	CD40	11492	+	NM_001250	44746982	44757679	9
chr20	44802371	44937137	CDH22	134766	-	NM_021248	44803144	44879933	12
chr20	44978166	44993097	SLC35C2	14931	-	NM_001281458	44979032	44987364	11
chr20	44994689	45035271	ELMO2	40582	-	NM_133171	44995998	45023121	22
chr20	45085131	45086282	ZNF663P	1151	-	NR_045983	45086282	45086282	1
chr20	45092298	45093931	MKRN7P	1633	-	NR_026640	45093931	45093931	1
chr20	45128268	45142198	ZNF334	13930	-	NM_001270497	45129934	45138261	6
chr20	45169669	45179213	OCSTAMP	9544	-	NM_080721	45169912	45179199	3
chr20	45186461	45313124	SLC13A3	126663	-	NM_001011554	45188660	45242334	14
chr20	45313003	45318276	TP53RK	5273	-	NM_033550	45315391	45318053	2
chr20	45338278	45364985	SLC2A10	26707	+	NM_030777	45338375	45362473	5
chr20	45523262	45817492	EYA2	294230	+	NM_005244	45618649	45816781	16
chr20	45795608	45795700	MIR3616	92	+	NR_037410	45795700	45795700	1
chr20	45837858	45985633	ZMYND8	147775	-	NM_001281779	45839405	45912392	24
chr20	45947245	45949498	LOC100131496	2253	+	NR_024594	45949498	45949498	1
chr20	46130600	46285621	NCOA3	155021	+	NM_001174088	46250991	46282161	23
chr20	46286149	46415360	SULF2	129211	-	NM_001161841	46287105	46386107	21
chr20	46608836	46618861	LINC01522	10025	-	NR_110027	46618861	46618861	3
chr20	46611969	46613057	LINC01523	1088	+	NR_109942	46613057	46613057	2
chr20	46988653	46999381	LINC00494	10728	+	NR_026958	46999381	46999381	5
chr20	47240792	47444420	PREX1	203628	-	NM_020820	47242422	47444397	40
chr20	47538274	47653230	ARFGEF2	114956	+	NM_006420	47538426	47649736	39
chr20	47656999	47662593	CSE1L-AS1	5594	-	NR_110624	47662593	47662593	3
chr20	47662782	47713497	CSE1L	50715	+	NM_001316	47675000	47712975	25
chr20	47729875	47804904	STAU1	75029	-	NM_017453	47731414	47782738	14
chr20	47835831	47860614	DDX27	24783	+	NM_017895	47835892	47860371	21
chr20	47862438	47894756	ZNFX1	32318	-	NM_021035	47863803	47892376	14
chr20	47894714	47905795	ZFAS1	11081	+	NR_003605	47905795	47905795	5
chr20	47895481	47895560	SNORD12C	79	+	NR_002433	47895560	47895560	1
chr20	47896849	47896952	SNORD12B	103	+	NR_003695	47896952	47896952	1
chr20	47897219	47897309	SNORD12	90	+	NR_003030	47897309	47897309	1
chr20	47988504	48099181	KCNB1	110677	-	NM_004975	47989519	48099017	2
chr20	48120410	48184707	PTGIS	64297	-	NM_000961	48124456	48184653	10
chr20	48249482	48330421	B4GALT5	80939	-	NM_004776	48252848	48330227	9
chr20	48429249	48508779	SLC9A8	79530	+	NM_001260491	48429459	48504473	16
chr20	48519928	48532080	SPATA2	12152	-	NM_006038	48522155	48525027	3
chr20	48552913	48570422	RNF114	17509	+	NM_018683	48552949	48568678	6
chr20	48599512	48605420	SNAI1	5908	+	NM_005985	48599596	48604593	3
chr20	48657243	48658166	TRERNA1	923	-	NR_051976	48658166	48658166	2
chr20	48697660	48732496	UBE2V1	34836	-	NM_001257393	48699304	48732112	5
chr20	48697660	48770335	TMEM189-UBE2V1	72675	-	NM_199203	48699304	48770174	8
chr20	48740273	48770335	TMEM189	30062	-	NR_027889	48770335	48770335	7
chr20	48789106	48793208	LINC01273	4102	+	NR_109943	48793208	48793208	3
chr20	48801139	48808606	CEBPB-AS1	7467	-	NR_125739	48808606	48808606	7
chr20	48807119	48809227	CEBPB	2108	+	NM_001285879	48808164	48808608	1
chr20	48884022	48896332	LINC01272	12310	+	NM_001278655	48892206	48894866	4
chr20	48909256	48931456	LINC01270	22200	+	NR_034124	48931456	48931456	5
chr20	48927247	48937879	LINC01271	10632	-	NR_109950	48937879	48937879	3
chr20	49126857	49201300	PTPN1	74443	+	NM_002827	49127064	49199252	10
chr20	49202322	49202416	MIR645	94	+	NR_030375	49202416	49202416	1
chr20	49202644	49308067	FAM65C	105423	-	NR_110890	49308067	49308067	22
chr20	49231172	49231322	MIR1302-5	150	-	NR_031634	49231322	49231322	1
chr20	49262007	49276828	LOC100506175	14821	+	NR_111906	49276828	49276828	3
chr20	49348080	49370278	PARD6B	22198	+	NM_032521	49348323	49367025	3
chr20	49411430	49493714	BCAS4	82284	+	NM_017843	49411530	49493072	6
chr20	49505454	49547527	ADNP	42073	-	NM_001282531	49507941	49520533	6
chr20	49547520	49561671	ADNP-AS1	14151	+	NR_110007	49561671	49561671	4
chr20	49551391	49575101	DPM1	23710	-	NM_001317034	49551668	49575060	10
chr20	49575350	49578399	MOCS3	3049	+	NM_014484	49575379	49576762	1
chr20	49620192	49639675	KCNG1	19483	-	NM_002237	49620575	49626875	3
chr20	50003493	50179370	NFATC2	175877	-	NM_001136021	50015223	50179168	11
chr20	50069441	50069514	MIR3194	73	-	NR_036162	50069514	50069514	1
chr20	50213313	50384950	ATP9A	171637	-	NM_006045	50217749	50384908	28
chr20	50400582	50419048	SALL4	18466	-	NM_020436	50400803	50418947	4
chr20	50448335	50479452	LINC01429	31117	-	NR_110016	50479452	50479452	3
chr20	50700549	50808524	ZFP64	107975	-	NM_199427	50701095	50808175	9
chr20	51237376	51266965	LINC01524	29589	+	NR_110038	51266965	51266965	3
chr20	51588945	52111869	TSHZ2	522924	+	NM_173485	51589832	51873102	3
chr20	52169308	52191847	LOC101927770	22539	+	NR_110051	52191847	52191847	6
chr20	52183609	52199636	ZNF217	16027	-	NM_006526	52188282	52199365	5
chr20	52491039	52492248	SUMO1P1	1209	-	NR_002189	52492248	52492248	1
chr20	52560078	52687304	BCAS1	127226	-	NM_003657	52561460	52675257	12
chr20	52684946	52685024	MIR4756	78	-	NR_039913	52685024	52685024	1
chr20	52769987	52790516	CYP24A1	20529	-	NM_000782	52773717	52790118	12
chr20	52824501	52836492	PFDN4	11991	+	NM_002623	52824639	52835689	4
chr20	53092010	53267710	DOK5	175700	+	NM_018431	53092485	53267018	8
chr20	54036873	54043735	LINC01441	6862	-	NR_110064	54043735	54043735	3
chr20	54039580	54043329	LINC01440	3749	+	NR_110629	54043329	54043329	3
chr20	54572412	54580528	CBLN4	8116	-	NM_080617	54573612	54579227	3
chr20	54823787	54824871	MC3R	1084	+	NM_019888	54823899	54824871	1
chr20	54933982	54943718	FAM210B	9736	+	NM_080821	54934061	54941343	3
chr20	54944444	54967351	AURKA	22907	-	NM_198433	54945213	54963253	11
chr20	54967426	54979582	CSTF1	12156	+	NM_001033521	54970608	54978783	6
chr20	54987167	55034396	CASS4	47229	+	NM_001164116	54987514	55033803	7
chr20	55043640	55093942	RTFDC1	50302	+	NM_001283035	55043753	55093321	10
chr20	55066547	55100981	GCNT7	34434	-	NM_080615	55066612	55072664	7
chr20	55099784	55101208	FAM209A	1424	+	NM_001012971	55099864	55101126	2
chr20	55108301	55111574	FAM209B	3273	+	NM_001013646	55108397	55111494	2
chr20	55204357	55214338	TFAP2C	9981	+	NM_003222	55204600	55213069	7
chr20	55743808	55841707	BMP7	97899	-	NM_001719	55746014	55841178	7
chr20	55788751	55790922	BMP7-AS1	2171	+	NR_110631	55790922	55790922	4
chr20	55896557	55896647	MIR4325	90	-	NR_036219	55896647	55896647	1
chr20	55904830	55919049	SPO11	14219	+	NM_012444	55904923	55918516	13
chr20	55926144	55953519	RAE1	27375	+	NM_003610	55929094	55953155	12
chr20	55933495	55934878	MTRNR2L3	1383	-	NM_001190472	55934020	55934095	1
chr20	55966453	55984386	RBM38	17933	+	NM_001291780	55966637	55982902	5
chr20	56071020	56100183	CTCFL	29163	-	NM_001269043	56071305	56099261	12
chr20	56136136	56141513	PCK1	5377	+	NM_002591	56136467	56140860	10
chr20	56178901	56195632	ZBP1	16731	-	NM_001160417	56179628	56195351	8
chr20	56223447	56286592	PMEPA1	63145	-	NM_199171	56227108	56234712	4
chr20	56285238	56287836	NKILA	2598	+	NR_131157	56287836	56287836	1
chr20	56470449	56470500	MIR4532	51	+	NR_039757	56470500	56470500	1
chr20	56725982	56736183	C20orf85	10201	+	NM_178456	56726020	56735878	4
chr20	56791181	56803709	ANKRD60	12528	-	NM_001304369	56793550	56803709	4
chr20	56807832	56884495	PPP4R1L	76663	-	NR_003505	56884495	56884495	17
chr20	56884770	56942563	RAB22A	57793	+	NM_020673	56885032	56934759	7
chr20	56964174	57026156	VAPB	61982	+	NM_004738	56964515	57019291	6
chr20	57034159	57089994	APCDD1L	55835	-	NM_001304787	57035845	57088954	5
chr20	57090434	57194948	APCDD1L-AS1	104514	+	NR_034147	57194948	57194948	7
chr20	57209827	57210794	LOC79160	967	+	NR_125359	57210794	57210794	1
chr20	57226308	57254582	STX16	28274	+	NM_001204868	57242560	57251347	10
chr20	57226308	57290900	STX16-NPEPL1	64592	+	NR_037945	57290900	57290900	23
chr20	57264186	57290900	NPEPL1	26714	+	NM_001204872	57266820	57290382	13
chr20	57392669	57392749	MIR296	80	-	NR_029844	57392749	57392749	1
chr20	57393280	57393368	MIR298	88	-	NR_030580	57393368	57393368	1
chr20	57393972	57425958	GNAS-AS1	31986	-	NR_002785	57425958	57425958	5
chr20	57414772	57486251	GNAS	71479	+	NM_016592	57415161	57415899	13
chr20	57438810	57463865	LOC101927932	25055	-	NR_126334	57463865	57463865	5
chr20	57556262	57570188	NELFCD	13926	+	NM_198976	57556310	57569731	15
chr20	57570241	57582309	CTSZ	12068	-	NM_001336	57570703	57582183	6
chr20	57594308	57601709	TUBB1	7401	+	NM_030773	57594577	57599838	4
chr20	57603732	57607422	ATP5E	3690	-	NM_006886	57605360	57607306	3
chr20	57603732	57617901	SLMO2-ATP5E	14169	-	NR_037929	57617901	57617901	8
chr20	57608199	57617901	PRELID3B	9702	-	NM_016045	57610061	57617785	6
chr20	57766074	57834167	ZNF831	68093	+	NM_178457	57766074	57829798	5
chr20	57875481	57901047	EDN3	25566	+	NM_207032	57875867	57899422	5
chr20	58152563	58422766	PHACTR3	270203	+	NM_001199505	58152563	58422185	13
chr20	58201518	58203344	LOC100506384	1826	-	NR_040513	58203344	58203344	2
chr20	58438611	58508718	SYCP2	70107	-	NM_014258	58439365	58497468	45
chr20	58508818	58523702	FAM217B	14884	+	NM_001190826	58518998	58520150	5
chr20	58511886	58515352	PPP1R3D	3466	-	NM_006242	58514086	58514986	1
chr20	58533470	58588168	CDH26	54698	+	NM_177980	58533781	58587785	18
chr20	58630979	58648008	C20orf197	17029	+	NM_001302815	58645029	58646198	4
chr20	58662740	58676442	LOC729296	13702	+	NR_109917	58676442	58676442	5
chr20	58713547	58897314	MIR646HG	183767	+	NR_046099	58897314	58897314	5
chr20	58883531	58883625	MIR646	94	+	NR_030376	58883625	58883625	1
chr20	59044666	59048034	LOC101928048	3368	-	NR_109903	59048034	59048034	2
chr20	59053168	59053239	MIR4533	71	+	NR_039758	59053239	59053239	1
chr20	59139619	59139683	MIR548AG2	64	+	NR_039653	59139683	59139683	1
chr20	59654119	59655235	LOC100506470	1116	+	NR_109919	59655235	59655235	2
chr20	59827481	60515673	CDH4	688192	+	NM_001794	59827569	60512001	16
chr20	60528601	60528718	MIR1257	117	-	NR_031658	60528718	60528718	1
chr20	60549853	60640866	TAF4	91013	-	NM_003185	60551223	60640866	15
chr20	60639857	60639941	MIR3195	84	+	NR_130463	60639941	60639941	1
chr20	60697516	60710434	LSM14B	12918	+	NM_144703	60697722	60708517	9
chr20	60711782	60718514	PSMA7	6732	-	NM_002792	60711912	60718359	7
chr20	60718775	60757566	SS18L1	38791	+	NR_125980	60757566	60757566	13
chr20	60758080	60777810	MTG2	19730	+	NM_015666	60768476	60776133	7
chr20	60790016	60795323	HRH3	5307	-	NM_007232	60791061	60795026	3
chr20	60813540	60871269	OSBPL2	57729	+	NM_014835	60831240	60868943	14
chr20	60877951	60883918	ADRM1	5967	+	NM_175573	60878624	60883817	10
chr20	60884115	60942368	LAMA5	58253	-	NM_005560	60884391	60942301	80
chr20	60907542	60907613	MIR4758	71	-	NR_039915	60907613	60907613	1
chr20	60928065	60931534	LAMA5-AS1	3469	+	NR_109924	60931534	60931534	3
chr20	60962120	60963576	RPS21	1456	+	NM_001024	60962394	60963522	6
chr20	60963685	60982339	CABLES2	18654	-	NM_031215	60966026	60982332	10
chr20	60985292	61002629	RBBP8NL	17337	-	NM_080833	60985933	60994703	14
chr20	61038552	61051026	GATA5	12474	-	NM_080473	61039891	61050577	7
chr20	61141437	61148768	C20orf166-AS1	7331	-	NR_033263	61148768	61148768	7
chr20	61147659	61167971	MIR1-1HG	20312	+	NM_001302812	61150864	61167884	5
chr20	61151512	61151583	MIR1-1	71	+	NR_029780	61151583	61151583	1
chr20	61162118	61162220	MIR133A2	102	+	NR_029676	61162220	61162220	1
chr20	61273796	61303647	SLCO4A1	29851	+	NM_016354	61287806	61303245	12
chr20	61294378	61297973	SLCO4A1-AS1	3595	-	NR_024470	61297973	61297973	4
chr20	61340188	61394123	NTSR1	53935	+	NM_002531	61340559	61391619	4
chr20	61405472	61408208	LINC00659	2736	-	NR_046225	61408208	61408208	3
chr20	61427804	61431945	MRGBP	4141	+	NM_018270	61427875	61430995	5
chr20	61431978	61436939	OGFR-AS1	4961	-	NR_102430	61436939	61436939	3
chr20	61436176	61445352	OGFR	9176	+	NM_007346	61436211	61445001	7
chr20	61448413	61472511	COL9A3	24098	+	NM_001853	61448416	61472084	32
chr20	61472365	61493115	TCFL5	20750	-	NM_006602	61473326	61493022	6
chr20	61475917	61477543	DPH3P1	1626	+	NM_080750	61477015	61477252	1
chr20	61509089	61569304	DIDO1	60215	-	NM_033081	61510584	61542964	16
chr20	61569440	61579827	GID8	10387	+	NM_017896	61572854	61576264	5
chr20	61583998	61599949	SLC17A9	15951	+	NM_001302643	61584583	61598852	14
chr20	61637330	61638387	BHLHE23	1057	-	NM_080606	61637400	61638126	1
chr20	61640734	61716423	LOC63930	75689	+	NR_033370	61716423	61716423	5
chr20	61665568	61668380	LINC00029	2812	-	NR_028295	61668380	61668380	4
chr20	61669362	61685215	LINC01056	15853	+	NR_033369	61685215	61685215	6
chr20	61726844	61733671	HAR1B	6827	-	NR_003245	61733671	61733671	2
chr20	61732643	61735737	HAR1A	3094	+	NR_003244	61735737	61735737	2
chr20	61809851	61809938	MIR124-3	87	+	NR_029670	61809938	61809938	1
chr20	61826781	61847538	YTHDF1	20757	-	NM_017798	61828059	61847244	5
chr20	61867234	61871859	BIRC7	4625	+	NM_022161	61867448	61870957	7
chr20	61870130	61870194	MIR3196	64	+	NR_036163	61870194	61870194	1
chr20	61872135	61885892	NKAIN4	13757	-	NM_152864	61872848	61885802	7
chr20	61885329	61892967	FLJ16779	7638	+	NR_024389	61892967	61892967	1
chr20	61904136	61921142	ARFGAP1	17006	+	NM_001281482	61906932	61918977	14
chr20	61918159	61918218	MIR4326	59	+	NR_036220	61918218	61918218	1
chr20	61924537	61962285	COL20A1	37748	+	NM_020882	61926459	61961010	36
chr20	61974661	61992748	CHRNA4	18087	-	NR_046317	61992748	61992748	6
chr20	61991339	62002529	LOC100130587	11190	+	NR_110634	62002529	62002529	5
chr20	62037541	62103993	KCNQ2	66452	-	NM_172107	62037996	62103816	17
chr20	62119364	62130668	EEF1A2	11304	-	NM_001958	62119650	62129116	8
chr20	62152132	62153524	PPDPF	1392	+	NM_024299	62152661	62153232	4
chr20	62159775	62168723	PTK6	8948	-	NM_005975	62160888	62168667	8
chr20	62171276	62178857	SRMS	7581	-	NM_080823	62172170	62178816	8
chr20	62184372	62188035	C20orf195	3663	+	NM_024059	62187016	62187973	2
chr20	62189438	62205592	HELZ2	16154	-	NM_001037335	62190598	62203738	20
chr20	62218954	62258381	GMEB2	39427	-	NM_012384	62221441	62250750	10
chr20	62258587	62260177	LOC100505771	1590	+	NR_132417	62260177	62260177	2
chr20	62271057	62284963	STMN3	13906	-	NM_015894	62272690	62284698	5
chr20	62289162	62327606	RTEL1	38444	+	NM_032957	62290755	62327138	35
chr20	62289162	62330051	RTEL1-TNFRSF6B	40889	+	NR_037882	62330051	62330051	38
chr20	62328003	62330051	TNFRSF6B	2048	+	NM_003823	62328120	62329916	3
chr20	62329994	62339365	ARFRP1	9371	-	NM_003224	62331794	62338443	8
chr20	62338793	62367494	ZGPAT	28701	+	NM_001083113	62339932	62367271	7
chr20	62367052	62370460	LIME1	3408	+	NM_001305654	62368902	62369833	6
chr20	62371210	62375403	SLC2A4RG	4193	+	NM_020062	62371265	62374343	8
chr20	62375020	62436856	ZBTB46	61836	-	NM_025224	62378282	62422110	5
chr20	62439428	62454360	ZBTB46-AS1	14932	+	NR_110081	62454360	62454360	3
chr20	62492565	62494341	ABHD16B	1776	+	NM_080622	62492893	62494303	1
chr20	62496580	62522898	TPD52L2	26318	+	NM_199360	62496718	62521298	9
chr20	62526454	62567384	DNAJC5	40930	+	NM_025219	62559698	62562921	5
chr20	62550913	62550985	MIR941-3	72	+	NR_030639	62550985	62550985	1
chr20	62550913	62550985	MIR941-4	72	+	NR_040032	62550985	62550985	1
chr20	62551025	62551124	MIR941-1	99	+	NR_030637	62551124	62551124	2
chr20	62551108	62551180	MIR941-2	72	+	NR_030638	62551180	62551180	1
chr20	62551220	62551292	MIR941-5	72	+	NR_128719	62551292	62551292	1
chr20	62571181	62587800	UCKL1	16619	-	NM_017859	62571328	62587725	15
chr20	62572817	62572897	MIR1914	80	-	NR_031735	62572897	62572897	1
chr20	62573983	62574079	MIR647	96	-	NR_030377	62574079	62574079	1
chr20	62584736	62588338	UCKL1-AS1	3602	+	NR_027287	62588338	62588338	2
chr20	62588056	62601223	ZNF512B	13167	-	NM_020713	62591240	62599303	17
chr20	62605465	62610995	SAMD10	5530	-	NM_080621	62606862	62610820	5
chr20	62612430	62664453	PRPF6	52023	+	NM_012469	62612598	62664346	21
chr20	62665696	62671315	LINC00176	5619	+	NR_027686	62671315	62671315	4
chr20	62679078	62680979	SOX18	1901	-	NM_018419	62679518	62680869	2
chr20	62688438	62703700	TCEA2	15262	+	NM_198723	62697837	62703533	11
chr20	62704534	62711324	RGS19	6790	-	NM_001039467	62705205	62708239	6
chr20	62708307	62708363	MIR6813	56	-	NR_106871	62708363	62708363	1
chr20	62711470	62731996	OPRL1	20526	+	NM_182647	62724073	62730152	5
chr20	62714732	62715712	LKAAEAR1	980	-	NM_001007125	62714737	62715572	2
chr20	62737182	62738184	NPBWR2	1002	-	NM_005286	62737182	62738184	1
chr20	62795826	62873606	MYT1	77780	+	NM_004535	62830214	62871801	23
chr20	62887047	62907579	PCMTD2	20532	+	NM_018257	62891318	62904953	6
chr20	62921737	62934707	LINC00266-1	12970	+	NR_040415	62934707	62934707	3
chr21	9825831	9826011	MIR3648-1	180	+	NR_037421	9826011	9826011	1
chr21	9825831	9826011	MIR3648-2	180	+	NR_128711	9826011	9826011	1
chr21	9826202	9826263	MIR3687-1	61	+	NR_037458	9826263	9826263	1
chr21	9826202	9826263	MIR3687-2	61	+	NR_128714	9826263	9826263	1
chr21	9907188	9968594	TEKT4P2	61406	-	NR_038328	9968594	9968594	4
chr21	10906186	10990943	TPTE	84757	-	NM_199261	10906904	10973733	24
chr21	11020841	11098925	BAGE2	78084	-	NM_182482	11049570	11098717	10
chr21	11020841	11098925	BAGE3	78084	-	NM_182481	11049570	11098717	10
chr21	11020841	11098925	BAGE4	78084	-	NM_181704	11097541	11098737	9
chr21	11020841	11098925	BAGE5	78084	-	NM_182484	11097542	11098737	9
chr21	11057795	11098937	BAGE	41142	-	NM_001187	11097542	11098737	5
chr21	14410486	14490571	ANKRD30BP2	80085	+	NR_026916	14490571	14490571	12
chr21	14778704	14778781	MIR3156-3	77	-	NR_036164	14778781	14778781	1
chr21	14918353	14930781	LOC102724188	12428	+	NR_110544	14930781	14930781	4
chr21	14982497	15013906	POTED	31409	+	NM_174981	14982549	15013887	11
chr21	15017095	15017171	MIR3118-1	76	-	NR_036061	15017171	15017171	1
chr21	15096509	15096595	MIR8069-1	86	+	NR_107036	15096595	15096595	1
chr21	15096509	15096595	MIR8069-2	86	+	NR_128718	15096595	15096595	1
chr21	15215453	15220685	CYP4F29P	5232	-	NR_026755	15220685	15220685	6
chr21	15316095	15352765	ANKRD20A11P	36670	-	NR_027270	15352765	15352765	6
chr21	15481134	15583212	LIPI	102078	-	NM_001302998	15481313	15583166	10
chr21	15588465	15600693	RBM11	12228	+	NM_144770	15588507	15599614	5
chr21	15646119	15673692	ABCC13	27573	+	NR_003087	15673692	15673692	6
chr21	15743436	15755509	HSPA13	12073	-	NM_006948	15745937	15755440	5
chr21	15857548	15955723	SAMSN1	98175	-	NM_001256370	15858232	15954717	9
chr21	15954522	15970624	SAMSN1-AS1	16102	+	NR_046512	15970624	15970624	5
chr21	15963712	16015428	LOC388813	51716	-	NM_001256579	15964942	16015394	7
chr21	16333555	16437126	NRIP1	103571	-	NM_003489	16337036	16340513	4
chr21	17102343	17252390	USP25	150047	+	NM_001283041	17102712	17250794	26
chr21	17442841	17982094	MIR99AHG	539253	+	NR_027790	17982094	17982094	8
chr21	17911408	17911489	MIR99A	81	+	NR_029514	17911489	17911489	1
chr21	17912147	17912231	MIRLET7C	84	+	NR_029480	17912231	17912231	1
chr21	17962556	17962645	MIR125B2	89	+	NR_029694	17962645	17962645	1
chr21	18811207	18821503	LINC01549	10296	+	NR_037586	18821503	18821503	4
chr21	18885223	18965897	CXADR	80674	+	NM_001207066	18885447	18965511	8
chr21	18965967	18985268	BTG3	19301	-	NM_001130914	18966410	18981462	6
chr21	19149720	19164826	C21orf91-OT1	15106	-	NR_038871	19164826	19164826	4
chr21	19161283	19191703	C21orf91	30420	-	NM_017447	19165731	19190635	5
chr21	19207988	19257925	CHODL-AS1	49937	-	NR_024354	19257925	19257925	3
chr21	19289656	19639687	CHODL	350031	+	NM_001204176	19628869	19638355	7
chr21	19641432	19775970	TMPRSS15	134538	-	NM_002772	19642285	19775939	25
chr21	19933582	20132130	MIR548XHG	198548	-	NR_109925	20132130	20132130	4
chr21	22114907	22175426	LINC00320	60519	-	NR_024090	22175426	22175426	8
chr21	22370632	22912517	NCAM2	541885	+	NM_004540	22370881	22910278	18
chr21	23095612	23109639	LINC00317	14027	-	NR_038872	23109639	23109639	3
chr21	23119304	23169735	LINC01425	50431	+	NR_109958	23169735	23169735	5
chr21	23381476	23470778	LOC101927843	89302	-	NR_109959	23470778	23470778	6
chr21	23470935	23488847	LINC00308	17912	+	NR_038400	23488847	23488847	6
chr21	24733425	24757156	D21S2088E	23731	-	NR_040254	24757156	24757156	5
chr21	25676862	25693690	LOC101927869	16828	-	NR_109963	25693690	25693690	4
chr21	26212863	26430056	LOC339622	217193	+	NR_046198	26430056	26430056	4
chr21	26758132	26804013	LINC00158	45881	-	NR_024027	26804013	26804013	5
chr21	26934456	26947480	MIR155HG	13024	+	NR_001458	26947480	26947480	3
chr21	26946291	26946356	MIR155	65	+	NR_030784	26946356	26946356	1
chr21	26955086	26955536	LINC00515	450	-	NR_024092	26955536	26955536	1
chr21	26957967	26979801	MRPL39	21834	-	NM_080794	26958062	26979787	11
chr21	27011593	27089874	JAM2	78281	+	NM_021219	27012133	27086984	10
chr21	27096790	27107965	ATP5J	11175	-	NM_001685	27096950	27102105	4
chr21	27107257	27144771	GABPA	37514	+	NM_001197297	27113909	27141543	10
chr21	27252860	27543446	APP	290586	-	NM_001136131	27253980	27484415	16
chr21	27838527	27945581	CYYR1	107054	-	NM_052954	27840819	27945259	4
chr21	28208605	28217728	ADAMTS1	9123	-	NM_006988	28209897	28217273	9
chr21	28290230	28339439	ADAMTS5	49209	-	NM_007038	28296371	28338710	8
chr21	28326279	28326362	MIR4759	83	+	NR_039916	28326362	28326362	1
chr21	28659821	29283529	MIR5009	623708	-	NR_049807	29283529	29283529	5
chr21	29094697	29123552	LINC00113	28855	+	NR_024357	29123552	29123552	4
chr21	29385681	29395528	LINC00314	9847	+	NR_027246	29395528	29395528	2
chr21	29420732	29509928	LOC284825	89196	+	NR_126010	29509928	29509928	5
chr21	29488412	29600986	LOC101927973	112574	-	NR_126012	29600986	29600986	6
chr21	29911639	29912677	LINC00161	1038	+	NR_026553	29912677	29912677	2
chr21	30244512	30257695	N6AMT1	13183	-	NR_047510	30257695	30257695	7
chr21	30300465	30365277	LTN1	64812	-	NM_015565	30302769	30365264	30
chr21	30378079	30391685	RWDD2B	13606	-	NM_016940	30378737	30391598	5
chr21	30396937	30426807	USP16	29870	+	NM_001032410	30400234	30426508	19
chr21	30428642	30446118	CCT8	17476	-	NM_001282907	30428795	30444275	16
chr21	30449791	30548210	MAP3K7CL	98419	+	NM_001286617	30505665	30547213	10
chr21	30565814	30660526	LINC00189	94712	+	NR_027072	30660526	30660526	2
chr21	30677524	30734217	BACH1	56693	+	NR_027655	30734217	30734217	8
chr21	30744820	30746300	BACH1-IT2	1480	+	NR_046564	30746300	30746300	2
chr21	30909253	31312282	GRIK1	403029	-	NM_175611	30909550	31311818	16
chr21	30968359	31003067	GRIK1-AS2	34708	+	NR_033368	31003067	31003067	3
chr21	31120493	31136325	GRIK1-AS1	15832	+	NR_027021	31136325	31136325	5
chr21	31538240	31538971	CLDN17	731	-	NM_012131	31538260	31538935	1
chr21	31581468	31584101	LINC00307	2633	-	NR_038855	31584101	31584101	3
chr21	31586323	31588469	CLDN8	2146	-	NM_199328	31587565	31588243	1
chr21	31653626	31655276	KRTAP24-1	1650	-	NM_001085455	31654485	31655250	1
chr21	31661462	31661832	KRTAP25-1	370	-	NM_001128598	31661499	31661808	1
chr21	31691449	31692607	KRTAP26-1	1158	-	NM_203405	31691720	31692353	1
chr21	31709330	31710012	KRTAP27-1	682	-	NM_001077711	31709362	31709986	1
chr21	31720716	31720924	KRTAP23-1	208	-	NM_181624	31720726	31720924	1
chr21	31743708	31744557	KRTAP13-2	849	-	NM_181621	31744003	31744531	1
chr21	31747611	31747696	MIR4327	85	-	NR_036221	31747696	31747696	1
chr21	31768391	31769138	KRTAP13-1	747	+	NM_181599	31768404	31768923	1
chr21	31797710	31798230	KRTAP13-3	520	-	NM_181622	31797711	31798230	1
chr21	31802593	31803076	KRTAP13-4	483	+	NM_181600	31802593	31803076	1
chr21	31812645	31813098	KRTAP15-1	453	+	NM_181623	31812645	31813059	1
chr21	31852363	31852636	KRTAP19-1	273	-	NM_181607	31852363	31852636	1
chr21	31859508	31859667	KRTAP19-2	159	-	NM_181608	31859508	31859667	1
chr21	31863781	31864275	KRTAP19-3	494	-	NM_181609	31864029	31864275	1
chr21	31869173	31869428	KRTAP19-4	255	-	NM_181610	31869173	31869428	1
chr21	31874189	31874408	KRTAP19-5	219	-	NM_181611	31874189	31874408	1
chr21	31913853	31914183	KRTAP19-6	330	-	NM_001303120	31913896	31914152	2
chr21	31933416	31933608	KRTAP19-7	192	-	NM_181614	31933416	31933608	1
chr21	31962423	31962716	KRTAP22-2	293	-	NM_001164434	31962555	31962693	1
chr21	31964758	31965374	KRTAP6-3	616	+	NM_181605	31964764	31965097	1
chr21	31971004	31971193	KRTAP6-2	189	-	NM_181604	31971004	31971193	1
chr21	31973439	31973586	KRTAP22-1	147	+	NM_181620	31973439	31973586	1
chr21	31986004	31986223	KRTAP6-1	219	-	NM_181602	31986007	31986223	1
chr21	31988773	31988944	KRTAP20-1	171	+	NM_181615	31988773	31988944	1
chr21	31992945	31993169	KRTAP20-4	224	+	NR_023342	31993169	31993169	1
chr21	32007582	32007780	KRTAP20-2	198	+	NM_181616	32007582	32007780	1
chr21	32015182	32015455	KRTAP20-3	273	+	NM_001128077	32015207	32015342	1
chr21	32090842	32091095	KRTAP21-3	253	-	NM_001164435	32090900	32091077	1
chr21	32119268	32119520	KRTAP21-2	252	-	NM_181617	32119268	32119520	1
chr21	32127456	32127696	KRTAP21-1	240	-	NM_181619	32127456	32127696	1
chr21	32185014	32185570	KRTAP8-1	556	-	NM_175857	32185346	32185538	1
chr21	32201357	32202051	KRTAP7-1	694	-	NM_181606	32201752	32202017	2
chr21	32252963	32253874	KRTAP11-1	911	-	NM_175858	32253351	32253843	1
chr21	32410477	32410795	KRTAP19-8	318	-	NM_001099219	32410570	32410762	1
chr21	32490735	32931290	TIAM1	440555	-	NM_003253	32492685	32639288	29
chr21	33031934	33041243	SOD1	9309	+	NM_000454	33032082	33040891	5
chr21	33043312	33104431	SCAF4	61119	-	NM_001145445	33043711	33104005	20
chr21	33245627	33376377	HUNK	130750	+	NM_014586	33245987	33371497	11
chr21	33452793	33458608	LINC00159	5815	-	NR_038033	33458608	33458608	2
chr21	33640529	33651376	MIS18A	10847	-	NM_018944	33641347	33651325	5
chr21	33664123	33687094	MRAP	22971	+	NM_206898	33671282	33686964	5
chr21	33683329	33765312	URB1	81983	-	NM_014825	33687228	33765219	39
chr21	33749495	33749631	SNORA80A	136	-	NR_002996	33749631	33749631	1
chr21	33765441	33766266	URB1-AS1	825	+	NR_026845	33766266	33766266	1
chr21	33784744	33887710	EVA1C	102966	+	NM_058187	33785161	33887500	8
chr21	33947150	33957845	TCP10L	10695	-	NM_144659	33949083	33956614	5
chr21	33973983	33984918	C21orf59	10935	-	NM_021254	33974172	33984553	7
chr21	34001068	34100351	SYNJ1	99283	-	NM_203446	34007173	34100351	33
chr21	34100424	34115433	PAXBP1-AS1	15009	+	NR_038879	34115433	34115433	4
chr21	34106209	34144169	PAXBP1	37960	-	NR_027873	34144169	34144169	18
chr21	34144410	34170016	C21orf62-AS1	25606	+	NR_024623	34170016	34170016	4
chr21	34162983	34186053	C21orf62	23070	-	NM_001162495	34166072	34166732	4
chr21	34398215	34401503	OLIG2	3288	+	NM_005806	34399170	34400142	2
chr21	34430134	34437385	LINC00945	7251	+	NR_104056	34437385	34437385	5
chr21	34442449	34444728	OLIG1	2279	+	NM_138983	34442552	34443368	1
chr21	34484009	34496006	LOC101928107	11997	-	NR_109961	34496006	34496006	3
chr21	34537775	34542541	LINC01548	4766	-	NR_024102	34542541	34542541	4
chr21	34602199	34636818	IFNAR2	34619	+	NM_207585	34614227	34635805	9
chr21	34637936	34638565	IL10RB-AS1	629	-	NR_038974	34638565	34638565	2
chr21	34638664	34669539	IL10RB	30875	+	NM_000628	34638770	34668662	7
chr21	34697213	34732128	IFNAR1	34915	+	NM_000629	34697360	34727855	11
chr21	34775201	34809828	IFNGR2	34627	+	NM_005534	34775849	34809269	7
chr21	34804792	34852316	TMEM50B	47524	-	NR_040016	34852316	34852316	9
chr21	34860361	34864030	DNAJC28	3669	-	NM_001040192	34860533	34861700	2
chr21	34876237	34915198	GART	38961	-	NM_001136006	34876430	34911621	22
chr21	34915343	34949820	SON	34477	+	NR_103797	34949820	34949820	13
chr21	34922967	34923034	MIR6501	67	+	NR_106756	34923034	34923034	1
chr21	34949858	34961014	DONSON	11156	-	NM_017613	34950612	34960947	10
chr21	34961647	35014160	CRYZL1	52513	-	NM_145858	34962127	35003857	13
chr21	35014783	35261609	ITSN1	246826	+	NM_003024	35091133	35260604	40
chr21	35275756	35288158	ATP5O	12402	-	NM_001697	35275829	35288067	7
chr21	35303515	35343487	LINC00649	39972	+	NR_038883	35343487	35343487	3
chr21	35445822	35478561	SLC5A3	32739	+	NM_006933	35467497	35469654	2
chr21	35445822	35515334	MRPS6	69512	+	NM_032476	35446000	35514900	3
chr21	35552977	35562220	LINC00310	9243	+	NR_027266	35562220	35562220	2
chr21	35736322	35743440	KCNE2	7118	+	NM_172201	35742777	35743149	2
chr21	35747748	35761452	SMIM11A	13704	+	NM_058182	35751803	35757940	4
chr21	35747778	35761452	SMIM11B	13674	+	NM_001313692	35751803	35757940	4
chr21	35772409	35773370	C21orf140	961	-	NM_001282537	35772614	35773370	1
chr21	35818985	35884573	KCNE1	65588	-	NM_000219	35821542	35821932	4
chr21	35888739	35987441	RCAN1	98702	-	NM_004414	35890381	35987310	4
chr21	36041461	36090525	CLIC6	49064	+	NM_001317009	36041687	36088780	7
chr21	36096104	36109479	LINC00160	13375	-	NR_024351	36109479	36109479	6
chr21	36118121	36157168	LINC01426	39047	+	NR_038885	36157168	36157168	3
chr21	36160097	36421595	RUNX1	261498	-	NM_001754	36164431	36421196	9
chr21	36410232	36411723	RUNX1-IT1	1491	-	NR_026812	36411723	36411723	1
chr21	36744804	36953062	LOC100506403	208258	-	NR_073512	36953062	36953062	3
chr21	37093012	37093106	MIR802	94	+	NR_030414	37093106	37093106	1
chr21	37326976	37376965	LOC101928269	49989	-	NR_110418	37376965	37376965	6
chr21	37377617	37380593	LINC01436	2976	+	NR_110419	37380593	37380593	2
chr21	37406838	37433116	SETD4	26278	-	NM_001286752	37408414	37429682	12
chr21	37441939	37498938	LOC100133286	56999	-	NR_040084	37498938	37498938	4
chr21	37442221	37445475	CBR1	3254	+	NM_001757	37442413	37445180	3
chr21	37504064	37528606	CBR3-AS1	24542	-	NR_038892	37528606	37528606	4
chr21	37507262	37518860	CBR3	11598	+	NM_001236	37507490	37518810	3
chr21	37536838	37666572	DOPEY2	129734	+	NM_005128	37537031	37665869	37
chr21	37692486	37748944	MORC3	56458	+	NM_015358	37692562	37747594	17
chr21	37757688	37789125	CHAF1B	31437	+	NM_005441	37758434	37788664	14
chr21	37832919	37948867	CLDN14	115948	-	NM_001146077	37833273	37833993	3
chr21	38071432	38122218	SIM2	50786	+	NM_005069	38072046	38120393	11
chr21	38123188	38362545	HLCS	239357	-	NM_000411	38126546	38311183	12
chr21	38378449	38391958	RIPPLY3	13509	+	NM_001317768	38390186	38390507	4
chr21	38435340	38436366	LOC105372795	1026	-	NR_131189	38436366	38436366	1
chr21	38437663	38445458	PIGP	7795	-	NR_028352	38445458	38445458	6
chr21	38445570	38575408	TTC3	129838	+	NM_001001894	38459557	38573875	46
chr21	38580803	38594037	DSCR9	13234	+	NR_026719	38594037	38594037	3
chr21	38595725	38639833	DSCR3	44108	-	NM_006052	38597844	38639595	8
chr21	38739858	38887679	DYRK1A	147821	+	NM_101395	38792676	38878610	13
chr21	38996524	39288741	KCNJ6	292217	-	NM_002240	38997460	39212984	4
chr21	39426312	39493454	DSCR4	67142	-	NM_005867	39426948	39493349	3
chr21	39493544	39528605	DSCR8	35061	+	NR_026841	39528605	39528605	4
chr21	39578249	39580738	DSCR10	2489	+	NR_027695	39580738	39580738	3
chr21	39601836	39673746	KCNJ15	71910	+	NM_001276439	39671183	39672311	4
chr21	39698280	39717998	LINC01423	19718	-	NR_110545	39717998	39717998	6
chr21	39739182	40033704	ERG	294522	-	NM_001243432	39739556	39947624	12
chr21	40110948	40145401	LINC00114	34453	-	NR_027065	40145401	40145401	7
chr21	40177230	40196878	ETS2	19648	+	NM_001256295	40177270	40194813	11
chr21	40229462	40230786	LOC101928398	1324	+	NR_109926	40230786	40230786	3
chr21	40249214	40310353	LOC400867	61139	-	NR_120405	40310353	40310353	4
chr21	40346354	40349700	LOC101928435	3346	-	NR_109962	40349700	40349700	3
chr21	40547371	40555440	PSMG1	8069	-	NM_001261824	40547515	40555311	7
chr21	40557403	40685712	BRWD1	128309	-	NM_018963	40558951	40685417	42
chr21	40685832	40686841	BRWD1-IT2	1009	+	NR_111942	40686841	40686841	1
chr21	40687632	40695144	BRWD1-AS1	7512	+	NR_046655	40695144	40695144	3
chr21	40714240	40721047	HMGN1	6807	-	NM_004965	40715037	40720843	6
chr21	40752169	40887433	WRB-SH3BGR	135264	+	NM_001317744	40752310	40883702	9
chr21	40752212	40769815	WRB	17603	+	NM_004627	40752310	40768865	5
chr21	40777769	40816128	LCA5L	38359	-	NM_152505	40777807	40800419	10
chr21	40817790	40887433	SH3BGR	69643	+	NM_001317742	40834399	40883702	7
chr21	40818935	40818995	MIR6508	60	+	NR_106763	40818995	40818995	1
chr21	40969074	40984749	B3GALT5-AS1	15675	-	NR_026542	40984749	40984749	3
chr21	40984866	41034816	B3GALT5	49950	+	NM_001278650	41032486	41033419	3
chr21	41117333	41174023	IGSF5	56690	+	NM_001080444	41117436	41173284	9
chr21	41239346	41301322	PCP4	61976	+	NM_006198	41239427	41301036	3
chr21	41384342	42219039	DSCAM	834697	-	NM_001271534	41384960	42218587	33
chr21	41584278	41584358	MIR4760	80	-	NR_039917	41584358	41584358	1
chr21	41755009	41757285	DSCAM-AS1	2276	+	NR_038896	41757285	41757285	3
chr21	41990432	42002693	DSCAM-IT1	12261	-	NR_046774	42002693	42002693	4
chr21	42513426	42519991	LINC00323	6565	-	NR_024100	42519991	42519991	2
chr21	42539483	42539556	MIR3197	73	+	NR_036167	42539556	42539556	1
chr21	42539727	42654461	BACE2	114734	+	NM_012105	42540190	42647551	9
chr21	42547157	42557166	PLAC4	10009	-	NM_182832	42551102	42551555	1
chr21	42688660	42729654	FAM3B	40994	+	NM_058186	42688806	42729124	8
chr21	42733949	42780869	MX2	46920	+	NM_002463	42748833	42780160	14
chr21	42792484	42831141	MX1	38657	+	NM_001144925	42803997	42830685	19
chr21	42836477	42880085	TMPRSS2	43608	-	NM_005656	42838068	42870060	14
chr21	43099461	43117496	LINC00111	18035	+	NR_024367	43117496	43117496	3
chr21	43131679	43135935	LINC00479	4256	-	NR_027272	43135935	43135935	6
chr21	43136595	43137742	LINC00112	1147	+	NR_024028	43137742	43137742	3
chr21	43159528	43187249	RIPK4	27721	-	NM_020639	43160997	43187201	8
chr21	43166931	43167001	MIR6814	70	-	NR_106872	43167001	43167001	1
chr21	43218384	43299591	PRDM15	81207	-	NM_001282934	43221399	43299480	25
chr21	43305218	43373999	C2CD2	68781	-	NM_015500	43309232	43373757	14
chr21	43368213	43368391	SNORA91	178	-	NR_132773	43368391	43368391	1
chr21	43406939	43430496	ZBTB21	23557	-	NM_001098403	43411003	43414204	4
chr21	43429302	43445029	ZNF295-AS1	15727	+	NR_119384	43445029	43445029	2
chr21	43483067	43563105	UMODL1	80038	+	NM_001199528	43496253	43557730	23
chr21	43522243	43528644	UMODL1-AS1	6401	-	NR_027243	43528644	43528644	2
chr21	43619798	43717354	ABCG1	97556	+	NM_207627	43621785	43716502	16
chr21	43731776	43735706	TFF3	3930	-	NM_003226	43732365	43735526	3
chr21	43766466	43771208	TFF2	4742	-	NM_005423	43766641	43771066	4
chr21	43782390	43786644	TFF1	4254	-	NM_003225	43782587	43786604	3
chr21	43791995	43816955	TMPRSS3	24960	-	NR_046020	43816955	43816955	13
chr21	43823970	43867790	UBASH3A	43820	+	NM_018961	43824054	43867304	15
chr21	43892596	43916464	RSPH1	23868	-	NM_080860	43892927	43916296	9
chr21	43919741	44001550	SLC37A1	81809	+	NM_018964	43938564	44000470	21
chr21	44019513	44035205	LOC101928233	15692	-	NR_131192	44035205	44035205	2
chr21	44073861	44195618	PDE9A	121757	+	NM_002606	44073924	44195403	20
chr21	44263189	44299693	WDR4	36504	-	NM_033661	44270158	44299605	12
chr21	44313377	44329773	NDUFV3	16396	+	NM_021075	44313443	44329131	4
chr21	44337360	44345708	ERVH48-1	8348	-	NM_001308491	44338633	44339116	2
chr21	44394619	44454041	PKNOX1	59422	+	NM_004571	44424491	44450211	11
chr21	44473300	44496472	CBS	23172	-	NM_001178009	44473989	44492303	18
chr21	44513065	44527688	U2AF1	14623	-	NM_001025204	44513211	44515833	9
chr21	44560632	44561202	FRGCA	570	-	NR_133677	44561202	44561202	2
chr21	44560632	44561202	LOC106780825	570	-	NR_133678	44561202	44561202	2
chr21	44589117	44592920	CRYAA	3803	+	NM_000394	44589209	44592390	3
chr21	44589159	44592431	LOC102724652	3272	+	NM_001314050	44589209	44592390	3
chr21	44742088	44751919	LINC00322	9831	-	NR_103713	44751919	44751919	3
chr21	44777934	44782229	TCONS_00029157	4295	-	NR_131902	44782229	44782229	2
chr21	44834397	44847002	SIK1	12605	-	NM_173354	44836621	44846058	14
chr21	44869903	44873771	LINC00319	3868	+	NR_026960	44873771	44873771	3
chr21	44881973	44898103	LINC00313	16130	-	NR_026863	44898103	44898103	4
chr21	44949071	45079374	HSF2BP	130303	-	NM_007031	44949633	45077977	9
chr21	45029767	45029870	MIR6070	103	-	NR_106718	45029870	45029870	1
chr21	45079431	45115960	RRP1B	36529	+	NM_015056	45079545	45113264	16
chr21	45138977	45182188	PDXK	43211	+	NM_003681	45139175	45175944	11
chr21	45193545	45196256	CSTB	2711	-	NM_000100	45194082	45196150	3
chr21	45209417	45223983	RRP1	14566	+	NM_003683	45209510	45223655	13
chr21	45225638	45232448	AATBC	6810	-	NR_026961	45232448	45232448	2
chr21	45285115	45407475	AGPAT3	122360	+	NM_020132	45379562	45402273	10
chr21	45432205	45526432	TRAPPC10	94227	+	NM_003274	45432374	45523412	23
chr21	45527207	45551063	PWP2	23856	+	NM_005049	45527297	45550653	21
chr21	45553493	45565605	C21orf33	12112	+	NM_004649	45553579	45564831	7
chr21	45642877	45660887	ICOSLG	18010	-	NM_001283050	45642929	45660700	7
chr21	45666221	45682099	DNMT3L	15878	-	NM_175867	45666279	45681142	12
chr21	45705720	45718102	AIRE	12382	+	NM_000383	45705889	45717610	14
chr21	45719916	45747264	PFKL	27348	+	NM_001002021	45725201	45746745	25
chr21	45748826	45759285	C21orf2	10459	-	NM_004928	45750080	45759077	7
chr21	45773483	45862964	TRPM2	89481	+	NR_038257	45862964	45862964	32
chr21	45834474	45845446	TRPM2-AS	10972	-	NR_109964	45845446	45845446	3
chr21	45870868	45875167	LRRC3-AS1	4299	-	NR_047476	45875167	45875167	4
chr21	45875368	45878739	LRRC3	3371	+	NM_030891	45876527	45877301	2
chr21	45917774	46131495	TSPEAR	213721	-	NM_001272037	45919665	45987767	13
chr21	45925926	45936458	TSPEAR-AS1	10532	+	NR_103707	45936458	45936458	7
chr21	45937097	45938860	TSPEAR-AS2	1763	+	NR_026547	45938860	45938860	3
chr21	45959067	45960078	KRTAP10-1	1011	-	NM_198691	45959184	45960033	1
chr21	45970239	45971388	KRTAP10-2	1149	-	NR_130165	45971388	45971388	2
chr21	45977905	45978643	KRTAP10-3	738	-	NM_198696	45977932	45978598	1
chr21	45993605	45995248	KRTAP10-4	1643	+	NM_198687	45993635	45994841	1
chr21	45999331	46000481	KRTAP10-5	1150	-	NM_198694	45999639	46000455	1
chr21	46011148	46012386	KRTAP10-6	1238	-	NM_198688	46011267	46012365	1
chr21	46020496	46022091	KRTAP10-7	1595	+	NM_198689	46020521	46021649	2
chr21	46031995	46032871	KRTAP10-8	876	+	NM_198695	46032017	46032797	1
chr21	46047039	46048295	KRTAP10-9	1256	+	NM_198690	46047088	46047967	1
chr21	46057272	46058372	KRTAP10-10	1100	+	NM_181688	46057334	46058090	1
chr21	46066330	46067566	KRTAP10-11	1236	+	NM_198692	46066375	46067272	1
chr21	46074129	46074576	KRTAP12-4	447	-	NM_198698	46074192	46074531	1
chr21	46077848	46078258	KRTAP12-3	410	+	NM_198697	46077896	46078187	1
chr21	46086105	46086844	KRTAP12-2	739	-	NM_181684	46086362	46086803	1
chr21	46101490	46102078	KRTAP12-1	588	-	NM_181686	46101747	46102038	1
chr21	46117086	46117959	KRTAP10-12	873	+	NM_198699	46117116	46117854	1
chr21	46188494	46221751	UBE2G2	33257	-	NM_182688	46191291	46207875	7
chr21	46222155	46224631	LINC01424	2476	+	NR_109928	46224631	46224631	2
chr21	46225531	46238044	SUMO3	12513	-	NM_001286416	46226865	46237883	4
chr21	46269499	46293818	PTTG1IP	24319	-	NM_004339	46271495	46293531	6
chr21	46305868	46348788	ITGB2	42920	-	NM_001127491	46306282	46330697	16
chr21	46340949	46349595	ITGB2-AS1	8646	+	NR_038313	46349595	46349595	5
chr21	46353198	46359828	LINC01547	6630	-	NR_027128	46359828	46359828	4
chr21	46359611	46396904	FAM207A	37293	+	NM_001316988	46380052	46396718	6
chr21	46409778	46414001	LINC00163	4223	-	NR_033840	46414001	46414001	2
chr21	46419121	46424642	LINC00162	5521	-	NR_024089	46424642	46424642	2
chr21	46490869	46493126	SSR4P1	2257	-	NR_027292	46493126	46493126	1
chr21	46494492	46646478	ADARB1	151986	+	NR_027673	46646478	46646478	13
chr21	46683842	46707811	POFUT2	23969	-	NR_004858	46707811	46707811	10
chr21	46707966	46717269	LOC642852	9303	+	NR_026943	46717269	46717269	3
chr21	46758504	46761905	LINC00316	3401	-	NR_103811	46761905	46761905	2
chr21	46825051	46933634	COL18A1	108583	+	NM_130445	46825145	46932312	43
chr21	46827300	46829980	COL18A1-AS2	2680	-	NR_052004	46829980	46829980	4
chr21	46839630	46844985	COL18A1-AS1	5355	-	NR_027498	46844985	46844985	3
chr21	46898179	46898240	MIR6815	61	+	NR_106873	46898240	46898240	1
chr21	46934628	46962385	SLC19A1	27757	-	NM_001205206	46934889	46957873	6
chr21	47247754	47256333	LOC100129027	8579	-	NR_038876	47256333	47256333	3
chr21	47269874	47362368	PCBP3	92494	+	NM_020528	47269999	47361620	14
chr21	47392883	47394867	LOC101928796	1984	+	NR_109931	47394867	47394867	2
chr21	47401662	47424963	COL6A1	23301	+	NM_001848	47401764	47423927	35
chr21	47518032	47552763	COL6A2	34731	+	NM_001849	47531390	47552466	28
chr21	47556175	47575481	FTCD	19306	-	NM_006657	47556900	47575437	15
chr21	47581061	47604373	SPATC1L	23312	-	NM_001142854	47581292	47602730	5
chr21	47608359	47648738	LSS	40379	-	NM_001001438	47611017	47648659	23
chr21	47649144	47671615	MCM3AP-AS1	22471	+	NR_110565	47671615	47671615	4
chr21	47655038	47705308	MCM3AP	50270	-	NM_003906	47655181	47705200	28
chr21	47706243	47717665	YBEY	11422	+	NM_058181	47706827	47717548	5
chr21	47721043	47743813	C21orf58	22770	-	NM_001286476	47721912	47734920	9
chr21	47744035	47865682	PCNT	121647	+	NM_006031	47744142	47865240	47
chr21	47878861	47989926	DIP2A	111065	+	NM_015151	47879044	47987535	38
chr21	47882383	47889218	DIP2A-IT1	6835	+	NR_046400	47889218	47889218	4
chr21	48018530	48025035	S100B	6505	-	NM_006272	48019275	48022328	3
chr21	48055506	48085036	PRMT2	29530	+	NM_206962	48056863	48084239	12
chr22	16150528	16193009	DUXAP8	42481	-	NR_122113	16193009	16193009	8
chr22	16199673	16231289	LINC01297	31616	-	NR_132385	16231289	16231289	3
chr22	16256331	16287937	POTEH	31606	-	NM_001136213	16258185	16287885	11
chr22	16448823	16449804	OR11H1	981	-	NM_001005239	16448823	16449804	1
chr22	17071647	17073700	CCT8L2	2053	-	NM_014406	17071766	17073440	1
chr22	17082800	17129720	TPTEP1	46920	+	NR_001591	17129720	17129720	9
chr22	17134598	17156430	ANKRD62P1-PARP4P3	21832	-	NR_040115	17156430	17156430	9
chr22	17264305	17302584	XKR3	38279	-	NM_175878	17264508	17288963	4
chr22	17308363	17310225	HSFY1P1	1862	+	NR_003607	17310225	17310225	2
chr22	17442826	17489112	GAB4	46286	-	NM_001037814	17443622	17489004	10
chr22	17517459	17539682	CECR7	22223	+	NR_015352	17539682	17539682	4
chr22	17565848	17596584	IL17RA	30736	+	NM_014339	17565981	17590710	13
chr22	17597188	17602257	CECR6	5069	-	NM_001163079	17600280	17600952	2
chr22	17602484	17612994	LOC100996342	10510	+	NR_103793	17612994	17612994	4
chr22	17618409	17646177	CECR5	27768	-	NM_017829	17618910	17646134	8
chr22	17640278	17646335	CECR5-AS1	6057	+	NR_024483	17646335	17646335	2
chr22	17659679	17702744	CECR1	43065	-	NM_001282227	17662372	17690441	10
chr22	17737749	17747623	CECR3	9874	-	NR_038398	17747623	17747623	3
chr22	17840838	18037856	CECR2	197018	+	NM_001290046	17978525	18032540	19
chr22	18043138	18073656	SLC25A18	30518	+	NM_031481	18062710	18073002	11
chr22	18062922	18071958	LOC101929372	9036	-	NM_001288707	18063079	18070784	4
chr22	18074902	18111588	ATP6V1E1	36686	-	NM_001696	18075439	18111401	9
chr22	18121349	18213621	BCL2L13	92272	+	NM_015367	18138477	18210300	7
chr22	18216905	18257431	BID	40526	-	NM_001244567	18218345	18232882	6
chr22	18246945	18247025	MIR3198-1	80	-	NR_036168	18247025	18247025	1
chr22	18260055	18262247	LINC00528	2192	+	NR_103718	18262247	18262247	1
chr22	18270415	18507325	MICAL3	236910	-	NM_015241	18273497	18389578	32
chr22	18463633	18463727	MIR648	94	-	NR_030378	18463727	18463727	1
chr22	18512150	18520734	FLJ41941	8584	+	NR_024417	18520734	18520734	2
chr22	18560685	18573797	PEX26	13112	+	NM_017929	18561142	18570841	6
chr22	18593452	18614498	TUBA8	21046	+	NM_001193414	18604440	18613903	5
chr22	18632757	18660162	USP18	27405	+	NM_017414	18640430	18659584	11
chr22	18761201	18779474	GGT3P	18273	-	NR_003267	18779474	18779474	13
chr22	18893735	18899601	DGCR6	5866	+	NM_005675	18893887	18899202	5
chr22	18900286	18924066	PRODH	23780	-	NM_016335	18900687	18923800	15
chr22	18958010	19018755	DGCR5	60745	+	NR_110533	19018755	19018755	6
chr22	19005346	19007761	DGCR9	2415	+	NR_024159	19007761	19007761	1
chr22	19010136	19011063	DGCR10	927	+	NR_026651	19011063	19011063	1
chr22	19023794	19109967	DGCR2	86173	-	NM_005137	19026377	19109719	10
chr22	19033674	19035888	DGCR11	2214	-	NR_024157	19035888	19035888	1
chr22	19117791	19132190	DGCR14	14399	-	NM_022719	19121708	19132153	10
chr22	19118320	19120136	TSSK2	1816	+	NM_053006	19118912	19119989	1
chr22	19136503	19137796	GSC2	1293	-	NM_005315	19136503	19137796	3
chr22	19159218	19160345	LINC01311	1127	+	NR_103767	19160345	19160345	1
chr22	19163087	19166376	SLC25A1	3289	-	NM_005984	19163642	19166186	9
chr22	19166986	19279239	CLTCL1	112253	-	NM_007098	19167731	19279164	33
chr22	19318223	19419219	HIRA	100996	-	NM_003325	19318962	19418999	25
chr22	19420035	19423596	MRPL40	3561	+	NM_003776	19420077	19423485	4
chr22	19428409	19435755	C22orf39	7346	-	NM_001166242	19429166	19435322	3
chr22	19437463	19466738	UFD1L	29275	-	NM_005659	19438192	19466608	12
chr22	19467348	19508135	CDC45	40787	+	NM_001178010	19467491	19506431	20
chr22	19510546	19512860	CLDN5	2314	-	NM_003277	19511121	19512033	2
chr22	19553652	19554362	LINC00895	710	-	NR_024381	19554362	19554362	1
chr22	19701986	19710845	SEPT5	8859	+	NM_002688	19702111	19710007	12
chr22	19704742	19712297	SEPT5-GP1BB	7555	+	NR_037611	19712297	19712297	12
chr22	19711065	19712297	GP1BB	1232	+	NM_000407	19711092	19711987	2
chr22	19744225	19771112	TBX1	26887	+	NM_005992	19747166	19770545	10
chr22	19775933	19842462	GNB1L	66529	-	NM_053004	19776231	19808878	8
chr22	19833660	19842371	C22orf29	8711	-	NM_024627	19838689	19839784	3
chr22	19863040	19929515	TXNRD2	66475	-	NM_006440	19864627	19929326	18
chr22	19929262	19957498	COMT	28236	+	NM_000754	19950049	19956259	6
chr22	19951275	19951357	MIR4761	82	+	NR_039918	19951357	19951357	1
chr22	19957401	20004309	ARVCF	46908	-	NM_001670	19958750	19978317	20
chr22	20004522	20053449	TANGO2	48927	+	NM_001283106	20024321	20052185	10
chr22	20020661	20020743	MIR185	82	+	NR_029706	20020743	20020743	1
chr22	20067754	20099400	DGCR8	31646	+	NM_022720	20073486	20097631	14
chr22	20073268	20073356	MIR3618	88	+	NR_037412	20073356	20073356	1
chr22	20073580	20073665	MIR1306	85	+	NR_031706	20073665	20073665	1
chr22	20099388	20104818	TRMT2A	5430	-	NM_182984	20100085	20104429	13
chr22	20102208	20102274	MIR6816	66	-	NR_106874	20102274	20102274	1
chr22	20103460	20114880	RANBP1	11420	+	NM_001278639	20103707	20114575	6
chr22	20119363	20135530	ZDHHC8	16167	+	NM_001185024	20119470	20134754	11
chr22	20136108	20137431	CCDC188	1323	-	NM_001243537	20136136	20137261	6
chr22	20186252	20192441	LOC284865	6189	-	NR_038460	20192441	20192441	4
chr22	20193854	20196060	LINC00896	2206	+	NR_026919	20196060	20196060	1
chr22	20228937	20255816	RTN4R	26879	-	NM_023004	20229233	20255615	2
chr22	20236656	20236734	MIR1286	78	-	NR_031618	20236734	20236734	1
chr22	20301760	20307628	DGCR6L	5868	-	NM_033257	20302197	20307511	5
chr22	20377668	20380440	TMEM191B	2772	+	NM_001242313	20377847	20380326	9
chr22	20383730	20398695	PI4KAP1	14965	-	NR_003563	20398695	20398695	15
chr22	20455993	20461786	RIMBP3	5793	-	NM_015672	20456381	20461301	1
chr22	20748404	20762753	ZNF74	14349	+	NM_001256524	20748918	20761258	6
chr22	20778873	20792146	SCARF2	13273	-	NM_153334	20779664	20792041	14
chr22	20795805	20850170	KLHL22	54365	-	NM_032775	20796359	20843498	7
chr22	20861828	20941919	MED15	80091	+	NM_001003891	20861965	20940991	18
chr22	21043842	21046009	POM121L4P	2167	+	NR_024592	21046009	21046009	1
chr22	21055401	21058891	TMEM191A	3490	+	NR_026815	21058891	21058891	8
chr22	21061978	21213100	PI4KA	151122	-	NM_058004	21062334	21213013	55
chr22	21128382	21142008	SERPIND1	13626	+	NM_000185	21133600	21141354	5
chr22	21213291	21245501	SNAP29	32210	+	NM_004782	21213398	21242124	5
chr22	21271713	21308037	CRKL	36324	+	NM_005207	21272222	21304133	3
chr22	21311379	21318968	LOC101928891	7589	+	NR_110537	21318968	21318968	2
chr22	21319417	21335649	AIFM3	16232	+	NM_144704	21322232	21335320	21
chr22	21336557	21353326	LZTR1	16769	+	NM_006767	21336660	21351637	21
chr22	21354060	21356404	THAP7	2344	-	NM_001008695	21354168	21356200	5
chr22	21356210	21364663	THAP7-AS1	8453	+	NR_027051	21364663	21364663	2
chr22	21362495	21368576	TUBA3FP	6081	-	NR_003608	21368576	21368576	3
chr22	21369441	21382302	P2RX6	12861	+	NM_001159554	21369463	21380906	12
chr22	21383006	21386847	SLC7A4	3841	-	NM_004173	21383343	21386101	5
chr22	21388464	21388561	MIR649	97	-	NR_030379	21388561	21388561	1
chr22	21396680	21398538	P2RX6P	1858	-	NR_002829	21398538	21398538	2
chr22	21400248	21418457	LRRC74B	18209	+	NR_027006	21418457	21418457	11
chr22	21457304	21476575	BCRP2	19271	+	NR_037566	21476575	21476575	6
chr22	21521191	21546445	FAM230B	25254	+	NR_108107	21546445	21546445	13
chr22	21636713	21652015	POM121L8P	15302	+	NR_024583	21652015	21652015	7
chr22	21737662	21743455	RIMBP3C	5793	+	NM_001128633	21738147	21743067	1
chr22	21738039	21743455	RIMBP3B	5416	+	NM_001128635	21738147	21743067	1
chr22	21771692	21805750	HIC2	34058	+	NM_015094	21797120	21801032	3
chr22	21821458	21824224	TMEM191C	2766	+	NM_001207052	21821607	21824110	9
chr22	21827286	21871780	PI4KAP2	44494	-	NR_003700	21871780	21871780	17
chr22	21903735	21978323	UBE2L3	74588	+	NM_001256355	21903738	21975958	4
chr22	21982377	21984340	YDJC	1963	-	NM_001017964	21982706	21984303	5
chr22	21987085	21991616	CCDC116	4531	+	NM_152612	21987470	21991359	5
chr22	21996541	21998588	SDF2L1	2047	+	NM_022044	21996625	21998464	3
chr22	22007269	22007347	MIR301B	78	+	NR_030622	22007347	22007347	1
chr22	22007592	22007674	MIR130B	82	+	NR_029845	22007674	22007674	1
chr22	22020272	22052202	PPIL2	31930	+	NM_001317996	22020388	22049779	21
chr22	22051825	22090123	YPEL1	38298	-	NM_013313	22055417	22065033	5
chr22	22113946	22221970	MAPK1	108024	-	NM_002745	22123492	22221730	9
chr22	22273791	22307250	PPM1F	33459	-	NM_014634	22277464	22300420	8
chr22	22311396	22337240	TOP3B	25844	-	NM_003935	22311485	22330081	18
chr22	22599191	22599927	VPREB1	736	+	NM_007128	22599225	22599749	2
chr22	22652462	22677324	BMS1P20	24862	+	NR_027293	22677324	22677324	11
chr22	22838770	22863505	ZNF280B	24735	-	NR_130642	22863505	22863505	5
chr22	22868060	22874624	ZNF280A	6564	-	NM_080740	22868325	22869954	2
chr22	22890117	22901768	PRAME	11651	-	NM_206956	22890488	22899252	6
chr22	22901749	22909004	LL22NC03-63E9.3	7255	+	NR_027426	22909004	22909004	3
chr22	22974027	22987012	POM121L1P	12985	-	NR_024591	22987012	22987012	10
chr22	22987090	22990368	GGTLC2	3278	+	NM_001282879	22988815	22990211	5
chr22	23165269	23165365	MIR650	96	+	NR_030755	23165365	23165365	1
chr22	23228446	23228559	MIR5571	113	+	NR_049835	23228559	23228559	1
chr22	23229959	23238013	IGLL5	8054	+	NM_001178126	23230233	23237874	3
chr22	23401592	23484241	RSPH14	82649	-	NM_014433	23401639	23482607	7
chr22	23412668	23467221	GNAZ	54553	+	NM_002073	23437882	23465618	3
chr22	23487512	23506531	RAB36	19019	+	NM_004914	23487552	23503751	11
chr22	23522551	23660224	BCR	137673	+	NM_004327	23523147	23657709	23
chr22	23604953	23607186	FBXW4P1	2233	+	NR_033408	23607186	23607186	1
chr22	23701792	23724313	CES5AP1	22521	-	NR_037839	23724313	23724313	7
chr22	23732791	23744799	ZDHHC8P1	12008	-	NR_003950	23744799	23744799	6
chr22	23775750	23777258	LOC101929374	1508	+	NR_110538	23777258	23777258	3
chr22	23804268	23829167	LOC388882	24899	-	NR_110539	23829167	23829167	12
chr22	23915312	23922495	IGLL1	7183	-	NM_020070	23915452	23922377	3
chr22	23950638	23974508	DRICH1	23870	-	NM_016449	23950950	23974210	12
chr22	23980674	24059610	GUSBP11	78936	-	NR_024448	24059610	24059610	12
chr22	24033047	24041363	RGL4	8316	+	NM_153615	24034217	24041070	11
chr22	24083770	24093279	ZNF70	9509	-	NM_021916	24085986	24087327	2
chr22	24094929	24096630	VPREB3	1701	-	NM_013378	24095062	24096550	2
chr22	24105207	24108050	C22orf15	2843	+	NM_182520	24105493	24107919	6
chr22	24108020	24110159	CHCHD10	2139	-	NM_213720	24108193	24110061	4
chr22	24115005	24126503	MMP11	11498	+	NM_005940	24115057	24125731	8
chr22	24129117	24176705	SMARCB1	47588	+	NM_001317946	24129356	24176367	9
chr22	24176689	24181199	DERL3	4510	-	NM_001135751	24177013	24181174	7
chr22	24198889	24228299	SLC2A11	29410	+	NM_030807	24199676	24227036	13
chr22	24235896	24241117	MIF-AS1	5221	-	NR_038911	24241117	24241117	3
chr22	24236564	24237409	MIF	845	+	NM_002415	24236661	24237293	3
chr22	24309025	24314748	DDTL	5723	+	NM_001084393	24309102	24313595	3
chr22	24313553	24322019	DDT	8466	-	NM_001355	24313739	24316603	4
chr22	24322218	24326106	GSTT2	3888	+	NR_126446	24326106	24326106	6
chr22	24322338	24326106	GSTT2B	3768	+	NM_001080843	24322388	24325797	5
chr22	24340594	24347258	GSTTP1	6664	-	NR_003081	24347258	24347258	4
chr22	24373116	24374043	LOC391322	927	+	NM_001144931	24373137	24373873	2
chr22	24375962	24376214	GSTT1-AS1	252	+	NR_132348	24376214	24376214	1
chr22	24376132	24384311	GSTT1	8179	-	NM_000853	24376422	24384231	5
chr22	24385937	24401899	GSTTP2	15962	-	NR_003082	24401899	24401899	5
chr22	24407764	24574596	CABIN1	166832	+	NM_012295	24431965	24574164	37
chr22	24577443	24585074	SUSD2	7631	+	NM_019601	24577487	24584404	15
chr22	24615621	24641110	GGT5	25489	-	NM_001099781	24615937	24640693	12
chr22	24647588	24661492	POM121L9P	13904	+	NR_003714	24661492	24661492	7
chr22	24666784	24813708	SPECC1L	146924	+	NM_015330	24698199	24810591	17
chr22	24666784	24838328	SPECC1L-ADORA2A	171544	+	NR_103546	24838328	24838328	20
chr22	24819564	24838328	ADORA2A	18764	+	NM_001278500	24829372	24837457	3
chr22	24825175	24891042	ADORA2A-AS1	65867	-	NR_028484	24891042	24891042	7
chr22	24891250	24922553	UPB1	31303	+	NM_016327	24891371	24921762	10
chr22	24936390	24951903	GUCD1	15513	-	NM_001284253	24938973	24951793	6
chr22	24951617	24970932	SNRPD3	19315	+	NM_004175	24953642	24967945	4
chr22	24979717	25024972	GGT1	45255	+	NM_013430	25007048	25024806	16
chr22	24981590	24989035	LRRC75B	7445	-	NM_207644	24981853	24989006	4
chr22	25028881	25049327	BCRP3	20446	+	NR_024494	25049327	25049327	7
chr22	25041132	25055114	POM121L10P	13982	-	NR_024593	25055114	25055114	6
chr22	25115000	25170687	PIWIL3	55687	-	NR_045648	25170687	25170687	22
chr22	25160467	25161986	TOP1P2	1519	+	NR_001283	25161986	25161986	1
chr22	25202187	25322813	SGSM1	120626	+	NM_001039948	25202292	25320241	26
chr22	25331207	25335314	TMEM211	4107	-	NM_001001663	25331299	25334242	3
chr22	25423940	25593415	KIAA1671	169475	+	NM_001145206	25423966	25586747	11
chr22	25498383	25508659	LOC100128531	10276	-	NR_038941	25508659	25508659	5
chr22	25595816	25603326	CRYBB3	7510	+	NM_004076	25597363	25603179	6
chr22	25615611	25627836	CRYBB2	12225	+	NM_000496	25617396	25627739	6
chr22	25714223	25716193	IGLL3P	1970	+	NR_029395	25716193	25716193	3
chr22	25747384	25777544	LRP5L	30160	-	NM_001135772	25747765	25756059	6
chr22	25844053	25857645	CRYBB2P1	13592	+	NR_033733	25857645	25857645	6
chr22	25851612	25851678	MIR6817	66	+	NR_106875	25851678	25851678	1
chr22	25960860	26125258	ADRBK2	164398	+	NM_005160	25961007	26118417	21
chr22	26138119	26427007	MYO18B	288888	+	NM_032608	26157059	26423644	44
chr22	26565439	26779563	SEZ6L	214124	+	NM_021115	26565635	26776261	17
chr22	26825279	26840978	ASPHD2	15699	+	NM_020437	26829581	26839172	4
chr22	26846848	26879829	HPS4	32981	-	NM_022081	26849198	26877728	14
chr22	26879849	26887904	SRRD	8055	+	NM_001013694	26879856	26887638	7
chr22	26887893	26908437	TFIP11	20544	-	NM_001008697	26887978	26906238	16
chr22	26921713	26986089	TPST2	64376	-	NM_003595	26924186	26937596	7
chr22	26951177	26951289	MIR548J	112	-	NR_031615	26951289	26951289	1
chr22	26995361	27013991	CRYBB1	18630	-	NM_001887	26995453	27012283	6
chr22	27017927	27026636	CRYBA4	8709	+	NM_001886	27018560	27026451	6
chr22	27053445	27072440	MIAT	18995	+	NR_003491	27072440	27072440	5
chr22	27068805	27176856	MIATNB	108051	+	NR_110543	27176856	27176856	6
chr22	27299254	27316573	LINC01422	17319	+	NR_110540	27316573	27316573	3
chr22	28144264	28197486	MN1	53222	-	NM_002430	28146902	28196531	2
chr22	28247656	28315294	PITPNB	67638	-	NM_012399	28250879	28315179	12
chr22	28315363	28398667	TTC28-AS1	83304	+	NR_026963	28398667	28398667	5
chr22	28316512	28316600	MIR3199-1	88	-	NR_036169	28316600	28316600	1
chr22	28316513	28316599	MIR3199-2	86	+	NR_036170	28316599	28316599	1
chr22	28374001	29075853	TTC28	701852	-	NM_001145418	28378208	29075711	23
chr22	28855856	28855936	MIR5739	80	+	NR_106713	28855936	28855936	1
chr22	29083730	29137822	CHEK2	54092	-	NM_001257387	29083884	29115402	16
chr22	29138042	29153496	HSCB	15454	+	NM_172002	29138083	29153157	6
chr22	29168661	29185289	CCDC117	16628	+	NM_173510	29168837	29182314	5
chr22	29190547	29196560	XBP1	6013	-	NM_001079539	29191162	29196512	6
chr22	29279754	29453476	ZNRF3	173722	+	NM_001206998	29279754	29449610	9
chr22	29420986	29427464	ZNRF3-AS1	6478	-	NR_046851	29427464	29427464	3
chr22	29454659	29457907	C22orf31	3248	-	NM_015370	29454729	29457780	3
chr22	29469065	29564321	KREMEN1	95256	+	NM_032045	29469118	29563094	10
chr22	29601900	29655586	EMID1	53686	+	NM_133455	29602027	29654933	15
chr22	29655843	29663914	RHBDD3	8071	-	NM_012265	29656048	29661615	7
chr22	29663997	29696515	EWSR1	32518	+	NM_013986	29664325	29696151	18
chr22	29702984	29708778	GAS2L1	5794	+	NM_152236	29704095	29708486	6
chr22	29708921	29711745	RASL10A	2824	-	NM_006477	29709289	29711235	3
chr22	29723668	29784572	AP1B1	60904	-	NM_001127	29724809	29763232	23
chr22	29729146	29729256	MIR3653	110	-	NR_037426	29729256	29729256	1
chr22	29729151	29729247	SNORD125	96	-	NR_003686	29729247	29729247	1
chr22	29833003	29838118	RFPL1S	5115	-	NR_002727	29838118	29838118	1
chr22	29834571	29838444	RFPL1	3873	+	NM_021026	29834780	29838111	2
chr22	29876180	29887277	NEFH	11097	+	NM_021076	29876251	29886692	4
chr22	29904155	29949736	THOC5	45581	-	NM_001002877	29904445	29945136	21
chr22	29950797	29977326	NIPSNAP1	26529	-	NM_003634	29951923	29977071	10
chr22	29999544	30094589	NF2	95045	+	NM_181832	29999987	30079044	17
chr22	30116343	30127820	CABP7	11477	+	NM_182527	30116413	30125558	5
chr22	30126944	30162969	ZMAT5	36025	-	NM_019103	30127213	30144533	7
chr22	30163357	30166402	UQCR10	3045	+	NM_013387	30163387	30165708	2
chr22	30184596	30234293	ASCC2	49697	-	NM_032204	30185001	30228314	20
chr22	30279157	30426857	MTMR3	147700	+	NM_153050	30367048	30421790	20
chr22	30403037	30403102	MIR6818	65	+	NR_106876	30403102	30403102	1
chr22	30404730	30476469	HORMAD2-AS1	71739	-	NR_110541	30476469	30476469	5
chr22	30476452	30573062	HORMAD2	96610	+	NM_152510	30489941	30572156	11
chr22	30636435	30642840	LIF	6405	-	NM_002309	30639639	30642684	3
chr22	30658818	30662829	OSM	4011	-	NM_020530	30659871	30662788	3
chr22	30681106	30685616	GATSL3	4510	-	NM_001037666	30681608	30685486	9
chr22	30687978	30722955	TBC1D10A	34977	-	NM_001204240	30688363	30722870	9
chr22	30727976	30752936	SF3A1	24960	-	NM_005877	30730582	30752781	16
chr22	30752626	30772818	CCDC157	20192	+	NM_001017437	30761989	30772734	12
chr22	30764799	30773894	KIAA1656	9095	-	NR_046312	30773894	30773894	2
chr22	30774802	30783302	RNF215	8500	-	NM_001017981	30775588	30783302	9
chr22	30792929	30821291	SEC14L2	28362	+	NM_012429	30793105	30818396	12
chr22	30821610	30825041	MTFP1	3431	+	NM_016498	30821867	30824521	4
chr22	30855215	30868034	SEC14L3	12819	-	NM_001257378	30856007	30864778	14
chr22	30877276	30877743	SDC4P	467	-	NR_001580	30877743	30877743	1
chr22	30884897	30901698	SEC14L4	16801	-	NM_001161368	30885863	30901598	12
chr22	30920916	30942669	SEC14L6	21753	-	NM_001193336	30920983	30942669	12
chr22	30950623	30960876	GAL3ST1	10253	-	NM_004861	30950939	30953379	4
chr22	30972611	31003000	PES1	30389	-	NM_001282328	30973032	30980655	17
chr22	31003069	31023047	TCN2	19978	+	NM_001184726	31003318	31022508	9
chr22	31031792	31043862	SLC35E4	12070	+	NM_001001479	31032437	31043018	2
chr22	31048037	31063877	DUSP18	15840	-	NM_001304795	31059423	31059990	3
chr22	31089768	31303811	OSBP2	214043	+	NM_001282738	31090047	31302326	15
chr22	31127543	31127628	MIR3200	85	+	NR_036171	31127628	31127628	1
chr22	31318294	31322640	MORC2-AS1	4346	+	NR_026920	31322640	31322640	2
chr22	31322597	31364483	MORC2	41886	-	NM_014941	31322789	31346402	27
chr22	31365196	31375380	TUG1	10184	+	NR_110492	31375380	31375380	4
chr22	31477281	31500610	SMTN	23329	+	NM_134270	31479244	31500452	21
chr22	31500762	31503551	SELM	2789	-	NM_080430	31500955	31503491	5
chr22	31518908	31530683	INPP5J	11775	+	NM_001284289	31521826	31530405	15
chr22	31530792	31536593	PLA2G3	5801	-	NM_015715	31531708	31536340	7
chr22	31556047	31556105	MIR3928	58	-	NR_037496	31556105	31556105	1
chr22	31556137	31603005	RNF185	46868	+	NR_024210	31603005	31603005	7
chr22	31608249	31676066	LIMK2	67817	+	NM_005569	31608394	31674427	16
chr22	31677578	31688520	PIK3IP1	10942	-	NM_052880	31679069	31688330	6
chr22	31721789	31742249	PATZ1	20460	-	NM_014323	31722876	31741588	5
chr22	31731334	31734007	PIK3IP1-AS1	2673	+	NR_110542	31734007	31734007	2
chr22	31742744	31747141	LINC01521	4397	+	NR_120386	31747141	31747141	1
chr22	31795538	31830172	DRG1	34634	+	NM_004147	31795669	31829957	9
chr22	31835344	31885874	EIF4ENIF1	50530	-	NM_019843	31835865	31884704	19
chr22	31892124	32014537	SFI1	122413	+	NM_001007467	31904270	32014404	33
chr22	32014476	32026810	PISD	12334	-	NM_014338	32015597	32021801	9
chr22	32017452	32017517	MIR7109	65	-	NR_106959	32017517	32017517	1
chr22	32077333	32146120	PRR14L	68787	-	NM_173566	32081512	32134846	9
chr22	32149936	32303020	DEPDC5	153084	+	NM_001242897	32150907	32302483	40
chr22	32329506	32341348	C22orf24	11842	-	NM_015372	32330103	32334052	3
chr22	32340478	32353590	YWHAH	13112	+	NM_003405	32340719	32352779	2
chr22	32439018	32509011	SLC5A1	69993	+	NM_000343	32439268	32506200	15
chr22	32517963	32529456	AP1B1P1	11493	+	NR_040114	32529456	32529456	4
chr22	32545518	32555243	C22orf42	9725	-	NM_001010859	32545526	32555202	9
chr22	32586421	32600718	RFPL2	14297	-	NM_001159545	32586758	32589174	4
chr22	32614462	32651318	SLC5A4	36856	-	NM_014227	32614500	32651316	15
chr22	32750871	32757148	RFPL3	6277	+	NM_006604	32754145	32756819	3
chr22	32755892	32767251	RFPL3S	11359	-	NR_104232	32767251	32767251	5
chr22	32772650	32780329	LOC339666	7679	+	NR_038918	32780329	32780329	3
chr22	32783561	32808274	RTCB	24713	-	NM_014306	32783978	32808143	12
chr22	32809833	32853373	BPIFC	43540	-	NM_174932	32810289	32853373	15
chr22	32870706	32894818	FBXO7	24112	+	NM_012179	32870989	32894517	9
chr22	32908539	33454377	SYN3	545838	-	NM_001135774	32909678	33402647	14
chr22	33196801	33259028	TIMP3	62227	+	NM_000362	33197987	33255364	5
chr22	33669061	34316416	LARGE	647355	-	NM_004737	33670412	34157463	16
chr22	33832567	33832655	MIR4764	88	-	NR_039921	33832655	33832655	1
chr22	34120971	34146803	LARGE-AS1	25832	+	NR_038949	34146803	34146803	10
chr22	35462128	35483380	ISX	21252	+	NM_001303508	35463080	35481686	5
chr22	35515816	35627049	LINC01399	111233	-	NR_126356	35627049	35627049	6
chr22	35653444	35691800	HMGXB4	38356	+	NR_027780	35691800	35691800	12
chr22	35695267	35743987	TOM1	48720	+	NM_001135729	35713916	35743202	15
chr22	35731632	35731751	MIR3909	119	+	NR_037471	35731751	35731751	1
chr22	35732713	35732792	MIR6069	79	-	NR_106717	35732792	35732792	1
chr22	35777059	35790207	HMOX1	13148	+	NM_002133	35777166	35789591	5
chr22	35796115	35820495	MCM5	24380	+	NM_006739	35796431	35820248	17
chr22	35937351	35950045	RASD2	12694	+	NM_014310	35942856	35948079	3
chr22	36002810	36019401	MB	16591	-	NM_203377	36003343	36013304	4
chr22	36044423	36064456	APOL6	20033	+	NM_030641	36052472	36055643	3
chr22	36113918	36125529	APOL5	11611	+	NM_030642	36113918	36124945	5
chr22	36134782	36424585	RBFOX2	289803	-	NM_001082579	36140251	36424473	14
chr22	36536370	36562225	APOL3	25855	-	NM_145641	36537247	36537856	5
chr22	36585175	36600879	APOL4	15704	-	NM_030643	36587122	36597780	7
chr22	36622254	36636000	APOL2	13746	-	NM_145637	36623449	36629208	6
chr22	36649116	36663577	APOL1	14461	+	NM_145343	36650008	36662079	7
chr22	36677322	36784112	MYH9	106790	-	NM_002473	36678713	36745281	41
chr22	36682892	36682953	MIR6819	61	-	NR_106877	36682953	36682953	1
chr22	36863092	36877687	TXN2	14595	-	NM_012473	36863850	36876884	4
chr22	36883232	36903148	FOXRED2	19916	-	NM_001102371	36886054	36902469	9
chr22	36906896	36925277	EIF3D	18381	-	NM_003753	36907033	36922168	15
chr22	36956915	37098690	CACNG2	141775	-	NM_006078	36960397	37098621	4
chr22	37154245	37172177	IFT27	17932	-	NM_006860	37154354	37171751	7
chr22	37196744	37215517	PVALB	18773	-	NM_002854	37196933	37213049	5
chr22	37257029	37274059	NCF4	17030	+	NM_000631	37257213	37273865	10
chr22	37309674	37336479	CSF2RB	26805	+	NM_000395	37318249	37334544	14
chr22	37361288	37364213	LL22NC01-81G9.3	2925	+	NR_038954	37364213	37364213	4
chr22	37387159	37403877	TEX33	16718	-	NM_001163857	37387219	37400028	6
chr22	37406899	37416224	TST	9325	-	NM_001270483	37407067	37414773	3
chr22	37415682	37425863	MPST	10181	+	NM_001130517	37420256	37425555	4
chr22	37447775	37459430	KCTD17	11655	+	NM_001282684	37447779	37458634	9
chr22	37461475	37505603	TMPRSS6	44128	-	NM_001289000	37462119	37499457	19
chr22	37521879	37545962	IL2RB	24083	-	NM_000878	37524135	37540212	10
chr22	37576205	37584330	C1QTNF6	8125	-	NM_182486	37578227	37584253	4
chr22	37600276	37608416	SSTR3	8140	-	NM_001051	37602585	37603842	2
chr22	37621300	37640339	RAC2	19039	-	NM_002872	37622712	37640188	7
chr22	37678423	37711389	CYTH4	32966	+	NM_001318024	37692043	37709552	13
chr22	37736684	37823505	ELFN2	86821	-	NR_110512	37823505	37823505	3
chr22	37748230	37750879	LOC100506271	2649	-	NR_110515	37750879	37750879	2
chr22	37865100	37882478	MFNG	17378	-	NM_002405	37866000	37882215	8
chr22	37886399	37915210	CARD10	28811	-	NM_014550	37887196	37915207	20
chr22	37956470	37965410	CDC42EP1	8940	+	NM_152243	37962356	37964827	3
chr22	37966252	37976024	LGALS2	9772	-	NM_006498	37966269	37975912	4
chr22	38004480	38029571	GGA1	25091	+	NM_001172687	38004867	38028718	17
chr22	38035683	38052050	SH3BP1	16367	+	NM_018957	38035794	38051691	18
chr22	38037838	38054384	LOC101927051	16546	-	NR_109952	38054384	38054384	6
chr22	38054736	38062939	PDXP	8203	+	NM_020315	38054789	38061878	2
chr22	38071612	38075809	LGALS1	4197	+	NM_002305	38071709	38075756	4
chr22	38082343	38089485	NOL12	7142	+	NM_024313	38082399	38087343	6
chr22	38092994	38172563	TRIOBP	79569	+	NM_001039141	38097372	38168769	24
chr22	38201113	38203443	H1F0	2330	+	NM_005318	38201551	38202136	1
chr22	38203911	38213183	GCAT	9272	+	NM_001171690	38203974	38212725	10
chr22	38219388	38221502	GALR3	2114	+	NM_003614	38219413	38221477	2
chr22	38226861	38240353	ANKRD54	13492	-	NM_138797	38227949	38240245	8
chr22	38240278	38240378	MIR658	100	-	NR_030395	38240378	38240378	1
chr22	38243684	38243781	MIR659	97	-	NR_030396	38243781	38243781	1
chr22	38245378	38284789	EIF3L	39411	+	NM_016091	38245456	38284471	13
chr22	38302154	38338465	MICALL1	36311	+	NM_033386	38302429	38336837	16
chr22	38339056	38349676	C22orf23	10620	-	NM_001207062	38340181	38349156	6
chr22	38349669	38437922	POLR2F	88253	+	NM_001301130	38349794	38437099	6
chr22	38363569	38363631	MIR6820	62	+	NR_106878	38363631	38363631	1
chr22	38368318	38380539	SOX10	12221	-	NM_006941	38369501	38379791	4
chr22	38384800	38384860	MIR4534	60	+	NR_039759	38384860	38384860	1
chr22	38453261	38471708	PICK1	18447	+	NM_001039584	38453816	38471139	13
chr22	38474143	38479170	SLC16A8	5027	-	NM_013356	38474394	38478880	5
chr22	38480895	38506676	BAIAP2L2	25781	-	NM_025045	38481306	38506532	14
chr22	38507501	38577836	PLA2G6	70335	-	NM_001199562	38508167	38565433	16
chr22	38597938	38612517	MAFF	14579	+	NM_001161572	38609860	38610885	3
chr22	38615297	38669040	TMEM184B	53743	-	NM_001195072	38617475	38642100	10
chr22	38620485	38620727	SNORA92	242	-	NR_132774	38620727	38620727	1
chr22	38686696	38714089	CSNK1E	27393	-	NM_001894	38689292	38710162	11
chr22	38686696	38794527	LOC400927-CSNK1E	107831	-	NM_001289912	38689292	38710162	15
chr22	38740669	38794931	LOC400927	54262	-	NR_002821	38794931	38794931	5
chr22	38822332	38851205	KCNJ4	28873	-	NM_152868	38822799	38824137	2
chr22	38864066	38879452	KDELR3	15386	+	NM_006855	38864238	38878541	5
chr22	38879442	38902345	DDX17	22903	-	NM_006386	38881939	38902242	13
chr22	38914953	38966201	DMC1	51248	-	NM_007068	38916024	38964261	14
chr22	38974124	39052634	FAM227A	78510	-	NM_001291030	38982129	39035635	17
chr22	39052657	39069855	CBY1	17198	+	NM_001002880	39061599	39069241	6
chr22	39077953	39080766	TOMM22	2813	+	NM_020243	39077983	39079846	4
chr22	39081547	39096459	JOSD1	14912	-	NM_014876	39083906	39095992	4
chr22	39101806	39129592	GTPBP1	27786	+	NM_004286	39101960	39126709	12
chr22	39130718	39152024	SUN2	21306	-	NM_001199579	39132271	39148633	18
chr22	39174512	39190161	DNAL4	15649	-	NM_005740	39175453	39178736	4
chr22	39214455	39240017	NPTXR	25562	-	NM_014293	39218613	39239863	5
chr22	39257431	39268339	CBX6	10908	-	NM_014292	39262213	39268195	5
chr22	39353526	39359188	APOBEC3A	5662	+	NM_145699	39353696	39358514	5
chr22	39353526	39388783	APOBEC3A_B	35257	+	NM_001193289	39353696	39388450	5
chr22	39378403	39388784	APOBEC3B	10381	+	NM_001270411	39378458	39388450	8
chr22	39387563	39394225	APOBEC3B-AS1	6662	-	NR_104187	39394225	39394225	5
chr22	39410264	39414825	APOBEC3C	4561	+	NM_014508	39410367	39414392	4
chr22	39417117	39429256	APOBEC3D	12139	+	NM_152426	39417524	39428321	7
chr22	39436672	39451975	APOBEC3F	15303	+	NM_145298	39436965	39448700	7
chr22	39473009	39483748	APOBEC3G	10739	+	NM_021822	39473366	39483426	8
chr22	39493228	39500072	APOBEC3H	6844	+	NM_001166003	39496283	39498576	6
chr22	39526778	39548538	CBX7	21760	-	NM_175709	39529895	39548449	6
chr22	39619363	39641060	PDGFB	21697	-	NM_002608	39621727	39639968	7
chr22	39708886	39715670	RPL3	6784	-	NM_001033853	39708944	39715602	10
chr22	39709823	39709916	SNORD83B	93	-	NR_000028	39709916	39709916	1
chr22	39711217	39711312	SNORD83A	95	-	NR_000027	39711312	39711312	1
chr22	39712846	39712901	RNU86	55	-	NR_000026	39712901	39712901	1
chr22	39715056	39715118	SNORD43	62	-	NR_002439	39715118	39715118	1
chr22	39745953	39781593	SYNGR1	35640	+	NM_004711	39746015	39777919	4
chr22	39795758	39833132	TAB1	37374	+	NM_153497	39795807	39832576	11
chr22	39828164	39833133	LOC100506472	4969	+	NR_040535	39833133	39833133	3
chr22	39853324	39888199	MGAT3	34875	+	NM_002409	39883352	39884954	2
chr22	39871811	39872827	MGAT3-AS1	1016	-	NR_126469	39872827	39872827	2
chr22	39896104	39914139	MIEF1	18035	+	NM_001304564	39907299	39911378	7
chr22	39916563	39918691	ATF4	2128	+	NM_001675	39917450	39918607	2
chr22	39925097	39928860	RPS19BP1	3763	-	NR_130151	39928860	39928860	5
chr22	39966757	40085740	CACNA1I	118983	+	NM_021096	39966757	40082410	37
chr22	40139048	40289794	ENTHD1	150746	-	NM_152512	40139683	40283752	7
chr22	40297085	40369346	GRAP2	72261	+	NM_004810	40343110	40367088	8
chr22	40390952	40426043	FAM83F	35091	+	NM_138435	40391046	40425569	5
chr22	40428335	40432581	LOC100130899	4246	+	NR_039988	40432581	40432581	1
chr22	40440820	40731812	TNRC6B	290992	+	NM_001024843	40521821	40719245	24
chr22	40742503	40762752	ADSL	20249	+	NM_000026	40742562	40762526	13
chr22	40766565	40806293	SGSM3	39728	+	NM_015705	40796810	40805763	22
chr22	40806284	41032723	MKL1	226439	-	NM_020831	40807393	40859231	15
chr22	40917803	40922711	LOC101927257	4908	+	NR_109965	40922711	40922711	4
chr22	41075181	41078818	MCHR1	3637	+	NM_005297	41075449	41077932	2
chr22	41165633	41215403	SLC25A17	49770	-	NR_104235	41215403	41215403	11
chr22	41209886	41209962	MIR4766	76	-	NR_039923	41209962	41209962	1
chr22	41220538	41253012	ST13	32474	-	NM_001278589	41222541	41252544	12
chr22	41253084	41328823	XPNPEP3	75739	+	NM_022098	41253185	41322439	10
chr22	41255553	41258130	DNAJB7	2577	-	NM_145174	41257068	41257998	1
chr22	41347350	41369019	RBX1	21669	+	NM_014248	41347402	41368492	5
chr22	41469611	41469725	SNORD140	114	-	NR_132979	41469725	41469725	1
chr22	41488516	41488570	MIR1281	54	+	NR_031694	41488570	41488570	1
chr22	41488613	41576081	EP300	87468	+	NM_001429	41489008	41574960	31
chr22	41581218	41593505	EP300-AS1	12287	-	NR_110514	41593505	41593505	3
chr22	41601312	41627275	L3MBTL2	25963	+	NM_031488	41601366	41626255	17
chr22	41625513	41636935	CHADL	11422	-	NM_138481	41625707	41636885	6
chr22	41640780	41698217	RANGAP1	57437	-	NM_001317930	41642606	41677048	16
chr22	41648995	41649054	MIR6889	59	-	NR_106949	41649054	41649054	1
chr22	41697506	41756151	ZC3H7B	58645	+	NM_017590	41716664	41753433	23
chr22	41763336	41795332	TEF	31996	+	NM_001145398	41763536	41791964	4
chr22	41829491	41843027	TOB2	13536	-	NM_016272	41832314	41833349	2
chr22	41855720	41864708	PHF5A	8988	-	NM_032758	41856401	41864657	4
chr22	41865128	41924993	ACO2	59865	+	NM_001098	41865150	41924617	18
chr22	41921805	41940610	POLR3H	18805	-	NM_001282884	41925286	41940105	7
chr22	41957013	41972670	CSDC2	15657	+	NM_014460	41967969	41970899	4
chr22	41972889	41985871	PMM1	12982	-	NM_002676	41973321	41985809	8
chr22	41994031	42017061	DESI1	23030	-	NM_015704	41997100	42016843	6
chr22	42017166	42060052	XRCC6	42886	+	NM_001469	42018008	42059819	13
chr22	42069936	42084913	SNU13	14977	-	NM_005008	42070936	42078362	4
chr22	42086546	42094140	C22orf46	7594	+	NM_001142964	42086631	42089982	2
chr22	42095517	42195459	MEI1	99942	+	NM_152513	42095542	42195303	31
chr22	42196625	42222303	CCDC134	25678	+	NM_024821	42204894	42221827	7
chr22	42229082	42303312	SREBF2	74230	+	NR_103834	42303312	42303312	22
chr22	42296947	42297016	MIR33A	69	+	NR_029507	42297016	42297016	1
chr22	42305557	42310671	SHISA8	5114	-	NM_001207020	42305768	42310671	4
chr22	42319225	42319301	MIR378I	76	-	NR_039760	42319301	42319301	1
chr22	42321035	42322821	TNFRSF13C	1786	-	NM_052945	42321370	42322777	3
chr22	42334724	42343168	CENPM	8444	-	NM_024053	42335059	42343080	6
chr22	42348190	42354946	LINC00634	6756	+	NR_024355	42354946	42354946	2
chr22	42372930	42394225	SEPT3	21295	+	NM_145733	42373068	42392971	11
chr22	42394728	42424477	WBP2NL	29749	+	NM_152613	42394822	42423185	6
chr22	42454337	42466846	NAGA	12509	-	NM_000262	42456282	42466301	9
chr22	42470254	42475442	FAM109B	5188	+	NM_001002034	42473297	42474077	3
chr22	42475694	42480288	SMDT1	4594	+	NM_033318	42475772	42478066	3
chr22	42481529	42486888	NDUFA6	5359	-	NM_002490	42482186	42486826	3
chr22	42486936	42521354	NDUFA6-AS1	34418	+	NR_034118	42521354	42521354	5
chr22	42522500	42526883	CYP2D6	4383	-	NM_000106	42522575	42526793	9
chr22	42522500	42526883	LOC101929829	4383	-	NR_111920	42526883	42526883	9
chr22	42536213	42540576	CYP2D7	4363	-	NR_002570	42540576	42540576	9
chr22	42556018	42679933	TCF20	123915	-	NM_005650	42564658	42611311	6
chr22	42665758	42670868	OGFRP1	5110	+	NR_036498	42670868	42670868	2
chr22	42760405	42765214	LINC01315	4809	-	NR_120597	42765214	42765214	2
chr22	42776413	42828401	NFAM1	51988	-	NM_145912	42781166	42828363	6
chr22	42896584	42908566	SERHL	11982	+	NR_027786	42908566	42908566	11
chr22	42904340	42915829	RRP7A	11489	-	NM_015703	42908915	42915792	7
chr22	42949867	42970388	SERHL2	20521	+	NM_014509	42950026	42970061	12
chr22	42969265	42978017	RRP7BP	8752	-	NR_002184	42978017	42978017	7
chr22	42979726	43010968	POLDIP3	31242	-	NM_032311	42981796	43010863	9
chr22	43011250	43011399	RNU12	149	+	NR_029422	43011399	43011399	1
chr22	43013845	43045405	CYB5R3	31560	-	NM_000398	43015778	43045321	9
chr22	43035808	43036607	ATP5L2	799	-	NM_001165877	43035977	43036280	1
chr22	43088120	43117307	A4GALT	29187	-	NM_001318038	43088895	43089957	3
chr22	43192531	43253408	ARFGAP3	60877	-	NM_014570	43193593	43253188	16
chr22	43265771	43411184	PACSIN2	145413	-	NM_001184970	43267362	43308086	11
chr22	43434590	43448371	LOC100506679	13781	+	NR_125362	43448371	43448371	3
chr22	43435522	43485434	TTLL1	49912	-	NR_027779	43485434	43485434	12
chr22	43506753	43525718	BIK	18965	+	NM_001197	43520028	43525311	5
chr22	43528211	43539403	MCAT	11192	-	NM_173467	43529048	43539354	4
chr22	43547519	43559248	TSPO	11729	+	NM_000714	43555244	43558997	4
chr22	43562627	43583137	TTLL12	20510	-	NM_015140	43564013	43583075	14
chr22	43599228	43739394	SCUBE1	140166	-	NM_173050	43600002	43739267	22
chr22	43808019	43902800	MPPED1	94781	+	NM_001044370	43820991	43901496	7
chr22	43912133	43932485	EFCAB6-AS1	20352	+	NR_046563	43932485	43932485	3
chr22	43924623	44208217	EFCAB6	283594	-	NM_022785	43924732	44178198	32
chr22	44220386	44258378	SULT4A1	37992	-	NM_014351	44221880	44258262	7
chr22	44275557	44287893	PNPLA5	12336	-	NM_138814	44276674	44287760	9
chr22	44319618	44343448	PNPLA3	23830	+	NM_025225	44319791	44342262	9
chr22	44351260	44392412	SAMM50	41152	+	NM_015380	44351457	44392263	15
chr22	44395090	44565112	PARVB	170022	+	NM_001003828	44395220	44564558	14
chr22	44568835	44604349	PARVG	35514	+	NM_001137605	44579209	44602306	14
chr22	44639556	44708731	KIAA1644	69175	-	NM_001099294	44645564	44696825	5
chr22	44839206	44840668	LOC101927526	1462	+	NR_109966	44840668	44840668	3
chr22	44888449	44894005	LDOC1L	5556	-	NM_032287	44892716	44893436	2
chr22	44965219	44968329	LINC00207	3110	+	NR_028409	44968329	44968329	5
chr22	45002207	45021299	LINC00229	19092	-	NR_044991	45021299	45021299	5
chr22	45064426	45133561	PRR5	69135	+	NM_001017528	45098381	45133127	9
chr22	45098077	45258664	PRR5-ARHGAP8	160587	+	NM_181334	45098354	45258475	15
chr22	45148437	45258664	ARHGAP8	110227	+	NM_001017526	45182407	45258475	13
chr22	45277042	45405809	PHF21B	128767	-	NM_001135862	45278965	45405430	14
chr22	45529638	45559662	NUP50-AS1	30024	-	NR_038956	45559662	45559662	3
chr22	45559725	45583890	NUP50	24165	+	NM_007172	45564058	45580536	8
chr22	45588122	45636650	KIAA0930	48528	-	NM_001009880	45593056	45636584	10
chr22	45596834	45596900	MIR1249	66	-	NR_031651	45596900	45596900	1
chr22	45680867	45691755	UPK3A	10888	+	NM_006953	45680894	45691600	6
chr22	45705080	45737836	FAM118A	32756	+	NM_001104595	45718260	45736286	10
chr22	45739944	45809500	SMC1B	69556	-	NM_148674	45740436	45809448	25
chr22	45809571	45828302	RIBC2	18731	+	NM_015653	45809767	45828242	7
chr22	45898718	45997014	FBLN1	98296	+	NM_006486	45898865	45996326	17
chr22	46000311	46001527	LINC01589	1216	-	NR_131244	46001527	46001527	2
chr22	46067677	46241187	ATXN10	173510	+	NM_013236	46067943	46239551	12
chr22	46156403	46156478	MIR4762	75	+	NR_039919	46156478	46156478	1
chr22	46316247	46373008	WNT7B	56761	-	NM_058238	46318735	46372634	4
chr22	46402495	46406657	LOC730668	4162	+	NR_027240	46406657	46406657	1
chr22	46435786	46440748	LINC00899	4962	-	NR_027036	46440748	46440748	4
chr22	46446338	46450024	PRR34	3686	-	NM_018280	46447706	46449973	2
chr22	46449725	46454402	PRR34-AS1	4677	+	NR_027034	46454402	46454402	3
chr22	46481876	46509808	MIRLET7BHG	27932	+	NR_027033	46509808	46509808	6
chr22	46486923	46487006	MIR3619	83	+	NR_037413	46487006	46487006	1
chr22	46508628	46508702	MIRLET7A3	74	+	NR_029478	46508702	46508702	1
chr22	46509445	46509537	MIR4763	92	+	NR_039920	46509537	46509537	1
chr22	46509565	46509648	MIRLET7B	83	+	NR_029479	46509648	46509648	1
chr22	46546498	46639653	PPARA	93155	+	NM_005036	46594280	46631277	9
chr22	46639909	46646193	CDPF1	6284	-	NM_207327	46640988	46644181	4
chr22	46651559	46659219	PKDREJ	7660	-	NM_006071	46652457	46659219	1
chr22	46663860	46689905	TTC38	26045	+	NM_017931	46663936	46688781	14
chr22	46691039	46692557	GTSE1-AS1	1518	-	NR_024009	46692557	46692557	1
chr22	46692637	46726707	GTSE1	34070	+	NM_016426	46693297	46726027	12
chr22	46731297	46753237	TRMU	21940	+	NR_104240	46753237	46753237	11
chr22	46756730	46933067	CELSR1	176337	-	NM_014246	46759074	46933067	35
chr22	47016298	47075688	GRAMD4	59390	+	NM_015124	47022696	47073148	19
chr22	47080306	47134152	CERK	53846	-	NM_022766	47083030	47134045	13
chr22	47158513	47571342	TBC1D22A	412829	+	NM_001284304	47188672	47569269	14
chr22	47309987	47311938	TBC1D22A-AS1	1951	-	NR_122047	47311938	47311938	1
chr22	47857047	47882860	LL22NC03-75H12.2	25813	-	NR_109967	47882860	47882860	3
chr22	48016791	48027318	LINC00898	10527	-	NR_033377	48027318	48027318	6
chr22	48027422	48251349	LOC284930	223927	+	NR_122046	48251349	48251349	9
chr22	48670175	48670227	MIR3201	52	+	NR_036172	48670227	48670227	1
chr22	48885271	49147747	FAM19A5	262476	+	NM_001082967	48885404	49145659	4
chr22	48934711	48943199	LOC284933	8488	-	NR_038917	48943199	48943199	5
chr22	49176106	49176165	MIR4535	59	+	NR_039761	49176165	49176165	1
chr22	49262581	49294198	LINC01310	31617	+	NR_038944	49294198	49294198	7
chr22	49808173	50051190	C22orf34	243017	-	NR_110523	50051190	50051190	5
chr22	49937040	49937114	MIR3667	74	-	NR_037440	49937114	49937114	1
chr22	50166925	50221196	BRD1	54271	-	NM_001304808	50167880	50217965	13
chr22	50247496	50283726	ZBED4	36230	+	NM_014838	50277310	50280826	2
chr22	50296853	50312106	ALG12	15253	-	NM_024105	50297485	50307413	10
chr22	50312277	50321188	CRELD2	8911	+	NM_001135101	50312417	50320955	11
chr22	50354142	50357720	PIM3	3578	+	NM_001001852	50354595	50356775	6
chr22	50356513	50356587	MIR6821	74	+	NR_106879	50356587	50356587	1
chr22	50432941	50451055	IL17REL	18114	-	NM_001001694	50435466	50439619	15
chr22	50497819	50524358	MLC1	26539	-	NM_015166	50500011	50523331	12
chr22	50528434	50600116	MOV10L1	71682	+	NM_018995	50528517	50599878	27
chr22	50609159	50618724	PANX2	9565	+	NR_027691	50618724	50618724	5
chr22	50624359	50638027	TRABD	13668	+	NM_025204	50631489	50636948	10
chr22	50639407	50656045	SELO	16638	+	NM_031454	50639465	50655798	9
chr22	50656117	50683400	TUBGCP6	27283	-	NM_020461	50656164	50682888	25
chr22	50683612	50689834	HDAC10	6222	-	NM_032019	50683935	50689461	20
chr22	50691330	50700188	MAPK12	8858	-	NM_002969	50691829	50699938	12
chr22	50702141	50708822	MAPK11	6681	-	NR_110887	50708822	50708822	13
chr22	50713407	50746001	PLXNB2	32594	-	NM_012401	50714132	50729013	37
chr22	50750391	50765489	DENND6B	15098	-	NM_001001794	50750567	50765417	20
chr22	50781745	50883518	PPP6R2	101773	+	NM_001242898	50832337	50882676	24
chr22	50883430	50913500	SBF1	30070	-	NM_002972	50885570	50913269	41
chr22	50920152	50924866	ADM2	4714	+	NM_001253845	50920276	50921332	3
chr22	50925212	50928750	MIOX	3538	+	NM_017584	50925326	50928285	10
chr22	50941375	50946135	LMF2	4760	-	NM_033200	50941819	50946104	14
chr22	50946644	50963209	NCAPH2	16565	+	NM_001185011	50946766	50961804	20
chr22	50961996	50964868	SCO2	2872	-	NM_001169109	50962039	50962840	2
chr22	50964180	50968514	TYMP	4334	-	NM_001953	50964198	50968138	10
chr22	50968837	50971008	ODF3B	2171	-	NM_001014440	50968908	50970506	7
chr22	50986461	50989452	KLHDC7B	2991	+	NM_138433	50986595	50988380	1
chr22	50989540	51001328	SYCE3	11788	-	NM_001123225	50989673	50994834	3
chr22	51007289	51017096	CPT1B	9807	-	NM_001145135	51007766	51016344	20
chr22	51007289	51021428	CHKB-CPT1B	14139	-	NR_027928	51021428	51021428	30
chr22	51017386	51021428	CHKB	4042	-	NM_005198	51017609	51021210	11
chr22	51021454	51033710	CHKB-AS1	12256	+	NR_110536	51033710	51033710	4
chr22	51039113	51049979	MAPK8IP2	10866	+	NM_012324	51039247	51049207	12
chr22	51061181	51066601	ARSA	5420	-	NM_001085425	51063572	51066207	9
chr22	51113069	51171640	SHANK3	58571	+	NM_033517	51113069	51169740	22
chr22	51176651	51183727	ACR	7076	+	NM_001097	51176663	51183635	5
chr22	51195513	51238065	RPL23AP82	42552	+	NR_026981	51238065	51238065	4
chr22	51205919	51222087	RABL2B	16168	-	NM_001130923	51207203	51220722	10
chrUn_gl000211	48502	93165	FLJ43315	44663	+	NR_033856	93165	93165	7
chrUn_gl000212	24048	60768	FAM230C	36720	+	NR_027278	60768	60768	8
chrUn_gl000213	108006	139339	LOC100288966	31333	-	NM_001257362	108025	139287	11
chrUn_gl000218	38785	97454	LOC100233156	58669	-	NR_037871	97454	97454	5
chrUn_gl000218	46844	55049	LOC389834	8205	-	NR_027420	55049	55049	1
chrUn_gl000219	56348	99642	LOC283788	43294	-	NR_027436	99642	99642	7
chrUn_gl000220	97128	126696	LOC100507412	29568	+	NR_038958	126696	126696	7
chrUn_gl000220	104731	104823	MIR6724-1	92	+	NR_106782	104823	104823	1
chrUn_gl000220	104731	104823	MIR6724-2	92	+	NR_128715	104823	104823	1
chrUn_gl000220	104731	104823	MIR6724-3	92	+	NR_128716	104823	104823	1
chrUn_gl000220	104731	104823	MIR6724-4	92	+	NR_128717	104823	104823	1
chrUn_gl000220	105423	118780	RNA45S5	13357	+	NR_046235	118780	118780	1
chrUn_gl000220	112024	112180	RNA5-8S5	156	+	NR_003285	112180	112180	1
chrUn_gl000227	66129	74245	LINC00266-3	8116	-	NR_109817	74245	74245	3
chrUn_gl000228	112604	114676	DUX4	2072	+	NM_001293798	112604	113879	3
chrUn_gl000241	14738	36767	FRG1CP	22029	-	NR_132315	36767	36767	9
chrUn_gl000241	16024	36957	LOC102723780	20933	-	NR_132320	36957	36957	9
chrX	192990	220022	PLCXD1	27032	+	NR_028057	220022	220022	9
chrX	221416	230887	GTPBP6	9471	-	NM_012227	221740	230887	6
chrX	281384	282054	LINC00685	670	+	NR_027231	282054	282054	1
chrX	294667	347690	PPP2R3B	53023	-	NM_013239	295101	347426	13
chrX	585078	620146	SHOX	35068	+	NM_006883	591632	619564	6
chrX	1314893	1331616	CRLF2	16723	-	NR_110830	1331616	1331616	6
chrX	1387692	1428828	CSF2RA	41136	+	NM_001161529	1401596	1428372	14
chrX	1412810	1412885	MIR3690	75	+	NR_037461	1412885	1412885	1
chrX	1455508	1501582	IL3RA	46074	+	NM_002183	1460658	1501358	12
chrX	1505044	1511039	SLC25A6	5995	-	NM_001636	1505494	1510902	4
chrX	1515917	1518291	LINC00106	2374	+	NR_130733	1518291	1518291	3
chrX	1519423	1534314	ASMTL-AS1	14891	+	NR_026711	1534314	1534314	6
chrX	1522031	1572655	ASMTL	50624	-	NM_001173473	1522161	1561129	13
chrX	1581465	1656037	P2RY8	74572	-	NM_178129	1584371	1585451	2
chrX	1710485	1721411	AKAP17A	10926	+	NM_005088	1712355	1720487	5
chrX	1714347	1761974	ASMT	47627	+	NM_004043	1734092	1761907	10
chrX	2137554	2419015	DHRSX	281461	-	NM_145177	2139081	2418966	7
chrX	2404454	2419008	ZBED1	14554	-	NM_001171136	2406675	2408760	2
chrX	2527231	2527295	MIR6089	64	+	NR_106737	2527295	2527295	1
chrX	2527305	2575270	CD99P1	47965	+	NR_033380	2575270	2575270	9
chrX	2531031	2533388	LINC00102	2357	-	NR_037842	2533388	2533388	2
chrX	2609227	2659350	CD99	50123	+	NM_001277710	2609401	2651405	11
chrX	2670092	2734541	XG	64449	+	NM_001141919	2670315	2732421	11
chrX	2670336	2693037	XGY2	22701	+	NR_003254	2693037	2693037	3
chrX	2746862	2800861	GYG2	53999	+	NM_003918	2748229	2799254	12
chrX	2822010	2847416	ARSD	25406	-	NM_001669	2825311	2847316	10
chrX	2852672	2886351	ARSE	33679	-	NM_001282631	2852872	2886196	10
chrX	2924653	2951426	ARSH	26773	+	NM_001011719	2924653	2951426	9
chrX	2958274	3030770	ARSF	72496	+	NM_001201538	2986141	3030597	11
chrX	3189860	3202694	LINC01546	12834	+	NR_038428	3202694	3202694	3
chrX	3226608	3264684	MXRA5	38076	-	NM_015419	3227756	3261874	7
chrX	3522383	3631675	PRKX	109292	-	NM_005044	3530240	3631294	9
chrX	3577527	3586231	PRKX-AS1	8704	+	NR_046643	3586231	3586231	3
chrX	3735575	3761935	LOC389906	26360	-	NR_034031	3761935	3761935	5
chrX	4545240	4551613	LOC101928201	6373	-	NR_110390	4551613	4551613	3
chrX	5808066	6146923	NLGN4X	338857	-	NM_001282145	5810857	6069507	7
chrX	6301946	6302004	MIR4770	58	-	NR_039927	6302004	6302004	1
chrX	6451658	6453159	VCX3A	1501	-	NM_016379	6451785	6452538	3
chrX	6966960	7066231	PUDP	99271	-	NM_001135565	6968336	7066154	5
chrX	7065900	7065978	MIR4767	78	+	NR_039924	7065978	7065978	1
chrX	7137471	7272682	STS	135211	+	NM_000351	7137716	7268302	10
chrX	7810302	7812184	VCX	1882	+	NM_013452	7811244	7812057	3
chrX	7866803	7895780	PNPLA4	28977	-	NM_001142389	7868726	7894160	7
chrX	8095005	8095102	MIR651	97	+	NR_030380	8095102	8095102	1
chrX	8137984	8139308	VCX2	1324	-	NM_016378	8138072	8138684	3
chrX	8432870	8434551	VCX3B	1681	+	NM_001001888	8433491	8434424	3
chrX	8496914	8700227	ANOS1	203313	-	NM_000216	8501035	8700077	14
chrX	8758836	8769424	FAM9A	10588	-	NM_174951	8759351	8768212	10
chrX	8992272	9002168	FAM9B	9896	-	NM_205849	8993555	9001027	9
chrX	9431334	9687780	TBL1X	256446	+	NM_001139468	9622304	9684286	18
chrX	9693452	9734005	GPR143	40553	-	NM_000273	9693785	9733857	9
chrX	9754495	9917481	SHROOM2	162986	+	NM_001649	9754585	9914977	10
chrX	9935397	9936042	CLDN34	645	+	NM_001195081	9935397	9936042	1
chrX	9983794	10112518	WWC3	128724	+	NM_015691	10031578	10109541	23
chrX	10124984	10205699	CLCN4	80715	+	NM_001830	10153072	10201624	13
chrX	10413349	10851809	MID1	438460	-	NM_033290	10417407	10535587	10
chrX	11129405	11141204	HCCS	11799	+	NM_005333	11130180	11139930	7
chrX	11155662	11683821	ARHGAP6	528159	-	NR_109776	11683821	11683821	15
chrX	11311532	11318881	AMELX	7349	+	NM_182680	11312908	11318732	7
chrX	11776277	11793872	MSL3	17595	+	NM_078629	11776382	11793198	13
chrX	12156584	12742642	FRMPD4	586058	+	NM_014728	12157090	12738652	17
chrX	12809473	12842346	PRPS2	32873	+	NM_001039091	12809616	12840915	7
chrX	12885201	12908480	TLR7	23279	+	NM_016562	12885697	12906777	3
chrX	12920935	12961419	TLR8-AS1	40484	-	NR_030727	12961419	12961419	5
chrX	12924738	12941288	TLR8	16550	+	NM_016610	12928504	12940285	3
chrX	12993225	12995346	TMSB4X	2121	+	NM_021109	12994380	12994930	3
chrX	13053735	13062917	FAM9C	9182	-	NM_174901	13056559	13061908	8
chrX	13328770	13338052	GS1-600G8.3	9282	+	NR_046087	13338052	13338052	17
chrX	13336767	13338518	ATXN3L	1751	-	NM_001135995	13336985	13338053	1
chrX	13353359	13359944	LINC01203	6585	+	NR_045260	13359944	13359944	7
chrX	13587693	13651694	EGFL6	64001	+	NM_001167890	13587980	13651214	12
chrX	13608410	13608465	MIR6086	55	+	NR_106734	13608465	13608465	1
chrX	13671224	13683527	TCEANC	12303	+	NM_001297563	13680627	13681683	5
chrX	13707239	13727944	RAB9A	20705	+	NM_004251	13726865	13727471	3
chrX	13730360	13752754	TRAPPC2	22394	-	NM_001011658	13732525	13738082	6
chrX	13752831	13787480	OFD1	34649	+	NM_003611	13753190	13787227	23
chrX	13792092	13956831	GPM6B	164739	-	NM_001001994	13792662	13956629	7
chrX	14024844	14048035	GEMIN8	23191	-	NM_001042479	14027031	14039597	5
chrX	14262386	14263545	UBE2E4P	1159	+	NR_110506	14263545	14263545	1
chrX	14547419	14749933	GLRA2	202514	+	NM_001171942	14592519	14748607	11
chrX	14861528	14891184	FANCB	29656	-	NM_001018113	14861688	14883632	10
chrX	14891526	14939459	MOSPD2	47933	+	NM_152581	14891650	14937931	15
chrX	15262108	15288589	ASB9	26481	-	NM_001168531	15266836	15287996	8
chrX	15299830	15333746	ASB11	33916	-	NM_001201583	15301626	15333727	7
chrX	15337572	15353676	PIGA	16104	-	NR_033836	15353676	15353676	6
chrX	15363712	15402535	FIGF	38823	-	NM_004469	15364254	15402068	7
chrX	15363712	15509432	PIR-FIGF	145720	-	NR_037859	15509432	15509432	15
chrX	15402923	15511711	PIR	108788	-	NM_003662	15403125	15509380	10
chrX	15518899	15574652	BMX	55753	+	NM_203281	15526476	15574270	19
chrX	15579155	15620192	ACE2	41037	-	NM_021804	15580027	15619034	19
chrX	15621003	15639607	GS1-594A7.3	18604	+	NR_126564	15639607	15639607	2
chrX	15645438	15683154	TMEM27	37716	-	NM_020665	15646093	15682898	6
chrX	15693038	15721474	CA5BP1	28436	+	NR_026551	15721474	15721474	5
chrX	15756411	15805748	CA5B	49337	+	NM_007220	15768146	15800787	8
chrX	15803838	15805712	INE2	1874	-	NR_002725	15805712	15805712	1
chrX	15808573	15841382	ZRSR2	32809	+	NM_005089	15808618	15841365	11
chrX	15843928	15873137	AP1S2	29209	-	NM_001272071	15845447	15870647	6
chrX	16141423	16171641	GRPR	30218	+	NM_005314	16142076	16170768	3
chrX	16185603	16189516	MAGEB17	3913	+	NM_001277307	16188505	16189516	2
chrX	16606121	16731102	CTPS2	124981	-	NM_019857	16608915	16721025	19
chrX	16645134	16645208	MIR548AM	74	-	NR_039762	16645208	16645208	1
chrX	16668280	16672791	S100G	4511	+	NM_004057	16669129	16672632	3
chrX	16737706	16780807	SYAP1	43101	+	NM_032796	16737847	16778482	9
chrX	16804554	16862642	TXLNG	58088	+	NM_018360	16804610	16859889	10
chrX	16862774	16888534	RBBP7	25760	-	NM_002893	16863157	16888176	12
chrX	16964813	17171403	REPS2	206590	+	NM_004726	16964984	17165604	18
chrX	17393542	17754113	NHS	360571	+	NM_001291867	17393880	17750584	9
chrX	17444003	17444077	MIR4768	74	+	NR_039925	17444077	17444077	1
chrX	17570469	17577248	NHS-AS1	6779	-	NR_046632	17577248	17577248	3
chrX	17755568	17773108	SCML1	17540	+	NM_001037540	17762306	17771512	8
chrX	17818168	17879457	RAI2	61289	-	NM_001172743	17818537	17820130	3
chrX	17988292	18122764	LINC01456	134472	-	NR_133641	18122764	18122764	5
chrX	18181050	18239024	BEND2	57974	-	NM_153346	18183128	18238870	14
chrX	18257432	18372844	SCML2	115412	-	NR_033717	18372844	18372844	16
chrX	18443724	18671749	CDKL5	228025	+	NM_003159	18525216	18671664	21
chrX	18657807	18690223	RS1	32416	-	NM_000330	18660123	18690188	6
chrX	18706762	18710806	PPEF1-AS1	4044	-	NR_046642	18710806	18710806	3
chrX	18709044	18846034	PPEF1	136990	+	NM_152224	18725899	18845605	19
chrX	18908413	18913093	PHKA2-AS1	4680	+	NR_029379	18913093	18913093	3
chrX	18910415	19002480	PHKA2	92065	-	NM_000292	18911602	19002050	33
chrX	19007424	19140755	ADGRG2	133331	-	NM_001079858	19008981	19086952	29
chrX	19362010	19379825	PDHA1	17815	+	NM_001173454	19362155	19377771	12
chrX	19378175	19533379	MAP3K15	155204	-	NM_001001671	19378866	19533379	29
chrX	19552082	19905744	SH3KBP1	353662	-	NM_031892	19554534	19905428	18
chrX	19930979	19988382	CXorf23	57403	-	NM_198279	19935422	19988382	11
chrX	20004934	20007897	LOC729609	2963	-	NR_024440	20007897	20007897	2
chrX	20024830	20135114	MAP7D2	110284	-	NM_001168465	20028920	20134997	17
chrX	20035205	20035305	MIR23C	100	-	NR_037414	20035305	20035305	1
chrX	20142635	20159966	EIF1AX	17331	-	NM_001412	20146423	20159758	7
chrX	20154183	20154531	SCARNA9L	348	-	NR_023358	20154531	20154531	1
chrX	20158085	20158562	EIF1AX-AS1	477	+	NR_046592	20158562	20158562	2
chrX	20168028	20284750	RPS6KA3	116722	-	NM_004586	20173515	20284750	22
chrX	21392535	21672813	CNKSR2	280278	+	NM_014927	21393015	21670639	22
chrX	21673466	21676505	KLHL34	3039	-	NM_153270	21673971	21675906	1
chrX	21724089	21776278	SMPX	52189	-	NR_045617	21776278	21776278	6
chrX	21857655	21903541	MBTPS2	45886	+	NM_015884	21857852	21900773	11
chrX	21874104	21876845	YY2	2741	+	NM_206923	21874602	21875721	1
chrX	21958690	22012955	SMS	54265	+	NM_004595	21958942	22012469	11
chrX	22050561	22269427	PHEX	218866	+	NM_000444	22051123	22266070	22
chrX	22180848	22191100	PHEX-AS1	10252	-	NR_046639	22191100	22191100	5
chrX	22277913	23311263	PTCHD1-AS	1033350	-	NR_073010	23311263	23311263	6
chrX	22291029	22292576	ZNF645	1547	+	NM_152577	22291108	22292386	1
chrX	23018077	23020206	DDX53	2129	+	NM_182699	23018174	23020070	1
chrX	23352984	23414918	PTCHD1	61934	+	NM_173495	23352992	23412302	3
chrX	23685644	23704514	PRDX4	18870	+	NM_006406	23685687	23704452	7
chrX	23721776	23761407	ACOT9	39631	-	NM_001037171	23722010	23761261	16
chrX	23801274	23804340	SAT1	3066	+	NR_027783	23804340	23804340	7
chrX	23851464	23926057	APOO	74593	-	NM_024122	23858458	23925819	9
chrX	23926122	23957624	CXorf58	31502	+	NM_001169574	23928419	23957420	9
chrX	24001832	24045303	KLHL15	43471	-	NM_030624	24006037	24024810	4
chrX	24073064	24096927	EIF2S3	23863	+	NM_001415	24073085	24094902	12
chrX	24164341	24167771	ZFX-AS1	3430	-	NR_046657	24167771	24167771	3
chrX	24167761	24234372	ZFX	66611	+	NM_001178095	24190859	24228315	8
chrX	24328978	24331432	SUPT20HL2	2454	-	NM_001136233	24328978	24331432	1
chrX	24380877	24383541	SUPT20HL1	2664	+	NM_001136234	24380877	24383541	1
chrX	24483343	24568583	PDK3	85240	+	NM_001142386	24483572	24557281	12
chrX	24576203	24690979	PCYT1B	114776	-	NM_001163264	24580409	24690749	8
chrX	24668189	24676354	PCYT1B-AS1	8165	+	NR_046638	24676354	24676354	2
chrX	24712063	25015102	POLA1	303039	+	NM_016937	24712078	25014067	37
chrX	24762557	24762687	SCARNA23	130	+	NR_003007	24762687	24762687	1
chrX	25021812	25034065	ARX	12253	-	NM_139058	25022786	25033854	5
chrX	26156459	26158853	MAGEB18	2394	+	NM_173699	26157102	26158134	3
chrX	26210556	26213763	MAGEB6	3207	+	NM_173523	26211963	26213187	2
chrX	26234285	26236387	MAGEB5	2102	+	NM_001271752	26235418	26236246	2
chrX	26576453	26579169	VENTXP1	2716	+	NR_001559	26579169	26579169	1
chrX	27478327	27481458	PPP4R3CP	3131	-	NR_002784	27481458	27481458	1
chrX	27764925	27766938	DCAF8L2	2013	+	NM_001136533	27765012	27766908	1
chrX	27826106	27841131	MAGEB10	15025	+	NM_182506	27839423	27840467	3
chrX	27996109	27999566	DCAF8L1	3457	-	NM_001017930	27997648	27999451	1
chrX	28513671	28513780	MIR6134	109	-	NR_106750	28513780	28513780	1
chrX	28605680	29974017	IL1RAPL1	1368337	+	NM_014271	28807460	29973937	11
chrX	29592394	29592475	MIR4666B	81	+	NR_049877	29592475	29592475	1
chrX	30233674	30238206	MAGEB2	4532	+	NM_002364	30236697	30237657	2
chrX	30248552	30255610	MAGEB3	7058	+	NM_002365	30254041	30255082	5
chrX	30260056	30262308	MAGEB4	2252	+	NM_002367	30260252	30261293	1
chrX	30261847	30270155	MAGEB1	8308	+	NM_002363	30268610	30269654	4
chrX	30322538	30327495	NR0B1	4957	-	NM_000475	30322695	30327480	2
chrX	30576940	30596033	CXorf21	19093	-	NM_025159	30577566	30578472	3
chrX	30671475	30749577	GK	78102	+	NM_001205019	30671654	30746859	21
chrX	30845558	30907511	TAB3	61953	-	NM_152787	30849543	30877705	11
chrX	31089357	31090170	FTHL17	813	-	NM_031894	31089518	31090070	1
chrX	31137344	33357726	DMD	2220382	-	NM_000109	31140035	33357382	79
chrX	32601772	32601869	MIR3915	97	-	NR_037478	32601869	32601869	1
chrX	34147868	34150447	FAM47A	2579	-	NM_203408	34148019	34150395	1
chrX	34645180	34675405	TMEM47	30225	-	NM_031442	34648429	34675146	3
chrX	34960912	34963034	FAM47B	2122	+	NM_152631	34960948	34962886	1
chrX	35816458	35821852	MAGEB16	5394	+	NM_001099921	35820313	35821288	2
chrX	35937850	36403434	CFAP47	465584	+	NM_001304548	35937916	36403121	64
chrX	36383740	36458375	RP11-87M18.2	74635	-	NR_110412	36458375	36458375	8
chrX	37026431	37029739	FAM47C	3308	+	NM_001013736	37026483	37029591	1
chrX	37060954	37061867	FTH1P18	913	-	NM_001271682	37061095	37061761	1
chrX	37208527	37316548	PRRG1	108021	+	NM_000950	37265502	37312874	5
chrX	37430821	37536750	LANCL3	105929	+	NM_198511	37431123	37527684	6
chrX	37545132	37591383	XK	46251	+	NM_021083	37545214	37587715	3
chrX	37639269	37672714	CYBB	33445	+	NM_000397	37639330	37670170	13
chrX	37698088	37706889	DYNLT3	8801	-	NM_006520	37699827	37706763	5
chrX	37850069	37850570	HYPM	501	+	NM_012274	37850092	37850446	1
chrX	37865834	37988073	SYTL5	122239	+	NM_001163335	37893142	37985983	18
chrX	38008587	38080177	SRPX	71590	-	NM_006307	38008963	38080045	10
chrX	38128422	38186788	RPGR	58366	-	NM_000328	38128878	38186620	19
chrX	38211735	38280703	OTC	68968	+	NM_000531	38211949	38280335	10
chrX	38420730	38548172	TSPAN7	127442	+	NM_004615	38420799	38546921	8
chrX	38660500	38663136	MID1IP1-AS1	2636	-	NR_046706	38663136	38663136	2
chrX	38660684	38665783	MID1IP1	5099	+	NM_001098790	38664199	38664751	3
chrX	39164209	39186616	LINC01281	22407	-	NR_038968	39186616	39186616	4
chrX	39226538	39251028	LINC01282	24490	-	NR_110385	39251028	39251028	6
chrX	39520469	39520575	MIR3937	106	+	NR_037501	39520575	39520575	1
chrX	39910498	40036582	BCOR	126084	-	NM_001123383	39911361	39937182	15
chrX	40122169	40146974	LOC101927476	24805	+	NR_110386	40146974	40146974	3
chrX	40440215	40465888	ATP6AP2	25673	+	NM_005765	40440317	40465007	9
chrX	40482817	40483391	MPC1L	574	+	NM_001195522	40482817	40483228	1
chrX	40486172	40506819	CXorf38	20647	-	NM_144970	40489866	40506772	7
chrX	40508794	40594804	MED14	86010	-	NM_004229	40511057	40594664	31
chrX	40594647	40597953	MED14OS	3306	+	NM_001289773	40594700	40597510	2
chrX	40690469	40692449	LOC100132831	1980	-	NR_027761	40692449	40692449	1
chrX	40944887	41095832	USP9X	150945	+	NM_001039591	40982881	41091777	45
chrX	41192560	41223725	DDX3X	31165	+	NR_126093	41223725	41223725	19
chrX	41306712	41334905	NYX	28193	+	NM_022567	41307142	41334152	2
chrX	41374188	41782287	CASK	408099	-	NM_003688	41379672	41782241	27
chrX	41548225	41556530	GPR34	8305	+	NM_001097579	41554886	41556032	3
chrX	41583407	41589388	GPR82	5981	+	NM_080817	41586279	41587290	3
chrX	42636616	42637486	PPP1R2P9	870	-	NR_002191	42637486	42637486	1
chrX	43036242	43085847	LOC101927501	49605	+	NR_110387	43085847	43085847	6
chrX	43514154	43606071	MAOA	91917	+	NM_001270458	43571211	43603760	16
chrX	43625856	43741721	MAOB	115865	-	NM_000898	43626712	43741545	15
chrX	43808023	43832921	NDP	24898	-	NM_000266	43809044	43817891	3
chrX	44007127	44202923	EFHC2	195796	-	NM_025184	44008040	44202834	15
chrX	44382884	44402221	FUNDC1	19337	-	NM_173794	44383443	44402078	5
chrX	44703248	44704134	DUSP21	886	+	NM_022076	44703378	44703951	1
chrX	44732420	44971857	KDM6A	239437	+	NM_001291415	44732797	44970656	30
chrX	45007617	45060146	CXorf36	52529	-	NM_176819	45010896	45060071	5
chrX	45364632	45386484	LINC01204	21852	+	NR_104644	45386484	45386484	4
chrX	45590576	45591246	LOC392452	670	+	NR_102268	45591246	45591246	1
chrX	45605584	45605694	MIR221	110	-	NR_029635	45605694	45605694	1
chrX	45606420	45606530	MIR222	110	-	NR_029636	45606530	45606530	1
chrX	45707508	45710920	LOC401585	3412	-	NR_125365	45710920	45710920	3
chrX	46185358	46187109	LINC01186	1751	-	NR_110388	46187109	46187109	2
chrX	46306623	46334074	KRBOX4	27451	+	NM_001129899	46309895	46330620	7
chrX	46357159	46404892	ZNF674	47733	-	NM_001039891	46359277	46401522	6
chrX	46404924	46407910	ZNF674-AS1	2986	+	NR_015378	46407910	46407910	2
chrX	46433121	46457931	CHST7	24810	+	NM_019886	46433366	46434827	2
chrX	46458685	46618607	SLC9A7	159922	-	NM_032591	46466386	46618464	17
chrX	46696346	46741791	RP2	45445	+	NM_006915	46696535	46739204	5
chrX	46746853	46759139	LINC01545	12286	-	NR_046101	46759139	46759139	4
chrX	46771710	46920641	JADE3	148931	+	NM_001077445	46844295	46918479	11
chrX	46937753	46952713	RGN	14960	+	NM_152869	46940543	46952346	8
chrX	47001614	47004609	NDUFB11	2995	-	NM_019056	47001715	47004078	3
chrX	47004616	47046214	RBM10	41598	+	NM_001204467	47006880	47045998	24
chrX	47050198	47074527	UBA1	24329	+	NM_153280	47058201	47074328	26
chrX	47064246	47065254	INE1	1008	+	NR_024616	47065254	47065254	1
chrX	47077527	47089394	CDK16	11867	+	NM_033018	47078051	47088167	16
chrX	47092313	47107727	USP11	15414	+	NM_004651	47092313	47107329	21
chrX	47229998	47273098	ZNF157	43100	+	NM_003446	47230067	47272993	4
chrX	47248048	47248175	SNORA11C	127	+	NR_003710	47248175	47248175	1
chrX	47305560	47342345	ZNF41	36785	-	NM_007130	47306828	47326880	5
chrX	47342114	47344626	LINC01560	2512	+	NR_126059	47344626	47344626	1
chrX	47420498	47431320	ARAF	10822	+	NM_001654	47422366	47430856	16
chrX	47431299	47479256	SYN1	47957	-	NM_006950	47432262	47479127	13
chrX	47441689	47446190	TIMP1	4501	+	NM_003254	47442814	47446090	6
chrX	47446827	47446904	MIR4769	77	+	NR_039926	47446904	47446904	1
chrX	47483611	47489704	CFP	6093	-	NM_002621	47483673	47489243	10
chrX	47494918	47510003	ELK1	15085	-	NM_001114123	47496227	47500840	7
chrX	47511190	47518579	UXT	7389	-	NR_045560	47518579	47518579	8
chrX	47518231	47519510	UXT-AS1	1279	+	NR_028119	47519510	47519510	2
chrX	47566589	47596027	CXXC1P1	29438	+	NR_033924	47596027	47596027	4
chrX	47696300	47781655	ZNF81	85355	+	NM_007137	47705666	47776031	5
chrX	47834249	47863394	ZNF182	29145	-	NM_001178099	47835565	47847995	7
chrX	47863733	47869126	SPACA5	5393	+	NM_205856	47867200	47869042	5
chrX	47867169	47869126	SPACA5B	1957	+	NM_001079900	47867200	47869042	4
chrX	47915698	47925970	ZNF630-AS1	10272	+	NR_046742	47925970	47925970	2
chrX	47917566	47931025	ZNF630	13459	-	NM_001190255	47917856	47926274	5
chrX	47967366	47980068	SSX6	12702	+	NR_028366	47980068	47980068	8
chrX	48045655	48056199	SSX5	10544	-	NM_021015	48047066	48054794	9
chrX	48114751	48126879	SSX1	12128	+	NM_001278691	48116676	48125822	9
chrX	48160984	48165614	SSX9	4630	-	NR_073393	48165614	48165614	5
chrX	48205862	48216188	SSX3	10326	-	NM_021014	48206938	48214684	8
chrX	48261523	48271344	SSX4	9821	-	NM_005636	48262897	48270814	8
chrX	48261523	48271355	SSX4B	9832	-	NM_001034832	48262897	48270814	8
chrX	48316919	48328644	SLC38A5	11725	-	NM_033518	48317318	48326311	17
chrX	48334408	48344752	FTSJ1	10344	+	NM_177439	48336435	48341406	14
chrX	48367346	48379202	PORCN	11856	+	NM_203475	48368208	48378864	15
chrX	48380163	48387104	EBP	6941	+	NM_006579	48382159	48386845	5
chrX	48398074	48420997	TBC1D25	22923	+	NM_002536	48398185	48419363	6
chrX	48432740	48439553	RBM3	6813	+	NM_006743	48433568	48435474	7
chrX	48455879	48463582	WDR13	7703	+	NR_029427	48463582	48463582	9
chrX	48542185	48549817	WAS	7632	+	NM_000377	48542242	48549553	12
chrX	48553944	48567406	SUV39H1	13462	+	NM_001282166	48554210	48565961	6
chrX	48620153	48632064	GLOD5	11911	+	NM_001080489	48620194	48631851	4
chrX	48644981	48652717	GATA1	7736	+	NM_002049	48649516	48652571	6
chrX	48660486	48683380	HDAC6	22894	+	NM_006044	48661099	48683022	29
chrX	48684922	48688279	ERAS	3357	+	NM_181532	48687533	48688235	2
chrX	48689501	48694040	PCSK1N	4539	-	NM_013271	48689669	48693934	3
chrX	48750729	48755426	TIMM17B	4697	-	NM_001167947	48751011	48755032	8
chrX	48755194	48760422	PQBP1	5228	+	NM_001167989	48755792	48760361	7
chrX	48760456	48769235	SLC35A2	8779	-	NM_005660	48760714	48768913	5
chrX	48770458	48776413	PIM2	5955	-	NM_006875	48771407	48776111	6
chrX	48779302	48815648	OTUD5	36346	-	NM_001136159	48780450	48801487	9
chrX	48818638	48828251	KCND1	9613	-	NM_004979	48819841	48826678	6
chrX	48830130	48858675	GRIPAP1	28545	-	NM_020137	48830604	48858640	26
chrX	48886237	48901043	TFE3	14806	-	NM_001282142	48887668	48896850	10
chrX	48910960	48927510	CCDC120	16550	+	NM_001271836	48919807	48925648	10
chrX	48928812	48931704	PRAF2	2892	-	NM_007213	48929527	48931646	3
chrX	48932091	48958059	WDR45	25968	-	NM_007075	48932461	48935754	12
chrX	48970322	48980151	GPKOW	9829	-	NM_015698	48970558	48980072	11
chrX	49019180	49024495	MAGIX	5315	+	NM_024859	49019227	49022738	6
chrX	49028183	49031468	PLP2	3285	+	NM_002668	49028347	49031043	5
chrX	49031150	49042853	PRICKLE3	11703	-	NM_006150	49032021	49042750	9
chrX	49044264	49056661	SYP	12397	-	NM_003179	49047893	49056645	7
chrX	49055297	49058913	SYP-AS1	3616	+	NR_046649	49058913	49058913	2
chrX	49061522	49089833	CACNA1F	28311	-	NM_001256789	49061596	49089771	48
chrX	49091926	49106987	CCDC22	15061	+	NM_014008	49092096	49106722	17
chrX	49106896	49121288	FOXP3	14392	-	NM_014009	49107794	49114962	12
chrX	49126305	49144555	PPP1R3F	18250	+	NM_033215	49126332	49143552	4
chrX	49160124	49176323	GAGE10	16199	+	NM_001098413	49161338	49176229	5
chrX	49178508	49294588	GAGE12J	116080	+	NM_001098406	49179672	49294494	5
chrX	49188080	49294588	GAGE13	106508	+	NM_001098412	49189215	49294494	5
chrX	49188103	49313700	GAGE8	125597	+	NM_012196	49189215	49313606	5
chrX	49197562	49223943	GAGE2D	26381	+	NM_001098407	49198718	49223849	5
chrX	49197581	49313700	GAGE2A	116119	+	NM_001127212	49198718	49313606	5
chrX	49216647	49294598	GAGE2C	77951	+	NM_001472	49236830	49294494	5
chrX	49216648	49223939	GAGE4	7291	+	NM_001474	49217770	49223849	5
chrX	49216656	49223943	GAGE5	7287	+	NM_001475	49217770	49223849	5
chrX	49216658	49304144	GAGE2E	87486	+	NM_001127200	49236830	49304050	5
chrX	49216677	49223939	GAGE7	7262	+	NM_021123	49217770	49223849	5
chrX	49235707	49242997	GAGE2B	7290	+	NM_001098411	49236830	49242922	5
chrX	49296779	49304144	GAGE12H	7365	+	NM_001098410	49297934	49304050	5
chrX	49296814	49304080	GAGE12B	7266	+	NM_001127345	49297934	49304050	5
chrX	49325410	49332811	GAGE12F	7401	+	NM_001098405	49326599	49332717	5
chrX	49325433	49332821	GAGE12D	7388	+	NM_001127199	49326599	49332717	5
chrX	49325444	49332811	GAGE12C	7367	+	NM_001098408	49326599	49332717	5
chrX	49325444	49332811	GAGE12E	7367	+	NM_001098418	49326599	49332717	5
chrX	49325444	49332811	GAGE12G	7367	+	NM_001098409	49326599	49332717	5
chrX	49325479	49332807	GAGE6	7328	+	NM_001476	49326599	49332717	5
chrX	49325506	49332811	GAGE12I	7305	+	NM_001477	49326599	49332717	5
chrX	49363615	49373139	GAGE1	9524	+	NR_102272	49373139	49373139	6
chrX	49452053	49460596	PAGE1	8543	-	NM_003785	49452143	49459373	6
chrX	49593905	49598637	PAGE4	4732	+	NM_007003	49595031	49598465	5
chrX	49641326	49643959	USP27X-AS1	2633	-	NR_026742	49643959	49643959	2
chrX	49644469	49647168	USP27X	2699	+	NM_001145073	49644910	49646227	1
chrX	49687224	49863892	CLCN5	176668	+	NM_001127898	49689908	49856876	15
chrX	49767753	49767844	MIR532	91	+	NR_030241	49767844	49767844	1
chrX	49768108	49768194	MIR188	86	+	NR_029708	49768194	49768194	1
chrX	49773038	49773122	MIR500A	84	+	NR_030224	49773122	49773122	1
chrX	49773571	49773635	MIR362	64	+	NR_029850	49773635	49773635	1
chrX	49774329	49774413	MIR501	84	+	NR_030225	49774413	49774413	1
chrX	49775279	49775358	MIR500B	79	+	NR_036257	49775358	49775358	1
chrX	49777848	49777945	MIR660	97	+	NR_030397	49777945	49777945	1
chrX	49779205	49779291	MIR502	86	+	NR_030226	49779291	49779291	1
chrX	49955410	49965664	AKAP4	10254	-	NM_003886	49955602	49965540	6
chrX	50027539	50094911	CCNB3	67372	+	NM_033031	50028163	50094702	12
chrX	50108405	50213737	DGKK	105332	-	NM_001013742	50111938	50213677	28
chrX	50334642	50557044	SHROOM4	222402	-	NR_027121	50557044	50557044	10
chrX	50653734	50659641	BMP15	5907	+	NM_005448	50653783	50659607	2
chrX	50838681	50914232	LINC01284	75551	-	NR_110382	50914232	50914232	9
chrX	51075082	51080377	NUDT10	5295	+	NM_153183	51075817	51079091	3
chrX	51149766	51151689	CXorf67	1923	+	NM_203407	51149868	51151380	1
chrX	51232862	51239459	NUDT11	6597	-	NM_018159	51234600	51239296	2
chrX	51242760	51250293	LINC01496	7533	-	NR_110654	51250293	51250293	5
chrX	51424145	51425447	CENPVP1	1302	-	NR_033772	51425447	51425447	1
chrX	51424145	51425447	CENPVP2	1302	-	NR_033773	51425447	51425447	1
chrX	51486480	51489326	GSPT2	2846	+	NM_018094	51486722	51488609	1
chrX	51546154	51645450	MAGED1	99296	+	NM_001005332	51637400	51645026	13
chrX	51804922	51812368	MAGED4B	7446	-	NM_001242362	51805124	51811268	14
chrX	51806442	51806569	SNORA11D	127	-	NR_003711	51806569	51806569	1
chrX	51806442	51806569	SNORA11E	127	-	NR_102368	51806569	51806569	1
chrX	51927918	51935366	MAGED4	7448	+	NM_001272061	51929018	51935162	14
chrX	52079698	52079784	MIR8088	86	-	NR_107055	52079784	52079784	1
chrX	52112152	52118826	XAGE2	6674	+	NM_130777	52113157	52118734	5
chrX	52238809	52243953	XAGE1B	5144	+	NM_001097594	52240503	52243866	4
chrX	52238809	52243953	XAGE1E	5144	+	NM_001097604	52240503	52243866	4
chrX	52651984	52662998	SSX8	11014	+	NR_027250	52662998	52662998	8
chrX	52673110	52683950	SSX7	10840	-	NM_173358	52674492	52682522	8
chrX	52780279	52790617	SSX2	10338	+	NM_003147	52781757	52789480	9
chrX	52780280	52790617	SSX2B	10337	+	NM_001278702	52781757	52789521	9
chrX	52825185	52826388	SPANXN5	1203	-	NM_001009616	52825527	52826388	2
chrX	52841227	52847322	XAGE5	6095	+	NM_130775	52841590	52847237	5
chrX	52891557	52897119	XAGE3	5562	-	NM_133179	52891646	52896164	5
chrX	52928408	52937585	FAM156B	9177	+	NM_001099684	52936252	52936894	3
chrX	52976463	53024651	FAM156A	48188	-	NM_001242492	52977154	52977796	5
chrX	53078505	53109796	GPR173	31291	+	NM_018969	53105803	53106925	2
chrX	53111541	53117728	TSPYL2	6187	+	NM_022117	53111680	53117121	7
chrX	53123338	53173249	KANTR	49911	+	NR_110456	53173249	53173249	3
chrX	53220502	53254604	KDM5C	34102	-	NM_001282622	53222148	53254071	26
chrX	53224592	53224670	MIR6895	78	-	NR_106955	53224670	53224670	1
chrX	53228070	53228127	MIR6894	57	-	NR_106954	53228127	53228127	1
chrX	53262057	53350522	IQSEC2	88465	-	NM_001111125	53263400	53350321	15
chrX	53401069	53449677	SMC1A	48608	-	NM_001281463	53407023	53448887	26
chrX	53432604	53432697	MIR6857	93	-	NR_106916	53432697	53432697	1
chrX	53449804	53458068	RIBC1	8264	+	NM_001031745	53453224	53457936	8
chrX	53458205	53461323	HSD17B10	3118	-	NM_001037811	53458351	53461292	6
chrX	53559056	53713674	HUWE1	154618	-	NM_031407	53560269	53681051	84
chrX	53583183	53583302	MIR98	119	-	NR_029513	53583302	53583302	1
chrX	53584152	53584235	MIRLET7F2	83	-	NR_029484	53584235	53584235	1
chrX	53963112	54071569	PHF8	108457	-	NM_001184896	53965590	54071323	22
chrX	54094756	54209714	FAM120C	114958	-	NM_001300788	54099656	54209631	14
chrX	54219255	54384438	WNK3	165183	-	NM_020922	54224756	54360106	24
chrX	54466852	54471731	TSR2	4879	+	NM_058163	54466854	54470983	5
chrX	54471886	54522599	FGD1	50713	-	NM_004463	54472541	54521865	18
chrX	54556643	54593720	GNL3L	37077	+	NM_019067	54558999	54587035	16
chrX	54775331	54824673	ITIH6	49342	-	NM_198510	54776327	54824643	13
chrX	54834031	54842448	MAGED2	8417	+	NM_177433	54835764	54842115	13
chrX	54840802	54840933	SNORA11	131	+	NR_002953	54840933	54840933	1
chrX	54946995	54957866	TRO	10871	+	NR_073148	54957866	54957866	14
chrX	54959566	55024967	PFKFB1	65401	-	NM_001271805	54959835	55024866	13
chrX	55026755	55034306	APEX2	7551	+	NM_014481	55026855	55033868	6
chrX	55035487	55057497	ALAS2	22010	-	NM_000032	55035612	55052433	11
chrX	55101488	55105336	PAGE2B	3848	+	NM_001015038	55102474	55105231	5
chrX	55115484	55119269	PAGE2	3785	+	NM_207339	55116453	55119164	5
chrX	55169534	55187628	FAM104B	18094	-	NM_138362	55170211	55187589	4
chrX	55207823	55208944	MTRNR2L10	1121	-	NM_001190708	55208352	55208427	1
chrX	55209914	55210040	SNORA109	126	-	NR_132964	55210040	55210040	1
chrX	55246779	55250541	PAGE5	3762	+	NM_001013435	55247815	55250436	5
chrX	55284848	55291349	PAGE3	6501	-	NM_001303613	55284938	55290336	5
chrX	55306520	55315219	LOC100421746	8699	+	NR_130179	55315219	55315219	5
chrX	55477927	55478015	MIR4536-1	88	-	NR_039764	55478015	55478015	1
chrX	55477927	55478015	MIR4536-2	88	+	NR_130469	55478015	55478015	1
chrX	55478521	55480001	MAGEH1	1480	+	NM_014061	55478807	55479467	1
chrX	55511048	55515631	USP51	4583	-	NM_201286	55513236	55515372	2
chrX	55649832	55652621	FOXR2	2789	+	NM_198451	55650144	55651080	1
chrX	55744109	55785207	RRAGB	41098	+	NM_016656	55744760	55784776	11
chrX	56258821	56314322	KLF8	55501	+	NM_007250	56259767	56310927	6
chrX	56590025	56593443	UBQLN2	3418	+	NM_013444	56590306	56592181	1
chrX	56755717	56844004	LINC01420	88287	+	NR_015367	56844004	56844004	3
chrX	56763220	56764017	UQCRBP1	797	-	NR_002308	56764017	56764017	1
chrX	57002802	57021988	SPIN3	19186	-	NR_027139	57021988	57021988	5
chrX	57146114	57147989	SPIN2B	1875	-	NM_001282461	57146285	57147062	3
chrX	57162082	57164058	SPIN2A	1976	-	NM_019003	57162253	57163030	2
chrX	57313109	57515629	FAAH2	202520	+	NM_174912	57313258	57515365	11
chrX	57618268	57623910	ZXDB	5642	+	NM_007157	57618481	57620893	1
chrX	57931863	57937067	ZXDA	5204	-	NM_007156	57934454	57936854	1
chrX	62567106	62571218	SPIN4	4112	-	NM_001012968	62569948	62570698	1
chrX	62646438	62780873	LINC01278	134435	-	NR_015353	62780873	62780873	4
chrX	62854847	63005426	ARHGEF9	150579	-	NM_001173479	62857907	63005025	9
chrX	62890075	62891382	ARHGEF9-IT1	1307	-	NR_046803	62891382	62891382	2
chrX	63005881	63005967	MIR1468	86	-	NR_031567	63005967	63005967	1
chrX	63404996	63425624	AMER1	20628	-	NM_152424	63409758	63413166	2
chrX	63444071	63450511	ASB12	6440	-	NM_130388	63444214	63445530	3
chrX	63487960	63615333	MTMR8	127373	-	NM_017677	63488416	63615243	14
chrX	64135681	64254624	ZC4H2	118943	-	NM_001178032	64137662	64141852	5
chrX	64708614	64727767	ZC3H12B	19153	+	NM_001010888	64708681	64723089	5
chrX	64732461	64754686	LAS1L	22225	-	NM_031206	64732654	64754595	14
chrX	64770501	64772301	FRMD8P1	1800	-	NR_033742	64772301	64772301	1
chrX	64887510	64961793	MSN	74283	+	NM_002444	64887708	64959755	13
chrX	65238711	65238821	MIR223	110	+	NR_029637	65238821	65238821	1
chrX	65241579	65259967	VSIG4	18388	-	NM_007268	65242104	65259840	8
chrX	65382390	65487230	HEPH	104840	+	NM_138737	65382569	65486514	21
chrX	65815481	65859140	EDA2R	43659	-	NM_001199687	65819325	65835862	7
chrX	66763873	66950461	AR	186588	+	NM_000044	66764988	66943683	8
chrX	67262185	67653299	OPHN1	391114	-	NM_002547	67268265	67652862	25
chrX	67718623	67757127	YIPF6	38504	+	NM_173834	67718908	67751841	7
chrX	67867510	67945684	STARD8	78174	+	NM_001142503	67867724	67944264	15
chrX	68048839	68062006	EFNB1	13167	+	NM_004429	68049619	68060497	5
chrX	68380580	68385365	PJA1	4785	-	NM_022368	68381149	68383081	3
chrX	68399399	68429767	LINC00269	30368	+	NR_103715	68429767	68429767	5
chrX	68725077	68752351	FAM155B	27274	+	NM_015686	68725125	68749799	3
chrX	68835910	69259321	EDA	423411	+	NM_001399	68836152	69255459	8
chrX	69242706	69242773	MIR676	67	+	NR_037494	69242773	69242773	1
chrX	69260391	69269788	AWAT2	9397	-	NM_001002254	69261657	69269782	8
chrX	69282340	69284029	OTUD6A	1689	+	NM_207320	69282374	69283241	1
chrX	69353317	69386173	IGBP1	32856	+	NM_001551	69353797	69385831	7
chrX	69397332	69425553	DGAT2L6	28221	+	NM_198512	69397432	69424956	7
chrX	69454504	69460511	AWAT1	6007	+	NM_001013579	69454545	69460140	7
chrX	69478015	69479654	P2RY4	1639	-	NM_002565	69478376	69479474	1
chrX	69488184	69501690	ARR3	13506	+	NM_004312	69489235	69501616	17
chrX	69502021	69504852	RAB41	2831	+	NM_001032726	69502067	69504493	8
chrX	69506210	69509798	PDZD11	3588	-	NM_016484	69506931	69509191	7
chrX	69509878	69640774	KIF4A	130896	+	NM_012310	69510308	69640115	31
chrX	69642880	69653241	GDPD2	10361	+	NM_001171192	69644834	69652936	17
chrX	69664704	69725339	DLG3	60635	+	NM_021120	69665051	69722119	19
chrX	69672805	69675844	DLG3-AS1	3039	-	NR_109801	69675844	69675844	2
chrX	69748789	70128567	TEX11	379778	-	NM_001003811	69748944	70117396	31
chrX	70145429	70150975	SLC7A3	5546	-	NM_032803	70145662	70149847	12
chrX	70279096	70293276	SNX12	14180	-	NM_001256185	70280865	70288156	5
chrX	70315998	70323384	FOXO4	7386	+	NM_001170931	70316378	70321934	4
chrX	70323738	70326638	CXorf65	2900	-	NM_001025265	70323836	70326406	6
chrX	70327253	70331481	IL2RG	4228	-	NM_000206	70327585	70331389	8
chrX	70338405	70362304	MED12	23899	+	NM_005120	70338604	70362068	45
chrX	70364680	70391051	NLGN3	26371	+	NM_181303	70367599	70389947	8
chrX	70430034	70948962	BCYRN1	518928	-	NR_001568	70948962	70948962	4
chrX	70435061	70445065	GJB1	10004	+	NM_001097642	70443557	70444409	2
chrX	70459473	70475047	ZMYM3	15574	-	NM_001171162	70460765	70473105	25
chrX	70503041	70521018	NONO	17977	+	NM_001145408	70510487	70519926	13
chrX	70521597	70525221	ITGB1BP2	3624	+	NM_012278	70521656	70525042	11
chrX	70586088	70750211	TAF1	164123	+	NR_104394	70750211	70750211	40
chrX	70711530	70712299	INGX	769	-	NR_002226	70712299	70712299	1
chrX	70752911	70795747	OGT	42836	+	NM_181673	70753149	70793644	22
chrX	70797873	70833433	ACRC	35560	+	NM_052957	70800671	70832832	13
chrX	70835765	70838367	CXCR3	2602	-	NM_001504	70836214	70838299	2
chrX	70917045	70923256	LINC00891	6211	+	NR_034005	70923256	70923256	3
chrX	70917045	70923256	LOC100132741	6211	+	NR_034004	70923256	70923256	3
chrX	70983139	70987051	CXorf49B	3912	+	NM_001145139	70983273	70986773	6
chrX	70983139	70987051	CXorf49	3912	+	NM_001145140	70983273	70986773	6
chrX	71130937	71363424	NHSL2	232487	+	NM_001013627	71130937	71363424	8
chrX	71264258	71264811	RPS26P11	553	+	NR_002309	71264811	71264811	1
chrX	71346960	71351751	RGAG4	4791	-	NM_001024455	71349680	71351390	2
chrX	71364033	71381600	FLJ44635	17567	+	NM_207422	71364381	71380102	2
chrX	71401525	71483814	PIN4	82289	+	NM_001170747	71401560	71482646	4
chrX	71424506	71458858	ERCC6L	34352	-	NM_017669	71424863	71458761	2
chrX	71492452	71497141	RPS4X	4689	-	NM_001007	71492520	71497045	7
chrX	71521487	71527037	CITED1	5550	-	NM_001144886	71521572	71522719	3
chrX	71549365	71792953	HDAC8	243588	-	NM_018486	71549903	71792611	11
chrX	71798663	71934029	PHKA1	135366	-	NM_002637	71800851	71933728	32
chrX	71908798	71932190	LOC101928259	23392	+	NR_110391	71932190	71932190	5
chrX	72001688	72002484	LINC00684	796	-	NR_120499	72002484	72002484	3
chrX	72001688	72002484	LOC100132304	796	-	NR_120493	72002484	72002484	3
chrX	72091858	72095622	DMRTC1B	3764	-	NM_001080851	72092285	72095528	6
chrX	72091858	72095622	DMRTC1	3764	-	NM_033053	72092285	72095528	6
chrX	72161567	72163589	FAM226A	2022	-	NR_026595	72163589	72163589	1
chrX	72161567	72163589	FAM226B	2022	-	NR_026594	72163589	72163589	1
chrX	72218226	72222695	PABPC1L2B-AS1	4469	-	NR_110398	72222695	72222695	4
chrX	72223351	72225551	PABPC1L2B	2200	+	NM_001042506	72223481	72224084	1
chrX	72297176	72299351	PABPC1L2A	2175	-	NM_001012977	72298622	72299225	1
chrX	72345875	72347919	NAP1L6	2044	-	NR_027291	72347919	72347919	1
chrX	72432136	72434710	NAP1L2	2574	-	NM_021963	72432945	72434328	1
chrX	72667089	72674421	CDX4	7332	+	NM_005193	72667089	72674421	3
chrX	72744110	72782921	MAP2K4P1	38811	-	NR_029423	72782921	72782921	2
chrX	72782983	72906944	CHIC1	123961	+	NM_001300884	72783120	72900840	5
chrX	73012039	73049066	TSIX	37027	+	NR_003255	73049066	73049066	1
chrX	73040485	73072588	XIST	32103	-	NR_001564	73072588	73072588	6
chrX	73164158	73290217	JPX	126059	+	NR_024582	73290217	73290217	5
chrX	73247970	73513409	FTX	265439	-	NR_028379	73513409	73513409	7
chrX	73438211	73438296	MIR421	85	-	NR_030398	73438296	73438296	1
chrX	73438381	73438453	MIR374B	72	-	NR_030620	73438453	73438453	1
chrX	73438383	73438453	MIR374C	70	+	NR_037511	73438453	73438453	1
chrX	73506938	73507044	MIR545	106	-	NR_030258	73507044	73507044	1
chrX	73507120	73507192	MIR374A	72	-	NR_030785	73507192	73507192	1
chrX	73524024	73524869	ZCCHC13	845	+	NM_203303	73524101	73524602	1
chrX	73641327	73753764	SLC16A2	112437	+	NM_006517	73641472	73751388	6
chrX	73802810	73834461	RLIM	31651	-	NM_183353	73811274	73815812	5
chrX	73952690	74145287	KIAA2022	192597	-	NM_001008537	73959239	73965485	4
chrX	74273006	74376175	ABCB7	103169	-	NM_004299	74273204	74376107	16
chrX	74493893	74524732	UPRT	30839	+	NR_030774	74524732	74524732	8
chrX	74588261	74743337	ZDHHC15	155076	-	NM_144969	74598986	74742859	12
chrX	74960372	74962914	TTC3P1	2542	-	NR_030737	74962914	74962914	1
chrX	75002822	75005079	MAGEE2	2257	-	NM_138703	75003314	75004886	1
chrX	75392763	75398145	PBDC1	5382	+	NM_001300888	75392973	75397852	5
chrX	75648045	75651746	MAGEE1	3701	+	NM_020932	75648323	75651197	1
chrX	75878198	76234957	MIR325HG	356759	-	NR_110403	76234957	76234957	4
chrX	76139697	76139785	MIR384	88	-	NR_029909	76139785	76139785	1
chrX	76225828	76225926	MIR325	98	-	NR_029905	76225926	76225926	1
chrX	76709646	76712013	FGF16	2367	+	NM_003868	76709646	76712013	2
chrX	76760355	77041755	ATRX	281400	-	NM_000489	76763828	77041487	35
chrX	77081861	77151065	MAGT1	69204	-	NM_032121	77084716	77151003	10
chrX	77154960	77160881	COX7B	5921	+	NM_001866	77155050	77160758	3
chrX	77166152	77305892	ATP7A	139740	+	NM_000052	77227138	77302067	23
chrX	77223457	77225135	PGAM4	1678	-	NM_001029891	77224370	77225135	1
chrX	77359665	77382324	PGK1	22659	+	NM_000291	77359837	77381327	11
chrX	77385244	77395179	TAF9B	9935	-	NM_015975	77387106	77395108	7
chrX	77526968	77583188	CYSLTR1	56220	-	NM_001282188	77528229	77529243	4
chrX	77911565	77914825	ZCCHC5	3260	-	NM_152694	77912489	77913917	2
chrX	78003205	78012578	LPAR4	9373	+	NM_005296	78010366	78011479	2
chrX	78156690	78156746	MIR4328	56	-	NR_036258	78156746	78156746	1
chrX	78200828	78217438	P2RY10	16610	+	NM_014499	78216017	78217037	4
chrX	78426468	78427726	GPR174	1258	+	NM_032553	78426504	78427506	1
chrX	78615880	78623049	ITM2A	7169	-	NM_004867	78616585	78622712	6
chrX	79270254	79287268	TBX22	17014	+	NM_001109878	79277768	79286610	9
chrX	79483987	79590817	CHMP1B2P	106830	-	NR_110646	79590817	79590817	6
chrX	79591002	79700810	FAM46D	109808	+	NM_001170574	79698038	79699208	5
chrX	79924986	80065233	BRWD3	140247	-	NM_153252	79932107	80064970	41
chrX	80369199	80457441	HMGN5	88242	-	NM_030763	80370147	80377048	7
chrX	80457302	80554046	SH3BGRL	96744	+	NM_003022	80457699	80552726	4
chrX	82763268	82764775	POU3F4	1507	+	NM_000307	82763332	82764418	1
chrX	83116133	83141708	CYLC1	25575	+	NM_021118	83116190	83141592	5
chrX	83313353	83442943	RPS6KA6	129590	-	NM_014496	83319284	83442907	22
chrX	83572881	83757487	HDX	184606	-	NM_001177479	83576896	83730405	11
chrX	84189156	84189896	UBE2DNL	740	+	NR_024062	84189896	84189896	1
chrX	84258897	84348323	APOOL	89426	+	NM_198450	84258918	84342684	9
chrX	84347291	84363974	SATL1	16683	-	NM_001012980	84347544	84363974	5
chrX	84465711	84474295	LOC101928128	8584	+	NR_110651	84474295	84474295	4
chrX	84498996	84528368	ZNF711	29372	+	NM_021998	84502578	84526834	9
chrX	84532394	84634748	POF1B	102354	-	NM_024921	84534426	84634459	17
chrX	85090784	85090863	MIR1321	79	+	NR_031710	85090863	85090863	1
chrX	85116184	85302566	CHM	186382	-	NM_000390	85119634	85302536	15
chrX	85158640	85158712	MIR361	72	-	NR_029848	85158712	85158712	1
chrX	85403454	86087605	DACH2	684151	+	NM_001139514	85403624	86082773	12
chrX	86772714	86925050	KLHL4	152336	+	NM_019117	86772896	86921534	11
chrX	88002225	88009785	CPXCR1	7560	+	NM_033048	88008415	88009321	3
chrX	89176939	89177882	TGIF2LX	943	+	NM_138960	89177084	89177810	2
chrX	90669901	90689998	PABPC5-AS1	20097	-	NR_110659	90689998	90689998	4
chrX	90689596	90693583	PABPC5	3987	+	NM_080832	90690576	90691725	2
chrX	91090459	91878228	PCDH11X	787769	+	NM_001168361	91090503	91723315	7
chrX	92925924	92928682	NAP1L3	2758	-	NM_004538	92926782	92928303	1
chrX	92929011	92967273	FAM133A	38262	+	NM_001171110	92964418	92965165	5
chrX	95592084	95592901	BRDTP1	817	-	NR_003539	95592901	95592901	1
chrX	95939661	96855597	DIAPH2	915936	+	NM_006729	95940057	96854316	27
chrX	96138906	96140450	RPA4	1544	+	NM_013347	96139309	96140095	1
chrX	96783362	96819534	DIAPH2-AS1	36172	-	NR_125391	96819534	96819534	3
chrX	98716599	99194841	XRCC6P5	478242	-	NR_024608	99194841	99194841	11
chrX	99546641	99665271	PCDH19	118630	-	NM_001184880	99551274	99663595	6
chrX	99839789	99854882	TNMD	15093	+	NM_022144	99840015	99854714	7
chrX	99882104	99892101	TSPAN6	9997	-	NM_001278741	99885794	99890566	8
chrX	99899162	99926296	SRPX2	27134	+	NM_014467	99901319	99925984	11
chrX	99929488	99987135	SYTL4	57647	-	NM_001129896	99931024	99957033	18
chrX	100075351	100096509	CSTF2	21158	+	NM_001306206	100075405	100093350	15
chrX	100098312	100129334	NOX1	31022	-	NM_007052	100098940	100129128	13
chrX	100168430	100183898	XKRX	15468	-	NM_212559	100169326	100183293	3
chrX	100224696	100245820	ARL13A	21124	+	NR_103708	100245820	100245820	9
chrX	100264333	100307105	TRMT2B	42772	-	NM_001167970	100265569	100297278	14
chrX	100333835	100351355	TMEM35	17520	+	NM_021637	100333991	100349945	2
chrX	100354797	100417978	CENPI	63181	+	NM_006733	100356059	100417956	21
chrX	100474932	100519485	DRP2	44553	+	NM_001939	100486636	100515610	24
chrX	100523240	100548059	TAF7L	24819	-	NM_024885	100524180	100548033	13
chrX	100600643	100603957	TIMM8A	3314	-	NM_004085	100601486	100603652	2
chrX	100604434	100645784	BTK	41350	-	NM_001287344	100604872	100645537	19
chrX	100645877	100651142	RPL36A	5265	+	NM_021029	100645923	100650736	5
chrX	100645877	100669128	RPL36A-HNRNPH2	23251	+	NM_001199973	100645923	100666980	5
chrX	100652778	100663001	GLA	10223	-	NM_000169	100652796	100662891	7
chrX	100663120	100669128	HNRNPH2	6008	+	NM_001032393	100666976	100668326	2
chrX	100673250	100790975	ARMCX4	117725	+	NR_028407	100790975	100790975	16
chrX	100805513	100809675	ARMCX1	4162	+	NM_016608	100807913	100809275	4
chrX	100870107	100872991	ARMCX6	2884	-	NR_033670	100872991	100872991	5
chrX	100878119	100882831	ARMCX3	4712	+	NM_177947	100879969	100881109	5
chrX	100910267	100914876	ARMCX2	4609	-	NM_177949	100910675	100912574	6
chrX	101087084	101112549	NXF5	25465	-	NR_028089	101112549	101112549	19
chrX	101137259	101187039	ZMAT1	49780	-	NM_001282400	101138481	101141695	10
chrX	101380659	101382684	TCEAL2	2025	+	NM_080390	101381802	101382486	3
chrX	101394932	101397388	TCEAL6	2456	-	NM_001006938	101395751	101396303	3
chrX	101408678	101410986	BEX5	2308	-	NM_001012978	101408901	101409237	3
chrX	101470279	101481785	TCP11X2	11506	+	NM_001277423	101476558	101481591	10
chrX	101615315	101694929	NXF2B	79614	-	NM_001099686	101615521	101634957	23
chrX	101615315	101694929	NXF2	79614	-	NM_022053	101615521	101634957	23
chrX	101768609	101771699	TMSB15A	3090	-	NM_021992	101769014	101770091	3
chrX	101804892	101826621	NXF4	21729	+	NR_002216	101826621	101826621	17
chrX	101854095	101859085	ARMCX5	4990	+	NM_001168479	101857069	101858746	6
chrX	101854275	101972661	ARMCX5-GPRASP2	118386	+	NM_001199818	101969797	101972314	7
chrX	101906293	101914010	GPRASP1	7717	+	NM_014710	101908841	101913029	5
chrX	101967103	101972661	GPRASP2	5558	+	NM_001184874	101969797	101972314	5
chrX	101975641	102007369	BHLHB9	31728	+	NM_001142526	102003923	102005567	4
chrX	102024094	102140338	LINC00630	116244	+	NR_038988	102140338	102140338	8
chrX	102192199	102193228	RAB40AL	1029	+	NM_001031834	102192246	102193083	1
chrX	102317580	102319168	BEX1	1588	-	NM_018476	102317824	102318202	3
chrX	102330749	102348022	NXF3	17273	-	NM_022052	102331217	102347951	20
chrX	102470019	102472128	BEX4	2109	+	NM_001080425	102471081	102471444	3
chrX	102507922	102510121	TCEAL8	2199	-	NM_153333	102508553	102508907	3
chrX	102528617	102531797	TCEAL5	3180	-	NM_001012979	102528870	102529491	3
chrX	102564273	102565974	BEX2	1701	-	NM_032621	102564517	102564904	3
chrX	102585113	102587251	TCEAL7	2138	+	NM_152278	102586331	102586634	3
chrX	102611379	102613397	WBP5	2018	+	NM_016303	102612612	102612927	3
chrX	102631250	102633092	NGFRAP1	1842	+	NM_206917	102632449	102632755	3
chrX	102754680	102774417	RAB40A	19737	-	NM_080879	102754850	102755684	3
chrX	102785694	102809881	LOC105373300	24187	-	NR_131237	102809881	102809881	6
chrX	102831158	102842664	TCEAL4	11506	+	NM_001300901	102831397	102842251	5
chrX	102862833	102864855	TCEAL3	2022	+	NM_032926	102863992	102864595	3
chrX	102883647	102885876	TCEAL1	2229	+	NM_001006640	102884844	102885324	3
chrX	102930425	102943086	MORF4L2	12661	-	NM_001142422	102931088	102931955	5
chrX	102942211	102947484	MORF4L2-AS1	5273	+	NR_038978	102947484	102947484	3
chrX	102962271	102983552	GLRA4	21281	-	NM_001024452	102962271	102983131	9
chrX	102965836	102968960	TMEM31	3124	+	NM_182541	102967186	102968926	3
chrX	103031433	103047547	PLP1	16114	+	NM_001128834	103031923	103045526	8
chrX	103077254	103087212	RAB9B	9958	-	NM_016370	103080108	103080714	3
chrX	103217199	103220563	TMSB15B	3364	+	NM_194324	103219095	103220149	3
chrX	103230501	103232935	H2BFXP	2434	+	NR_003238	103232935	103232935	4
chrX	103230501	103232935	LOC100101478	2434	+	NR_130172	103232935	103232935	4
chrX	103265718	103268259	H2BFWT	2541	-	NM_001002916	103267283	103268232	3
chrX	103294515	103297021	H2BFM	2506	+	NM_001164416	103294543	103295431	3
chrX	103343897	103401708	SLC25A53	57811	-	NM_001012755	103349016	103349940	2
chrX	103357216	103360538	ZCCHC18	3322	+	NR_026694	103360538	103360538	4
chrX	103366999	103369317	LOC286437	2318	-	NR_039980	103369317	103369317	1
chrX	103411155	103440582	FAM199X	29427	+	NM_207318	103411466	103434459	6
chrX	103494718	103499599	ESX1	4881	-	NM_153448	103494908	103499530	4
chrX	103810995	105011822	IL1RAPL2	1200827	+	NM_017416	103903594	105011654	11
chrX	104463610	104465377	TEX13A	1767	-	NM_031274	104463645	104465081	5
chrX	105066535	105202602	NRK	136067	+	NM_198465	105066838	105199592	29
chrX	105277189	105282718	SERPINA7	5529	-	NM_000354	105277490	105281049	5
chrX	105412297	105452949	MUM1L1	40652	+	NM_152423	105449425	105451516	5
chrX	105855159	105922673	CXorf57	67514	+	NM_018015	105855310	105921488	14
chrX	105937067	106040246	RNF128	103179	+	NM_024539	105937232	106038943	7
chrX	106045918	106119377	TBC1D8B	73459	+	NM_017752	106046083	106117195	21
chrX	106143292	106146561	RIPPLY1	3269	-	NM_138382	106143978	106146517	4
chrX	106143393	106174091	CLDN2	30698	+	NM_001171092	106171458	106172151	2
chrX	106183963	106243474	MORC4	59511	-	NM_001085354	106184781	106243199	17
chrX	106305117	106362057	RBM41	56940	-	NM_001171080	106308983	106362003	8
chrX	106366656	106449670	NUP62CL	83014	-	NM_017681	106391014	106418376	9
chrX	106449861	106487473	PIH1D3	37612	+	NM_001169154	106456105	106486528	8
chrX	106756212	106789051	FRMPD3-AS1	32839	-	NR_046750	106789051	106789051	2
chrX	106765679	106848474	FRMPD3	82795	+	NM_032428	106765679	106846603	16
chrX	106871653	106894256	PRPS1	22603	+	NM_002764	106871858	106893262	7
chrX	106956451	107019017	TSC22D3	62566	-	NM_198057	106957748	107018649	3
chrX	107069083	107174867	MID2	105784	+	NM_012216	107069656	107170303	10
chrX	107137826	107179210	LOC101928335	41384	-	NR_110395	107179210	107179210	4
chrX	107224093	107225600	TEX13B	1507	-	NM_031273	107224309	107225357	3
chrX	107288199	107322414	VSIG1	34215	+	NM_001170553	107288360	107320611	8
chrX	107327434	107334874	PSMD10	7440	-	NM_170750	107328349	107334750	5
chrX	107334898	107397901	ATG4A	63003	+	NM_052936	107335056	107396942	13
chrX	107398836	107682727	COL4A6	283891	-	NM_001847	107400229	107682601	45
chrX	107683073	107940775	COL4A5	257702	+	NM_000495	107683355	107939608	51
chrX	107975726	107979607	IRS4	3881	-	NM_003604	107975800	107979574	1
chrX	107979769	107982133	LOC101928358	2364	+	NR_110652	107982133	107982133	3
chrX	108297771	108297820	MIR6087	49	+	NR_106735	108297820	108297820	1
chrX	108616134	108725285	GUCY2F	109151	-	NM_001522	108619127	108719165	20
chrX	108779009	108787927	NXT2	8918	+	NM_018698	108779111	108785917	5
chrX	108866928	108868393	KCNE5	1465	-	NM_012282	108867820	108868249	1
chrX	108884563	108976621	ACSL4	92058	-	NM_022977	108887257	108926715	17
chrX	109245862	109421016	TMEM164	175154	+	NM_017698	109352314	109416679	6
chrX	109298556	109298654	MIR652	98	+	NR_030381	109298654	109298654	1
chrX	109325345	109325446	MIR3978	101	+	NR_039774	109325446	109325446	1
chrX	109437413	109683461	AMMECR1	246048	-	NM_001171689	109441747	109560930	8
chrX	109468216	109468288	SNORD96B	72	-	NR_004379	109468288	109468288	1
chrX	109662284	109699562	RGAG1	37278	+	NM_020769	109693845	109698549	4
chrX	109763539	109766249	TDGF1P3	2710	+	NR_002718	109766249	109766249	1
chrX	109917083	110039286	CHRDL1	122203	-	NM_001143982	109919458	110035409	12
chrX	110187512	110464173	PAK3	276661	+	NM_001128166	110366331	110463675	16
chrX	110488326	110513774	CAPN6	25448	-	NM_014289	110489804	110507164	13
chrX	110537006	110655460	DCX	118454	-	NM_178153	110544914	110653626	7
chrX	110754889	110765627	LINC00890	10738	+	NR_033974	110765627	110765627	3
chrX	110924345	111003875	ALG13	79530	+	NM_001099922	110924446	111003227	27
chrX	111017541	111326004	TRPC5	308463	-	NM_012471	111019540	111195648	11
chrX	111119278	111147213	TRPC5OS	27935	+	NM_001195576	111145077	111145413	4
chrX	111326252	111700473	ZCCHC16	374221	+	NM_001004308	111697956	111698889	3
chrX	111873878	111923375	LHFPL1	49497	-	NM_178175	111874647	111914618	4
chrX	112018104	112084043	AMOT	65939	-	NM_133265	112021794	112058750	12
chrX	112023945	112024016	MIR4329	71	-	NR_036255	112024016	112024016	1
chrX	112285954	112763885	LOC101928437	477931	+	NR_110399	112763885	112763885	4
chrX	112859586	113181506	XACT	321920	-	NR_131204	113181506	113181506	3
chrX	113818550	114144624	HTR2C	326074	+	NM_001256760	113961345	114141978	7
chrX	113865258	113865386	SNORA35	128	+	NR_002993	113865386	113865386	1
chrX	113873917	113874002	MIR764	85	+	NR_031581	113874002	113874002	1
chrX	113886018	113886098	MIR1912	80	+	NR_031733	113886098	113886098	1
chrX	113887129	113887198	MIR1264	69	+	NR_031563	113887198	113887198	1
chrX	113949649	113949761	MIR1298	112	+	NR_031578	113949761	113949761	1
chrX	113997743	113997823	MIR1911	80	+	NR_031732	113997823	113997823	1
chrX	114058016	114058127	MIR448	111	+	NR_029955	114058127	114058127	1
chrX	114238537	114252207	IL13RA2	13670	-	NM_000640	114238642	114251832	10
chrX	114345182	114468635	LRCH2	123453	-	NM_020871	114347778	114468604	21
chrX	114423962	114427431	RBMXL3	3469	+	NM_001145346	114424004	114427208	1
chrX	114524282	114542123	LUZP4	17841	+	NM_016383	114524325	114541369	4
chrX	114752496	114797058	PLS3-AS1	44562	-	NR_110383	114797058	114797058	5
chrX	114795176	114885179	PLS3	90003	+	NM_001282337	114845226	114883881	18
chrX	114956728	115085444	DANT2	128716	-	NR_132337	115085444	115085444	2
chrX	115301957	115306225	AGTR2	4268	+	NM_000686	115303533	115304625	3
chrX	115567746	115592625	SLC6A14	24879	+	NM_007231	115567877	115590121	14
chrX	115592852	115594194	CT83	1342	-	NM_001017978	115592907	115594017	2
chrX	117031775	117251303	KLHL13	219528	-	NM_001168301	117032870	117162436	8
chrX	117480035	117583923	WDR44	103888	+	NM_001184965	117480466	117582950	20
chrX	117520356	117520434	MIR1277	78	+	NR_031685	117520434	117520434	1
chrX	117629871	117820123	DOCK11	190252	+	NM_144658	117629934	117819770	53
chrX	117861558	117928496	IL13RA1	66938	+	NM_001560	117861601	117925817	11
chrX	117957705	117960936	ZCCHC12	3231	+	NM_173798	117959207	117960416	4
chrX	117973518	118015977	LINC01285	42459	+	NR_110393	118015977	118015977	7
chrX	118108576	118152318	LONRF3	43742	+	NM_001031855	118108743	118151653	11
chrX	118212597	118284542	KIAA1210	71945	-	NM_020721	118215291	118284542	14
chrX	118370207	118378429	PGRMC1	8222	+	NM_006667	118370326	118377217	3
chrX	118425491	118469573	LOC101928336	44082	+	NR_110396	118469573	118469573	4
chrX	118533257	118588437	SLC25A43	55180	+	NM_145305	118533366	118587028	5
chrX	118599995	118603083	SLC25A5-AS1	3088	-	NR_028443	118603083	118603083	1
chrX	118602362	118605359	SLC25A5	2997	+	NM_001152	118602478	118605021	4
chrX	118672111	118699397	CXorf56	27286	-	NM_022101	118673689	118699318	7
chrX	118708429	118718392	UBE2A	9963	+	NM_003336	118708674	118717218	6
chrX	118722299	118739846	NKRF	17547	-	NM_001173487	118723314	118737453	4
chrX	118749687	118827333	SEPT6	77646	-	NM_145800	118759338	118827068	11
chrX	118780700	118780811	MIR766	111	-	NR_030413	118780811	118780811	1
chrX	118892575	118894165	SOWAHD	1590	+	NM_001105576	118892630	118893578	1
chrX	118920466	118925622	RPL39	5156	-	NM_001000	118920646	118925539	3
chrX	118921315	118921447	SNORA69	132	-	NR_002584	118921447	118921447	1
chrX	118967988	118986991	UPF3B	19003	-	NM_080632	118968840	118986891	11
chrX	119004494	119005791	RNF113A	1297	-	NM_006978	119004544	119005576	1
chrX	119005733	119010629	NDUFA1	4896	+	NM_004541	119005874	119010497	3
chrX	119029935	119054679	AKAP14	24744	+	NM_178813	119037186	119054570	7
chrX	119059012	119077735	NKAP	18723	-	NM_024528	119059182	119077568	9
chrX	119144673	119149508	RHOXF1P1	4835	-	NR_131250	119149508	119149508	4
chrX	119170200	119280761	RHOXF1-AS1	110561	+	NR_131238	119280761	119280761	5
chrX	119206228	119211707	RHOXF2B	5479	-	NM_001099685	119206480	119211517	4
chrX	119206228	119211707	RHOXF2	5479	-	NM_032498	119206480	119211517	4
chrX	119243010	119249847	RHOXF1	6837	-	NM_139282	119243149	119249772	3
chrX	119251551	119253610	LINC01402	2059	-	NR_126557	119253610	119253610	3
chrX	119370308	119379122	NKAPP1	8814	-	NR_027131	119379122	119379122	3
chrX	119384606	119392251	ZBTB33	7645	+	NM_006777	119387270	119389289	2
chrX	119392504	119445391	TMEM255A	52887	-	NM_017938	119394724	119445164	10
chrX	119495939	119517104	ATP1B4	21165	+	NM_012069	119496023	119513489	8
chrX	119560002	119603204	LAMP2	43202	-	NM_001122606	119562338	119603024	9
chrX	119658445	119709684	CUL4B	51239	-	NM_003588	119660615	119708472	22
chrX	119737743	119755016	MCTS1	17273	+	NM_014060	119738091	119746119	6
chrX	119759528	119764005	C1GALT1C1	4477	-	NM_152692	119760064	119761021	3
chrX	120006451	120009779	CT47B1	3328	-	NM_001145718	120007749	120009524	3
chrX	120011344	120066151	CT47A1	54807	-	NM_001080146	120012653	120065896	3
chrX	120011344	120066151	CT47A2	54807	-	NM_001080145	120064142	120065896	3
chrX	120011344	120066151	CT47A3	54807	-	NM_001080144	120064142	120065896	3
chrX	120011344	120066151	CT47A4	54807	-	NM_001080143	120064142	120065896	3
chrX	120011344	120066151	CT47A5	54807	-	NM_001080142	120064142	120065896	3
chrX	120011344	120066151	CT47A8	54807	-	NM_001080139	120064142	120065896	3
chrX	120011344	120066151	CT47A9	54807	-	NM_001080138	120064142	120065896	3
chrX	120011344	120066151	CT47A10	54807	-	NM_001080137	120064142	120065896	3
chrX	120011344	120066151	CT47A11	54807	-	NM_173571	120064142	120065896	3
chrX	120011344	120066151	CT47A12	54807	-	NM_001242922	120064142	120065896	3
chrX	120067694	120071012	CT47A6	3318	-	NM_001080141	120069003	120070757	3
chrX	120087136	120090454	CT47A7	3318	-	NM_001080140	120088445	120090199	3
chrX	120181461	120183796	GLUD2	2335	+	NM_012084	120181538	120183215	1
chrX	120504825	120504907	MIR3672	82	+	NR_037444	120504907	120504907	1
chrX	122318095	122624766	GRIA3	306671	+	NM_000828	122318387	122616895	16
chrX	122734411	122866904	THOC2	132493	-	NM_001081550	122744786	122866872	39
chrX	122993661	123047829	XIAP	54168	+	NM_001204401	123019512	123041031	7
chrX	123093082	123095191	LOC101928402	2109	-	NR_130770	123095191	123095191	2
chrX	123094409	123236505	STAG2	142096	+	NM_001042749	123156477	123234447	35
chrX	123480131	123507010	SH2D1A	26879	+	NM_001114937	123480492	123505241	4
chrX	123509755	124097666	TENM1	587911	-	NM_001163278	123514385	124097602	32
chrX	124453968	124456950	TEX13C	2982	+	NM_001195272	124453968	124456950	1
chrX	125243744	125249545	LOC101928495	5801	+	NR_110409	125249545	125249545	3
chrX	125297481	125300080	DCAF12L2	2599	-	NM_001013628	125298515	125299907	1
chrX	125683365	125686842	DCAF12L1	3477	-	NM_178470	125685199	125686591	2
chrX	125953746	125955768	PRR32	2022	+	NM_001122716	125953826	125955518	2
chrX	127184940	127186382	ACTRT1	1442	-	NM_138289	127185054	127186185	1
chrX	128580477	128657482	SMARCA1	77005	-	NM_003069	128582285	128657347	25
chrX	128674251	128726530	OCRL	52279	+	NM_000276	128674416	128724247	24
chrX	128779235	128788933	APLN	9698	-	NM_017413	128782602	128788607	3
chrX	128872945	128903525	XPNPEP2	30580	+	NM_003399	128873189	128902461	21
chrX	128913891	128929176	SASH3	15285	+	NM_018990	128914073	128927808	8
chrX	128937263	128977910	ZDHHC9	40647	-	NM_016032	128940345	128975921	11
chrX	129040096	129063738	UTP14A	23642	+	NM_006649	129040186	129063584	15
chrX	129139163	129192058	BCORL1	52895	+	NM_001184772	129139207	129190111	13
chrX	129198894	129244688	ELF4	45794	-	NM_001127197	129200695	129215304	9
chrX	129263337	129299861	AIFM1	36524	-	NM_001130847	129271492	129299630	17
chrX	129305772	129318844	RAB33A	13072	+	NM_004794	129306036	129318714	2
chrX	129336672	129402922	ZNF280C	66250	-	NM_017666	129338950	129394423	19
chrX	129473861	129507335	SLC25A14	33474	+	NM_001282197	129474252	129506924	12
chrX	129518318	129519511	GPR119	1193	-	NM_178471	129518413	129519421	1
chrX	129535942	129547317	RBMX2	11375	+	NM_016024	129536006	129546822	6
chrX	129757356	130037291	ENOX2	279935	-	NM_182314	129759287	129843265	16
chrX	130150442	130192120	LINC01201	41678	-	NR_126350	130192120	130192120	3
chrX	130192215	130223859	ARHGAP36	31644	+	NM_001282607	130192360	130222759	12
chrX	130407482	130423403	IGSF1	15921	-	NM_001555	130407769	130420648	20
chrX	130678047	130678974	OR13H1	927	+	NM_001004486	130678047	130678974	1
chrX	130836677	130964671	FIRRE	127994	-	NR_026975	130964671	130964671	13
chrX	131157244	131209971	STK26	52727	+	NM_016542	131157645	131208187	12
chrX	131211013	131262048	FRMD7	51035	-	NM_001306193	131211899	131261872	12
chrX	131337051	131353508	RAP2C	16457	-	NR_073150	131353508	131353508	7
chrX	131352534	131566839	RAP2C-AS1	214305	+	NR_110410	131566839	131566839	3
chrX	131503342	131623996	MBNL3	120654	-	NM_001170704	131513693	131540309	9
chrX	131760037	132095423	HS6ST2	335386	-	NM_001077188	131762250	132092630	6
chrX	131801669	131803915	HS6ST2-AS1	2246	+	NR_046691	131803915	131803915	3
chrX	132159506	132162300	USP26	2794	-	NM_031907	132159506	132162248	1
chrX	132350696	132352376	TFDP3	1680	-	NM_016521	132351069	132352287	1
chrX	132435063	132549205	GPC4	114142	-	NM_001448	132436894	132548993	9
chrX	132669775	133119673	GPC3	449898	-	NM_001164617	132670151	133119476	9
chrX	133303407	133303482	MIR363	75	-	NR_029852	133303482	133303482	1
chrX	133303567	133303642	MIR92A2	75	-	NR_029509	133303642	133303642	1
chrX	133303700	133303796	MIR19B2	96	-	NR_029491	133303796	133303796	1
chrX	133303838	133303907	MIR20B	69	-	NR_029950	133303907	133303907	1
chrX	133304070	133304141	MIR18B	71	-	NR_029949	133304141	133304141	1
chrX	133304227	133304308	MIR106A	81	-	NR_029523	133304308	133304308	1
chrX	133371076	133379808	CCDC160	8732	+	NM_001101357	133378830	133379808	2
chrX	133507341	133562822	PHF6	55481	+	NM_001015877	133511647	133559360	11
chrX	133594174	133634698	HPRT1	40524	+	NM_000194	133594341	133634107	9
chrX	133674214	133674292	MIR450B	78	-	NR_030587	133674292	133674292	1
chrX	133674370	133674461	MIR450A1	91	-	NR_029962	133674461	133674461	1
chrX	133674537	133674637	MIR450A2	100	-	NR_030227	133674637	133674637	1
chrX	133675370	133675467	MIR542	97	-	NR_030399	133675467	133675467	1
chrX	133677406	133680660	MIR503HG	3254	-	NR_024607	133680660	133680660	3
chrX	133680357	133680428	MIR503	71	-	NR_030228	133680428	133680428	1
chrX	133680643	133680741	MIR424	98	-	NR_029946	133680741	133680741	1
chrX	133684053	133694428	LINC00629	10375	+	NR_038998	133694428	133694428	3
chrX	133699872	133898352	PLAC1	198480	-	NM_001316887	133700073	133700712	4
chrX	133903595	133931262	FAM122B	27667	-	NM_001166600	133905314	133930235	11
chrX	133941222	133988641	FAM122C	47419	+	NM_001170779	133941628	133988266	7
chrX	134021655	134049374	MOSPD1	27719	-	NM_019556	134023190	134033463	6
chrX	134124967	134126503	SMIM10	1536	+	NM_001163438	134125125	134125377	1
chrX	134154533	134156566	FAM127C	2033	-	NM_001078173	134156147	134156489	1
chrX	134166332	134167575	FAM127A	1243	+	NM_001078171	134166413	134166755	1
chrX	134184962	134186221	FAM127B	1259	-	NM_001134321	134185338	134186138	2
chrX	134229014	134232664	SMIM10L2B	3650	-	NR_024493	134232664	134232664	2
chrX	134252881	134254405	LINC00633	1524	-	NR_033941	134254405	134254405	3
chrX	134254548	134257529	LOC100287728	2981	+	NR_103770	134257529	134257529	2
chrX	134290460	134305751	CT55	15291	-	NM_001031705	134290883	134305095	6
chrX	134382535	134478012	ZNF75D	95477	-	NR_110381	134478012	134478012	4
chrX	134478695	134497338	ZNF449	18643	+	NM_152695	134481043	134495001	5
chrX	134530353	134531672	LOC100506790	1319	+	NR_104652	134531672	134531672	2
chrX	134555857	134561999	SMIM10L2A	6142	+	NR_024359	134561999	134561999	2
chrX	134654007	134654599	DDX26B-AS1	592	-	NR_046740	134654599	134654599	2
chrX	134654554	134716460	DDX26B	61906	+	NM_182540	134654917	134715561	17
chrX	134847184	134891539	CT45A1	44355	+	NM_001017417	134852701	134891326	5
chrX	134847385	134856984	CT45A7	9599	+	NM_001291543	134852701	134856795	5
chrX	134866213	134874248	CT45A6	8035	+	NM_001017438	134869963	134874055	5
chrX	134866213	134874249	CT45A2	8036	+	NM_152582	134869963	134874055	5
chrX	134866213	134874249	CT45A8	8036	+	NM_001291535	134869963	134874055	5
chrX	134866213	134874249	CT45A9	8036	+	NM_001291540	134869963	134874055	5
chrX	134866213	134874561	CT45A5	8348	+	NM_001172288	134869963	134874055	5
chrX	134866213	134891519	CT45A4	25306	+	NM_001017436	134869963	134891326	5
chrX	134883487	134891519	CT45A3	8032	+	NM_001017435	134887232	134891326	5
chrX	134945650	134975579	CT45A10	29929	-	NM_001291530	134946156	134950246	5
chrX	134975784	134995220	SAGE1	19436	+	NM_018666	134978401	134995056	20
chrX	135044230	135056134	MMGT1	11904	-	NM_173470	135047182	135055834	4
chrX	135067582	135129428	SLC9A6	61846	+	NM_001177651	135067817	135126883	17
chrX	135228860	135293518	FHL1	64658	+	NR_027621	135293518	135293518	7
chrX	135298973	135338641	MAP7D3	39668	-	NM_001173516	135301588	135338478	19
chrX	135383121	135499047	ADGRG4	115926	+	NM_153834	135390936	135498650	26
chrX	135570124	135574598	BRS3	4474	+	NM_001727	135570273	135574534	3
chrX	135579237	135594503	HTATSF1	15266	+	NM_001163280	135579843	135594172	10
chrX	135614310	135638966	VGLL1	24656	+	NM_016267	135618179	135638698	5
chrX	135633036	135633119	MIR934	83	+	NR_030631	135633119	135633119	1
chrX	135721701	135724588	LINC00892	2887	+	NR_038462	135724588	135724588	3
chrX	135730335	135742549	CD40LG	12214	+	NM_000074	135730407	135741574	5
chrX	135747711	135863503	ARHGEF6	115792	-	NM_004840	135750187	135863041	22
chrX	135951352	135962939	RBMX	11587	-	NM_001164803	135954453	135961586	8
chrX	135961357	135961430	SNORD61	73	-	NR_002735	135961430	135961430	1
chrX	136112306	136113833	GPR101	1527	-	NM_054021	136112306	136113833	1
chrX	136648345	136654259	ZIC3	5914	+	NM_003413	136648850	136652229	3
chrX	137696891	137699799	LINC00889	2908	-	NR_026935	137699799	137699799	1
chrX	137713733	138287185	FGF13	573452	-	NM_001139501	137715010	137939803	8
chrX	137749871	137749954	MIR504	83	-	NR_030229	137749954	137749954	1
chrX	137794268	137798763	FGF13-AS1	4495	+	NR_038405	137798763	137798763	3
chrX	138528977	138531132	SRD5A1P1	2155	+	NR_028597	138531132	138531132	1
chrX	138612894	138645617	F9	32723	+	NM_000133	138612923	138644230	8
chrX	138663929	138790381	MCF2	126452	-	NM_001171876	138664629	138733903	29
chrX	138808504	138914447	ATP11C	105943	-	NM_173694	138813812	138914348	30
chrX	139006306	139006390	MIR505	84	-	NR_030230	139006390	139006390	1
chrX	139037883	139047677	CXorf66	9794	-	NM_001013403	139038054	139047655	3
chrX	139173825	139175070	LOC389895	1245	+	NM_001271560	139173901	139174723	1
chrX	139585151	139587225	SOX3	2074	-	NM_005634	139585884	139587225	1
chrX	139791923	139854841	LINC00632	62918	+	NR_104228	139854841	139854841	4
chrX	139865424	139866723	CDR1	1299	-	NM_004065	139865742	139866531	1
chrX	140008336	140008384	MIR320D2	48	-	NR_031725	140008384	140008384	1
chrX	140084755	140085871	SPANXB1	1116	+	NM_032461	140084858	140085817	2
chrX	140269930	140271399	LDOC1	1469	-	NM_012317	140270765	140271206	1
chrX	140590842	140738069	SPANXA2-OT1	147227	+	NR_037183	140738069	140738069	5
chrX	140677834	140678899	SPANXA1	1065	+	NM_013453	140677894	140678835	2
chrX	140677834	140678899	SPANXA2	1065	+	NM_145662	140677894	140678835	2
chrX	140785557	140786896	SPANXD	1339	-	NM_032417	140785621	140786562	2
chrX	140785567	140786655	SPANXC	1088	-	NM_022661	140785621	140786562	2
chrX	140926101	140985618	MAGEC3	59517	+	NM_138702	140926101	140985618	8
chrX	140991641	140997187	MAGEC1	5546	+	NM_005462	140992858	140996619	4
chrX	141290127	141293076	MAGEC2	2949	-	NM_016249	141290651	141291773	3
chrX	142113703	142122066	SPANXN4	8363	+	NM_001009613	142113800	142122032	2
chrX	142596563	142605303	SPANXN3	8740	-	NM_001009609	142596643	142605219	2
chrX	142710594	142723926	SLITRK4	13332	-	NM_001184749	142716410	142718924	3
chrX	142795134	142803762	SPANXN2	8628	-	NM_001009615	142795134	142803762	2
chrX	142967172	142968357	UBE2NL	1185	+	NM_001012989	142967202	142967664	1
chrX	144329106	144337728	SPANXN1	8622	+	NM_001009614	144329106	144337334	2
chrX	144899346	144907360	SLITRK2	8014	+	NM_032539	144903943	144906481	5
chrX	144908927	144911370	TMEM257	2443	+	NM_004709	144909195	144909531	1
chrX	145074267	145074344	MIR892C	77	-	NR_106783	145074344	145074344	1
chrX	145075792	145075869	MIR890	77	-	NR_030589	145075869	145075869	1
chrX	145076301	145076378	MIR888	77	-	NR_030592	145076378	145076378	1
chrX	145078186	145078261	MIR892A	75	-	NR_030584	145078261	145078261	1
chrX	145078715	145078792	MIR892B	77	-	NR_030593	145078792	145078792	1
chrX	145082570	145082649	MIR891B	79	-	NR_030590	145082649	145082649	1
chrX	145109311	145109390	MIR891A	79	-	NR_030581	145109390	145109390	1
chrX	145891301	145891929	CXorf51A	628	+	NM_001144064	145891309	145891826	2
chrX	145891301	145891929	CXorf51B	628	+	NM_001244892	145891309	145891826	2
chrX	146271221	146271305	MIR513C	84	-	NR_031709	146271305	146271305	1
chrX	146280561	146280645	MIR513B	84	-	NR_031708	146280645	146280645	1
chrX	146294980	146295109	MIR513A1	129	-	NR_030231	146295109	146295109	1
chrX	146307343	146307470	MIR513A2	127	-	NR_030232	146307470	146307470	1
chrX	146312237	146312361	MIR506	124	-	NR_030233	146312361	146312361	1
chrX	146312501	146312595	MIR507	94	-	NR_030234	146312595	146312595	1
chrX	146318430	146318545	MIR508	115	-	NR_030235	146318545	146318545	1
chrX	146331668	146331748	MIR514B	80	-	NR_036173	146331748	146331748	1
chrX	146340277	146340368	MIR509-2	91	-	NR_030586	146340368	146340368	1
chrX	146340282	146340358	MIR509-3	76	-	NR_030629	146340358	146340358	1
chrX	146342049	146342143	MIR509-1	94	-	NR_030236	146342143	146342143	1
chrX	146353852	146353926	MIR510	74	-	NR_030237	146353926	146353926	1
chrX	146360764	146360862	MIR514A1	98	-	NR_030238	146360862	146360862	1
chrX	146363460	146363548	MIR514A2	88	-	NR_030239	146363548	146363548	1
chrX	146363460	146363548	MIR514A3	88	-	NR_030240	146363548	146363548	1
chrX	146990948	146993335	FMR1-AS1	2387	-	NR_024502	146993335	146993335	3
chrX	146993468	147032647	FMR1	39179	+	NM_002024	146993697	147030364	17
chrX	147062848	147108187	FMR1NB	45339	+	NM_152578	147062922	147106520	6
chrX	147582138	148082193	AFF2	500055	+	NM_002025	147582617	148072862	21
chrX	148560294	148586884	IDS	26590	-	NM_000202	148564276	148586667	9
chrX	148609131	148621312	LINC00893	12181	-	NR_027455	148621312	148621312	10
chrX	148622518	148629876	CXorf40A	7358	+	NM_001171908	148627176	148628508	5
chrX	148663308	148669109	MAGEA9	5801	-	NM_005365	148663887	148664835	4
chrX	148663308	148669116	MAGEA9B	5808	-	NM_001080790	148663887	148664835	4
chrX	148674171	148676970	HSFX2	2799	-	NM_001164415	148674251	148676360	2
chrX	148674182	148676974	HSFX1	2792	-	NM_016153	148674251	148676360	2
chrX	148678215	148713568	TMEM185A	35353	-	NM_032508	148679670	148713263	7
chrX	148769902	148798928	MAGEA11	29026	+	NM_001011544	148770635	148798436	5
chrX	148958632	149008599	LINC00850	49967	+	NR_109813	149008599	149008599	5
chrX	149007562	149025779	MAGEA8-AS1	18217	-	NR_102703	149025779	149025779	5
chrX	149009940	149014609	MAGEA8	4669	+	NM_001166400	149013046	149014003	4
chrX	149100414	149106716	CXorf40B	6302	-	NM_001013845	149100761	149102092	5
chrX	149106765	149185018	LINC00894	78253	+	NR_027456	149185018	149185018	12
chrX	149396238	149396318	MIR2114	80	+	NR_031748	149396318	149396318	1
chrX	149531544	149682448	MAMLD1	150904	+	NM_001177465	149613782	149681343	5
chrX	149737046	149841616	MTM1	104570	+	NM_000252	149761076	149840068	15
chrX	149861836	149933576	MTMR1	71740	+	NM_003828	149862003	149931202	16
chrX	149934808	150067289	CD99L2	132481	-	NM_001242614	149937506	150067061	12
chrX	150148980	150159248	HMGB3	10268	+	NM_001301231	150149062	150156387	5
chrX	150336693	150336798	MIR4330	105	+	NR_036256	150336798	150336798	1
chrX	150345055	150349937	GPR50	4882	+	NM_004224	150345193	150349909	2
chrX	150565656	150577836	VMA21	12180	+	NM_001017980	150565780	150573530	3
chrX	150732006	150845211	PASD1	113205	+	NM_173493	150770025	150844615	16
chrX	150863729	150870063	PRRG3	6334	+	NM_024082	150867286	150869505	4
chrX	150884507	150891664	FATE1	7157	+	NM_033085	150884591	150891231	5
chrX	150903217	150914036	CNGA2	10819	+	NM_005140	150906955	150912970	7
chrX	151081360	151093642	MAGEA4	12282	+	NM_001011548	151092136	151093090	3
chrX	151121595	151143151	GABRE	21556	-	NM_004961	151123172	151143097	9
chrX	151127049	151127130	MIR224	81	-	NR_029638	151127130	151127130	1
chrX	151128099	151128184	MIR452	85	-	NR_029973	151128184	151128184	1
chrX	151282520	151286411	MAGEA5	3891	-	NM_021049	151283637	151284012	3
chrX	151282520	151307050	MAGEA10-MAGEA5	24530	-	NM_001204811	151283637	151284012	4
chrX	151301782	151307050	MAGEA10	5268	-	NM_001251828	151302982	151304092	5
chrX	151335633	151619831	GABRA3	284198	-	NM_000808	151336699	151533042	10
chrX	151560690	151560771	MIR105-1	81	-	NR_029521	151560771	151560771	1
chrX	151561892	151562001	MIR767	109	-	NR_030409	151562001	151562001	1
chrX	151562883	151562964	MIR105-2	81	-	NR_029522	151562964	151562964	1
chrX	151806636	151821825	GABRQ	15189	+	NM_018558	151806656	151821744	9
chrX	151867231	151870825	MAGEA6	3594	+	NM_005363	151869310	151870255	3
chrX	151876742	151883038	CSAG3	6296	-	NR_130638	151883038	151883038	5
chrX	151883074	151887096	MAGEA2	4022	+	NM_175743	151885595	151886540	6
chrX	151885383	151887079	MAGEA2B	1696	+	NM_153488	151885595	151886540	2
chrX	151895977	151903136	CSAG4	7159	-	NR_073432	151903136	151903136	4
chrX	151899292	151903184	MAGEA12	3892	-	NM_001166387	151899855	151900800	3
chrX	151903226	151909518	CSAG1	6292	+	NM_153478	151904502	151909208	5
chrX	151934651	151938240	MAGEA3	3589	-	NM_005362	151935221	151936166	3
chrX	151995870	151999301	CETN2	3431	-	NM_004344	151996384	151999254	5
chrX	151999510	152037907	NSDHL	38397	+	NM_001129765	152014868	152037660	9
chrX	152082985	152142025	ZNF185	59040	+	NM_001178106	152083033	152139085	24
chrX	152157367	152162671	PNMA5	5304	-	NM_001184924	152158795	152160142	4
chrX	152224765	152228827	PNMA3	4062	+	NM_001282535	152225412	152226901	3
chrX	152240796	152243402	PNMA6A	2606	+	NM_032882	152241445	152242645	2
chrX	152481521	152486116	MAGEA1	4595	-	NM_004988	152482080	152483010	3
chrX	152599612	152618384	ZNF275	18772	+	NM_001080485	152602137	152613231	5
chrX	152683780	152687086	ZFP92	3306	+	NM_001136273	152683780	152687086	4
chrX	152710177	152711945	TREX2	1768	-	NM_080701	152710177	152710888	2
chrX	152713122	152760983	HAUS7	47861	-	NR_073156	152760983	152760983	13
chrX	152760346	152775012	BGN	14666	+	NM_001711	152770089	152773903	8
chrX	152801579	152848387	ATP2B3	46808	+	NM_021949	152801705	152845461	21
chrX	152853382	152864632	FAM58A	11250	-	NM_001130997	152853822	152864529	5
chrX	152864794	152865348	LOC105373383	554	+	NR_131982	152865348	152865348	1
chrX	152907896	152916781	DUSP9	8885	+	NM_001395	152913407	152915760	4
chrX	152935187	152939816	PNCK	4629	-	NM_001039582	152935911	152939630	12
chrX	152953751	152962048	SLC6A8	8297	+	NM_005629	152954029	152960669	13
chrX	152965946	152990201	BCAP31	24255	-	NM_001256447	152966391	152988699	8
chrX	152990322	153010216	ABCD1	19894	+	NM_000033	152990721	153009189	10
chrX	153029650	153044801	PLXNB3	15151	+	NM_001163257	153031665	153044494	37
chrX	153046455	153051187	SRPK3	4732	+	NM_001170761	153046541	153050975	16
chrX	153051220	153059978	IDH3G	8758	-	NM_004135	153051326	153059781	13
chrX	153059629	153063967	SSR4	4338	+	NM_001204527	153059779	153063888	7
chrX	153067620	153096022	PDZD4	28402	-	NM_001303513	153068807	153073359	9
chrX	153126968	153151628	L1CAM	24660	-	NM_001278116	153128117	153141291	29
chrX	153146126	153154427	LCA10	8301	+	NR_130768	153154427	153154427	7
chrX	153167984	153172620	AVPR2	4636	+	NR_027419	153172620	153172620	4
chrX	153172829	153191714	ARHGAP4	18885	-	NM_001164741	153173182	153191656	23
chrX	153195279	153200607	NAA10	5328	-	NM_001256120	153195439	153200357	8
chrX	153200721	153210232	RENBP	9511	-	NM_002910	153200738	153210062	11
chrX	153213007	153236819	HCFC1	23812	-	NM_005334	153214797	153236291	26
chrX	153234215	153235543	HCFC1-AS1	1328	+	NR_046608	153235543	153235543	3
chrX	153237990	153248646	TMEM187	10656	+	NM_003492	153247513	153248299	2
chrX	153246547	153246628	MIR3202-1	81	+	NR_036174	153246628	153246628	1
chrX	153246548	153246627	MIR3202-2	79	-	NR_036175	153246627	153246627	1
chrX	153275956	153285342	IRAK1	9386	-	NM_001569	153277309	153285263	14
chrX	153285370	153285440	MIR718	70	-	NR_031757	153285440	153285440	1
chrX	153287263	153363188	MECP2	75925	-	NM_004992	153295817	153357667	4
chrX	153409697	153424507	OPN1LW	14810	+	NM_020061	153409757	153424401	6
chrX	153485202	153498755	OPN1MW2	13553	+	NM_001048181	153485284	153498649	6
chrX	153485202	153499470	OPN1MW	14268	+	NM_000513	153485284	153498649	6
chrX	153498929	153523564	TEX28	24635	-	NM_001205201	153499079	153520470	5
chrX	153524026	153558713	TKTL1	34687	+	NM_001145933	153524212	153558038	13
chrX	153576899	153603006	FLNA	26107	-	NM_001110556	153577216	153599613	48
chrX	153607596	153609883	EMD	2287	+	NM_000117	153607844	153609557	6
chrX	153626405	153630680	RPL10	4275	+	NM_006013	153626860	153629195	7
chrX	153628621	153628756	SNORA70	135	+	NR_000011	153628756	153628756	1
chrX	153629576	153640428	DNASE1L1	10852	-	NM_001009932	153631047	153633909	10
chrX	153639853	153650063	TAZ	10210	+	NM_000116	153640180	153649343	11
chrX	153652722	153656825	CH17-340M24.3	4103	-	NR_103768	153656825	153656825	2
chrX	153656977	153664863	ATP6AP1	7886	+	NM_001183	153657038	153664237	10
chrX	153665258	153671814	GDI1	6556	+	NM_001493	153665600	153671019	11
chrX	153672472	153679002	FAM50A	6530	+	NM_004699	153672582	153678780	13
chrX	153678667	153678734	MIR6858	67	+	NR_106917	153678734	153678734	1
chrX	153686620	153701989	PLXNA3	15369	+	NM_017514	153688523	153701028	33
chrX	153706107	153707596	LAGE3	1489	-	NM_006014	153706282	153707254	3
chrX	153712055	153715009	UBL4A	2954	-	NM_014235	153713877	153714923	4
chrX	153715644	153719029	SLC10A3	3385	-	NM_001142391	153715845	153717279	4
chrX	153734489	153744566	FAM3A	10077	-	NM_001282312	153735141	153744096	10
chrX	153759604	153775801	G6PD	16197	-	NM_001042351	153760214	153774370	13
chrX	153770458	153793261	IKBKG	22803	+	NM_001099856	153770478	153792676	10
chrX	153799478	153800188	FAM223A	710	+	NR_027401	153800188	153800188	1
chrX	153813417	153815075	CTAG1B	1658	+	NM_001327	153813470	153814923	3
chrX	153845864	153847522	CTAG1A	1658	-	NM_139250	153846016	153847469	3
chrX	153860738	153861448	FAM223B	710	-	NR_027402	153861448	153861448	1
chrX	153880245	153881853	CTAG2	1608	-	NM_172377	153880402	153881789	3
chrX	153903526	153979858	GAB3	76332	-	NR_104114	153979858	153979858	9
chrX	153991016	154005964	DKC1	14948	+	NM_001142463	153991240	154005142	15
chrX	153996802	153996932	SNORA36A	130	+	NR_002969	153996932	153996932	1
chrX	153996870	153996931	MIR664B	61	+	NR_049842	153996931	153996931	1
chrX	154003272	154003401	SNORA56	129	+	NR_002984	154003401	154003401	1
chrX	154006958	154033802	MPP1	26844	-	NM_001166462	154007451	154028031	13
chrX	154051622	154062937	SMIM9	11315	-	NM_001162936	154052029	154059131	5
chrX	154064063	154250998	F8	186935	-	NM_000132	154065871	154250827	26
chrX	154113243	154113837	H2AFB2	594	+	NM_001017991	154113324	154113672	1
chrX	154113316	154113833	H2AFB1	517	+	NM_001017990	154113324	154113672	1
chrX	154113316	154113833	H2AFB3	517	+	NM_080720	154113324	154113672	1
chrX	154114634	154116336	F8A1	1702	+	NM_012151	154114649	154115765	1
chrX	154114649	154115765	F8A2	1116	+	NM_001007523	154114649	154115765	1
chrX	154114649	154115765	F8A3	1116	+	NM_001007524	154114649	154115765	1
chrX	154115634	154115733	MIR1184-1	99	-	NR_036049	154115733	154115733	1
chrX	154115634	154115733	MIR1184-2	99	-	NR_036259	154115733	154115733	1
chrX	154115634	154115733	MIR1184-3	99	-	NR_036260	154115733	154115733	1
chrX	154255063	154285191	FUNDC2	30128	+	NM_023934	154255213	154282947	5
chrX	154289899	154299547	CMC4	9648	-	NM_001018024	154290117	154292298	3
chrX	154292308	154299547	MTCP1	7239	-	NM_001018025	154293764	154294285	5
chrX	154299694	154351349	BRCC3	51655	+	NM_024332	154299802	154348425	12
chrX	154425283	154468122	VBP1	42839	+	NM_001303544	154437181	154467123	7
chrX	154487518	154493874	RAB39B	6356	-	NM_171998	154490087	154493573	2
chrX	154505495	154563990	CLIC2	58495	-	NM_001289	154507191	154563736	6
chrX	154696200	154723771	LOC101927830	27571	+	NR_109985	154723771	154723771	4
chrX	154696200	154723771	TMLHE-AS1	27571	+	NR_039991	154723771	154723771	4
chrX	154718672	154842622	TMLHE	123950	-	NM_018196	154721195	154774937	8
chrX	154842225	155012119	SPRY3	169894	+	NM_001304990	155003533	155004400	3
chrX	155110942	155173433	VAMP7	62491	+	NM_005638	155119129	155171615	8
chrX	155227245	155240482	IL9R	13237	+	NM_002186	155227424	155240074	9
chrX	155255322	155257848	DDX11L16	2526	-	NR_110561	155257848	155257848	3
chrY	2654895	2655782	SRY	887	-	NM_003140	2655029	2655644	1
chrY	2709622	2734997	RPS4Y1	25375	+	NM_001008	2709665	2734935	7
chrY	2803111	2850547	ZFY	47436	+	NM_001145276	2821977	2848034	7
chrY	2871036	2970313	LINC00278	99277	+	NR_046502	2970313	2970313	4
chrY	3447125	3448082	TGIF2LY	957	+	NM_139214	3447285	3447843	2
chrY	4924130	5610269	PCDH11Y	686139	+	NM_032973	4924864	5605983	5
chrY	6110486	6111651	TTTY23B	1165	-	NR_003593	6111651	6111651	3
chrY	6110486	6111651	TTTY23	1165	-	NR_001540	6111651	6111651	3
chrY	6114263	6117053	TSPY2	2790	+	NM_022573	6114309	6116866	6
chrY	6225259	6229454	LINC00280	4195	-	NR_046505	6229454	6229454	3
chrY	6258441	6279605	TTTY1B	21164	+	NR_003589	6279605	6279605	5
chrY	6258441	6279605	TTTY1	21164	+	NR_001538	6279605	6279605	5
chrY	6274284	6296485	TTTY2B	22201	-	NR_003590	6296485	6296485	8
chrY	6274284	6296485	TTTY2	22201	-	NR_001536	6296485	6296485	8
chrY	6311474	6315118	TTTY21B	3644	+	NR_003588	6315118	6315118	2
chrY	6311474	6315118	TTTY21	3644	+	NR_001535	6315118	6315118	2
chrY	6317508	6325947	TTTY7B	8439	+	NR_003592	6325947	6325947	6
chrY	6317508	6325947	TTTY7	8439	+	NR_001534	6325947	6325947	7
chrY	6339071	6341671	TTTY8B	2600	-	NR_003591	6341671	6341671	3
chrY	6339071	6341671	TTTY8	2600	-	NR_001533	6341671	6341671	3
chrY	6733958	6742068	AMELY	8110	-	NM_001143	6734113	6740649	6
chrY	6778726	6959724	TBL1Y	180998	+	NM_033284	6893125	6959533	19
chrY	7142012	7249588	PRKY	107576	+	NR_028062	7249588	7249588	8
chrY	7567397	7569288	TTTY16	1891	-	NR_001552	7569288	7569288	2
chrY	7672964	7678723	TTTY12	5759	+	NR_001551	7678723	7678723	2
chrY	8551410	8551919	TTTY18	509	-	NR_001550	8551919	8551919	2
chrY	8572512	8573324	TTTY19	812	+	NR_001549	8573324	8573324	2
chrY	8651358	8685423	TTTY11	34065	-	NR_001548	8685423	8685423	5
chrY	9154669	9160483	RBMY1A3P	5814	-	NR_001547	9160483	9160483	4
chrY	9167488	9172441	TTTY20	4953	-	NR_001546	9172441	9172441	2
chrY	9195451	9198202	TSPY8	2751	+	NM_001243721	9195451	9198014	6
chrY	9207465	9213071	FAM197Y2P	5606	-	NR_001553	9213071	9213071	4
chrY	9207465	9213071	FAM197Y5P	5606	-	NR_046300	9213071	9213071	4
chrY	9236029	9238826	TSPY3	2797	+	NM_001077697	9236075	9238638	6
chrY	9236048	9238663	TSPY10	2615	+	NM_001282469	9236075	9238638	6
chrY	9236075	9368285	TSPY4	132210	+	NM_001164471	9236075	9368097	7
chrY	9304563	9307358	TSPY1	2795	+	NM_003308	9304609	9307170	6
chrY	9448329	9452762	RBMY3AP	4433	-	NR_001573	9452762	9452762	3
chrY	9638761	9650854	TTTY22	12093	+	NR_001539	9650854	9650854	5
chrY	14517914	14533389	GYG2P1	15475	-	NR_033667	14533389	14533389	5
chrY	14774297	14804153	TTTY15	29856	+	NR_001545	14804153	14804153	4
chrY	14813159	14972768	USP9Y	159609	+	NM_004654	14821380	14971341	46
chrY	15016696	15032390	DDX3Y	15694	+	NM_004660	15016847	15030034	17
chrY	15360258	15592550	UTY	232292	-	NR_047618	15592550	15592550	32
chrY	15815446	15817902	TMSB4Y	2456	+	NM_004202	15816215	15817139	2
chrY	16097651	16098388	VCY1B	737	-	NM_181880	16097750	16098320	2
chrY	16097651	16098392	VCY	741	-	NM_004679	16097750	16098320	2
chrY	16634487	16955848	NLGN4Y	321361	+	NM_001206850	16835028	16953142	6
chrY	16905521	16915913	NLGN4Y-AS1	10392	-	NR_046504	16915913	16915913	4
chrY	19612837	19628622	FAM41AY1	15785	+	NR_028083	19628622	19628622	10
chrY	19612837	19628622	FAM41AY2	15785	+	NR_028084	19628622	19628622	10
chrY	19880859	19882440	XKRY2	1581	-	NM_001002906	19881423	19881777	1
chrY	19880859	19882440	XKRY	1581	-	NM_004677	19881423	19881777	1
chrY	19990139	19992099	CDY2B	1960	-	NM_001001722	19990146	19991772	1
chrY	19990140	19992100	CDY2A	1960	-	NM_004825	19990146	19991772	1
chrY	20488418	20492712	FAM224A	4294	+	NR_002161	20492712	20492712	3
chrY	20488439	20492736	FAM224B	4297	+	NR_002160	20492736	20492736	3
chrY	20743091	20752407	TTTY9A	9316	-	NR_001530	20752407	20752407	5
chrY	20743091	20752407	TTTY9B	9316	-	NR_002159	20752407	20752407	5
chrY	20893325	20935601	HSFY1	42276	-	NR_003510	20935601	20935601	6
chrY	20893325	20935621	HSFY2	42296	-	NR_003509	20935621	20935621	6
chrY	21034386	21239433	TTTY14	205047	-	NR_125733	21239433	21239433	5
chrY	21152525	21438350	CD24	285825	-	NM_001291738	21154352	21154595	2
chrY	21617316	21665039	BCORP1	47723	-	NR_033732	21665039	21665039	11
chrY	21729243	21769056	TXLNGY	39813	+	NR_045128	21769056	21769056	10
chrY	21867300	21906825	KDM5D	39525	-	NM_001146705	21867880	21906420	28
chrY	22627553	22681114	TTTY10	53561	-	NR_001542	22681114	22681114	6
chrY	22737596	22755040	EIF1AY	17444	+	NM_004681	22737757	22754232	7
chrY	22917953	22942918	RPS4Y2	24965	+	NM_001039567	22918049	22942918	7
chrY	23544859	23548246	PRORY	3387	-	NM_001282471	23545071	23548149	4
chrY	23557033	23563448	RBMY2EP	6415	-	NR_001574	23563448	23563448	5
chrY	23745485	23756552	TTTY13	11067	-	NR_001537	23756552	23756552	6
chrY	24026222	24040633	RBMY1D	14411	-	NM_001006120	24026500	24038660	12
chrY	24026222	24040633	RBMY1E	14411	-	NM_001006118	24026500	24038660	12
chrY	24026222	24040639	RBMY1A1	14417	-	NM_005058	24026500	24038660	12
chrY	24026222	24040673	RBMY1B	14451	-	NM_001006121	24026500	24038660	12
chrY	24217902	24242154	PRY2	24252	-	NM_001002758	24218469	24230986	5
chrY	24217902	24242154	PRY	24252	-	NM_004676	24218469	24230986	5
chrY	24247838	24293631	LOC101929148	45793	-	NR_110413	24293631	24293631	13
chrY	24291111	24292978	TTTY6	1867	+	NR_001527	24292978	24292978	3
chrY	24291133	24292981	TTTY6B	1848	+	NR_002175	24292981	24292981	3
chrY	24442944	24445023	TTTY5	2079	-	NR_001541	24445023	24445023	2
chrY	24455005	24462352	RBMY2FP	7347	+	NR_002193	24462352	24462352	4
chrY	24455009	24564028	RBMY1F	109019	+	NM_152585	24551594	24563750	12
chrY	24462824	24466531	LOC100652931	3707	+	NR_104151	24466531	24466531	3
chrY	24549622	24564028	RBMY1J	14406	+	NM_001006117	24551594	24563750	12
chrY	24997730	24998862	TTTY17A	1132	+	NR_001526	24998862	24998862	2
chrY	24997730	24998862	TTTY17B	1132	+	NR_002180	24998862	24998862	2
chrY	24997730	24998862	TTTY17C	1132	+	NR_002179	24998862	24998862	2
chrY	25082601	25119431	TTTY4B	36830	+	NR_002178	25119431	25119431	4
chrY	25082601	25119431	TTTY4C	36830	+	NR_002177	25119431	25119431	4
chrY	25082601	25119431	TTTY4	36830	+	NR_001525	25119431	25119431	4
chrY	25275501	25345239	DAZ1	69738	-	NM_004081	25281356	25344947	28
chrY	26191376	26194161	CDY1B	2785	-	NM_001003895	26191750	26193835	2
chrY	26191376	26194161	CDY1	2785	-	NM_004680	26191750	26193835	2
chrY	26329580	26333378	CSPG4P1Y	3798	-	NR_001554	26333378	26333378	2
chrY	26356113	26360978	GOLGA2P2Y	4865	-	NR_001555	26360978	26360978	9
chrY	26356113	26360978	GOLGA2P3Y	4865	-	NR_002195	26360978	26360978	9
chrY	26764150	26785352	BPY2B	21202	+	NM_001002760	26772231	26778157	9
chrY	26764150	26785352	BPY2C	21202	+	NM_001002761	26772231	26778157	9
chrY	26764150	26785352	BPY2	21202	+	NM_004678	26772231	26778157	9
chrY	26979966	27053187	DAZ3	73221	+	NM_020364	26980273	27047322	19
chrY	26979966	27053187	DAZ4	73221	+	NM_001005375	26980273	27047322	23
chrY	26979989	27053187	DAZ2	73198	+	NM_001005785	26980273	27047322	23
chrY	27874636	27879535	TTTY3B	4899	+	NR_002176	27879535	27879535	3
chrY	27874636	27879535	TTTY3	4899	+	NR_001524	27879535	27879535	3
