Chromosome	Start	Stop	Name	Size	Orientation	RefSeq	CStart	CStop	NumExons
chr1	3204562	3661579	Xkr4	457017	-	NM_001011874	3206102	3661429	3
chr1	4280926	4399322	Rp1	118396	-	NM_001195662	4283061	4399268	4
chr1	4481008	4487435	Sox17	6427	-	NM_011441	4481796	4483487	5
chr1	4763278	4775807	Mrpl15	12529	-	NM_025300	4764532	4775758	5
chr1	4797973	4836816	Lypla1	38843	+	NM_008866	4797994	4835097	9
chr1	4847774	4887990	Tcea1	40216	+	NM_001159750	4847994	4886445	10
chr1	4899656	5060366	Rgs20	160710	-	NM_001177795	4900554	5060258	6
chr1	5073166	5152630	Atp6v1h	79464	+	NM_133826	5074531	5152246	14
chr1	5578573	5596214	Oprk1	17641	+	NM_001204371	5579129	5592865	4
chr1	5903787	5907479	Npbwr1	3692	-	NM_010342	5906384	5907374	1
chr1	6204742	6266185	Rb1cc1	61443	+	NM_009826	6220083	6264356	24
chr1	6349411	6384812	Fam150a	35401	+	NM_001195732	6349411	6381185	5
chr1	6477311	6851021	St18	373710	+	NM_001244692	6758978	6848681	24
chr1	7079000	7163709	Pcmtd1	84709	+	NM_183028	7110389	7159963	6
chr1	8349819	9289958	Sntg1	940139	-	NM_001290390	8353555	8794024	21
chr1	9535488	9537536	Rrs1	2048	+	NM_021511	9535604	9536702	1
chr1	9538126	9568049	Adhfe1	29923	+	NM_175236	9538173	9566355	14
chr1	9550913	9621173	2610203C22Rik	70260	-	NR_015470	9621173	9621173	5
chr1	9591347	9617223	3110035E14Rik	25876	+	NM_178399	9591664	9614977	6
chr1	9657491	9690290	Mybl1	32799	-	NM_008651	9659964	9690035	16
chr1	9708702	9738463	Vcpip1	29761	-	NM_173443	9714562	9738237	3
chr1	9737728	9761337	1700034P13Rik	23609	+	NR_040462	9761337	9761337	4
chr1	9788210	9892649	Sgk3	104439	+	NM_133220	9855333	9888971	18
chr1	9898718	9931035	Mcmdc2	32317	+	NM_177722	9901799	9930625	15
chr1	9932105	9934199	Snhg6	2094	-	NR_024067	9934199	9934199	4
chr1	9932550	9932624	Snord87	74	-	NR_004410	9932624	9932624	1
chr1	9950243	9957566	Tcf24	7323	-	NM_001285425	9953488	9957566	2
chr1	9958702	9999217	Ppp1r42	40515	-	NM_145692	9958900	9993444	9
chr1	10014680	10028240	Cops5	13560	-	NM_001277101	10015059	10028091	8
chr1	10028298	10126849	Cspp1	98551	+	NM_026493	10035166	10126226	30
chr1	10127587	10222751	Arfgef1	95164	-	NM_001102430	10128912	10222575	38
chr1	10314799	10710026	Cpa6	395227	-	NM_177834	10315204	10709808	11
chr1	10983545	11293763	Prex2	310218	+	NM_029525	10983873	11287834	40
chr1	11404185	11965983	A830018L16Rik	561798	+	NM_177173	11404649	11965047	14
chr1	12416066	12416187	Mir6341	121	+	NR_105759	12416187	12416187	1
chr1	12657643	12663171	Gm17644	5528	+	NR_045297	12663171	12663171	3
chr1	12682510	12850453	Sulf1	167943	+	NM_001198565	12776607	12848923	22
chr1	12856630	12981216	Slco5a1	124586	-	NM_172841	12861948	12980576	9
chr1	13103508	13117244	Prdm14	13736	-	NM_001081209	13104340	13115916	8
chr1	13129185	13364164	Ncoa2	234979	-	NM_008678	13132841	13214775	23
chr1	13554773	13579991	Tram1	25218	-	NM_028173	13556403	13579803	11
chr1	13615979	13650590	Lactb2	34611	-	NM_145381	13616941	13650531	7
chr1	13658851	13691804	Xkr9	32953	+	NM_001011873	13662573	13691464	4
chr1	13775765	13777010	Gm5523	1245	-	NR_004447	13777010	13777010	1
chr1	14159038	14300280	Eya1	141242	-	NM_010164	14160996	14292974	18
chr1	14743428	14746047	Msc	2619	-	NM_010827	14744319	14745829	2
chr1	14862728	14908943	Trpa1	46215	-	NM_177781	14863586	14908916	27
chr1	15302532	15704295	Kcnb2	401763	+	NM_001098528	15302532	15701710	2
chr1	15795726	15834133	Terf1	38407	+	NM_009352	15795758	15833163	10
chr1	15843942	15882803	Sbspon	38861	-	NM_001033288	15845825	15882733	5
chr1	16056059	16083406	4930444P10Rik	27347	-	NM_001305227	16056206	16071037	6
chr1	16091375	16094514	Rpl7	3139	-	NM_011291	16091808	16094459	7
chr1	16095962	16122631	Rdh10	26669	+	NM_133832	16096098	16121498	6
chr1	16218890	16509383	Stau2	290493	-	NM_025303	16219853	16476214	14
chr1	16530868	16609419	Ube2w	78551	-	NM_001271016	16531852	16609419	7
chr1	16631805	16647200	Tceb1	15395	-	NM_001310470	16633368	16638039	5
chr1	16647632	16652359	D030040B21Rik	4727	+	NR_037998	16652359	16652359	4
chr1	16655271	16668356	Tmem70	13085	+	NM_026392	16655388	16667506	3
chr1	16678536	16699686	Ly96	21150	+	NM_001159711	16678588	16699618	5
chr1	16985020	17087970	Jph1	102950	-	NM_020604	16987559	17087685	5
chr1	17135453	17154351	Gdap1	18898	+	NM_010267	17135552	17151590	6
chr1	17591981	17621020	Pi15	29039	+	NM_053191	17592659	17615051	6
chr1	17666107	17717727	Gm16070	51620	-	NR_130314	17717727	17717727	7
chr1	17717497	17756288	Crispld1	38791	+	NM_031402	17718737	17754195	15
chr1	18105271	18127132	Crisp4	21861	-	NM_030033	18105709	18127131	7
chr1	18200133	18213645	Defb44-ps	13512	-	NR_002879	18213645	18213645	2
chr1	18226553	18227524	Defb18	971	-	NM_001039123	18226553	18227524	2
chr1	18241058	18255219	Defb41	14161	-	NM_183124	18241280	18255161	2
chr1	18250604	18255219	Gm15386	4615	-	NM_001040027	18250604	18255161	2
chr1	19093102	19156413	Tfap2d	63311	+	NM_153154	19093336	19156259	8
chr1	19198994	19228926	Tfap2b	29932	+	NM_001286340	19199248	19226711	8
chr1	20047859	20608138	Pkhd1	560279	-	NM_153179	20048378	20605404	67
chr1	20346534	20382381	4930486I03Rik	35847	+	NR_045734	20382381	20382381	3
chr1	20659962	20673039	Linc-md1	13077	+	NR_131249	20673039	20673039	3
chr1	20669090	20669163	Mir206	73	+	NR_029593	20669163	20669163	1
chr1	20672849	20672968	Mir133b	119	+	NR_029902	20672968	20672968	1
chr1	20720985	20724577	Il17a	3592	+	NM_010552	20721042	20723940	3
chr1	20767229	20774351	Il17f	7122	-	NM_145856	20767847	20774280	3
chr1	20793094	20810294	Mcm3	17200	-	NM_008563	20793536	20810289	17
chr1	20878730	20880554	6720483E21Rik	1824	-	NR_040492	20880554	20880554	4
chr1	20880702	20928837	Paqr8	48135	+	NM_028829	20924704	20925769	3
chr1	20941706	20980922	Efhc1	39216	+	NM_027974	20941814	20980769	11
chr1	20991477	21069306	Tram2	77829	-	NM_177409	20991642	21069194	11
chr1	21208655	21220248	Tmem14a	11593	+	NM_029398	21215654	21219711	5
chr1	21230665	21255656	Gsta3	24991	+	NM_001077353	21239852	21255043	8
chr1	21275326	21288393	Gm4956	13067	-	NR_002858	21288393	21288393	6
chr1	21339757	21342280	Khdc1a	2523	+	NM_183322	21340100	21341174	3
chr1	21358411	21359824	Khdc1c	1413	+	NM_001033904	21358738	21359808	3
chr1	21373636	21376465	Khdc1b	2829	+	NM_001113187	21374017	21374980	3
chr1	21388479	21952731	Kcnq5	564252	-	NM_001310477	21392243	21951662	13
chr1	22278502	22812563	Rims1	534061	-	NM_053270	22278502	22812563	32
chr1	23107312	23109092	4933415F23Rik	1780	-	NM_025746	23108608	23109070	1
chr1	23279107	23279178	Mir30a	71	+	NR_029533	23279178	23279178	1
chr1	23298539	23298623	Mir30c-2	84	+	NR_029717	23298623	23298623	1
chr1	23373262	23390014	Ogfrl1	16752	-	NM_001081079	23376587	23389890	7
chr1	23768764	23854697	B3gat2	85933	+	NM_172124	23769473	23852026	4
chr1	23852463	23929220	Smap1	76757	-	NM_028534	23853267	23928994	10
chr1	24002777	24012479	Sdhaf4	9702	-	NM_026503	24003089	24012439	3
chr1	24017596	24107180	Fam135a	89584	-	NM_026604	24019130	24092326	21
chr1	24184448	24259577	Col9a1	75129	+	NM_007740	24184693	24258700	38
chr1	24264521	24594276	Col19a1	329755	-	NM_007733	24271528	24582262	51
chr1	24685382	24823146	Lmbrd1	137764	+	NM_026719	24685595	24819581	16
chr1	25124320	25886552	Adgrb3	762232	-	NM_175642	25125012	25883605	31
chr1	25333248	25334799	Gm20172	1551	-	NM_001204913	25333416	25333791	1
chr1	26738645	26744305	4931408C20Rik	5660	-	NM_001033764	26738796	26744271	2
chr1	28832966	28837097	Gm597	4131	-	NM_001013750	28833103	28837043	2
chr1	29478332	29478457	Mir6342	125	+	NR_105760	29478457	29478457	1
chr1	30859186	30920101	Phf3	60915	-	NM_001081080	30860643	30920075	15
chr1	30997147	31006600	Ptp4a1	9453	-	NM_011200	31000050	31002987	6
chr1	30998436	31006555	Gm13363	8119	-	NR_002688	31006555	31006555	7
chr1	31197922	31279501	4931428L18Rik	81579	-	NR_033445	31279501	31279501	3
chr1	31233279	31261570	Lgsn	28291	+	NM_153601	31233295	31261375	5
chr1	31279683	31281132	Pih1d3	1449	+	NM_029062	31279783	31280440	1
chr1	31321691	31324906	Gm4850	3215	+	NR_015347	31324906	31324906	2
chr1	32229650	32714583	Khdrbs2	484933	+	NM_133235	32229762	32714386	9
chr1	32576407	32577844	Gm9839	1437	-	NM_001199956	32576407	32577844	1
chr1	32600390	32604138	Gm5415	3748	-	NM_001164286	32602235	32603672	1
chr1	33510652	33726639	Prim2	215987	-	NM_008922	33510930	33725856	14
chr1	33726668	33727557	1700001G17Rik	889	+	NR_033199	33727557	33727557	1
chr1	33776740	33799409	Rab23	22669	+	NM_008999	33780695	33796237	8
chr1	33802328	33814595	Bag2	12267	-	NM_145392	33803451	33814536	3
chr1	33818385	33871440	Zfp451	53055	-	NM_133817	33819007	33871203	15
chr1	33892743	33895759	Gm15455	3016	-	NM_001161816	33892966	33895525	1
chr1	33908896	33964612	Bend6	55716	-	NM_001310484	33910198	33935216	6
chr1	33965069	34365507	Dst	400438	+	NM_001276764	33965116	34364437	103
chr1	34174203	34174276	Mir6896	73	+	NR_105861	34174276	34174276	1
chr1	34489965	34490044	Mir5103	79	-	NR_039562	34490044	34490044	1
chr1	34493514	34496517	Ccdc115	3003	-	NM_027159	34494342	34496183	5
chr1	34496673	34502592	Imp4	5919	+	NM_178601	34496769	34501315	9
chr1	34516590	34530624	Ptpn18	14034	+	NM_011206	34516668	34530491	15
chr1	34555274	34559907	Prss39	4633	+	NM_009355	34555301	34559792	5
chr1	34592492	34601156	Cfc1	8664	+	NM_007685	34592747	34600982	6
chr1	34609176	34617788	Prss40	8612	-	NM_009356	34609339	34617749	5
chr1	34636537	34647789	Amer3	11252	+	NM_213727	34643526	34645869	2
chr1	34690379	34693055	AA619741	2676	-	NR_033627	34693055	34693055	1
chr1	34858566	34869599	Arhgef4	11033	+	NM_183019	34861812	34868674	10
chr1	34870062	34899895	Fam168b	29833	-	NM_001160235	34874858	34893647	8
chr1	34906803	34936430	Plekhb2	29627	+	NM_145516	34918725	34933892	8
chr1	36125244	36163291	Hs6st1	38047	+	NM_015818	36125502	36161066	2
chr1	36196872	36301147	Uggt1	104275	-	NM_198899	36201070	36300972	41
chr1	36201096	36201158	Mir6897	62	-	NR_105862	36201158	36201158	1
chr1	36321446	36330270	Neurl3	8824	-	NM_153408	36323204	36330210	4
chr1	36364577	36380874	Arid5a	16297	+	NM_001290726	36368722	36377048	8
chr1	36392574	36426026	Kansl3	33452	-	NM_001310513	36394475	36424828	22
chr1	36405526	36405603	Mir6898	77	-	NR_105863	36405603	36405603	1
chr1	36429135	36478955	Fer1l5	49820	+	NM_001277076	36429135	36478754	53
chr1	36480030	36502116	Lman2l	22086	-	NM_001310517	36481205	36502078	9
chr1	36528441	36565621	Cnnm4	37180	+	NM_033570	36528537	36563451	7
chr1	36568720	36585082	Cnnm3	16362	+	NM_001039551	36568755	36580928	9
chr1	36587037	36593401	Ankrd23	6364	-	NM_001310521	36588390	36589512	9
chr1	36595015	36604097	Ankrd39	9082	-	NM_026241	36596235	36604030	4
chr1	36605483	36615226	Sema4c	9743	-	NM_001126047	36606383	36612885	15
chr1	36619540	36740028	Fam178b	120488	-	NM_001126046	36619832	36717792	15
chr1	36748331	36750233	Cox5b	1902	+	NM_009942	36748431	36750154	4
chr1	36756046	36766770	Actr1b	10724	-	NM_146107	36756920	36766698	11
chr1	36771382	36814805	4933424G06Rik	43423	+	NR_040290	36814805	36814805	9
chr1	36818642	36839665	Zap70	21023	+	NM_009539	36827655	36839429	13
chr1	36849033	36996372	Tmem131	147339	-	NM_018872	36849765	36996190	41
chr1	37275122	37320229	Cnga3	45107	+	NM_001282010	37289089	37318941	8
chr1	37356682	37467585	Inpp4a	110903	+	NM_001290797	37414763	37465104	26
chr1	37473929	37486948	Coa5	13019	-	NM_198006	37477430	37486812	3
chr1	37487016	37495969	Unc50	8953	+	NM_026123	37488141	37495663	6
chr1	37496184	37597861	Mgat4a	101677	-	NM_173870	37501503	37592977	16
chr1	37542695	37545450	4930594C11Rik	2755	-	NR_024017	37545450	37545450	1
chr1	37668520	37776656	2010300C02Rik	108136	-	NM_028096	37669101	37701475	10
chr1	37811416	37921927	Tsga10	110511	-	NM_207228	37812341	37898080	20
chr1	37929050	37933143	Lipt1	4093	+	NM_001037918	37931709	37932831	2
chr1	37935734	37947256	Mitd1	11522	-	NM_026913	37936112	37947155	7
chr1	37947397	37955178	Mrpl30	7781	+	NM_027098	37950809	37955109	6
chr1	37962767	37973338	Lyg2	10571	-	NM_001033427	37964401	37972607	6
chr1	38003582	38014604	Lyg1	11022	-	NM_027111	38003729	38009627	6
chr1	38040711	38054053	Txndc9	13342	-	NM_172054	38044506	38052666	5
chr1	38054854	38112424	Eif5b	57570	+	NM_198303	38055134	38108558	24
chr1	38109630	38186507	Rev1	76877	-	NM_019570	38109931	38165302	23
chr1	38232835	38684089	Aff3	451254	-	NM_001290814	38236293	38683986	22
chr1	38851353	38878060	Lonrf2	26707	-	NM_001029878	38854873	38878060	11
chr1	38920717	38955005	Chst10	34288	-	NM_145142	38922342	38952803	7
chr1	38995993	39007121	Nms	11128	+	NM_001011684	38996130	39005512	10
chr1	39044658	39054081	Pdcl3	9423	+	NM_026850	39044688	39053128	6
chr1	39243740	39243837	Mir6349	97	-	NR_105767	39243837	39243837	1
chr1	39251116	39420085	Npas2	168969	+	NM_008719	39320188	39418852	21
chr1	39424695	39428755	Rpl31	4060	+	NM_001252219	39424993	39428178	5
chr1	39428341	39535592	Tbc1d8	107251	-	NM_018775	39429193	39535411	20
chr1	39592646	39603722	Cnot11	11076	+	NM_028043	39592683	39602111	7
chr1	39605591	39605685	Snord89	94	-	NR_028555	39605685	39605685	1
chr1	39608143	39634192	Rnf149	26049	-	NM_001033135	39609316	39634119	7
chr1	39675250	39708027	Creg2	32777	-	NM_170597	39679940	39707785	4
chr1	39722145	39777834	Rfx8	55689	-	NM_001145660	39722307	39777787	15
chr1	39860985	39862177	Gm3646	1192	-	NM_001177348	39861027	39862022	2
chr1	39899272	39904175	1700066B17Rik	4903	-	NR_040465	39904175	39904175	5
chr1	39957757	40083155	Map4k4	125398	+	NM_001252200	39958074	40081557	32
chr1	40133056	40142696	Gm16894	9640	-	NR_037980	40142696	40142696	4
chr1	40141612	40182070	Il1r2	40458	+	NM_010555	40159273	40182052	9
chr1	40281924	40373022	Il1r1	91098	+	NM_008362	40282148	40370238	11
chr1	40381471	40422316	Il1rl2	40845	+	NM_133193	40383339	40422290	11
chr1	40496473	40522259	Il1rl1	25786	+	NM_001025602	40497594	40519014	11
chr1	40522850	40557699	Il18r1	34849	+	NM_008365	40528601	40555535	11
chr1	40572206	40608550	Il18rap	36344	+	NM_010553	40581157	40605933	13
chr1	40637071	40687576	Slc9a4	50505	+	NM_177084	40637360	40686437	12
chr1	40738556	40825730	Slc9a2	87174	+	NM_001033289	40738718	40824844	12
chr1	40828884	40847502	Mfsd9	18618	-	NM_172499	40830597	40847464	6
chr1	40862445	40912112	Tmem182	49667	+	NM_001081198	40862600	40911861	5
chr1	41224404	41238097	4930448I06Rik	13693	-	NR_040475	41238097	41238097	3
chr1	42705044	42751670	Pantr1	46626	-	NR_027826	42751670	42751670	4
chr1	42753990	42757054	Pou3f3	3064	+	NM_008900	42753990	42755484	1
chr1	42757180	42760021	2900092D14Rik	2841	+	NR_027891	42760021	42760021	1
chr1	42763907	42770299	Pantr2	6392	-	NR_110495	42770299	42770299	4
chr1	42807556	42809731	Dalir	2175	+	NR_130904	42809731	42809731	1
chr1	42908077	42962528	Mrps9	54451	+	NM_023514	42908136	42962341	11
chr1	43009716	43092294	Gpr45	82578	+	NM_053107	43089043	43090165	2
chr1	43104113	43155467	Tgfbrap1	51354	-	NM_001013025	43106503	43132783	13
chr1	43155554	43172791	AI597479	17237	+	NM_133818	43155608	43170087	4
chr1	43179915	43253606	Fhl2	73691	-	NM_001289533	43180358	43210076	6
chr1	43502595	43627363	Nck2	124768	+	NM_010879	43590412	43626187	5
chr1	43787446	43799409	1500015O10Rik	11963	+	NM_024283	43787729	43799251	4
chr1	43807075	43884553	Uxs1	77478	-	NM_026430	43807075	43884553	15
chr1	43990838	44059845	Tpp2	69007	+	NM_009418	43990933	44059038	30
chr1	44066252	44076851	Mettl21c	10599	-	NM_001013799	44066483	44074112	5
chr1	44143461	44159233	Tex30	15772	-	NM_029368	44143734	44156707	8
chr1	44163390	44175618	Kdelc1	12228	-	NM_023645	44163931	44175344	10
chr1	44176812	44201616	Bivm	24804	+	NM_144558	44183236	44199987	10
chr1	44204588	44238105	Ercc5	33517	+	NM_011729	44204907	44237927	15
chr1	44260914	44275776	Mettl21e	14862	-	NM_207281	44263194	44275001	5
chr1	44608515	44853681	Gulp1	245166	+	NM_028450	44746032	44851866	11
chr1	44796519	44801794	4930521E06Rik	5275	-	NR_040602	44801794	44801794	3
chr1	45368382	45406551	Col3a1	38169	+	NM_009930	45368592	45405592	51
chr1	45431175	45560127	Col5a2	128952	-	NM_007737	45432928	45559759	54
chr1	45852345	45880458	Wdr75	28113	+	NM_028599	45852366	45880360	21
chr1	45964914	45982439	Slc40a1	17525	-	NM_016917	45966250	45982108	8
chr1	46077259	46087282	Stk-ps2	10023	-	NR_037691	46087282	46087282	4
chr1	46123582	46430395	Dnah7b	306813	+	NM_001160386	46123582	46430284	66
chr1	46482362	46864322	Dnah7c	381960	+	NM_001310335	46482457	46864210	65
chr1	46864388	46910354	Slc39a10	45966	-	NM_172653	46866797	46892985	10
chr1	47523864	47523969	Mir6350	105	-	NR_105768	47523969	47523969	1
chr1	50984366	51244114	Tmeff2	259748	+	NM_019790	50984791	51242325	10
chr1	51275229	51390623	9330175M20Rik	115394	-	NR_045151	51390623	51390623	5
chr1	51345969	51359804	Sdpr	13835	+	NM_138741	51346229	51358266	2
chr1	51526331	51535243	Nabp1	8912	-	NM_028696	51528088	51534759	6
chr1	51806601	51972822	Myo1b	166221	-	NM_001161817	51808016	51940061	31
chr1	52043991	52164033	Stat4	120042	+	NM_001308266	52068627	52163780	25
chr1	52176281	52218709	Stat1	42428	+	NM_001205314	52179437	52216141	25
chr1	52220293	52290076	Gls	69783	-	NM_001081081	52223001	52289836	18
chr1	52512692	52557292	Nab1	44600	-	NM_008667	52516061	52547580	8
chr1	52687548	52708763	Tmem194b	21215	+	NM_001142647	52687601	52706688	9
chr1	52713147	52784162	Mfsd6	71015	-	NM_133829	52715185	52766548	7
chr1	52846263	52874532	Inpp1	28269	-	NM_008384	52846511	52856332	6
chr1	52901881	52977830	Hibch	75949	+	NM_146108	52901953	52977222	14
chr1	52981970	53009684	1700019D03Rik	27714	-	NM_144953	52982090	52982411	2
chr1	53118483	53124923	Mstn	6440	+	NM_010834	53118609	53123475	3
chr1	53215420	53244461	1700019A02Rik	29041	-	NM_027070	53215590	53244445	9
chr1	53246030	53353872	Pms1	107842	-	NM_153556	53246177	53338916	13
chr1	53353938	53367089	Ormdl1	13151	+	NM_145517	53355822	53365806	4
chr1	53370467	53383186	Osgepl1	12719	+	NR_104361	53383186	53383186	9
chr1	53401460	53409596	Asnsd1	8136	-	NM_001290984	53401573	53405310	6
chr1	53453845	53763628	Dnah7a	309783	-	NM_001252070	53453950	53763536	66
chr1	53812355	53842059	Stk17b	29704	-	NM_133810	53814331	53833482	8
chr1	53863717	54251878	Hecw2	388161	-	NM_001001883	53870065	54097336	29
chr1	53906267	53906339	Mir7681	72	+	NR_106149	53906339	53906339	1
chr1	54307526	54425571	Ccdc150	118045	+	NM_030025	54307672	54425243	28
chr1	54452720	54495870	Gtf3c3	43150	-	NM_001033194	54454723	54495758	18
chr1	54529843	54614528	Pgap1	84685	-	NM_001163314	54537549	54614424	27
chr1	54702183	54983231	Ankrd44	281048	-	NM_001081433	54705120	54983010	28
chr1	55042012	55084322	Sf3b1	42310	-	NM_031179	55044177	55084210	25
chr1	55109613	55129546	Coq10b	19933	+	NM_001039710	55109718	55128647	5
chr1	55134677	55144776	Hspd1	10099	-	NM_010477	55135131	55143783	12
chr1	55144991	55148161	Hspe1	3170	+	NM_008303	55145253	55147964	4
chr1	55188088	55211743	Mob4	23655	+	NM_025283	55188143	55209650	8
chr1	55227003	55283626	Rftn2	56623	-	NM_028713	55228653	55283103	9
chr1	55294020	55296902	Mars2	2882	+	NM_175439	55294083	55295844	1
chr1	55356912	55420313	Boll	63401	-	NM_029267	55356912	55420163	10
chr1	55462789	55811129	Plcl1	348340	+	NM_001114663	55463231	55808307	6
chr1	55988084	56028942	9130227L01Rik	40858	+	NR_045837	56028942	56028942	6
chr1	56075821	56077047	1700003I22Rik	1226	+	NR_126076	56077047	56077047	2
chr1	56692892	56694295	Hsfy2	1403	-	NM_027661	56693041	56694220	1
chr1	56850824	57028178	Satb2	177354	-	NM_139146	56853626	57026665	11
chr1	57028312	57032040	9130024F11Rik	3728	+	NR_024326	57032040	57032040	2
chr1	57257488	57271840	BC055402	14352	-	NR_037990	57271840	57271840	7
chr1	57416065	57434388	4930558J18Rik	18323	-	NR_037999	57434388	57434388	4
chr1	57434463	57442266	1700066M21Rik	7803	+	NM_028546	57434514	57440408	2
chr1	57445087	57463518	Tyw5	18431	-	NM_001302962	57445339	57463305	9
chr1	57463391	57472802	9430016H08Rik	9411	+	NM_001081181	57463616	57472578	5
chr1	57831704	58005241	Spats2l	173537	+	NM_144882	57888943	58003307	14
chr1	58011944	58026928	Kctd18	14984	-	NM_001159864	58013171	58024533	7
chr1	58042183	58082741	Sgol2a	40558	+	NM_001177867	58042207	58081643	6
chr1	58086812	58163254	Aox1	76442	+	NM_009676	58086860	58162922	35
chr1	58169979	58257296	Aox3	87317	+	NM_023617	58170102	58257067	35
chr1	58267240	58325440	Aox4	58200	+	NM_023631	58267418	58324657	35
chr1	58335169	58436108	Aox2	100939	+	NM_001008419	58335262	58433159	36
chr1	58449979	58463392	Bzw1	13413	+	NM_025824	58451055	58461910	12
chr1	58468831	58480932	Clk1	12101	-	NM_001042634	58469040	58478778	13
chr1	58487836	58502330	Ppil3	14494	-	NM_027351	58488047	58501435	7
chr1	58504476	58519120	Nif3l1	14644	+	NM_022988	58504500	58518169	6
chr1	58519614	58561953	Orc2	42339	-	NM_001271526	58521047	58558260	18
chr1	58579649	58643177	Fam126b	63528	-	NM_001310598	58586501	58614871	13
chr1	58643240	58652808	Ndufb3	9568	+	NM_025597	58647935	58652649	3
chr1	58709484	58712675	Gm20257	3191	+	NR_045007	58712675	58712675	2
chr1	58714964	58752833	Als2cr12	37869	-	NM_175370	58715267	58749257	15
chr1	58768334	58816053	Cflar	47719	+	NM_001289704	58783280	58810766	10
chr1	58852217	58904347	Casp8	52130	+	NM_009812	58880786	58903598	9
chr1	58957293	59030326	Trak2	73033	-	NM_172406	58960347	59003181	16
chr1	59030414	59051965	Stradb	21551	+	NM_172656	59033897	59051280	12
chr1	59107349	59151744	Als2cr11	44395	-	NM_175200	59107766	59151704	13
chr1	59157436	59176940	Tmem237	19504	-	NM_001033449	59157980	59176858	13
chr1	59177778	59220233	Mpp4	42455	-	NM_001164682	59178096	59218358	23
chr1	59219599	59294075	Als2	74476	-	NM_028717	59221020	59277238	34
chr1	59313750	59409213	Cdk15	95463	+	NM_001033373	59313816	59401201	14
chr1	59538990	59543799	Fzd7	4809	+	NM_008057	59539803	59541522	1
chr1	59573107	59691353	Gm973	118246	+	NM_001013771	59573275	59691106	20
chr1	59696277	59727678	Sumo1	31401	-	NM_009460	59697043	59727535	5
chr1	59741849	59768354	Nop58	26505	+	NM_018868	59742025	59768165	15
chr1	59748801	59748854	Snord70	53	+	NR_028554	59748854	59748854	1
chr1	59761651	59761714	Snord11	63	+	NR_028521	59761714	59761714	1
chr1	59821122	59934925	Bmpr2	113803	+	NM_007561	59821496	59927329	13
chr1	59969849	60042192	Fam117b	72343	+	NM_001037725	59970007	60038571	8
chr1	60045911	60099966	Ica1l	54055	-	NM_001316694	60047967	60085073	11
chr1	60133711	60155344	Wdr12	21633	-	NM_001199060	60135007	60154391	14
chr1	60155090	60210797	Carf	55707	+	NM_001285463	60181982	60207531	18
chr1	60237442	60391549	Nbeal1	154107	+	NM_173444	60238547	60387836	55
chr1	60400143	60444904	Cyp20a1	44761	+	NM_030013	60400229	60444133	13
chr1	60466462	60538007	Abi2	71545	+	NM_001198570	60466646	60534851	12
chr1	60540028	60623609	Raph1	83581	-	NM_001045513	60545143	60590250	14
chr1	60803231	60830203	Cd28	26972	+	NM_007642	60803317	60826629	4
chr1	60965868	60972676	Ctla4	6808	+	NM_009843	60966014	60971561	4
chr1	61034757	61057164	Icos	22407	+	NM_017480	61034802	61054558	5
chr1	61435275	61452748	9530026F06Rik	17473	+	NR_040483	61452748	61452748	5
chr1	61685397	62688858	Pard3b	1003461	+	NM_001081050	61685816	62684497	23
chr1	62749890	62865266	Nrp2	115376	+	NM_001077403	62750778	62862211	17
chr1	62837491	62841306	4930487H11Rik	3815	-	NR_040601	62841306	62841306	3
chr1	63094374	63160841	Ino80d	66467	-	NM_001081436	63104556	63132875	12
chr1	63161044	63204869	Ino80dos	43825	+	NR_045915	63204869	63204869	4
chr1	63190165	63223396	Ndufs1	33231	-	NM_001160039	63190404	63217483	20
chr1	63223404	63227060	Eef1b2	3656	+	NM_018796	63223785	63226186	6
chr1	63225596	63225709	Snora41	113	+	NR_028558	63225709	63225709	1
chr1	63229144	63260855	Gpr1	31711	-	NM_146250	63229586	63230648	3
chr1	63246931	63361149	Zdbf2	114218	+	NM_001285936	63327391	63356519	7
chr1	63492464	63642675	Adam23	150211	+	NM_011780	63492784	63639230	26
chr1	63669424	63733501	Dytn	64077	-	NM_001081658	63669588	63731693	15
chr1	63745400	63776892	Mdh1b	31492	-	NM_029696	63745582	63776866	11
chr1	63777198	63799959	Fastkd2	22761	+	NM_172422	63778060	63798978	12
chr1	63801482	63815841	4933402D24Rik	14359	-	NM_001256158	63802672	63815779	3
chr1	64011300	64015573	Gm13749	4273	+	NR_027824	64015573	64015573	2
chr1	64082246	64167963	Klf7	85717	-	NM_033563	64082286	64167575	4
chr1	64089011	64089075	Mir6899	64	-	NR_105864	64089075	64089075	1
chr1	64579377	64651122	Creb1	71745	+	NM_009952	64597430	64643952	9
chr1	64653053	64663742	Mettl21a	10689	-	NM_025964	64654313	64662993	3
chr1	64726442	64737233	2810408I11Rik	10791	-	NR_038009	64737233	64737233	2
chr1	64737918	64772216	Ccnyl1	34298	+	NM_001097644	64737964	64770213	10
chr1	64777131	64784324	Fzd5	7193	-	NM_001042659	64781416	64783174	2
chr1	64835694	65003398	Plekhm3	167704	-	NM_001039493	64841610	64984883	8
chr1	65059651	65079333	Akr1cl	19682	-	NM_027582	65059840	65077222	10
chr1	65095130	65097737	Cryge	2607	-	NM_007777	65095197	65097687	3
chr1	65108411	65110014	Crygd	1603	-	NM_007776	65108483	65109976	3
chr1	65118098	65120106	Crygc	2008	-	NM_001082573	65118172	65120079	3
chr1	65126795	65128864	Crygb	2069	-	NM_144761	65126865	65128829	3
chr1	65146962	65149937	Cryga	2975	-	NM_007774	65147026	65149911	3
chr1	65151858	65169788	D630023F18Rik	17930	-	NM_001285882	65152302	65169667	8
chr1	65205189	65233053	Idh1	27864	-	NM_001111320	65206038	65221926	9
chr1	65233258	65325270	Pikfyve	92012	+	NM_011086	65236901	65320332	42
chr1	65357830	65435818	Pth2r	77988	+	NM_139270	65358169	65435384	13
chr1	65973095	65974878	Crygf	1783	+	NM_027010	65973131	65974817	3
chr1	66221902	66489157	Map2	267255	+	NM_001039934	66427085	66485581	15
chr1	66515020	66745722	Unc80	230702	+	NM_175510	66515020	66742170	65
chr1	66747404	66766379	Rpe	18975	+	NM_001310643	66761152	66764450	7
chr1	66765816	66864169	Kansl1l	98353	-	NM_001122738	66767349	66848713	15
chr1	66877412	66909883	Acadl	32471	-	NM_007381	66878007	66909823	11
chr1	66970869	66991630	Myl1	20761	-	NM_021285	66971610	66991479	7
chr1	67047090	67085446	Lancl1	38356	-	NM_021295	67050054	67085149	10
chr1	67169600	67277841	Cps1	108241	+	NM_001080809	67169738	67276920	38
chr1	68078760	69154633	Erbb4	1075873	-	NM_010154	68086614	69154330	27
chr1	69577783	69732534	Ikzf2	154751	-	NM_011770	69585341	69730731	8
chr1	69873543	70771706	Spag16	898163	+	NM_029160	69873577	70771516	17
chr1	70772288	70931971	Vwc2l	159683	+	NM_177164	70775352	70928789	4
chr1	71074108	71149546	Bard1	75438	-	NM_007525	71077093	71149381	11
chr1	71289663	71461484	Abca12	171821	-	NM_175210	71289870	71461156	53
chr1	71603729	71625977	Atic	22248	+	NM_026195	71603829	71625245	16
chr1	71632046	71699808	Fn1	67762	-	NM_010233	71632785	71699556	46
chr1	71699908	71709417	Apol7d	9509	+	NR_040308	71709417	71709417	4
chr1	71934685	71937778	Gm8883	3093	+	NR_027659	71937778	71937778	3
chr1	72005571	72051769	4933417E11Rik	46198	-	NR_040454	72051769	72051769	3
chr1	72205806	72258881	Mreg	53075	-	NM_001005423	72207458	72258685	5
chr1	72305746	72330888	Pecr	25142	-	NM_023523	72305921	72330790	8
chr1	72330946	72349569	Tmem169	18623	+	NM_175564	72344481	72347880	3
chr1	72353994	72441527	Xrcc5	87533	+	NM_009533	72354120	72441296	21
chr1	72473685	72583138	March4	109453	-	NM_001045533	72475215	72581711	4
chr1	72629824	72683364	Smarcal1	53540	+	NM_018817	72632269	72679628	17
chr1	72689553	72747138	Ankar	57585	-	NM_176980	72689580	72745595	24
chr1	72757833	72760387	Rpl37a	2554	+	NM_009084	72757894	72760139	4
chr1	72871053	72899045	Igfbp2	27992	+	NM_008342	72871153	72898736	4
chr1	72904638	72921439	Igfbp5	16801	-	NM_010518	72908950	72920713	4
chr1	73061648	73062473	Tnp1	825	-	NM_009407	73061870	73062437	2
chr1	73062609	73072082	1700027A15Rik	9473	+	NR_038001	73072082	73072082	3
chr1	73437958	73454143	Pinc	16185	-	NR_003202	73454143	73454143	5
chr1	73445541	73477353	D530049I02Rik	31812	+	NR_040605	73477353	73477353	3
chr1	73664954	73911040	6030407O03Rik	246086	-	NR_045311	73911040	73911040	9
chr1	73902050	73902149	Mir6351	99	-	NR_105769	73902149	73902149	1
chr1	73956804	74171023	Tns1	214219	-	NM_001289895	73961103	74171021	33
chr1	74172114	74194804	Rufy4	22690	+	NM_001170641	74174251	74194320	12
chr1	74200567	74207820	Cxcr2	7253	+	NM_009909	74204922	74206002	2
chr1	74238359	74241205	Cxcr1	2846	-	NM_178241	74238379	74239435	2
chr1	74253127	74253194	Mir1928	67	-	NR_035449	74253194	74253194	1
chr1	74283123	74314787	Arpc2	31664	+	NM_029711	74283399	74314369	10
chr1	74325173	74326163	Gpbar1	990	+	NM_174985	74325173	74326163	1
chr1	74326413	74331312	Aamp	4899	-	NM_001190444	74326807	74331197	11
chr1	74331607	74400266	Pnkd	68659	+	NM_001039509	74331644	74398505	10
chr1	74334820	74350910	Tmbim1	16090	-	NM_027154	74335945	74341973	12
chr1	74408681	74415895	Catip	7214	+	NM_001033345	74409208	74415647	10
chr1	74421776	74432625	Slc11a1	10849	+	NM_013612	74421888	74432080	15
chr1	74438182	74443859	Ctdsp1	5677	+	NM_153088	74438471	74442158	7
chr1	74440883	74440968	Mir26b	85	+	NR_029743	74440968	74440968	1
chr1	74455957	74482134	Vil1	26177	+	NM_009509	74461653	74481565	20
chr1	74482083	74590860	Usp37	108777	-	NM_176972	74485964	74542359	26
chr1	74552633	74577416	Rqcd1	24783	+	NM_021383	74553011	74575428	8
chr1	74589462	74612551	Plcd4	23089	+	NM_001081456	74594520	74611940	17
chr1	74612999	74634602	Zfp142	21603	-	NM_029888	74613451	74632237	9
chr1	74634862	74639017	Bcs1l	4155	+	NM_025784	74636132	74638645	8
chr1	74640321	74647971	Rnf25	7650	-	NM_001305230	74640397	74647939	10
chr1	74648028	74683467	Stk36	35439	+	NM_175031	74648691	74682432	27
chr1	74708327	74744547	Ttll4	36220	+	NM_001014974	74725565	74744273	20
chr1	74760108	74784471	Cyp27a1	24363	+	NM_024264	74760204	74784233	9
chr1	74785495	74795529	Prkag3	10034	-	NM_153744	74787278	74795424	14
chr1	74818465	74831893	Wnt6	13428	+	NM_009526	74818719	74831174	4
chr1	74838592	74850749	Wnt10a	12157	+	NM_009518	74838744	74850194	4
chr1	74901602	74904306	Cdk5r2	2704	+	NM_009872	74901671	74902781	1
chr1	74928082	74931982	Fev	3900	-	NM_153111	74928649	74931784	3
chr1	74936507	74939717	Cryba2	3210	-	NM_021541	74936562	74939461	5
chr1	74947231	74947295	Mir375	64	-	NR_029876	74947295	74947295	1
chr1	74948653	74982173	Ccdc108	33520	-	NM_001039495	74948708	74979772	33
chr1	74991888	74998246	Ihh	6358	-	NM_010544	74992662	74997788	3
chr1	75013919	75121800	Nhej1	107881	-	NM_029342	75014267	75093214	6
chr1	75122115	75130464	Slc23a3	8349	-	NM_194333	75122302	75130429	12
chr1	75131788	75138942	Cnppd1	7154	-	NM_026977	75132972	75138058	9
chr1	75139359	75144483	Fam134a	5124	+	NM_001305231	75139436	75143629	10
chr1	75165219	75168200	Zfand2b	2981	+	NM_001159905	75165425	75167854	10
chr1	75168214	75176966	Abcb6	8752	-	NM_023732	75168453	75176692	19
chr1	75177434	75188584	Atg9a	11150	-	NM_001288613	75178499	75183374	16
chr1	75188733	75195960	Ankzf1	7227	+	NM_026187	75189025	75195762	14
chr1	75194809	75207353	Glb1l	12544	-	NM_029010	75196068	75206015	17
chr1	75207403	75212181	Stk16	4778	+	NM_011494	75207903	75210527	8
chr1	75211546	75215869	Tuba4a	4323	-	NM_009447	75212196	75215770	4
chr1	75216669	75228668	A630095N17Rik	11999	-	NM_001243090	75217034	75228649	3
chr1	75232997	75242267	Dnajb2	9270	+	NM_001159884	75233458	75241379	10
chr1	75243615	75260783	Ptprn	17168	-	NM_008985	75244123	75260702	23
chr1	75268776	75274955	Resp18	6179	-	NM_009049	75268885	75274882	6
chr1	75305139	75314212	Dnpep	9073	-	NM_001110831	75305233	75313915	15
chr1	75356866	75365154	Des	8288	+	NM_010043	75356992	75363625	9
chr1	75364784	75371590	Gm15179	6806	-	NR_037976	75371590	75371590	4
chr1	75371871	75428881	Speg	57010	+	NM_007463	75372014	75428026	41
chr1	75432517	75439751	Gmppa	7234	+	NM_133708	75433373	75439576	13
chr1	75447084	75470915	Asic4	23831	+	NM_183022	75447406	75470207	10
chr1	75471143	75476046	Chpf	4903	-	NM_001001565	75471544	75474221	5
chr1	75476106	75482268	Tmem198	6162	+	NM_177056	75476806	75481559	5
chr1	75482399	75503027	Obsl1	20628	-	NM_178884	75482526	75502799	20
chr1	75503651	75506929	Inha	3278	+	NM_010564	75503822	75506738	2
chr1	75518103	75533910	Stk11ip	15807	+	NM_027886	75518363	75532810	25
chr1	75542840	75556006	Slc4a3	13166	+	NM_009208	75543445	75555465	23
chr1	76485707	76498603	Gm17751	12896	+	NR_038013	76498603	76498603	5
chr1	76506134	76506218	Mir6343	84	+	NR_105761	76506218	76506218	1
chr1	77363759	77511663	Epha4	147904	-	NM_007936	77370307	77511606	18
chr1	77493227	77493343	Mir6352	116	-	NR_105770	77493343	77493343	1
chr1	78097841	78193711	Pax3	95870	-	NM_001159520	78099375	78193324	9
chr1	78306920	78416861	Sgpp2	109941	+	NM_001004173	78306993	78414001	5
chr1	78414532	78485472	Farsb	70940	-	NM_001278075	78421768	78485417	18
chr1	78507634	78534748	Mogat1	27114	+	NM_026713	78508536	78534673	7
chr1	78654399	78664176	Utp14b	9777	+	NM_001001981	78660961	78663304	3
chr1	78654399	78704318	Acsl3	49919	+	NM_028817	78678207	78702990	16
chr1	78813523	78816600	Kcne4	3077	+	NM_021342	78814211	78814724	2
chr1	79431243	79436665	Scg2	5422	-	NM_001310680	79431725	79433579	3
chr1	79603450	79668547	Ap1s3	65097	-	NM_183027	79605741	79668427	5
chr1	79698836	79758344	Wdfy1	59508	-	NM_001111279	79702085	79758275	12
chr1	79772592	79778020	Mrpl44	5428	+	NM_001081210	79772707	79777713	4
chr1	79790895	79855240	Serpine2	64345	-	NM_009255	79791579	79818110	9
chr1	80195273	80210519	Fam124b	15246	-	NM_173425	80196484	80210239	2
chr1	80261497	80337265	Cul3	75768	-	NM_001313728	80263730	80318470	17
chr1	80442506	80472235	1700016L21Rik	29729	+	NR_040460	80472235	80472235	3
chr1	80497642	80755128	Dock10	257486	-	NM_175291	80498281	80755023	56
chr1	81073891	81268226	Nyap2	194335	+	NM_172849	81083847	81266127	5
chr1	82128490	82128594	Mir6344	104	+	NR_105762	82128594	82128594	1
chr1	82229679	82288014	Irs1	58335	-	NM_010570	82283372	82287068	2
chr1	82313153	82441941	Rhbdd1	128788	+	NM_029777	82336972	82439529	7
chr1	82447297	82583424	Col4a4	136127	-	NM_007735	82449705	82567990	48
chr1	82583495	82718634	Col4a3	135139	+	NM_007734	82583919	82715459	52
chr1	82721464	82748964	Mff	27500	+	NM_029409	82725830	82748291	9
chr1	82753223	82765031	Tm4sf20	11808	-	NM_025453	82754006	82764992	4
chr1	82836034	82897576	Agfg1	61542	+	NM_010472	82836297	82891633	13
chr1	83009097	83035023	Slc19a3	25926	-	NM_030556	83010393	83022953	7
chr1	83057504	83058496	Krtap28-13	992	+	NM_027778	83057570	83057987	1
chr1	83113340	83115742	Ccl20	2402	+	NM_001159738	83113398	83115292	4
chr1	83156336	83207147	Daw1	50811	+	NR_027636	83207147	83207147	13
chr1	83252355	83404775	Sphkap	152420	-	NM_172430	83253701	83404586	11
chr1	84032867	84281220	Pid1	248353	-	NM_001003948	84034605	84280945	3
chr1	84215423	84215536	Mir6353	113	-	NR_105771	84215536	84215536	1
chr1	84366413	84692796	Dner	326383	-	NM_152915	84367338	84692303	13
chr1	84692413	84692490	Mir5126	77	+	NR_039588	84692490	84692490	1
chr1	84717763	84835879	Trip12	118116	-	NM_133975	84721192	84811495	41
chr1	84836415	84897061	Fbxo36	60646	+	NM_025386	84836447	84896760	4
chr1	84903279	84931658	Slc16a14	28379	-	NM_027921	84903852	84926126	5
chr1	85084713	85106428	A530032D15Rik	21715	-	NM_213615	85085352	85105943	7
chr1	85196185	85210337	Gm7609	14152	+	NM_001081746	85209224	85210115	4
chr1	85242918	85267141	C130026I21Rik	24223	-	NM_175219	85243511	85266639	8
chr1	87473474	87500466	Sp110	26992	-	NM_175397	87473866	87492683	13
chr1	87497277	87541611	Sp140	44334	+	NM_001013817	87497734	87541257	17
chr1	87546562	87606572	Sp100	60010	+	NM_013673	87546676	87605693	20
chr1	87613657	87633181	A630001G21Rik	19524	-	NM_177055	87614767	87623189	6
chr1	87648522	87648649	Mir8096	127	+	NR_106172	87648649	87648649	1
chr1	87671845	87681269	9930111H07Rik	9424	+	NR_108086	87681269	87681269	4
chr1	87690021	87748152	Cab39	58131	+	NM_133781	87714974	87745796	9
chr1	87791084	87805273	Itm2c	14189	+	NM_022417	87791238	87804213	6
chr1	87825057	87828331	4933407L21Rik	3274	+	NR_037692	87828331	87828331	3
chr1	87836111	87857630	Gpr55	21519	-	NM_001033290	87837448	87838432	2
chr1	87918516	87926533	Spata3	8017	+	NM_001122732	87918623	87923094	4
chr1	87942437	87952031	2810459M11Rik	9594	+	NM_001144993	87942537	87949664	3
chr1	87961193	88035870	Psmd1	74677	+	NM_027357	87961364	88033684	25
chr1	87995611	88008545	Htr2b	12934	-	NM_008311	87995917	88007457	4
chr1	88051354	88174859	Armc9	123505	+	NM_030184	88053529	88172257	25
chr1	88199795	88203880	B3gnt7	4085	+	NM_145222	88200118	88202802	2
chr1	88241293	88256030	Ncl	14737	-	NM_010880	88247194	88255798	14
chr1	88247744	88247860	Snora75	116	-	NR_028478	88247860	88247860	1
chr1	88248555	88248702	Gm24148	147	-	NR_106184	88248702	88248702	1
chr1	88252834	88252902	Snord82	68	-	NR_002851	88252902	88252902	1
chr1	88256148	88264539	C130036L24Rik	8391	+	NR_015507	88264539	88264539	2
chr1	88282899	88284716	Nmur1	1817	-	NM_010341	88282899	88284716	2
chr1	88322903	88324624	1700019O17Rik	1721	+	NM_027966	88322945	88324538	1
chr1	88423310	88427273	Ptma	3963	+	NM_008972	88423480	88426587	5
chr1	88439589	88479076	Pde6d	39487	-	NM_008801	88440076	88478924	5
chr1	88483674	88503075	Cops7b	19401	+	NM_172974	88485754	88501791	7
chr1	88562867	88567148	Nppc	4281	-	NM_010933	88566238	88567013	3
chr1	88600378	88946672	Dis3l2	346294	+	NM_001172157	88641351	88946320	22
chr1	88983265	88986503	Alppl2	3238	-	NM_007433	88983622	88986338	11
chr1	88994576	88998181	Alpi	3605	-	NM_001081082	88995177	88998110	11
chr1	89021582	89024487	Akp3	2905	+	NM_007432	89021582	89024487	11
chr1	89044229	89052931	Ecel1	8702	-	NM_021306	89044561	89051564	18
chr1	89079888	89084980	Prss56	5092	+	NM_027084	89080067	89084795	13
chr1	89087171	89096645	Chrnd	9474	+	NM_021600	89087265	89095337	12
chr1	89102385	89108410	Chrng	6025	+	NM_009604	89102399	89108063	12
chr1	89110488	89137063	Eif4e2	26575	+	NM_023314	89110574	89134460	7
chr1	89160938	89207366	Efhd1	46428	+	NM_028889	89161024	89206370	4
chr1	89223572	89347385	Gigyf2	123813	+	NM_146112	89251020	89345720	29
chr1	89281151	89291304	Kcnj13	10153	-	NM_001110227	89282990	89285964	3
chr1	89366838	89372034	3110079O15Rik	5196	+	NM_028473	89366913	89372013	3
chr1	89373403	89470445	Ngef	97042	-	NM_001111314	89374128	89442633	15
chr1	89470601	89494415	Neu2	23814	+	NM_001160163	89476079	89494051	4
chr1	89516886	89617085	Inpp5d	100199	+	NR_122078	89617085	89617085	28
chr1	89652585	89689003	Atg16l1	36418	+	NM_001205391	89652774	89687884	19
chr1	89681145	89681393	Scarna6	248	+	NR_028519	89681393	89681393	1
chr1	89700254	89741732	Sag	41478	+	NM_009118	89701886	89741598	16
chr1	89749861	89841064	Dgkd	91203	+	NM_177646	89749875	89839047	30
chr1	89841695	89905126	Usp40	63431	-	NM_001198573	89843170	89903998	32
chr1	89951985	90116577	Ugt1a10	164592	+	NM_201641	89952056	90114999	5
chr1	89967353	90116577	Ugt1a9	149224	+	NM_201644	89967404	90114999	5
chr1	89991575	90116577	Ugt1a7c	125002	+	NM_201642	89991695	90114999	5
chr1	89999831	90115573	Ugt1a6b	115742	+	NM_201410	90003516	90114999	6
chr1	90031383	90116577	Ugt1a6a	85194	+	NM_145079	90035048	90114999	6
chr1	90062586	90116577	Ugt1a5	53991	+	NM_201643	90062626	90114999	5
chr1	90097185	90116577	Ugt1a2	19392	+	NM_013701	90097211	90114999	5
chr1	90101306	90102323	Dnajb3	1017	-	NM_008299	90101524	90102253	1
chr1	90108533	90116577	Ugt1a1	8044	+	NM_201645	90108576	90114999	5
chr1	90123594	90158864	Mroh2a	35270	+	NM_001281466	90124642	90156601	42
chr1	90155430	90174154	Hjurp	18724	-	NM_198652	90161755	90174044	8
chr1	90159687	90165983	6430706D22Rik	6296	-	NR_040291	90165983	90165983	5
chr1	90161402	90174132	A730008H23Rik	12730	-	NM_172505	90161755	90174044	5
chr1	90203286	90285426	Trpm8	82140	+	NM_134252	90215544	90281288	27
chr1	90303584	90323013	Spp2	19429	+	NM_029269	90303724	90317243	8
chr1	90396445	90406641	Glrp1	10196	-	NM_008132	90397697	90406461	3
chr1	90448091	90458741	Gm19589	10650	+	NR_037971	90458741	90458741	6
chr1	90594800	90598766	Arl4c	3966	-	NM_177305	90597660	90598239	1
chr1	90651464	90652308	Platr5	844	+	NR_040493	90652308	90652308	3
chr1	90912687	90918785	1700067G17Rik	6098	+	NR_040471	90918785	90918785	3
chr1	90967036	91050368	Sh3bp4	83332	+	NM_133816	91034260	91049926	6
chr1	91256916	91302708	C030007H22Rik	45792	-	NR_040482	91302708	91302708	3
chr1	91351385	91791857	Agap1	440472	+	NM_178119	91352004	91785469	18
chr1	91573081	91580467	4933400F21Rik	7386	-	NR_015540	91580467	91580467	4
chr1	91824536	91827751	Gbx2	3215	-	NM_010262	91825194	91827330	2
chr1	91849252	91911152	Asb18	61900	-	NM_139152	91849252	91911152	6
chr1	91938706	92049976	Iqca	111270	-	NM_029122	91939200	92049750	19
chr1	92100554	92112297	Ackr3	11743	+	NM_001271607	92110395	92111484	3
chr1	92499999	92509916	Cops8	9917	+	NM_133805	92500124	92508828	8
chr1	92663434	92740548	Col6a3	77114	-	NM_001243008	92664166	92726807	46
chr1	92811676	92847719	Mlph	36043	+	NM_053015	92818445	92845186	16
chr1	92849684	92850589	Prlh	905	+	NM_001101647	92849684	92850589	2
chr1	92854709	92866197	Rab17	11488	-	NM_008998	92855460	92860877	6
chr1	92895303	93025521	Lrrfip1	130218	+	NM_001111312	92895374	93024773	13
chr1	93041679	93067372	Rbm44	25693	+	NM_001033408	93046677	93065657	16
chr1	93076398	93121773	Ramp1	45375	+	NM_016894	93076665	93119938	3
chr1	93146895	93182602	Ube2f	35707	+	NM_026454	93150852	93181932	10
chr1	93194914	93217657	Scly	22743	+	NM_016717	93194972	93216807	12
chr1	93218651	93244880	Espnl	26229	+	NM_001033292	93218709	93242514	9
chr1	93247649	93258981	Klhl30	11332	+	NM_027551	93250255	93257843	8
chr1	93263006	93270794	Fam132b	7788	+	NM_173395	93263057	93269053	8
chr1	93272407	93295360	Ilkap	22953	-	NM_023343	93272518	93295282	12
chr1	93301456	93302606	1700020N18Rik	1150	-	NR_026924	93302606	93302606	3
chr1	93308059	93309799	Hes6	1740	-	NM_019479	93308634	93309714	4
chr1	93312558	93355905	Per2	43347	-	NM_011066	93314447	93347402	23
chr1	93391244	93425884	Traf3ip1	34640	+	NM_028718	93391342	93424360	15
chr1	93437141	93456167	Asb1	19026	+	NM_001039126	93437389	93451455	5
chr1	93698037	93744611	Twist2	46574	+	NM_007855	93698203	93698686	2
chr1	93825355	94076918	Hdac4	251563	-	NM_207225	93829923	94044854	27
chr1	94336295	94370335	Ndufa10	34040	-	NM_024197	94336415	94370314	10
chr1	94361059	94361119	Mir6900	60	-	NR_105865	94361119	94361119	1
chr1	94376257	94377196	Olfr1416	939	-	NM_147038	94376257	94377196	1
chr1	94387394	94388330	Olfr1415	936	-	NM_001011525	94387394	94388330	1
chr1	94407624	94415092	Olfr1414	7468	-	NM_147039	94407664	94408603	2
chr1	94469701	94470783	Olfr1413	1082	+	NM_147037	94469749	94470721	1
chr1	94484908	94485874	Olfr1412	966	+	NM_146277	94484908	94485874	1
chr1	94493097	94494069	Olfr1411	972	+	NM_146490	94493097	94494069	1
chr1	94504415	94505384	Olfr1410	969	+	NM_146491	94504415	94505384	1
chr1	94516457	94517578	Olfr12	1121	+	NM_206896	94516484	94517486	1
chr1	94533721	94538562	Myeov2	4841	-	NM_001163425	94533942	94538519	3
chr1	94540794	94545418	Otos	4624	-	NM_153114	94540909	94541968	5
chr1	94728262	94756773	Gpc1	28511	+	NM_016696	94728508	94755141	9
chr1	94746954	94747020	Mir149	66	+	NR_029559	94747020	94747020	1
chr1	94766705	94799483	Ankmy1	32778	-	NM_172850	94766848	94799160	18
chr1	94803565	94805197	Dusp28	1632	+	NM_175118	94803631	94804264	2
chr1	94807401	94817162	Rnpepl1	9761	+	NM_181405	94807547	94816432	11
chr1	94830119	94847167	9430060I03Rik	17048	-	NR_015525	94847167	94847167	2
chr1	94830984	94844525	Capn10	13541	+	NM_011796	94831450	94844115	12
chr1	94869695	94882968	Gpr35	13273	+	NM_001104529	94879144	94880068	2
chr1	94902910	94908846	Aqp12	5936	+	NM_177587	94902979	94908700	3
chr1	94912031	94998451	Kif1a	86420	-	NM_008440	94915033	94978998	48
chr1	95031816	95041998	Agxt	10182	+	NM_001276710	95031936	95041744	11
chr1	95047931	95057525	2310007B03Rik	9594	-	NM_172411	95048584	95056706	6
chr1	95064999	95127643	Crocc2	62644	+	NM_001310428	95065301	95125434	32
chr1	95132473	95193025	Sned1	60552	+	NM_172463	95132565	95192855	31
chr1	95171125	95171187	Mir6901	62	+	NR_105866	95171187	95171187	1
chr1	95197781	95202456	Mterf4	4675	-	NM_001310756	95197954	95202422	4
chr1	95206013	95239365	Pask	33352	-	NM_080850	95206668	95234108	18
chr1	95240221	95264195	Ppp1r7	23974	+	NM_023200	95240236	95261643	10
chr1	95242668	95242732	Mir6902	64	+	NR_105867	95242732	95242732	1
chr1	95248734	95248862	Mir6345	128	+	NR_105763	95248862	95248862	1
chr1	95270472	95300881	Ano7	30409	+	NM_001271884	95271718	95299673	24
chr1	95302516	95375494	Hdlbp	72978	-	NM_133808	95304749	95337332	28
chr1	95375569	95406309	Sept2	30740	+	NM_010891	95385722	95403641	13
chr1	95408680	95518553	Farp2	109873	+	NM_145519	95425173	95517948	27
chr1	95517327	95532304	Stk25	14977	-	NM_021537	95519063	95531904	12
chr1	95582151	95592347	Bok	10196	+	NM_016778	95583023	95591739	5
chr1	95601967	95651415	Thap4	49448	-	NM_025920	95602112	95651110	6
chr1	95651609	95686106	Atg4b	34497	+	NM_174874	95651621	95684336	13
chr1	95689152	95698511	Dtymk	9359	-	NM_001105667	95689409	95698404	5
chr1	95700541	95718677	Ing5	18136	+	NM_025454	95700579	95714900	8
chr1	95721816	95748938	D2hgdh	27122	+	NM_178882	95722883	95747403	10
chr1	95757920	95773071	Gal3st2	15151	+	NM_199366	95758170	95771666	4
chr1	95815013	95837816	Gm9994	22803	+	NM_001205249	95815013	95837816	4
chr1	95887085	95908116	Gm6086	21031	+	NM_001039219	95892954	95906102	8
chr1	95917069	95924907	Neu4	7838	+	NM_001310769	95918172	95921993	5
chr1	95934881	95949130	Pdcd1	14249	-	NM_008798	95935881	95949067	5
chr1	96694018	96699049	4930440C22Rik	5031	+	NR_040473	96699049	96699049	4
chr1	97210204	97231861	Fam174a	21657	+	NM_026321	97210393	97230516	3
chr1	97484258	97564171	St8sia4	79913	-	NM_009183	97488258	97563838	5
chr1	97597760	97613095	4930598F16Rik	15335	-	NR_040479	97613095	97613095	4
chr1	97887235	97918335	1700063A18Rik	31100	-	NR_040467	97918335	97918335	3
chr1	98508633	98559150	4930533P14Rik	50517	-	NR_040478	98559150	98559150	3
chr1	98715360	98768748	Slco4c1	53388	-	NM_172658	98715523	98768686	13
chr1	98767702	98777811	Panct2	10109	+	NR_131964	98777811	98777811	4
chr1	98802752	98894137	Slco6b1	91385	-	NR_120500	98894137	98894137	15
chr1	98956025	99024880	Slco6c1	68855	-	NM_028942	98958970	99024751	14
chr1	99540478	99558595	D1Ertd622e	18117	-	NM_133825	99542291	99542915	3
chr1	99602619	99666669	Ppip5k2	64050	-	NM_173760	99604294	99658133	28
chr1	99666748	99690285	Gin1	23537	+	NM_026250	99672030	99689148	8
chr1	99717670	99992209	Pam	274539	-	NM_013626	99718386	99873534	26
chr1	99927699	99944370	B230216N24Rik	16671	-	NR_037993	99944370	99944370	3
chr1	100028043	100041232	1810006J02Rik	13189	+	NR_040439	100041232	100041232	3
chr1	100317700	100405957	Slco6d1	88257	+	NM_027584	100317782	100404190	14
chr1	101669341	102382519	Cntnap5b	713178	+	NM_172851	101669341	102381278	24
chr1	103052344	103071779	Gm20268	19435	+	NR_037989	103071779	103071779	3
chr1	106665395	106892058	Cdh20	226663	+	NM_011800	106830673	106890962	12
chr1	107173493	107253287	Rnf152	79794	-	NM_178779	107180795	107181407	3
chr1	107414998	107560253	Pign	145255	-	NM_013784	107418580	107554399	31
chr1	107560437	107651708	2310035C23Rik	91271	+	NM_173187	107560684	107650200	29
chr1	107677299	107744558	Tnfrsf11a	67259	+	NM_009399	107677328	107741443	10
chr1	107886982	107930654	Zcchc2	43672	+	NM_001122676	107887366	107928740	14
chr1	108049201	108068101	Gm20753	18900	-	NR_040630	108068101	108068101	3
chr1	108068445	108290822	Phlpp1	222377	+	NM_133821	108068580	108289917	17
chr1	108434752	108610867	Bcl2	176115	-	NM_009741	108439840	108609457	2
chr1	108443072	108443208	Mir3473f	136	-	NR_106164	108443208	108443208	1
chr1	108616986	108656319	Kdsr	39333	-	NM_027534	108621478	108656228	10
chr1	108667364	108693302	Vps4b	25938	-	NM_009190	108669023	108693024	11
chr1	108757756	108779925	Serpinb5	22169	+	NM_009257	108766859	108778570	7
chr1	108831025	108853655	Serpinb12	22630	+	NM_027971	108843123	108853374	8
chr1	108877560	108897772	Serpinb13	20212	+	NM_172852	108878731	108897398	8
chr1	108942163	108948880	Serpinb3a	6717	-	NM_009126	108942592	108948347	8
chr1	108974769	108980057	Serpinb3d	5288	-	NM_201376	108974769	108980057	7
chr1	109050537	109057691	Serpinb3b	7154	-	NM_198680	109050945	109056354	8
chr1	109167777	109174948	Serpinb3c	7171	-	NM_201363	109168205	109173591	8
chr1	109258890	109277052	Serpinb11	18162	+	NM_025867	109265972	109276584	8
chr1	109319265	109349266	Serpinb7	30001	+	NM_027548	109324825	109348584	8
chr1	109407999	109422177	Serpinb2	14178	+	NM_001174170	109412049	109421518	8
chr1	109425579	109445848	Serpinb10	20269	+	NM_198028	109429067	109443649	8
chr1	109486582	109505555	Serpinb8	18973	+	NM_011459	109494046	109503902	7
chr1	109813835	109847524	D830032E09Rik	33689	+	NR_102307	109847524	109847524	5
chr1	111879476	112036480	Cdh7	157004	+	NM_001316743	111890756	112034932	12
chr1	112785771	112873949	Cdh19	88178	-	NM_001081386	112786274	112851337	12
chr1	113755278	113761495	Dsel	6217	-	NM_001081316	113755756	113759380	2
chr1	117581713	118477251	Cntnap5a	895538	+	NM_001077425	117581713	118477251	24
chr1	120195094	120207709	Tsn	12615	-	NM_011650	120197380	120207643	6
chr1	120218419	120230408	Nifk	11989	+	NM_026472	120218469	120229518	7
chr1	120285634	120506039	Clasp1	220405	+	NM_001293300	120316300	120503571	41
chr1	120355245	120355842	2900060B14Rik	597	-	NR_027901	120355842	120355842	1
chr1	120524521	120581745	Tfcp2l1	57224	+	NM_023755	120524617	120574011	15
chr1	120730637	120950196	Gli2	219559	-	NM_001081125	120732361	120898752	14
chr1	120850796	120850876	Mir6346	80	+	NR_105764	120850876	120850876	1
chr1	121312041	121318825	Inhbb	6784	-	NM_008381	121313898	121317663	2
chr1	121366881	121401359	Ralb	34478	-	NM_022327	121368282	121380184	5
chr1	121422730	121425560	Tmem185b	2830	+	NM_146103	121423087	121424140	1
chr1	121426056	121432742	3830432H09Rik	6686	-	NR_126486	121432742	121432742	4
chr1	121441609	121545577	Epb41l5	103968	-	NM_145506	121445705	121539233	25
chr1	121554669	121733648	Ptpn4	178979	-	NM_019933	121556407	121699037	27
chr1	121804477	121809745	Tmem177	5268	-	NM_175106	121806588	121807524	2
chr1	121820095	121891787	Cfap221	71692	-	NM_001115074	121820095	121891787	23
chr1	121903556	121960109	Sctr	56553	+	NM_001012322	121903833	121959859	14
chr1	121963953	121970357	Tmem37	6404	-	NM_019432	121964286	121970309	2
chr1	122009856	122017673	Dbi	7817	-	NM_007830	122010036	122017530	4
chr1	122017763	122084766	3110009E18Rik	67003	+	NM_028439	122047191	122084694	6
chr1	122122992	122167659	Steap3	44667	-	NM_001085409	122124223	122140836	6
chr1	122237158	122239751	C1ql2	2593	+	NM_207233	122237694	122239151	2
chr1	122371114	122401661	Marco	30547	-	NM_010766	122371235	122401354	17
chr1	122499063	122504568	En1	5505	+	NM_010133	122499609	122503766	2
chr1	122983981	123017552	Celrr	33571	+	NR_038008	123017552	123017552	5
chr1	123200929	123229166	Insig2	28237	-	NM_178082	123202482	123216417	6
chr1	123327643	123403037	Ccdc93	75394	+	NM_001025156	123327792	123397820	24
chr1	123406349	123425042	Htr5b	18693	-	NM_010483	123406964	123424766	2
chr1	123450411	123464557	Ddx18	14146	-	NM_025860	123450572	123464452	13
chr1	125228714	125942136	Dpp10	713422	-	NM_199021	125230825	125942020	26
chr1	127289481	127332304	Actr3	42823	-	NM_001205386	127290571	127331905	13
chr1	127457592	127492261	Slc35f5	34669	+	NM_028787	127457821	127487685	16
chr1	127573572	127770438	Gpr39	196866	+	NM_027677	127573913	127769461	2
chr1	127764198	127809505	Lypd1	45307	-	NM_001311089	127769912	127807001	3
chr1	127810212	128727209	Nckap5	916997	-	NM_001081756	127811319	128592331	17
chr1	129101562	129379549	Mgat5	277987	+	NM_145128	129203352	129379302	18
chr1	129386918	129574598	Tmem163	187680	-	NM_028135	129388176	129574206	8
chr1	129625989	129664141	Acmsd	38152	+	NM_001033041	129626062	129662922	10
chr1	129650193	129670631	2900009J06Rik	20438	-	NR_045298	129670631	129670631	2
chr1	129670740	129701414	Ccnt2	30674	+	NM_028399	129670804	129700136	9
chr1	129711847	129736867	Map3k19	25020	-	NM_011737	129711847	129736867	10
chr1	129765349	129840453	Rab3gap1	75104	+	NM_178690	129765388	129839187	24
chr1	129850755	129999624	Zranb3	148869	-	NM_001285945	129851543	129999549	21
chr1	129999882	130134312	R3hdm1	134430	+	NM_181750	130049805	130133335	27
chr1	130098937	130099007	Mir128-1	70	+	NR_029543	130099007	130099007	1
chr1	130140757	130175954	Ubxn4	35197	+	NM_026390	130141047	130173672	13
chr1	130181332	130224895	Lct	43563	-	NM_001081078	130181695	130224880	17
chr1	130228151	130256282	Mcm6	28131	-	NM_008567	130228511	130256142	17
chr1	130260283	130313993	Dars	53710	-	NM_177445	130260810	130313794	16
chr1	130484775	130488876	Cxcr4	4101	-	NM_009911	130485419	130488786	2
chr1	131169880	132115855	Thsd7b	945975	+	NM_172485	131327407	132114757	28
chr1	132285104	132319620	Cd55b	34516	-	NM_007827	132285184	132319535	10
chr1	132335602	132359321	Cd55	23719	-	NM_010016	132336888	132359246	10
chr1	132473282	132526183	Zp3r	52901	-	NM_009581	132473495	132516014	12
chr1	132532497	132558195	C4bp	25698	-	NM_007576	132532782	132553874	10
chr1	132566778	132578148	C4bp-ps1	11370	-	NR_028304	132578148	132578148	6
chr1	132585619	132625830	Pfkfb2	40211	-	NM_001162415	132587659	132611133	16
chr1	132613903	132618634	Yod1	4731	+	NM_178691	132614060	132615996	2
chr1	132628552	132641199	AA986860	12647	+	NM_177604	132634159	132640440	4
chr1	132697478	132711317	Fcamr	13839	+	NM_144960	132697526	132711230	7
chr1	132723260	132748826	Pigr	25566	+	NM_011082	132731005	132747473	11
chr1	132762353	132777367	Fcmr	15014	+	NM_026976	132762436	132777228	8
chr1	132778650	132783988	Il24	5338	-	NM_053095	132779031	132783916	6
chr1	132803561	132807873	Il20	4312	-	NM_021380	132803991	132807803	5
chr1	132829232	132835818	Il19	6586	-	NM_001009940	132829724	132835818	5
chr1	132916421	132921547	Il10	5126	+	NM_010548	132916488	132920845	5
chr1	132950277	132994420	Mapkapk2	44143	-	NM_008551	132951668	132994102	10
chr1	133025017	133034811	Dyrk3	9794	-	NM_145508	133025250	133034733	3
chr1	133049783	133070048	Eif2d	20265	+	NM_001136070	133049946	133069948	15
chr1	133072986	133141755	Rassf5	68769	-	NM_001313731	133077155	133141707	6
chr1	133151178	133176140	Ikbke	24962	-	NM_019777	133151881	133173131	22
chr1	133181827	133423938	Srgap2	242111	-	NM_001081011	133185933	133421581	23
chr1	133424565	133436449	Fam72a	11884	+	NM_175382	133425277	133435506	4
chr1	133495690	133508577	Avpr1b	12887	+	NM_011924	133496317	133506322	2
chr1	133534890	133572084	Ctse	37194	+	NM_007799	133558572	133571522	10
chr1	133585271	133612016	Rab7b	26745	+	NM_145509	133593590	133608274	6
chr1	133640598	133666982	Slc26a9	26384	+	NM_177243	133647174	133665825	21
chr1	133693971	133714692	Pm20d1	20721	+	NM_178079	133693994	133712687	13
chr1	133724588	133745440	Slc41a1	20852	+	NM_173865	133727198	133743312	11
chr1	133763853	133769464	Rab29	5611	+	NM_144875	133764228	133769157	6
chr1	133807034	133832898	Nucks1	25864	+	NM_175294	133807310	133827783	7
chr1	133859491	133879549	Slc45a3	20058	+	NM_001177628	133873517	133878305	5
chr1	133904181	133922261	Elk4	18080	+	NM_007923	133910968	133920228	5
chr1	133923197	133964639	Mfsd4	41442	-	NM_172510	133925062	133964469	11
chr1	134010123	134036262	Cdk18	26139	-	NM_008795	134011512	134019012	16
chr1	134088012	134153959	Lemd1	65947	+	NM_001311104	134124798	134153303	5
chr1	134094664	134094761	Mir135b	97	+	NR_029777	134094761	134094761	1
chr1	134195202	134203934	Klhdc8a	8732	+	NM_144810	134195853	134201369	5
chr1	134212701	134230065	Nuak2	17364	+	NM_001195025	134212806	134228958	8
chr1	134252891	134287963	Tmcc2	35072	-	NM_178874	134254082	134287760	5
chr1	134314029	134363536	Dstyk	49507	+	NM_172516	134314182	134360088	13
chr1	134373943	134402242	Rbbp5	28299	+	NM_172517	134374085	134400369	14
chr1	134402806	134405216	Tmem81	2410	+	NM_029025	134404034	134404814	2
chr1	134406001	134439517	Cntn2	33516	-	NM_177129	134412110	134430309	23
chr1	134461266	134638374	Nfasc	177108	-	NM_182716	134466996	134539345	30
chr1	134625929	134629403	Gm10538	3474	+	NR_045892	134629403	134629403	3
chr1	134776931	134836582	Lrrn2	59651	+	NM_010732	134833775	134835968	2
chr1	134882681	134927164	Mdm4	44483	-	NM_001302802	134888232	134915431	11
chr1	134942588	135005265	Pik3c2b	62677	+	NM_001099276	134962876	135002735	33
chr1	135027742	135036377	Ppp1r15b	8635	+	NM_133819	135028323	135033464	2
chr1	135142673	135200012	Plekha6	57339	+	NM_182930	135156631	135195612	27
chr1	135146428	135166385	Gm19461	19957	-	NR_037984	135166385	135166385	4
chr1	135206399	135219603	Golt1a	13204	+	NM_026680	135206463	135218227	5
chr1	135223788	135226299	Kiss1	2511	+	NM_178260	135223826	135226222	2
chr1	135247142	135256900	Ren2	9758	+	NM_031193	135247213	135256715	9
chr1	135247250	135256896	Ren1	9646	+	NM_031192	135247282	135256715	9
chr1	135260148	135276895	Etnk2	16747	+	NM_175443	135260340	135275966	8
chr1	135278876	135320789	Sox13	41913	-	NM_011439	135280227	135289847	14
chr1	135500447	135506857	Snrpe	6410	-	NM_009227	135500597	135506794	5
chr1	135516447	135557976	Zc3h11a	41529	-	NM_001276767	135518119	135543966	18
chr1	135552455	135557462	Zbed6	5007	-	NM_001166552	135553231	135556174	1
chr1	135575605	135586685	Lax1	11080	-	NM_001159649	135576354	135585483	6
chr1	135599250	135650324	Atp2b4	51074	-	NM_001167949	135608210	135649858	21
chr1	135623134	135623222	Mir6903	88	-	NR_105868	135623222	135623222	1
chr1	135793770	135804576	Optc	10806	-	NM_001160420	135794376	135803611	7
chr1	135806881	135817978	Prelp	11097	-	NM_054077	135809182	135811982	3
chr1	135934091	135944854	Fmod	10763	+	NM_021355	135936800	135943202	3
chr1	135971441	135975732	Btg2	4291	-	NM_007570	135973945	135975630	2
chr1	136007818	136048117	Chit1	40299	+	NM_027979	136035324	136047925	12
chr1	136078980	136086608	Chil1	7628	+	NM_007695	136079080	136086189	10
chr1	136090024	136097809	Mybph	7785	+	NM_016749	136090080	136096988	11
chr1	136095791	136132034	Adora1	36243	-	NM_001282945	136099527	136130932	3
chr1	136186580	136189125	Myog	2545	+	NM_031189	136186632	136188372	3
chr1	136193359	136229505	Ppfia4	36146	-	NM_001144855	136195654	136229100	29
chr1	136242673	136258576	Tmem183a	15903	-	NM_020588	136244585	136258447	8
chr1	136282516	136287560	4933406M09Rik	5044	+	NM_173771	136282794	136287508	4
chr1	136302566	136308315	Cyb5r1	5749	+	NM_028057	136302615	136307656	9
chr1	136311954	136329927	Adipor1	17973	+	NM_028320	136319591	136328235	8
chr1	136352107	136387450	Klhl12	35343	+	NM_153128	136355048	136386035	12
chr1	136391236	136404461	Rabif	13225	+	NM_145510	136391260	136402898	2
chr1	136437517	136446259	Mgat4e	8742	-	NM_001291015	136437561	136438635	4
chr1	136456754	136529455	Kdm5b	72701	+	NM_152895	136456915	136527951	27
chr1	136543257	136645994	Syt2	102737	+	NM_009307	136637428	136644258	10
chr1	136662519	136852517	Ppp1r12b	189998	-	NM_001081307	136662519	136852359	24
chr1	136859141	136870756	Ube2t	11615	+	NM_026024	136864366	136870523	7
chr1	136882929	137001853	Lgr6	118924	-	NM_001033409	136883512	137001717	18
chr1	137005074	137029152	Ptprv	24078	-	NM_007955	137005200	137023649	38
chr1	137029301	137041897	Ptpn7	12596	+	NM_177081	137030378	137039831	10
chr1	137043410	137052845	Arl8a	9435	+	NM_026823	137043554	137051848	7
chr1	137056826	137064258	Gpr37l1	7432	-	NM_134438	137057456	137064081	2
chr1	137150150	137155049	Elf3	4899	-	NM_007921	137150842	137154351	9
chr1	137159275	137180661	Rnpep	21386	-	NM_145417	137159547	137180585	11
chr1	137198111	137210314	Timm17a	12203	-	NM_011590	137198494	137210296	6
chr1	137221389	137264642	Lmod1	43253	+	NM_053106	137221586	137262685	3
chr1	137268032	137271640	Shisa4	3608	-	NM_175259	137268526	137271538	5
chr1	137278891	137327068	Ipo9	48177	-	NM_153774	137281943	137327007	24
chr1	137331156	137481932	Nav1	150776	-	NM_173437	137338260	137481897	29
chr1	137351179	137351260	Mir1231	81	-	NR_049188	137351260	137351260	1
chr1	137625773	137648806	Csrp1	23033	+	NM_007791	137635977	137647697	6
chr1	137662661	137665711	Phlda3	3050	+	NM_013750	137663025	137663403	2
chr1	137695997	137707566	Tnni1	11569	+	NM_021467	137699189	137706310	9
chr1	137715174	137729918	Lad1	14744	+	NM_133664	137715555	137728894	10
chr1	137732910	137748845	Tnnt2	15935	+	NM_001130179	137732949	137748649	15
chr1	137767970	137815784	Pkp1	47814	-	NM_001313701	137772206	137815589	14
chr1	137850154	137902919	Igfn1	52765	-	NM_177642	137850600	137902919	27
chr1	137904795	137931607	Tmem9	26812	+	NM_001160145	137915118	137930797	6
chr1	137947380	137947947	Ascl5	567	+	NM_001270609	137947380	137947947	1
chr1	137949477	138016399	Cacna1s	66922	+	NM_001081023	137949477	138015707	44
chr1	138024295	138027760	Gm15850	3465	-	NR_046168	138027760	138027760	4
chr1	138027977	138074591	Kif21b	46614	+	NM_001039472	138028298	138070668	35
chr1	138110098	138130857	5730559C18Rik	20759	-	NM_028872	138110902	138130682	10
chr1	138155490	138157450	Gpr25	1960	-	NM_001101516	138156373	138157450	1
chr1	138164699	138242681	Camsap2	77982	-	NM_001081360	138167418	138242014	19
chr1	138308492	138312096	9230116N13Rik	3604	-	NR_024328	138312096	138312096	3
chr1	138311847	138336797	Ddx59	24950	+	NM_026500	138313169	138336593	8
chr1	138364424	138427396	Kif14	62972	+	NM_001287179	138364534	138424193	29
chr1	138521477	138526968	Zfp281	5491	+	NM_001160251	138521862	138524544	2
chr1	138579972	138587382	Gm19705	7410	+	NR_045324	138587382	138587382	3
chr1	138592787	138622305	Platr22	29518	+	NR_037986	138622305	138622305	5
chr1	138740160	138857025	Nr5a2	116865	-	NM_030676	138742039	138856867	9
chr1	139863031	139863118	Mir181a-1	87	+	NR_029795	139863118	139863118	1
chr1	139863215	139863295	Mir181b-1	80	+	NR_029820	139863295	139863295	1
chr1	139959435	140071882	Ptprc	112447	-	NM_011210	139961082	140071664	30
chr1	140170314	140186039	Atp6v1g3	15725	+	NM_177397	140170342	140184537	3
chr1	140380413	140516334	Nek7	135921	-	NM_021605	140383576	140458336	10
chr1	140536671	140578652	Gm5833	41981	-	NR_040304	140578652	140578652	5
chr1	140721762	140744156	Lhx9	22394	-	NM_010714	140725230	140743780	7
chr1	140748555	140753431	2310009B15Rik	4876	-	NM_001081226	140748678	140753394	3
chr1	140860285	141072619	Dennd1b	212334	+	NM_001166501	140860445	141066875	22
chr1	140874233	140875823	4930596I21Rik	1590	+	NR_108103	140875823	140875823	3
chr1	141094830	141273653	Crb1	178823	-	NM_133239	141095148	141273487	12
chr1	141276028	141299429	4933436E23Rik	23401	+	NR_040455	141299429	141299429	9
chr1	141318959	141349584	Zbtb41	30625	+	NM_172643	141319727	141344107	11
chr1	141351349	141390665	Aspm	39316	+	NM_009791	141351508	141390327	28
chr1	141398283	141420333	F13b	22050	+	NM_031164	141398322	141420004	12
chr1	141443640	141456799	Cfhr1	13159	-	NM_015780	141444276	141456735	6
chr1	141594495	141677816	Gm4788	83321	-	NM_001160303	141594671	141677745	15
chr1	141706868	141755276	Cfhr2	48408	-	NM_001025575	141707399	141755204	6
chr1	141982431	142079988	Cfh	97557	-	NM_009888	141982902	142079853	22
chr1	142142833	142506838	Kcnt2	364005	+	NM_001081027	142142833	142506289	28
chr1	142466752	142552979	4930590L20Rik	86227	-	NR_040604	142552979	142552979	4
chr1	145450405	145550023	Cdc73	99618	-	NM_145991	145455650	145549754	17
chr1	145487826	145497067	B3galt2	9241	+	NM_020025	145493257	145494526	2
chr1	145586478	145596808	Glrx2	10330	+	NM_001038593	145588778	145593769	4
chr1	145597920	145624181	Trove2	26261	-	NM_013835	145604871	145618135	9
chr1	145624407	145654596	Uchl5	30189	+	NM_001159866	145624530	145653858	11
chr1	145846467	145851279	Rgs2	4812	-	NM_009061	145848809	145851248	5
chr1	145985796	146024502	Rgs13	38706	-	NM_153171	145986630	146018611	6
chr1	146091798	146096234	Rgs1	4436	-	NM_015811	146092431	146096167	5
chr1	146366819	146414797	Rgs21	47978	-	NM_001290269	146366819	146392450	5
chr1	146599970	146622551	Rgs18	22581	-	NM_022881	146600941	146622371	5
chr1	148342795	148749602	Brinp3	406807	+	NM_153539	148361847	148749247	8
chr1	151676748	151808420	Pla2g4a	131672	-	NM_008869	151677190	151779820	18
chr1	151871390	151899332	Mir7652	27942	-	NR_106112	151899332	151899332	3
chr1	151922002	151947004	Ptgs2os	25002	-	NR_015466	151947004	151947004	5
chr1	151947160	151955364	Ptgs2	8204	+	NM_011198	151947353	151952912	10
chr1	152006172	152012078	Ptgs2os2	5906	-	NR_110420	152012078	152012078	2
chr1	152166546	152181036	Pdc	14490	+	NM_024458	152175469	152180632	4
chr1	152167810	152193901	2310030A07Rik	26091	-	NR_040603	152193901	152193901	4
chr1	152208440	152240185	BC003331	31745	-	NM_145511	152209950	152237464	14
chr1	152239967	152297065	Tpr	57098	+	NM_133780	152240073	152296917	52
chr1	152296541	152313295	Prg4	16754	-	NM_021400	152297113	152312703	13
chr1	152409631	152840565	Hmcn1	430934	-	NM_001024720	152410656	152840181	107
chr1	152985163	152991225	C730036E19Rik	6062	+	NR_038011	152991225	152991225	7
chr1	153191627	153211575	Ivns1abp	19948	+	NM_054102	153198128	153210495	15
chr1	153214828	153275565	Swt1	60737	-	NM_025819	153215588	153270690	20
chr1	153275777	153305313	Trmt1l	29536	+	NM_026876	153276006	153305064	15
chr1	153289522	153289580	Mir7682	58	+	NR_106150	153289580	153289580	1
chr1	153316535	153347953	Rnf2	31418	-	NM_011277	153318445	153325753	7
chr1	153418502	153566477	Fam129a	147975	+	NM_022018	153418659	153565476	14
chr1	153602503	153669458	Edem3	66955	+	NM_001311165	153602696	153665843	21
chr1	153731653	153937450	1700025G04Rik	205797	-	NM_197990	153740523	153853768	6
chr1	154217865	154233812	Tsen15	15947	-	NM_025677	154218392	154233714	5
chr1	154246996	154357825	Colgalt2	110829	+	NM_177756	154247267	154355918	12
chr1	154364659	154472241	Rgl1	107582	-	NM_016846	154366138	154472140	18
chr1	154597680	154604674	Apobec4	6994	+	NM_001081197	154603352	154604477	2
chr1	154613671	154622710	Arpc5	9039	+	NM_026369	154613854	154621452	4
chr1	154647282	154684120	Ncf2	36838	+	NM_010877	154655161	154683244	16
chr1	154684124	154749776	Smg7	65652	-	NM_001160256	154686401	154749667	23
chr1	154802230	154966391	Nmnat2	164161	+	NM_175460	154802238	154962800	11
chr1	154969885	155033577	Lamc2	63692	-	NM_008485	154971159	155033117	24
chr1	155066051	155179916	Lamc1	113865	-	NM_010683	155068602	155179669	28
chr1	155251315	155261363	E330020D12Rik	10048	-	NR_033736	155261363	155261363	4
chr1	155272338	155299704	Shcbp1l	27366	+	NM_001033162	155272353	155299594	10
chr1	155302887	155334790	Dhx9	31903	-	NM_007842	155303198	155330980	28
chr1	155350145	155396844	Npl	46699	-	NM_028749	155350502	155392460	12
chr1	155500166	155544795	Rgs8	44629	+	NM_026380	155515057	155540037	7
chr1	155568369	155584959	C230024C17Rik	16590	-	NR_046171	155584959	155584959	3
chr1	155587482	155592598	Rgs16	5116	+	NM_011267	155587598	155590985	5
chr1	155596555	155611351	Rnasel	14796	+	NM_011882	155600869	155609420	9
chr1	155626516	155691271	Rgsl1	64755	-	NM_001243223	155628818	155691244	21
chr1	155696671	155698325	Teddm2	1654	-	NM_178243	155697473	155698256	1
chr1	155721474	155724001	Teddm1b	2527	+	NM_001008426	155721576	155722497	1
chr1	155738775	155740190	Teddm1a	1415	+	NM_178244	155738921	155739839	1
chr1	155747055	155747166	Mir8114	111	+	NR_106194	155747166	155747166	1
chr1	155747058	155756853	Glul	9795	+	NM_008131	155750076	155755312	7
chr1	156048316	156052804	Zfp648	4488	+	NM_001204908	156051226	156052804	2
chr1	156088650	156104036	4930452N14Rik	15386	-	NR_040629	156104036	156104036	4
chr1	156102818	156117546	4930532M18Rik	14728	+	NR_108050	156117546	156117546	3
chr1	156239648	156573050	Cacna1e	333402	-	NM_009782	156245522	156573049	47
chr1	156943496	156946766	Ier5	3270	-	NM_010500	156945633	156946560	1
chr1	156975007	156993910	Mr1	18903	-	NM_008209	156976396	156993816	6
chr1	157005832	157050647	Stx6	44815	+	NM_021433	157006022	157049146	8
chr1	157122786	157264574	Xpr1	141788	-	NM_011273	157128139	157264364	15
chr1	157367302	157374241	Gm5532	6939	-	NR_132128	157374241	157374241	2
chr1	157405249	157534363	Acbd6	129114	+	NM_028250	157405767	157534233	8
chr1	157548823	157589157	Lhx4	40334	-	NM_010712	157549351	157589007	6
chr1	157625284	157660029	Qsox1	34745	-	NM_023268	157625972	157659929	13
chr1	157692093	157820385	Cep350	128292	-	NM_001039184	157695692	157809677	38
chr1	157851728	157883610	Tor1aip1	31882	-	NM_001160018	157854054	157883365	10
chr1	157882793	157915989	Tor1aip2	33196	+	NM_172843	157906650	157912588	7
chr1	157923085	158135156	Fam163a	212071	-	NM_177838	157926026	157927174	5
chr1	158185425	158233737	Tdrd5	48312	-	NM_001277730	158185703	158232729	19
chr1	158240849	158258166	Nphs2	17317	+	NM_130456	158240918	158256269	8
chr1	158358238	158404459	Soat1	46221	-	NM_009230	158361189	158396899	16
chr1	158488917	158579750	Abl2	90833	+	NM_001136104	158489179	158572847	13
chr1	158583747	158604470	Tor3a	20723	-	NM_023141	158585823	158604436	6
chr1	158608701	158649041	Fam20b	40340	-	NM_145413	158611541	158636175	8
chr1	158734296	158869757	Ralgps2	135461	-	NR_027640	158869757	158869757	20
chr1	158769153	158791209	Angptl1	22056	+	NM_028333	158774736	158790733	5
chr1	159029277	159038811	Tex35	9534	-	NM_001305062	159029473	159037994	9
chr1	159065313	159342726	Rasal2	277413	-	NM_177644	159070841	159342069	18
chr1	159342482	159350367	2810025M15Rik	7885	+	NR_027984	159350367	159350367	3
chr1	159388712	159418864	BC026585	30152	+	NM_001033284	159388726	159418642	10
chr1	159436926	159498555	Sec16b	61629	+	NM_033354	159459354	159497478	28
chr1	160175399	160286391	Brinp2	110992	-	NM_207583	160176328	160225825	8
chr1	160292434	160621917	Astn1	329483	+	NM_007495	160292713	160618881	23
chr1	160435755	160435864	Mir488	109	+	NR_030441	160435864	160435864	1
chr1	160641861	160887569	Pappa2	245708	-	NM_001085376	160645076	160887569	22
chr1	161162456	161277711	Rfwd2	115255	+	NM_011931	161162568	161274969	20
chr1	161270437	161270555	Scarna3a	118	+	NR_028518	161270555	161270555	1
chr1	161270488	161270554	Mir1843b	66	+	NR_039543	161270554	161270554	1
chr1	161453899	161855053	Tnr	401154	+	NM_022312	161780177	161854344	23
chr1	161974510	162008717	4930523C07Rik	34207	+	NM_001162896	162005292	162005592	3
chr1	162004865	162008116	4930562F07Rik	3251	-	NR_038031	162008116	162008116	3
chr1	162015162	162083706	Tnn	68544	-	NM_177839	162016161	162077986	22
chr1	162125390	162131317	Mrps14	5927	+	NM_025474	162125397	162129741	3
chr1	162132497	162143023	Cacybp	10526	-	NM_009786	162133697	162142798	6
chr1	162186702	162723069	Rabgap1l	536367	-	NM_013862	162187382	162671020	21
chr1	162225994	162226103	Mir1927	109	-	NR_035448	162226103	162226103	1
chr1	162506798	162507884	Gpr52	1086	-	NM_001146330	162506798	162507884	1
chr1	162836541	162905107	Rc3h1	68566	+	NM_001024952	162860244	162897928	20
chr1	162908736	162933145	Serpinc1	24409	+	NM_080844	162917673	162932594	8
chr1	162947886	162964390	Zbtb37	16504	-	NM_173424	162950051	162962864	4
chr1	162965296	162968668	Gas5	3372	+	NR_002840	162968668	162968668	4
chr1	162968222	162968287	Snord47	65	+	NR_028543	162968287	162968287	1
chr1	162970731	163000791	Dars2	30060	-	NM_172644	162971846	163000247	17
chr1	163000897	163016856	Cenpl	15959	+	NR_131029	163016856	163016856	6
chr1	163018508	163061610	Klhl20	43102	-	NM_001039482	163020557	163060527	12
chr1	163072842	163100638	Ankrd45	27796	+	NM_028664	163072897	163094322	7
chr1	163086973	163089445	4930469G21Rik	2472	-	NM_001195189	163087229	163089317	2
chr1	163170242	163181341	Prdx6	11099	-	NM_001303408	163171851	163179512	6
chr1	163325568	163348337	Tnfsf4	22769	+	NM_009452	163325712	163347469	3
chr1	163424787	163435421	Tnfsf18	10634	+	NM_183391	163424843	163433935	3
chr1	163710822	163718626	Fasl	7804	-	NM_010177	163711706	163718416	4
chr1	163746242	163806792	Suco	60550	-	NM_172645	163748496	163806503	24
chr1	163872219	163909767	4930558K02Rik	37548	-	NM_001204904	163872520	163909637	7
chr1	163899318	163903566	Pigc	4248	+	NM_026078	163900581	163901475	2
chr1	163917432	164408161	Dnm3	490729	-	NM_001038619	163922152	164407954	21
chr1	163935099	163946616	2810442N19Rik	11517	+	NR_040562	163946616	163946616	3
chr1	164147753	164155681	Dnm3os	7928	+	NR_002870	164155681	164155681	1
chr1	164147944	164148054	Mir199a-2	110	+	NR_029810	164148054	164148054	1
chr1	164153498	164153608	Mir214	110	+	NR_029796	164153608	164153608	1
chr1	164463802	164478476	Mettl13	14674	-	NM_144877	164464406	164478387	8
chr1	164500958	164529209	Vamp4	28251	+	NM_016796	164504481	164527208	8
chr1	164569280	164579825	Myoc	10545	+	NM_010865	164569394	164579332	3
chr1	164577373	164588350	7420461P10Rik	10977	-	NM_001177581	164577578	164588246	4
chr1	164601915	164670687	Prrc2c	68772	-	NM_001081290	164603532	164654946	35
chr1	164724013	164742680	Fmo4	18667	-	NM_144878	164724088	164740052	9
chr1	164759691	164796679	Fmo1	36988	-	NM_010231	164760102	164789687	9
chr1	164805177	164828843	Fmo2	23666	-	NM_018881	164806858	164828436	9
chr1	164846681	164867356	Fmo6	20675	-	NM_001178038	164846853	164867257	8
chr1	164883929	164914659	Fmo3	30730	-	NM_008030	164884308	164913250	9
chr1	164954432	165015801	Mroh9	61369	-	NM_030071	164954573	165010710	22
chr1	165175249	165243781	Prrx1	68532	-	NM_175686	165184124	165242766	5
chr1	165315033	165333800	Gorab	18767	-	NR_132627	165333800	165333800	6
chr1	165633123	165655363	Mettl11b	22240	-	NM_001143956	165633147	165655186	4
chr1	165709713	165847238	Kifap3	137525	+	NM_010629	165710001	165842248	21
chr1	165859230	165885257	Scyl3	26027	+	NM_001286002	165863659	165883569	14
chr1	165884138	165924912	BC055324	40774	-	NM_201364	165884275	165924851	24
chr1	165925075	165927374	Mettl18	2299	+	NM_027279	165926242	165927331	2
chr1	165978364	165987808	Sele	9444	+	NM_011345	165978816	165985865	14
chr1	165992206	166010916	Sell	18710	+	NM_011346	165992319	166009827	9
chr1	166045394	166080157	Selp	34763	+	NM_011347	166045517	166078661	16
chr1	166078706	166082348	Gm16548	3642	-	NR_037987	166082348	166082348	3
chr1	166081965	166150408	F5	68443	+	NM_007976	166082093	166149655	25
chr1	166179176	166195516	Slc19a2	16340	+	NM_054087	166179383	166193649	6
chr1	166205728	166217978	Ccdc181	12250	+	NM_029115	166208328	166217800	6
chr1	166219930	166237615	Blzf1	17685	-	NM_025505	166222356	166236609	9
chr1	166237802	166367431	Nme7	129629	+	NM_138314	166243009	166367179	14
chr1	166367229	166388486	Atp1b1	21257	-	NM_009721	166368406	166387988	6
chr1	166726862	166754397	Dpt	27535	+	NM_019759	166726862	166753367	4
chr1	166793251	166801569	Gm20743	8318	+	NR_040303	166801569	166801569	5
chr1	166861778	166865641	Xcl1	3863	-	NM_008510	166861915	166865621	3
chr1	166996747	167022061	4930568G15Rik	25314	-	NR_040480	167022061	167022061	5
chr1	167067983	167090904	Tbx19	22921	-	NM_032005	167069093	167090693	8
chr1	167104471	167124564	Sft2d2	20093	-	NM_145512	167109386	167124433	8
chr1	167142416	167167089	Tiprl	24673	-	NM_145513	167145870	167166964	7
chr1	167225896	167256876	Gpr161	30980	+	NM_001081126	167226012	167251832	7
chr1	167259631	167390594	Dcaf6	130963	-	NM_028759	167260069	167390358	19
chr1	167391338	167411345	Mpc2	20007	+	NM_027430	167391533	167411070	5
chr1	167415313	167506904	Adcy10	91591	+	NM_173029	167433300	167506753	34
chr1	167522311	167564672	Mpzl1	42361	-	NM_001083897	167523706	167564524	6
chr1	167579075	167638225	Rcsd1	59150	-	NM_178593	167580308	167638027	7
chr1	167693910	167705435	Creg1	11525	+	NM_011804	167693915	167703978	4
chr1	167718811	167801284	Cd247	82473	+	NM_001113393	167718959	167799195	9
chr1	167795284	167932765	Pou2f1	137481	-	NM_011137	167805868	167932753	17
chr1	168028278	168058029	Dusp27	29751	-	NM_001033344	168028755	168057310	6
chr1	168060590	168096641	Gpa33	36051	+	NM_021610	168060692	168095410	7
chr1	168131515	168168875	Mael	37360	-	NM_175296	168131678	168168797	12
chr1	168184269	168246963	Ildr2	62694	+	NM_001164528	168184506	168240926	10
chr1	168309297	168323751	Tada1	14454	+	NM_030245	168309533	168322851	8
chr1	168323741	168339959	Pogk	16218	-	NM_175170	168328830	168339147	6
chr1	168413743	168427719	Gm4846	13976	-	NM_001164306	168413802	168427651	8
chr1	168559101	168577824	Gm4847	18723	-	NM_001164312	168560299	168573610	9
chr1	168592185	168611976	Fmo9	19791	-	NM_172844	168593418	168610415	10
chr1	168904153	168929861	Gm16701	25708	-	NR_037988	168929861	168929861	3
chr1	168931547	169021433	Fam78b	89886	+	NM_001160262	168931696	169009190	3
chr1	169156216	169215258	Uck2	59042	-	NM_030724	169156512	169215005	7
chr1	169220255	169220356	Mir6347	101	+	NR_105765	169220356	169220356	1
chr1	169238800	169264109	Tmco1	25309	+	NM_001039483	169238994	169260396	7
chr1	169280121	169298661	Aldh9a1	18540	+	NM_019993	169280366	169297630	11
chr1	169302514	169323928	Mgst3	21414	-	NM_025569	169302633	169308539	6
chr1	169375805	169396911	Lrrc52	21106	-	NM_001013382	169375931	169396845	2
chr1	169528492	169569754	Rxrg	41262	+	NM_009107	169528882	169569404	10
chr1	169619688	169778864	Lmx1a	159176	+	NM_033652	169619905	169776892	8
chr1	170049494	170362300	Pbx1	312806	-	NM_008783	170113703	170361635	8
chr1	170420773	170420893	Mir6348	120	+	NR_105766	170420893	170420893	1
chr1	170949104	170949220	Mir6354	116	-	NR_105772	170949220	170949220	1
chr1	171428064	171461595	Nuf2	33531	-	NM_023284	171428919	171455565	14
chr1	171585631	171625944	Rgs5	40313	+	NM_009063	171585708	171622471	5
chr1	171671607	171677773	Rgs4	6166	-	NM_009062	171673811	171677654	5
chr1	171859069	171864784	Ccdc190	5715	+	NM_001033185	171860104	171864331	4
chr1	171879667	171899336	Hsd17b7	19669	-	NM_010476	171883163	171899263	9
chr1	171899539	171902527	3110045C21Rik	2988	+	NR_040438	171902527	171902527	3
chr1	171902437	172019075	Ddr2	116638	-	NM_022563	171907985	171966125	17
chr1	172071353	172105095	Uap1	33742	-	NM_133806	172072610	172097036	11
chr1	172129386	172145524	Uhmk1	16138	-	NM_010633	172129997	172145371	8
chr1	172163001	172181718	Sh2d1b2	18717	+	NM_001033499	172163001	172181718	4
chr1	172207454	172215793	Sh2d1b1	8339	+	NM_012009	172207506	172214811	4
chr1	172228323	172236463	Gm7694	8140	-	NM_001198955	172231276	172232958	3
chr1	172238991	172242256	1700015E13Rik	3265	+	NM_001039593	172239012	172242179	2
chr1	172247626	172519980	Nos1ap	272354	-	NM_001109985	172248602	172519495	10
chr1	172574662	172612920	Olfml2b	38258	+	NM_177068	172575052	172612456	8
chr1	172634587	172797902	Atf6	163315	-	NM_001081304	172640009	172797832	16
chr1	172804318	172815671	Dusp12	11353	-	NM_023173	172804539	172815538	6
chr1	172837403	172843072	Fcrlb	5669	-	NM_001029984	172837403	172843072	6
chr1	172847724	172857714	Fcrla	9990	-	NM_145141	172848280	172857671	5
chr1	172890688	172906202	Fcgr2b	15514	-	NM_001077189	172891144	172906134	8
chr1	172949056	172959892	Fcgr4	10836	+	NM_144559	172949110	172959446	5
chr1	172981299	172989534	Fcgr3	8235	-	NM_010188	172981798	172989484	5
chr1	172994721	172994783	Mir6546	62	-	NR_106103	172994783	172994783	1
chr1	173051791	173057098	Cfap126	5307	+	NM_001081275	173053297	173056916	6
chr1	173059287	173080734	Sdhc	21447	-	NM_025321	173059931	173080709	6
chr1	173080843	173091261	Mpz	10418	+	NM_008623	173085712	173090174	8
chr1	173103394	173126399	Pcp4l1	23005	-	NM_025557	173104513	173126150	3
chr1	173144100	173148976	Nr1i3	4876	+	NM_001243063	173144479	173148849	9
chr1	173147933	173152645	Tomm40l	4712	-	NM_001037170	173149651	173152149	10
chr1	173151694	173156510	Apoa2	4816	+	NM_001305585	173155445	173156397	4
chr1	173159702	173164480	Fcer1g	4778	-	NM_010185	173159995	173164376	5
chr1	173164983	173177253	Ndufs2	12270	-	NM_153064	173165180	173177219	13
chr1	173180552	173190053	Adamts4	9501	+	NM_172845	173180943	173189309	9
chr1	173200458	173207026	B4galt3	6568	+	NM_020579	173201873	173206510	8
chr1	173207122	173211317	Ppox	4195	-	NM_008911	173207187	173210891	13
chr1	173212083	173218092	Usp21	6009	-	NM_013919	173212342	173217080	13
chr1	173218694	173225113	Ufc1	6419	-	NM_025388	173219021	173224887	7
chr1	173259275	173272632	Dedd	13357	+	NM_001128609	173268446	173271335	6
chr1	173272367	173275776	Nit1	3409	-	NM_012049	173272661	173275700	7
chr1	173275829	173288301	Pfdn2	12472	+	NM_011070	173275842	173288157	4
chr1	173288579	173290929	Klhdc9	2350	-	NM_001033039	173288944	173290792	4
chr1	173300303	173318418	Pvrl4	18115	+	NM_027893	173300798	173316936	9
chr1	173319090	173340370	Arhgap30	21280	+	NM_001005508	173319397	173339472	12
chr1	173341443	173348890	Usf1	7447	+	NM_001305678	173346268	173348252	10
chr1	173349163	173350483	Tstd1	1320	+	NM_001164525	173349202	173350373	4
chr1	173367691	173394724	F11r	27033	+	NM_172647	173367771	173393225	10
chr1	173433608	173434881	Alyref2	1273	+	NM_019484	173433787	173434444	1
chr1	173448254	173465425	Itln1	17171	-	NM_010584	173448371	173464942	8
chr1	173489323	173515447	Cd244	26124	+	NM_018729	173489455	173513015	9
chr1	173518743	173537541	Ly9	18798	-	NM_008534	173519190	173537454	10
chr1	173562533	173583168	Slamf7	20635	-	NM_144539	173565055	173579058	8
chr1	173571970	173572031	Mir7683	61	-	NR_106151	173572031	173572031	1
chr1	173612185	173635388	Cd48	23203	+	NM_007649	173612224	173635008	4
chr1	173697262	173731315	Slamf1	34053	+	NM_013730	173697357	173729754	7
chr1	173769827	173820849	Cd84	51022	+	NM_001289470	173770788	173816557	9
chr1	173847667	173873999	Slamf6	26332	+	NM_030710	173847838	173872723	8
chr1	173931090	173957426	Vangl2	26336	-	NM_033509	173934732	173943284	8
chr1	173982422	173987727	Nhlh1	5305	-	NM_010916	173984026	173984428	2
chr1	173996143	174012880	Ncstn	16737	-	NM_021607	173996804	174012813	17
chr1	174012659	174052463	Copa	39804	+	NM_009938	174013040	174051890	33
chr1	174056885	174066628	Pex19	9743	+	NM_023041	174056909	174064421	8
chr1	174078145	174126524	Dcaf8	48379	+	NM_153555	174095997	174124803	14
chr1	174126859	174136912	Pea15a	10053	-	NM_011063	174128756	174130710	4
chr1	174140024	174150026	Casq1	10002	-	NM_009813	174140475	174149821	11
chr1	174153638	174188555	Atp1a4	34917	-	NM_013734	174153928	174188165	23
chr1	174201839	174228195	Atp1a2	26356	-	NM_178405	174204831	174228023	23
chr1	174242497	174249974	Igsf8	7477	+	NM_080419	174242666	174249539	7
chr1	174251163	174259394	Kcnj9	8231	-	NM_008429	174252993	174256686	4
chr1	174271340	174304216	Kcnj10	32876	+	NM_001039484	174299051	174300191	2
chr1	174306661	174314230	Pigm	7569	+	NM_026234	174306829	174308101	1
chr1	174405490	174408540	Slamf9	3050	+	NM_029612	174405627	174408390	4
chr1	174412343	174429008	Igsf9	16665	+	NM_001145800	174414619	174428669	21
chr1	174430376	174437506	Tagln2	7130	+	NM_178598	174435278	174436839	5
chr1	174451260	174476001	Cfap45	24741	+	NM_027972	174451309	174475884	12
chr1	174471750	174480937	4933439K11Rik	9187	-	NR_040558	174480937	174480937	3
chr1	174486068	174493848	Vsig8	7780	+	NM_177723	174486202	174493435	7
chr1	174511507	174520699	Slamf8	9192	-	NM_029084	174512574	174520563	5
chr1	174526770	174532682	Fcrl6	5912	-	NM_001164725	174527786	174532591	7
chr1	174560899	174563105	Dusp23	2206	-	NM_026725	174561771	174563013	2
chr1	174628186	174630097	Crp	1911	+	NM_007768	174628267	174629158	2
chr1	174824091	174825185	Apcs	1094	-	NM_011318	174824233	174825018	2
chr1	174886898	174887948	Olfr16	1050	+	NM_008763	174886927	174887857	1
chr1	175060413	175061346	Olfr1408	933	-	NM_146764	175060413	175061346	1
chr1	175113572	175114635	Olfr1406	1063	-	NM_146763	175113630	175114563	1
chr1	175133488	175134430	Olfr218	942	+	NM_001001809	175133488	175134430	1
chr1	175145737	175146771	Olfr1404	1034	+	NM_146881	175145783	175146725	1
chr1	175151401	175157360	Fcer1a	5959	-	NM_010184	175151620	175157306	5
chr1	175200277	175201268	Olfr418	991	+	NM_146651	175200307	175201240	1
chr1	175204591	175207887	Mptx2	3296	-	NM_001205011	175204591	175207853	2
chr1	175262016	175263634	Ackr1	1618	-	NM_010045	175262076	175263541	2
chr1	175264384	175297826	Cadm3	33442	-	NM_053199	175267151	175297625	9
chr1	175350734	175396167	Aim2	45433	+	NM_001013779	175385484	175395149	9
chr1	175451441	175466088	BC094916	14647	-	NM_001024721	175451769	175459666	5
chr1	175522087	175529405	Pydc4	7318	-	NM_001177349	175524044	175525428	4
chr1	175560989	175578059	Pyhin1	17070	+	NM_175026	175567436	175576142	7
chr1	175603810	175628523	Pydc3	24713	+	NM_001162938	175607816	175627598	7
chr1	175653558	175671940	AI607873	18382	-	NM_001204910	175653862	175666582	8
chr1	175677424	175697050	Ifi204	19626	-	NM_008329	175677730	175691994	9
chr1	175787350	175810318	Mndal	22968	-	NM_001170853	175787515	175805968	10
chr1	175826471	175843177	Mnda	16706	-	NM_001301745	175826729	175837992	7
chr1	175850530	175872803	Ifi203	22273	-	NM_001302650	175852666	175868137	9
chr1	175892699	175912975	Ifi202b	20276	-	NM_011940	175892933	175907515	7
chr1	175942128	175961886	Ifi205	19758	-	NM_172648	175942374	175958593	7
chr1	175972063	175973067	Olfr433	1004	+	NM_146717	175972082	175973027	1
chr1	175980505	175981444	Olfr432	939	+	NM_146716	175980505	175981444	1
chr1	175999430	176000384	Olfr430	954	+	NM_146718	175999430	176000384	1
chr1	176019168	176020111	Olfr429	943	+	NM_146722	176019172	176020111	1
chr1	176029590	176030538	Olfr427	948	+	NM_207158	176029590	176030538	1
chr1	176029590	176030541	Olfr426	951	+	NM_001206926	176029590	176030541	2
chr1	176047221	176048145	Olfr231	924	-	NM_001005520	176047221	176048145	1
chr1	176066876	176067824	Olfr424	948	+	NM_146721	176066876	176067824	1
chr1	176081611	176082661	Olfr421-ps1	1050	+	NM_146720	176081648	176082596	1
chr1	176088852	176089898	Olfr420	1046	+	NM_146305	176088905	176089871	1
chr1	176102906	176178580	Spta1	75674	+	NM_011465	176103071	176177588	52
chr1	176180019	176181107	Olfr419	1088	-	NM_146715	176180114	176181056	1
chr1	176260648	176263008	Mptx1	2360	+	NM_025470	176260703	176262920	2
chr1	176299049	176299979	Olfr417	930	+	NM_207137	176299049	176299979	1
chr1	176321176	176322186	Olfr248	1010	+	NM_146714	176321201	176322131	1
chr1	176360560	176361515	Olfr414	955	+	NM_146761	176360560	176361514	1
chr1	176378755	176379733	Olfr220	978	+	NM_207694	176378755	176379733	1
chr1	176431955	176752860	Fmn2	320905	+	NM_019445	176432176	176751376	18
chr1	176763915	176851950	Grem2	88035	-	NM_011825	176766905	176767412	2
chr1	176989206	177422676	Rgs7	433470	-	NM_001199003	176996771	177421261	18
chr1	177531508	177555766	Fh1	24258	-	NM_010209	177531554	177555704	10
chr1	177562323	177590984	Kmo	28661	+	NM_133809	177562350	177589953	15
chr1	177592552	177622763	Opn3	30211	-	NM_010098	177593021	177622667	4
chr1	177612368	177618484	Chml	6116	-	NM_021350	177616618	177618484	1
chr1	177628723	177745864	Wdr64	117141	+	NM_029453	177628917	177745497	28
chr1	177810908	177841527	Exo1	30619	+	NM_012012	177813038	177838696	15
chr1	177850459	177852356	Becn2	1897	+	NM_001290692	177850500	177851952	2
chr1	177892436	178205443	Pld5	313007	-	NM_176916	177893958	178205005	10
chr1	178663783	178737255	Cep170	73472	-	NM_001099637	178665810	178723740	20
chr1	178702455	178702554	Mir350	99	-	NR_029775	178702554	178702554	1
chr1	178744790	178950563	Sdccag8	205773	+	NM_029756	178745119	178950275	18
chr1	178764754	178766264	Hmga2-ps1	1510	-	NR_037996	178766264	178766264	1
chr1	178952245	179178898	Akt3	226653	-	NM_011785	178955494	179178852	13
chr1	179374791	179380897	Zbtb18	6106	+	NM_001012330	179374940	179378802	2
chr1	179571672	179573074	2310043L19Rik	1402	-	NR_037994	179573074	179573074	3
chr1	179659944	179683436	1700016C15Rik	23492	+	NM_027077	179663627	179683159	6
chr1	179693308	179726640	Adss	33332	-	NM_007422	179694375	179726525	13
chr1	179921565	179978422	Gm16432	56857	+	NM_001034899	179921647	179977279	8
chr1	180117547	180182728	Desi2	65181	+	NM_024282	180118046	180179599	5
chr1	180249283	180252824	Cox20	3541	+	NM_025511	180249300	180252747	4
chr1	180258430	180267915	Hnrnpu	9485	-	NM_016805	180259484	180267702	14
chr1	180336011	180413380	Efcab2	77369	+	NM_026626	180336233	180411559	7
chr1	180459255	180862988	Kif26b	403733	+	NM_001161665	180459693	180862359	15
chr1	180885169	181448134	Smyd3	562965	-	NM_027188	180887591	181448082	12
chr1	181458186	181476398	Tfb2m	18212	-	NM_008249	181459307	181476262	8
chr1	181476659	181557604	Cnst	80945	+	NM_146105	181509520	181555335	11
chr1	181598361	181617315	Sccpdh	18954	+	NM_178653	181598486	181616808	12
chr1	181675034	181734146	Ahctf1	59112	-	NM_026375	181676463	181729462	36
chr1	181891219	182095733	Cdc42bpa	204514	+	NM_001033285	181891240	182092297	37
chr1	182095368	182126151	Adck3	30783	-	NM_023341	182097299	182112369	15
chr1	182157134	182186431	Psen2	29297	-	NM_001128605	182157703	182175885	11
chr1	182257099	182260680	Gm5069	3581	-	NR_003623	182260680	182260680	1
chr1	182260606	182353790	Itpkb	93184	+	NM_001081175	182262441	182352021	8
chr1	182362503	182413635	6330403A02Rik	51132	-	NM_001081227	182368459	182413460	4
chr1	182499105	182531385	Parp1	32280	+	NM_007415	182499164	182530662	23
chr1	182517331	182517398	Mir6904	67	+	NR_105869	182517398	182517398	1
chr1	182571280	182620818	Lin9	49538	+	NR_120498	182620818	182620818	15
chr1	182623178	182627165	Mixl1	3987	-	NM_013729	182624749	182627143	2
chr1	182656173	182684335	Acbd3	28162	+	NM_133225	182656232	182682501	8
chr1	182732690	182743736	H3f3a	11046	-	NM_008210	182733207	182742057	4
chr1	182781281	182798245	Sde2	16964	+	NM_145943	182781303	182796424	7
chr1	182823238	182829238	Lefty2	6000	+	NM_177099	182823314	182827944	4
chr1	182834404	182838219	Pycr2	3815	+	NM_133705	182834594	182837773	7
chr1	182865169	182868532	Lefty1	3363	+	NM_010094	182865240	182868106	4
chr1	182872648	182905235	Tmem63a	32587	+	NM_144794	182876710	182904467	23
chr1	182919686	182947700	Ephx1	28014	-	NM_001312918	182919909	182932112	9
chr1	182981367	182990798	9130409I23Rik	9431	+	NM_001033819	182981449	182989945	3
chr1	183017268	183074335	Nvl	57067	-	NM_026171	183023995	183074238	23
chr1	183081061	183099125	Cnih4	18064	+	NM_030131	183081123	183096339	5
chr1	183103356	183142109	Wdr26	38753	-	NM_145514	183107936	183141568	14
chr1	183282758	183390772	Cnih3	108014	+	NM_028408	183283556	183389383	6
chr1	183439763	183441582	Ccdc121	1819	-	NM_207280	183440544	183441516	1
chr1	183745445	183772532	Lbr	27087	-	NM_133815	183746988	183768673	14
chr1	183826515	183950111	Enah	123596	-	NM_010135	183835990	183949665	15
chr1	184054867	184062546	Srp9	7679	+	NM_012058	184055034	184061586	3
chr1	184087308	184088229	Vmn1r1	921	-	NM_001166728	184087308	184088229	1
chr1	184205900	184212890	Degs1	6990	-	NM_007853	184206877	184212834	3
chr1	184230964	184233420	1700047M11Rik	2456	+	NR_015458	184233420	184233420	2
chr1	184243232	184271737	Fbxo28	28505	-	NM_175127	184247021	184271720	5
chr1	184339297	184392567	Trp53bp2	53270	+	NM_173378	184339554	184391859	18
chr1	184397389	184447614	Capn2	50225	-	NM_009794	184398342	184447485	21
chr1	184495137	184562483	Capn8	67346	+	NM_130890	184495191	184562238	21
chr1	184677256	184679311	Ccdc185	2055	-	NM_001033547	184677387	184679253	1
chr1	184695036	184825785	Susd4	130749	+	NM_144796	184695171	184825358	8
chr1	184884918	184906175	Tlr5	21257	+	NM_016928	184902565	184905885	4
chr1	185856910	185857877	1700056E22Rik	967	-	NM_028516	185857034	185857739	1
chr1	185858339	185899515	Dusp10	41176	+	NM_022019	185860717	185898402	4
chr1	186351719	186381570	1700112H15Rik	29851	-	NR_040472	186381570	186381570	6
chr1	186536375	186542868	4930488B22Rik	6493	+	NR_040627	186542868	186542868	3
chr1	186551023	186556372	Hlx	5349	-	NM_008250	186551387	186556020	4
chr1	186610645	186635179	Marc1	24534	-	NM_001290273	186611593	186635008	7
chr1	186636946	186669726	Marc2	32780	-	NM_133684	186643099	186669696	8
chr1	186646285	186646367	Mir1981	82	-	NR_035502	186646367	186646367	1
chr1	186695804	186706915	C130074G19Rik	11111	-	NM_178692	186698186	186706870	2
chr1	186720302	186823428	Mark1	103126	-	NM_145515	186722402	186823351	18
chr1	187028046	187110625	Rab3gap2	82579	+	NM_001163754	187028120	187107875	35
chr1	187066804	187066917	Snora36b	113	+	NR_034044	187066917	187066917	1
chr1	187066853	187066922	Mir664	69	+	NR_035529	187066922	187066922	1
chr1	187110540	187153280	Iars2	42740	-	NM_198653	187110927	187153166	23
chr1	187137197	187137264	Mir194-1	67	+	NR_029580	187137264	187137264	1
chr1	187137459	187137570	Mir215	111	+	NR_029908	187137570	187137570	1
chr1	187156037	187181648	Bpnt1	25611	+	NM_011794	187161991	187180505	9
chr1	187186973	187252234	Eprs	65261	+	NM_029735	187187076	187252026	32
chr1	187253235	187265698	9630028B13Rik	12463	-	NR_038006	187265698	187265698	2
chr1	187270994	187279447	Gm2061	8453	-	NR_040305	187279447	187279447	3
chr1	187278726	187292640	Slc30a10	13914	+	NM_001033286	187278942	187288434	4
chr1	187321184	187321893	5033404E19Rik	709	+	NR_033600	187321893	187321893	1
chr1	187911610	187941189	Lyplal1	29579	-	NM_146106	187912407	187941129	5
chr1	188335716	188382560	A730004F24Rik	46844	-	NR_131124	188382560	188382560	3
chr1	188447064	188529871	Tgfb2	82807	-	NM_009367	188449326	188528653	7
chr1	188544964	188573237	Rrp15	28273	-	NM_026041	188545281	188573187	5
chr1	188791294	188794506	D1Pas1	3212	+	NM_033077	188791754	188793737	1
chr1	188872285	189039325	Spata17	167040	-	NM_028848	188872287	189039164	10
chr1	188949016	188951731	1700007P06Rik	2715	+	NR_040554	188951731	188951731	3
chr1	189039389	189175308	Gpatch2	135919	+	NM_026367	189039502	189172456	10
chr1	189432884	190038763	Esrrg	605879	+	NM_001243792	189867225	190035018	8
chr1	189830454	189832869	9330162B11Rik	2415	-	NR_038007	189832869	189832869	3
chr1	190086716	190788918	Ush2a	702202	+	NM_021408	190086912	190788807	71
chr1	190794976	190831719	Kctd3	36743	-	NM_172650	190796003	190831491	18
chr1	191031808	191226152	Kcnk2	194344	-	NM_001281848	191033668	191163847	6
chr1	191464492	191511965	Cenpf	47473	-	NM_001081363	191466477	191508985	18
chr1	191552146	191700572	Ptpn14	148426	+	NM_008976	191610653	191693934	19
chr1	191704370	191746167	Smyd2	41797	-	NM_026796	191704664	191746158	12
chr1	191945657	191994559	Prox1	48902	-	NM_008937	191947098	191986125	5
chr1	192596757	192735649	Rps6kc1	138892	-	NM_178775	192597471	192735539	15
chr1	192748986	192770370	Angel2	21384	+	NM_001199020	192756752	192768970	10
chr1	192771524	192803175	Vash2	31651	-	NR_027352	192803175	192803175	8
chr1	192829710	192850069	Mfsd7b	20359	-	NM_001081259	192832017	192849972	10
chr1	192849229	192853660	A230020J21Rik	4431	+	NR_027298	192853660	192853660	2
chr1	192860700	192866820	Spata45	6120	+	NM_029336	192863461	192866777	3
chr1	192869708	192886811	Tatdn3	17103	-	NM_001163421	192870188	192886736	10
chr1	192886899	192908437	Nsl1	21538	+	NM_198654	192886917	192906328	6
chr1	192922292	192932822	Batf3	10530	+	NM_030060	192922337	192932512	3
chr1	192986462	192988696	Fam71a	2234	-	NM_001109759	192986565	192988323	1
chr1	192994175	193007212	Atf3	13037	-	NM_007498	192995360	193001349	4
chr1	193130675	193141997	Nenf	11322	-	NM_025424	193130791	193141971	4
chr1	193149843	193176804	Tmem206	26961	+	NM_025864	193149919	193173729	8
chr1	193175859	193220920	Ppp2r5a	45061	-	NM_144880	193176855	193220295	13
chr1	193361234	193399423	Dtl	38189	-	NM_001305233	193363121	193392225	16
chr1	193399514	193447569	Ints7	48055	+	NM_178632	193399736	193445343	20
chr1	193541902	193608134	Lpgat1	66232	+	NM_172266	193543259	193602413	8
chr1	193645351	193656928	Nek2	11577	+	NM_010892	193645524	193655236	8
chr1	193717950	193731406	1700034H15Rik	13456	-	NR_030669	193731406	193731406	5
chr1	193730659	193737126	Slc30a1	6467	+	NM_009579	193730885	193733634	2
chr1	193801250	193812163	Rd3	10913	+	NM_023727	193807146	193809384	3
chr1	193821083	193916480	Traf5	95397	-	NM_011633	193821310	193894515	10
chr1	193822434	193822515	Mir3473c	81	-	NR_039566	193822515	193822515	1
chr1	193922428	193961922	Rcor3	39494	-	NM_001290282	193924691	193949899	11
chr1	193960779	193974907	Gm10516	14128	+	NR_033536	193974907	193974907	4
chr1	194014658	194334041	Kcnh1	319383	+	NM_010600	194014889	194330003	11
chr1	194336709	194597413	Hhat	260704	-	NM_144881	194337765	194585955	12
chr1	194667898	194668933	1700065J18Rik	1035	+	NR_040468	194668933	194668933	3
chr1	194670681	194681946	Sertad4	11265	-	NM_198247	194672566	194677320	4
chr1	194681121	194683049	Gm15867	1928	+	NR_131748	194683049	194683049	2
chr1	194717427	194861969	Syt14	144542	-	NM_001301370	194723500	194861829	9
chr1	194930596	194956445	Diexf	25849	-	NM_145415	194933736	194956344	12
chr1	194979305	194998229	Irf6	18924	+	NM_016851	194983412	194995700	8
chr1	194999662	195004026	A130010J15Rik	4364	+	NM_001160360	195000535	195001327	2
chr1	195001697	195027740	Traf3ip3	26043	-	NM_153137	195001860	195024213	16
chr1	195047834	195090239	Hsd11b1	42405	-	NM_008288	195048204	195068456	7
chr1	195098353	195099382	G0s2	1029	-	NM_008059	195098656	195098968	2
chr1	195128187	195170072	Lamb3	41885	+	NM_008484	195129713	195169704	23
chr1	195172539	195196476	Camk1g	23937	-	NM_144817	195173550	195188298	13
chr1	195333656	195333724	Mir205	68	-	NR_029592	195333724	195333724	1
chr1	196038380	196048953	4930503O07Rik	10573	-	NR_040477	196048953	196048953	3
chr1	196446022	196643062	Plxna2	197040	+	NM_008882	196469953	196638355	32
chr1	196648194	196648258	Mir3962	64	+	NR_039539	196648258	196648258	1
chr1	196765014	196787486	Cd34	22472	+	NM_133654	196765159	196786315	8
chr1	196781952	196803153	Gm16897	21201	-	NR_033564	196803153	196803153	5
chr1	196843592	196864102	A330023F24Rik	20510	+	NR_015566	196864102	196864102	8
chr1	196863233	196863314	Mir29b-2	81	+	NR_029809	196863314	196863314	1
chr1	196863740	196863828	Mir29c	88	+	NR_029745	196863828	196863828	1
chr1	196867431	196918442	Cd46	51011	-	NR_132621	196918442	196918442	12
chr1	196929981	196957764	Cr1l	27783	-	NM_013499	196930055	196957499	10
chr1	196963004	197002909	Cr2	39905	-	NM_007758	196967383	197002804	19
chr1_random	48173	185338	Disp1	137165	-	NM_026866	48198	97511	10
chr1_random	249689	270356	Brox	20667	-	NM_027861	251699	267782	14
chr1_random	270407	297849	Aida	27442	+	NM_181732	270866	295933	10
chr1_random	299583	342913	Mia3	43330	-	NM_177389	300687	342877	27
chr1_random	362232	383551	Taf1a	21319	+	NM_001277957	364268	382701	11
chr1_random	391817	410401	Hhipl2	18584	+	NM_030175	391859	409828	9
chr1_random	842350	862929	LOC100041034	20579	-	NR_131981	862929	862929	12
chr2	3031495	3145073	Fam171a1	113578	+	NM_001310434	3103744	3143782	8
chr2	3201483	3246149	Nmt2	44666	+	NM_001290368	3201650	3243363	14
chr2	3246220	3249900	Rpp38	3680	-	NM_001013376	3246292	3247135	2
chr2	3253439	3258269	Acbd7	4830	+	NM_030063	3253481	3258043	4
chr2	3259259	3283841	Olah	24582	-	NM_145921	3259681	3282565	8
chr2	3326314	3339920	Meig1	13606	-	NM_008579	3326466	3329254	3
chr2	3341402	3378389	Dclre1c	36987	+	NM_175683	3341489	3376226	16
chr2	3373086	3392258	Suv39h2	19172	-	NM_022724	3375894	3392218	6
chr2	3406125	3430086	Hspa14	23961	-	NM_015765	3406262	3429962	14
chr2	3430336	3443648	Cdnf	13312	+	NM_177647	3430398	3441261	4
chr2	3630729	3699406	Fam107b	68677	+	NM_025626	3690123	3696889	4
chr2	4053110	4062187	1700080N15Rik	9077	-	NR_040500	4062187	4062187	3
chr2	4073908	4535089	Frmd4a	461181	+	NM_172475	4074123	4532115	23
chr2	4543212	4573132	Prpf18	29920	-	NM_026045	4545491	4573027	10
chr2	4638876	4723192	Bend7	84316	+	NM_001190400	4639277	4721061	9
chr2	4802609	4831602	Sephs1	28993	+	NM_175400	4805458	4827841	9
chr2	4840041	4859789	Phyh	19748	+	NM_010726	4840115	4859406	9
chr2	4897167	4906794	Ucma	9627	+	NM_001113558	4897297	4906457	5
chr2	4911769	4933837	Mcm10	22068	-	NM_027290	4912438	4931741	20
chr2	4941687	4984984	Optn	43297	-	NM_181848	4942396	4975751	15
chr2	5058821	5151912	Ccdc3	93091	+	NM_028804	5058979	5150234	3
chr2	5214502	5635808	Camk1d	421306	-	NM_177343	5220028	5635283	11
chr2	5715339	5766006	Cdc123	50667	-	NM_133837	5715899	5765954	13
chr2	5766079	5789782	Nudt5	23703	+	NM_016918	5775904	5789244	9
chr2	5792032	5816399	Sec61a2	24367	-	NM_021305	5792880	5816309	12
chr2	5819105	5863838	Dhtkd1	44733	-	NM_001081131	5819753	5863717	17
chr2	5872514	5977749	Upf2	105235	+	NM_001081132	5878534	5976488	22
chr2	6019545	6051231	Proser2	31686	-	NM_001159657	6021381	6035076	4
chr2	6053914	6061616	Gm10857	7702	+	NR_033470	6061616	6061616	2
chr2	6109510	6134040	Echdc3	24530	-	NM_024208	6110385	6134006	5
chr2	6114296	6242657	A230108P19Rik	128361	+	NR_040333	6242657	6242657	7
chr2	6243802	6364866	Usp6nl	121064	+	NM_001080548	6257501	6362788	15
chr2	6460743	7317825	Celf2	857082	-	NM_001110231	6468131	6642640	16
chr2	6843747	6849768	5031426D15Rik	6021	-	NR_027890	6849768	6849768	1
chr2	9111141	9119111	1700061F12Rik	7970	+	NR_038180	9119111	9119111	4
chr2	9778704	9800227	Gata3	21523	-	NM_008091	9779996	9799216	6
chr2	9802872	9808394	4930412O13Rik	5522	+	NR_024257	9808394	9808394	5
chr2	9804667	9811167	9230102O04Rik	6500	-	NR_040511	9811167	9811167	4
chr2	9836178	9970236	Taf3	134058	-	NM_027748	9837975	9970027	7
chr2	9977658	10002137	Atp5c1	24479	-	NM_001112738	9978426	9991338	10
chr2	10002238	10014328	Kin	12090	+	NM_025280	10002257	10014144	5
chr2	10016217	10052310	Itih2	36093	-	NM_010582	10016380	10052204	21
chr2	10075169	10178156	Itih5	102987	+	NM_172471	10075292	10173210	14
chr2	10292077	10516880	Sfmbt2	224803	+	NM_001198808	10314936	10512197	23
chr2	10388289	10388373	Mir466m	84	+	NR_130333	10388373	10388373	1
chr2	10388855	10388976	Mir669f	121	+	NR_130324	10388976	10388976	1
chr2	10389121	10389240	Mir669e	119	+	NR_035426	10389240	10389240	1
chr2	10389416	10389513	Mir669b	97	+	NR_030469	10389513	10389513	1
chr2	10389969	10390090	Mir669d	121	+	NR_130323	10390090	10390090	1
chr2	10390597	10390695	Mir669l	98	+	NR_130330	10390695	10390695	1
chr2	10393270	10393356	Mir669d-2	86	+	NR_130334	10393356	10393356	1
chr2	10393880	10393970	Mir297a-2	90	+	NR_029648	10393970	10393970	1
chr2	10394166	10394250	Mir466o	84	+	NR_037248	10394250	10394250	1
chr2	10395557	10395654	Mir467c	97	+	NR_030571	10395654	10395654	1
chr2	10395841	10395931	Mir466b-4	90	+	NR_130336	10395931	10395931	1
chr2	10395841	10395931	Mir466b-6	90	+	NR_130338	10395931	10395931	1
chr2	10395843	10395931	Mir466b-5	88	+	NR_130337	10395931	10395931	1
chr2	10395843	10395931	Mir466b-7	88	+	NR_130339	10395931	10395931	1
chr2	10395845	10395927	Mir466b-1	82	+	NR_130319	10395927	10395927	1
chr2	10396059	10396168	Mir669a-3	109	+	NR_030471	10396168	10396168	1
chr2	10396926	10397053	Mir669k	127	+	NR_035410	10397053	10397053	1
chr2	10398254	10398340	Mir466b-8	86	+	NR_130341	10398340	10398340	1
chr2	10398256	10398340	Mir466e	84	+	NR_130321	10398340	10398340	1
chr2	10398483	10398570	Mir669a-4	87	+	NR_037250	10398570	10398570	1
chr2	10398483	10398570	Mir669a-5	87	+	NR_037251	10398570	10398570	1
chr2	10398483	10398570	Mir669a-8	87	+	NR_037259	10398570	10398570	1
chr2	10398483	10398570	Mir669a-9	87	+	NR_037260	10398570	10398570	1
chr2	10398483	10398570	Mir669a-10	87	+	NR_037264	10398570	10398570	1
chr2	10398483	10398570	Mir669a-11	87	+	NR_037266	10398570	10398570	1
chr2	10398483	10398570	Mir669a-12	87	+	NR_037268	10398570	10398570	1
chr2	10398776	10398899	Mir669g	123	+	NR_035411	10398899	10398899	1
chr2	10399536	10399657	Mir669j	121	+	NR_035416	10399657	10399657	1
chr2	10400941	10401028	Mir669a-6	87	+	NR_037253	10401028	10401028	1
chr2	10402874	10402947	Mir467b	73	+	NR_030472	10402947	10402947	1
chr2	10403157	10403247	Mir466c-2	90	+	NR_130335	10403247	10403247	1
chr2	10403160	10403244	Mir466c-1	84	+	NR_130320	10403244	10403244	1
chr2	10405304	10405387	Mir467a-10	83	+	NR_037267	10405387	10405387	1
chr2	10407766	10407839	Mir467a-1	73	+	NR_035406	10407839	10407839	1
chr2	10410225	10410308	Mir467a-2	83	+	NR_037249	10410308	10410308	1
chr2	10410225	10410308	Mir467a-8	83	+	NR_037263	10410308	10410308	1
chr2	10410742	10410829	Mir669p-1	87	+	NR_037257	10410829	10410829	1
chr2	10410742	10410829	Mir669p-2	87	+	NR_037262	10410829	10410829	1
chr2	10412962	10413052	Gm25285	90	+	NR_130344	10413052	10413052	1
chr2	10420019	10420102	Mir467a-7	83	+	NR_037261	10420102	10420102	1
chr2	10420311	10420393	Mir466b-2	82	+	NR_030564	10420393	10420393	1
chr2	10422448	10422531	Mir467a-4	83	+	NR_037254	10422531	10422531	1
chr2	10422448	10422531	Mir467a-5	83	+	NR_037256	10422531	10422531	1
chr2	10422448	10422531	Mir467a-9	83	+	NR_037265	10422531	10422531	1
chr2	10422961	10423058	Mir669a-1	97	+	NR_035408	10423058	10423058	1
chr2	10424899	10424982	Mir467a-3	83	+	NR_037252	10424982	10424982	1
chr2	10424899	10424982	Mir467a-6	83	+	NR_037258	10424982	10424982	1
chr2	10425191	10425272	Mir466b-3	81	+	NR_030565	10425272	10425272	1
chr2	10425417	10425504	Mir669a-7	87	+	NR_037255	10425504	10425504	1
chr2	10427632	10427721	Mir466p	89	+	NR_105742	10427721	10427721	1
chr2	10429256	10429341	Mir467d	85	+	NR_030572	10429341	10429341	1
chr2	10429544	10429617	Mir466	73	+	NR_030150	10429617	10429617	1
chr2	10430922	10431031	Mir669c	109	+	NR_030473	10431031	10431031	1
chr2	10431790	10431887	Mir669a-2	97	+	NR_030470	10431887	10431887	1
chr2	10433293	10433402	Mir297b	109	+	NR_030474	10433402	10433402	1
chr2	10435060	10435158	Mir669m-2	98	+	NR_035475	10435158	10435158	1
chr2	10435061	10435155	Mir669m-1	94	+	NR_035474	10435155	10435155	1
chr2	10435367	10435461	Mir466n	94	+	NR_037269	10435461	10435461	1
chr2	10435926	10436022	Mir669o	96	+	NR_130331	10436022	10436022	1
chr2	10436221	10436301	Mir466g	80	+	NR_030569	10436301	10436301	1
chr2	10437446	10437543	Mir297c	97	+	NR_030555	10437543	10437543	1
chr2	10437446	10437548	Mir297a-3	102	+	NR_030551	10437548	10437548	1
chr2	10437723	10437844	Mir466l	121	+	NR_130322	10437844	10437844	1
chr2	10439230	10439357	Mir669i	127	+	NR_035417	10439357	10439357	1
chr2	10439781	10439906	Mir669h	125	+	NR_035418	10439906	10439906	1
chr2	11094008	11222853	Prkcq	128845	+	NM_008859	11148494	11221752	18
chr2	11259992	11320127	8030442B05Rik	60135	-	NR_040615	11320127	11320127	3
chr2	11261115	11265733	Gm13293	4618	+	NR_040369	11265733	11265733	4
chr2	11393057	11475556	Pfkfb3	82499	-	NM_001177758	11396122	11475469	15
chr2	11507065	11524826	Rbm17	17761	-	NM_152824	11507251	11522368	12
chr2	11564418	11614821	Il2ra	50403	+	NM_008367	11564627	11611409	8
chr2	11626919	11655612	Il15ra	28693	+	NM_001271497	11645074	11654876	7
chr2	11664199	11699154	Fbxo18	34955	-	NM_015792	11664489	11699059	21
chr2	11699379	11711950	Ankrd16	12571	+	NM_177268	11700215	11711518	7
chr2	12028286	12223547	Itga8	195261	-	NM_001001309	12030741	12223409	30
chr2	12222872	12233942	E030013I19Rik	11070	+	NR_040353	12233942	12233942	2
chr2	12268890	12341087	Fam188a	72197	-	NM_024185	12269680	12340879	15
chr2	12845667	12925081	Pter	79414	+	NM_001305437	12896070	12922694	6
chr2	12923513	12932491	C1ql3	8978	-	NM_153155	12925891	12932474	2
chr2	12998593	13193042	Rsu1	194449	-	NM_009105	12999131	13192646	9
chr2	13197964	13413503	Cubn	215539	-	NM_001081084	13198354	13413440	67
chr2	13431787	13466291	Trdmt1	34504	-	NM_010067	13433144	13466259	11
chr2	13495937	13504453	Vim	8516	+	NM_011701	13496058	13504141	9
chr2	13576564	13715147	St8sia6	138583	-	NM_145838	13578448	13715071	8
chr2	13948457	13977662	Hacd1	29205	-	NM_013935	13948550	13977494	7
chr2	13991959	13995561	Stamos	3602	-	NR_038162	13995561	13995561	2
chr2	13995738	14069957	Stam	74219	+	NM_011484	13995923	14068107	14
chr2	14096150	14143620	Tmem236	47470	+	NM_001081310	14096216	14141063	4
chr2	14151040	14253650	Mrc1	102610	+	NM_008625	14151139	14252802	30
chr2	14182629	14182708	Mir511	79	+	NR_030609	14182708	14182708	1
chr2	14310024	14416604	Slc39a12	106580	+	NM_001012305	14310947	14416176	13
chr2	14525932	14909535	Cacnb2	383603	+	NM_023116	14526077	14907703	14
chr2	14642268	14644249	Gm13315	1981	+	NR_028497	14644249	14644249	1
chr2	14916757	14976499	Nsun6	59742	-	NM_001165941	14917939	14970623	12
chr2	14976988	15000818	Arl5b	23830	+	NM_029466	14977152	14997931	6
chr2	15448105	16177184	Malrd1	729079	+	NM_001310455	15448258	16176969	39
chr2	16277930	16677466	Plxdc2	399536	+	NM_026162	16278752	16672934	14
chr2	16840304	16935353	4930515L03Rik	95049	-	NR_040632	16935353	16935353	4
chr2	17268360	17652695	Nebl	384335	-	NM_028757	17270320	17652488	7
chr2	17485140	17485253	Mir6419	113	+	NR_105847	17485253	17485253	1
chr2	17918043	17918585	H2afb1	542	-	NM_026627	17918164	17918500	1
chr2	17946815	17959368	A930004D18Rik	12553	-	NR_028376	17959368	17959368	2
chr2	17948875	17952204	Gm17762	3329	+	NR_028378	17952204	17952204	1
chr2	17965713	17970076	Skida1	4363	-	NM_028317	17967236	17969966	1
chr2	17976863	18134017	Mllt10	157154	+	NM_010804	17986661	18132439	23
chr2	17979472	17979530	Mir7655	58	+	NR_106115	17979530	17979530	1
chr2	18127959	18314457	Dnajc1	186498	-	NM_001190817	18138883	18314127	13
chr2	18594088	18597843	Commd3	3755	+	NM_147778	18594091	18597553	8
chr2	18598644	18608256	Bmi1	9612	+	NM_007552	18603438	18606108	10
chr2	18620648	18671232	Spag6l	50584	+	NM_001001334	18620696	18671159	11
chr2	18664335	18682489	Gm3363	18154	-	NR_126079	18682489	18682489	5
chr2	18720874	18723445	Carlr	2571	-	NR_131254	18723445	18723445	1
chr2	18763882	18919748	Pip4k2a	155866	-	NM_008845	18766009	18919622	10
chr2	18919945	18921431	4930426L09Rik	1486	+	NR_024323	18921431	18921431	1
chr2	19120744	19231870	Armc3	111126	+	NM_001081083	19123394	19231753	20
chr2	19265943	19273878	4930447M23Rik	7935	+	NR_126563	19273878	19273878	4
chr2	19293262	19316597	Msrb2	23335	+	NM_029619	19293309	19315982	5
chr2	19363134	19368301	Ptf1aos	5167	-	NR_131924	19368301	19368301	4
chr2	19367289	19369128	Ptf1a	1839	+	NM_018809	19367487	19368793	2
chr2	19384463	19475537	4921504E06Rik	91074	-	NM_027600	19384754	19475507	17
chr2	19577432	19579524	Gm3230	2092	-	NR_033642	19579524	19579524	1
chr2	19579688	19582217	Otud1	2529	+	NM_027715	19579688	19581053	1
chr2	20211539	20732162	Etl4	520623	+	NM_001081006	20211633	20730837	22
chr2	20769545	20889348	Arhgap21	119803	-	NM_001128084	20770338	20889037	25
chr2	20890500	20891975	Gm13375	1475	+	NR_033225	20891975	20891975	2
chr2	21102357	21126992	Enkur	24635	-	NM_027728	21102571	21126775	5
chr2	21127350	21136636	Thnsl1	9286	+	NM_177588	21133063	21135307	3
chr2	21289193	21752169	Gpr158	462976	+	NM_001004761	21289882	21749320	11
chr2	22149129	22473772	Myo3a	324643	+	NM_148413	22149262	22473689	34
chr2	22477846	22549397	Gad2	71551	+	NM_008078	22478182	22545866	16
chr2	22509802	22509870	Mir3967	68	+	NR_039548	22509870	22509870	1
chr2	22629846	22731173	Apbb1ip	101327	+	NM_019456	22672472	22730841	14
chr2	22751041	22795779	Pdss1	44738	+	NM_019501	22751150	22795483	11
chr2	22795508	22895761	Abi1	100253	-	NM_001077190	22797391	22895585	11
chr2	22923720	22970032	Acbd5	46312	+	NM_028793	22925063	22968037	13
chr2	22972063	23011544	Mastl	39481	-	NM_025979	22973954	23011381	12
chr2	23012024	23054780	Yme1l1	42756	+	NM_013771	23012218	23052551	19
chr2	23062995	23122649	4931423N10Rik	59654	+	NM_027635	23063331	23122292	11
chr2	23176765	23257493	Nxph2	80728	+	NM_008752	23177008	23255943	2
chr2	23365573	23427624	Spopl	62051	-	NM_001165997	23366835	23400295	12
chr2	23858431	23904899	Hnmt	46468	-	NM_080462	23859112	23904344	7
chr2	23926885	23952115	Tbpl2	25230	-	NM_001289689	23927506	23952055	7
chr2	24008691	24015623	Il1f8	6932	+	NM_027163	24010109	24015450	5
chr2	24041995	24049087	Il1f9	7092	+	NM_153511	24042697	24048316	5
chr2	24070936	24081221	Il1f6	10285	+	NM_019450	24071366	24080117	6
chr2	24132473	24137952	Il1f5	5479	+	NM_001146087	24133018	24136892	6
chr2	24146715	24149340	Il1f10	2625	+	NM_153077	24146743	24149289	4
chr2	24192379	24207011	Il1rn	14632	+	NM_031167	24192502	24205150	5
chr2	24240916	24264249	Psd4	23333	+	NM_177611	24249645	24262754	17
chr2	24276070	24331119	Pax8	55049	-	NM_011040	24277067	24330617	12
chr2	24459408	24618672	Cacna1b	159264	-	NM_001042528	24462089	24618567	47
chr2	24646288	24775129	Ehmt1	128841	-	NM_172545	24647469	24775094	27
chr2	24780871	24790801	Arrdc1	9930	-	NM_178408	24781125	24790665	8
chr2	24805296	24816390	Zmynd19	11094	+	NM_026021	24805516	24814581	6
chr2	24817941	24828991	Dph7	11050	+	NM_026044	24817998	24827530	9
chr2	24827989	24830618	Mrpl41	2629	-	NM_001031808	24829770	24830178	2
chr2	24831552	24909592	Pnpla7	78040	+	NM_146251	24831803	24909313	35
chr2	24909898	24918401	Nsmf	8503	+	NM_001039386	24910120	24917289	16
chr2	24915330	24915393	Mir7664	63	+	NR_106124	24915393	24915393	1
chr2	24935842	24941239	Entpd8	5397	+	NM_028093	24937341	24940672	10
chr2	24941189	24950725	Noxa1	9536	-	NM_172204	24941243	24950444	12
chr2	25036277	25038852	Nrarp	2575	+	NM_025980	25036630	25036975	1
chr2	25048239	25052333	Tor4a	4094	-	NM_146115	25050128	25051409	2
chr2	25055231	25067009	Nelfb	11778	-	NM_021393	25055839	25066867	13
chr2	25068078	25070150	4933433C11Rik	2072	-	NM_028961	25068558	25070121	6
chr2	25074264	25077801	Fam166a	3537	+	NM_026624	25074320	25077691	7
chr2	25077677	25080222	Tubb4b	2545	-	NM_146116	25077827	25080110	4
chr2	25084416	25089754	Slc34a3	5338	-	NM_080854	25084570	25088907	13
chr2	25089995	25092307	Rnf224	2312	-	NM_001033410	25091388	25091859	2
chr2	25094338	25095417	Cysrt1	1079	-	NM_026415	25094589	25095018	2
chr2	25098448	25099781	Rnf208	1333	+	NM_176834	25098815	25099613	1
chr2	25100332	25110934	Ndor1	10602	-	NM_001252542	25101294	25110389	14
chr2	25110958	25111872	Tmem203	914	+	NM_177344	25111189	25111600	1
chr2	25118117	25125406	Tprn	7289	+	NM_175286	25118207	25124938	4
chr2	25126558	25127938	Ssna1	1380	-	NM_023464	25126993	25127869	3
chr2	25127985	25141436	Anapc2	13451	+	NM_175300	25128035	25140983	13
chr2	25143664	25144707	Tmem210	1043	+	NM_030055	25143694	25144665	4
chr2	25145430	25146713	Lrrc26	1283	+	NM_146117	25145508	25146580	2
chr2	25146696	25174707	Grin1	28011	-	NM_001177656	25147579	25174406	20
chr2	25146739	25154448	Grin1os	7709	+	NM_001242940	25151531	25152532	4
chr2	25182969	25188091	AA543186	5122	-	NR_027448	25188091	25188091	2
chr2	25188262	25207733	Man1b1	19471	+	NM_001029983	25188379	25206085	13
chr2	25207809	25211852	Dpp7	4043	-	NM_031843	25207938	25211847	13
chr2	25217011	25221146	Uap1l1	4135	-	NM_001033293	25217166	25221135	9
chr2	25227554	25233733	Sapcd2	6179	+	NM_001081085	25227950	25232000	7
chr2	25251393	25256843	Entpd2	5450	+	NM_009849	25251492	25256493	9
chr2	25258569	25265014	Npdc1	6445	+	NM_008721	25258773	25264711	9
chr2	25278761	25281893	Fut7	3132	+	NM_001289456	25280285	25281421	4
chr2	25284193	25304059	Abca2	19866	+	NM_007379	25284289	25303396	48
chr2	25298298	25298354	Mir3087	56	+	NR_037270	25298354	25298354	1
chr2	25312362	25314292	Clic3	1930	+	NM_027085	25312398	25314243	6
chr2	25315007	25316614	BC029214	1607	-	NM_153557	25315181	25316431	7
chr2	25322231	25325269	Ptgds	3038	-	NM_008963	25322845	25325193	7
chr2	25346364	25349431	Lcn12	3067	-	NM_029958	25346443	25349376	6
chr2	25354169	25357239	C8g	3070	-	NM_001271777	25354329	25357083	7
chr2	25356297	25360990	Fbxw5	4693	+	NM_013908	25357478	25360485	9
chr2	25373501	25402460	Traf2	28959	-	NM_001290413	25374929	25394573	11
chr2	25413419	25417602	Edf1	4183	+	NM_021519	25413471	25417432	5
chr2	25418634	25426836	Mamdc4	8202	-	NM_001081199	25418826	25426737	29
chr2	25428950	25430391	Phpt1	1441	-	NM_029293	25429126	25430359	3
chr2	25430935	25435619	Gm996	4684	-	NM_001005424	25432492	25435417	1
chr2	25438537	25463966	Rabl6	25429	-	NM_001024616	25439310	25463762	15
chr2	25464148	25473198	Ccdc183	9050	-	NM_029859	25464194	25473124	14
chr2	25475585	25477525	Tmem141	1940	-	NM_001109993	25476036	25477155	4
chr2	25480186	25483494	Fcna	3308	-	NM_007995	25480360	25483356	10
chr2	25508637	25511736	Lcn8	3099	+	NM_033145	25508659	25511634	7
chr2	25513471	25517750	Lcn5	4279	+	NM_001042630	25513500	25517406	6
chr2	25532305	25537127	Lcn6	4822	+	NM_177840	25532335	25536975	7
chr2	25538245	25541600	Lcn10	3355	+	NM_178036	25538305	25541104	6
chr2	25555593	25558846	Obp2a	3253	+	NM_153558	25555610	25558272	7
chr2	25562398	25563239	Bmyc	841	+	NM_023326	25562445	25562958	1
chr2	25592528	25595617	Obp2b	3089	+	NM_001099301	25592576	25595134	7
chr2	25621088	25623619	Lcn3	2531	+	NM_010694	25621092	25623503	7
chr2	25632536	25635799	Lcn11	3263	+	NM_001100455	25632555	25635703	6
chr2	25640136	25642542	Gm13539	2406	+	NR_045340	25642542	25642542	3
chr2	25649486	25671356	Glt6d1	21870	-	NM_001039095	25649576	25669718	5
chr2	25678672	25681057	Lcn9	2385	+	NM_029959	25678679	25680436	7
chr2	25698516	25702768	Sohlh1	4252	-	NM_001001714	25698676	25702715	8
chr2	25719314	25773793	Kcnt1	54479	+	NM_001145403	25719487	25771637	32
chr2	25782357	25838802	Camsap1	56445	-	NM_001276361	25785245	25838458	18
chr2	25852477	25877280	Ubac1	24803	-	NM_133835	25854471	25877054	10
chr2	25911055	25978331	Nacc2	67276	-	NM_026495	25915481	25945942	6
chr2	25992327	25996026	C330006A16Rik	3699	-	NM_001256521	25993902	25994322	2
chr2	26055731	26063769	Lhx3	8038	-	NM_010711	26056612	26063709	6
chr2	26064643	26092919	Qsox2	28276	-	NM_153559	26065110	26092872	13
chr2	26127166	26150077	Ccdc187	22911	-	NM_177841	26127262	26149903	10
chr2	26171052	26203757	Gpsm1	32705	+	NM_153410	26171172	26202533	14
chr2	26203637	26207630	Dnlz	3993	-	NM_026828	26205924	26207532	3
chr2	26207831	26215067	Card9	7236	-	NM_001037747	26207831	26215067	12
chr2	26218284	26236173	Snapc4	17889	-	NM_001290419	26219177	26232463	24
chr2	26238319	26244836	Sdccag3	6517	-	NM_026563	26239117	26244738	10
chr2	26244867	26252641	Pmpca	7774	+	NM_173180	26244884	26251108	13
chr2	26251768	26264739	Inpp5e	12971	-	NM_033134	26253358	26264107	10
chr2	26264950	26300736	Sec16a	35786	-	NM_153125	26266404	26297521	30
chr2	26313421	26359342	Notch1	45921	-	NM_008714	26315050	26359078	34
chr2	26325578	26325639	Mir6996	61	-	NR_105962	26325639	26325639	1
chr2	26359446	26360866	Gm35978	1420	+	NR_132655	26360866	26360866	2
chr2	26436575	26448202	Egfl7	11627	+	NM_178444	26444597	26447960	10
chr2	26446876	26446949	Mir126a	73	+	NR_029541	26446949	26446949	1
chr2	26446882	26446940	Mir126b	58	-	NR_106155	26446940	26446940	1
chr2	26448576	26459937	Agpat2	11361	-	NM_026212	26449106	26459730	6
chr2	26483976	26492017	Fam69b	8041	+	NM_019833	26484156	26491871	5
chr2	26492695	26495764	Snhg7	3069	-	NR_024068	26495764	26495764	4
chr2	26493366	26493505	Snora43	139	-	NR_028572	26493505	26493505	1
chr2	26494709	26494841	Snora17	132	-	NR_028571	26494841	26494841	1
chr2	26523193	26526802	Lcn4	3609	-	NM_010695	26523394	26526787	7
chr2	26698022	26720515	Abo	22493	-	NM_030718	26698706	26720403	6
chr2	26746291	26758333	Surf6	12042	-	NM_009298	26747765	26758307	5
chr2	26760786	26766162	Med22	5376	-	NM_001033908	26761323	26765935	4
chr2	26766326	26768831	Rpl7a	2505	+	NM_013721	26766347	26768789	8
chr2	26768897	26772050	Surf1	3153	-	NM_001271724	26768955	26771851	9
chr2	26771940	26775690	Surf2	3750	+	NM_013678	26771945	26775333	6
chr2	26775560	26789031	Surf4	13471	-	NM_011512	26777424	26788842	6
chr2	26789588	26809016	Stkld1	19428	+	NM_198628	26790842	26808911	19
chr2	26809082	26819906	Rexo4	10824	-	NM_207234	26809996	26819838	8
chr2	26828935	26865145	Adamts13	36210	+	NM_001001322	26829056	26864967	29
chr2	26865445	26876609	Cacfd1	11164	+	NM_029862	26865507	26874498	6
chr2	26876884	26883518	Slc2a6	6634	-	NM_172659	26877433	26883425	10
chr2	26917155	26927681	Tmem8c	10526	-	NM_025376	26917707	26927535	5
chr2	26934900	26964133	Adamtsl2	29233	+	NM_029981	26937224	26963959	19
chr2	26965898	26997997	Fam163b	32099	-	NM_175427	26967999	26969160	3
chr2	27000417	27018223	Dbhos	17806	-	NR_040524	27018223	27018223	7
chr2	27021026	27038724	Dbh	17698	+	NM_138942	27021035	27038320	12
chr2	27043912	27102823	Sardh	58911	-	NM_138665	27045038	27100022	21
chr2	27117623	27283128	Vav2	165505	-	NR_133905	27283128	27283128	30
chr2	27301100	27331193	Brd3	30093	-	NM_001113574	27303984	27319618	13
chr2	27306068	27306150	Mir7578	82	-	NR_106102	27306150	27306150	1
chr2	27370666	27392055	Wdr5	21389	+	NM_080848	27374231	27390377	14
chr2	27532720	27618839	Rxra	86119	+	NM_011305	27532952	27615208	10
chr2	27741944	27895030	Col5a1	153086	+	NM_015734	27742335	27892536	66
chr2	27931998	27940398	Fcnb	8400	-	NM_010190	27932094	27940377	9
chr2	28048612	28086256	Olfm1	37644	+	NM_001038613	28048916	28085248	6
chr2	28303460	28311028	Ppp1r26	7568	+	NM_001005420	28305879	28309371	3
chr2	28317520	28321844	1700007K13Rik	4324	-	NM_027040	28317765	28321789	3
chr2	28323585	28326697	Mrps2	3112	+	NM_080452	28323619	28325528	4
chr2	28352410	28360935	Gbgt1	8525	+	NM_139197	28353285	28360915	7
chr2	28368686	28408602	Ralgds	39916	+	NM_001145834	28369062	28407787	18
chr2	28411339	28418923	Cel	7584	-	NM_009885	28411577	28418882	11
chr2	28421764	28438799	Gtf3c5	17035	-	NM_001290484	28423152	28438497	12
chr2	28464969	28477502	Gfi1b	12533	-	NM_001160406	28465544	28470896	7
chr2	28496752	28546692	Tsc1	49940	+	NM_022887	28514204	28542693	23
chr2	28547599	28555171	1700026L06Rik	7572	-	NM_027283	28547660	28551570	5
chr2	28555680	28668685	Ak8	113005	+	NM_001033874	28555710	28668585	13
chr2	28588797	28588871	Mir3088	74	+	NR_037271	28588871	28588871	1
chr2	28677819	28695880	Gtf3c4	18061	-	NM_001166033	28682252	28690815	6
chr2	28695925	28761095	Ddx31	65170	+	NM_001033294	28696371	28760277	20
chr2	28763199	28771960	Barhl1	8761	-	NM_001164186	28765147	28771199	4
chr2	28811000	28910586	Cfap77	99586	-	NM_001166705	28811057	28910528	6
chr2	28915782	28943170	Ttf1	27388	+	NM_009442	28920145	28941645	12
chr2	28980511	29037991	Setx	57480	+	NM_198033	28982406	29035645	26
chr2	29050245	29103619	Ntng2	53374	-	NM_133501	29050340	29103560	9
chr2	29100635	29108513	6530402F18Rik	7878	-	NR_029460	29108513	29108513	2
chr2	29202329	29380310	Med27	177981	+	NM_026896	29202364	29380021	8
chr2	29330734	29330814	Mir133c	80	-	NR_105753	29330814	29330814	1
chr2	29475239	29595883	Rapgef1	120644	+	NM_001039086	29475522	29593590	26
chr2	29617047	29619609	Gm13547	2562	+	NM_001177392	29617083	29619508	4
chr2	29630203	29643191	Trub2	12988	-	NM_145520	29633150	29643131	8
chr2	29643782	29653263	Coq4	9481	+	NM_178693	29643804	29652099	7
chr2	29658199	29673042	Slc27a4	14843	+	NM_011989	29659685	29671253	13
chr2	29682908	29700516	Urm1	17608	+	NM_026615	29682920	29698691	5
chr2	29701150	29701247	Mir219a-2	97	-	NR_029838	29701247	29701247	1
chr2	29701166	29701231	Mir219b	65	+	NR_106110	29701231	29701231	1
chr2	29725013	29738360	Cercam	13347	+	NM_207298	29725057	29737468	12
chr2	29745239	29787266	Odf2	42027	+	NM_001177659	29748566	29786181	21
chr2	29790928	29814952	Gle1	24024	+	NM_028923	29791019	29814035	16
chr2	29821079	29886970	Sptan1	65891	+	NM_001309460	29833899	29886616	58
chr2	29851469	29851540	Mir6997	71	+	NR_105963	29851540	29851540	1
chr2	29887077	29904399	Wdr34	17322	-	NM_001008498	29887253	29904389	9
chr2	29917515	29928097	Set	10582	+	NM_023871	29917691	29926462	8
chr2	29934285	29946539	Pkn3	12254	+	NM_153805	29934295	29946255	22
chr2	29946463	29949155	Zdhhc12	2692	-	NM_001037762	29946764	29949108	5
chr2	29952802	29980131	Zer1	27329	-	NM_001290503	29954305	29968923	16
chr2	29989390	30007533	Tbc1d13	18143	+	NM_146252	29989409	30005285	12
chr2	30027043	30029589	Endog	2546	+	NM_007931	30027094	30029493	3
chr2	30028966	30033979	D2Wsu81e	5013	-	NM_172660	30029612	30033945	12
chr2	30040650	30061219	Ccbl1	20569	-	NM_172404	30041023	30049626	14
chr2	30092717	30093151	1700084E18Rik	434	-	NR_028299	30093151	30093151	1
chr2	30093288	30119310	Lrrc8a	26022	+	NM_177725	30110695	30117643	4
chr2	30121722	30137669	Phyhd1	15947	+	NM_172267	30122131	30137335	12
chr2	30139748	30141874	Dolk	2126	-	NM_177648	30139946	30141551	1
chr2	30141952	30199782	Nup188	57830	+	NM_198304	30141958	30199398	44
chr2	30200296	30214836	Sh3glb2	14540	-	NM_001289709	30200839	30214725	12
chr2	30219752	30241039	Fam73b	21287	+	NM_001242407	30223211	30239655	16
chr2	30247773	30256049	Dolpp1	8276	+	NM_001290508	30251704	30254698	9
chr2	30255995	30271268	Crat	15273	-	NM_007760	30258097	30270858	14
chr2	30271569	30303327	Ppp2r4	31758	+	NM_138748	30271821	30301974	10
chr2	30328160	30329719	Ier5l	1559	-	NM_030244	30328310	30329531	1
chr2	30450563	30464465	Cstad	13902	+	NM_030137	30450589	30463989	2
chr2	30576729	30576813	Mir3089	84	+	NR_037272	30576813	30576813	1
chr2	30651082	30659184	1700001O22Rik	8102	-	NR_028487	30659184	30659184	7
chr2	30663496	30678534	Ntmt1	15038	+	NM_170592	30675190	30678138	4
chr2	30678617	30683820	Asb6	5203	-	NM_133346	30679359	30683706	6
chr2	30700886	30736767	Prrx2	35881	+	NM_009116	30700954	30736450	4
chr2	30744990	30758817	Ptges	13827	-	NM_022415	30748096	30758738	3
chr2	30808520	30814535	Tor1b	6015	+	NM_133673	30808544	30812573	5
chr2	30816080	30823438	Tor1a	7358	-	NM_144884	30816466	30823374	5
chr2	30828352	30837461	BC005624	9109	-	NM_144885	30828729	30837380	9
chr2	30837798	30878175	Usp20	40377	+	NM_028846	30854307	30877004	25
chr2	30881725	30997528	Fnbp1	115803	-	NM_001177648	30884395	30997322	17
chr2	31006568	31007811	D330023K18Rik	1243	-	NR_040334	31007811	31007811	2
chr2	31007835	31072087	Gpr107	64252	+	NM_178760	31007878	31069860	18
chr2	31101442	31150991	Ncs1	49549	+	NM_019681	31101698	31142905	8
chr2	31325789	31376190	Ass1	50401	+	NM_007494	31332410	31375937	16
chr2	31428170	31473046	Fubp3	44876	+	NM_001290548	31428389	31471707	19
chr2	31467940	31468004	Mir6998	64	+	NR_105964	31468004	31468004	1
chr2	31495556	31511315	Prdm12	15759	+	NM_001123362	31495618	31510004	5
chr2	31526256	31536827	Exosc2	10571	+	NM_144886	31526259	31536090	9
chr2	31544056	31659882	Abl1	115826	+	NM_001283047	31640185	31657419	12
chr2	31661687	31666100	Qrfp	4413	-	NM_183424	31664063	31664438	2
chr2	31668809	31701525	Fibcd1	32716	-	NM_178887	31671957	31701302	7
chr2	31742800	31802055	Lamc3	59255	+	NM_011836	31742863	31800934	28
chr2	31805822	31828962	Aif1l	23140	+	NM_145144	31805870	31826510	6
chr2	31829969	31909495	Nup214	79526	+	NM_172268	31830083	31907672	36
chr2	31906465	31906528	Mir7674	63	+	NR_106135	31906528	31906528	1
chr2	31922404	31939225	Fam78a	16821	-	NM_175511	31924764	31938426	2
chr2	31951170	31966340	Plpp7	15170	+	NM_145521	31951331	31965493	2
chr2	32006667	32090057	Prrc2b	83390	+	NM_001159634	32038031	32086262	32
chr2	32092202	32110525	Pomt1	18323	+	NM_145145	32092225	32109964	20
chr2	32110521	32115625	Uck1	5104	-	NM_011675	32111549	32115554	7
chr2	32134324	32143589	Swi5	9265	-	NM_001290552	32134586	32143582	5
chr2	32143772	32163441	Golga2	19669	+	NM_133852	32143832	32162140	27
chr2	32163990	32208849	Dnm1	44859	-	NM_001301737	32165985	32208729	22
chr2	32173784	32173863	Gm23363	79	+	NR_128563	32173863	32173863	1
chr2	32173979	32174089	Mir199b	110	+	NR_029811	32174089	32174089	1
chr2	32218529	32233833	Ciz1	15304	+	NM_001252536	32219329	32233690	19
chr2	32234620	32237435	1110008P14Rik	2815	-	NM_198001	32234880	32237290	2
chr2	32240156	32243259	Lcn2	3103	-	NM_008491	32240384	32243237	6
chr2	32251409	32258260	Ptges2	6851	+	NM_133783	32251794	32257848	7
chr2	32270006	32306990	Slc25a25	36984	-	NM_146118	32271657	32306844	11
chr2	32305976	32310996	Naif1	5020	+	NM_194335	32307958	32310789	2
chr2	32390878	32425270	Fam102a	34392	+	NM_153560	32391606	32422960	11
chr2	32426377	32429091	Dpm2	2714	+	NM_010073	32426429	32428537	4
chr2	32431338	32439299	Pip5kl1	7961	+	NM_198191	32431384	32439060	10
chr2	32442597	32455216	St6galnac4	12619	+	NM_001276425	32443189	32452723	6
chr2	32455228	32476329	St6galnac6	21101	+	NM_001025311	32455299	32475049	5
chr2	32477277	32490578	Ak1	13301	+	NM_001198790	32484001	32489229	7
chr2	32502114	32538189	Eng	36075	+	NM_007932	32502477	32537081	15
chr2	32507848	32507934	Mir1954	86	+	NR_035479	32507934	32507934	1
chr2	32538128	32549695	Fpgs	11567	-	NM_010236	32538578	32549646	15
chr2	32543149	32543286	Mir8093	137	-	NR_106168	32543286	32543286	1
chr2	32561301	32568304	Cdk9	7003	-	NM_130860	32563443	32568176	7
chr2	32568326	32568408	Mir2861	82	-	NR_037217	32568408	32568408	1
chr2	32568419	32568492	Mir3960	73	-	NR_039536	32568492	32568492	1
chr2	32576574	32610527	Sh2d3c	33953	+	NR_045535	32610527	32610527	13
chr2	32588140	32596536	6330409D20Rik	8396	-	NM_027529	32588513	32596280	3
chr2	32612545	32631153	Ttc16	18608	-	NM_001290563	32612768	32630868	15
chr2	32612753	32617764	Tor2a	5011	+	NM_152800	32612819	32617260	5
chr2	32631340	32633113	Ptrh1	1773	+	NM_178595	32631349	32632824	5
chr2	32632932	32639925	Cfap157	6993	-	NM_025619	32633017	32639907	9
chr2	32643126	32702757	Stxbp1	59631	-	NM_001113569	32650123	32702611	20
chr2	32731653	32780773	Fam129b	49120	+	NM_146119	32731869	32779546	14
chr2	32780734	32816775	Lrsam1	36041	-	NM_199302	32782295	32815108	25
chr2	32817231	32819565	Rpl12	2334	+	NM_009076	32817322	32819516	7
chr2	32818820	32818938	Snora65	118	+	NR_002898	32818938	32818938	1
chr2	32828508	32837576	Slc2a8	9068	-	NM_019488	32829114	32837533	10
chr2	32841885	32942724	Garnl3	100839	-	NM_178888	32842175	32942609	29
chr2	32988938	33227014	Ralgps1	238076	-	NM_175211	32993199	33196289	20
chr2	33071480	33103234	Angptl2	31754	+	NM_011923	33083735	33101806	5
chr2	33261627	33286844	Zbtb34	25217	-	NM_001085507	33266490	33283652	3
chr2	33305807	33324052	Zbtb43	18245	-	NM_027947	33309216	33317873	4
chr2	33420055	33496031	Lmx1b	75976	-	NM_010725	33420155	33496031	8
chr2	33496712	33501183	C130021I20Rik	4471	+	NR_046275	33501183	33501183	3
chr2	33585475	33743466	Mvb12b	157991	-	NM_175184	33588964	33742914	10
chr2	33661335	33669111	Nron	7776	+	NR_045729	33669111	33669111	3
chr2	33873808	33963255	C230014O12Rik	89447	-	NR_130173	33963255	33963255	4
chr2	34026976	34227565	Pbx3	200589	-	NM_016768	34028400	34227440	9
chr2	34262290	34480478	Mapkap1	218188	+	NM_001290625	34287591	34479068	12
chr2	34532501	34610752	Gapvd1	78251	-	NM_025709	34533556	34586167	27
chr2	34627609	34632049	Hspa5	4440	+	NM_001163434	34627841	34631633	9
chr2	34634185	34655432	Rabepk	21247	-	NM_145522	34634756	34655288	8
chr2	34659883	34681755	Fbxw2	21872	-	NM_001164770	34661230	34678180	8
chr2	34707608	34726482	Psmd5	18874	-	NM_080554	34708095	34726442	10
chr2	34729915	34747653	Cutal	17738	+	NM_030021	34730045	34745902	6
chr2	34749274	34769496	Phf19	20222	-	NM_028716	34751238	34767316	15
chr2	34798777	34817292	Traf1	18515	-	NM_009421	34799392	34813600	11
chr2	34838850	34916961	Hc	78111	-	NM_010406	34839197	34916918	41
chr2	34937380	34956205	AI182371	18825	-	NM_001243103	34938000	34956173	10
chr2	34965011	35034342	Cntrl	69331	+	NM_012018	34967105	35033615	44
chr2	35035724	35056640	Rab14	20916	-	NM_026697	35037789	35048192	8
chr2	35111878	35163422	Gsn	51544	+	NM_001206367	35139433	35163186	18
chr2	35169509	35192529	Stom	23020	-	NM_013515	35171380	35192439	7
chr2	35209737	35223249	4930568D16Rik	13512	-	NM_029463	35209898	35221798	6
chr2	35231081	35252694	4930402F06Rik	21613	-	NM_001080709	35231177	35246070	6
chr2	35255698	35316969	Ggta1	61271	-	NM_010283	35257628	35278847	9
chr2	35405053	35414222	Gm13446	9169	-	NR_045894	35414222	35414222	4
chr2	35413977	35586514	Dab2ip	172537	+	NM_001114125	35414092	35584640	17
chr2	35606745	35835144	Ttll11	228399	-	NM_029774	35607752	35835144	10
chr2	35674709	35678905	9030204H09Rik	4196	+	NR_040618	35678905	35678905	3
chr2	35891853	35904812	Ndufa8	12959	-	NM_026703	35892023	35904762	4
chr2	35904992	35935229	Morn5	30237	+	NM_029309	35905048	35935108	5
chr2	35937472	35960928	Lhx6	23456	-	NM_008500	35939574	35960727	10
chr2	35971598	35992224	Rbm18	20626	-	NM_001159635	35973334	35989767	6
chr2	35991917	36045803	Mrrf	53886	+	NM_026422	35996993	36044672	7
chr2	36085945	36107791	Ptgs1	21846	+	NM_008969	36086082	36106871	11
chr2	36232297	36233218	Olfr338	921	+	NM_146947	36232297	36233218	1
chr2	36276919	36277849	Olfr339	930	+	NM_146949	36276919	36277849	1
chr2	36308106	36309045	Olfr340	939	+	NM_146951	36308106	36309045	1
chr2	36334706	36335648	Olfr341	942	-	NM_146950	36334706	36335648	1
chr2	36382933	36383872	Olfr342	939	+	NM_146948	36382933	36383872	1
chr2	36424119	36425049	Olfr344	930	+	NM_146628	36424119	36425049	1
chr2	36495560	36496496	Olfr345	936	+	NM_146945	36495560	36496496	1
chr2	36543523	36544453	Olfr346	930	+	NM_146938	36543523	36544453	1
chr2	36589842	36590781	Olfr347	939	+	NM_146943	36589842	36590781	1
chr2	36642046	36642988	Olfr348	942	+	NM_146944	36642046	36642988	1
chr2	36648757	36649696	Olfr50	939	+	NM_146946	36648757	36649696	1
chr2	36667668	36668610	Olfr3	942	-	NM_206903	36667668	36668610	1
chr2	36705567	36706506	Olfr350	939	+	NM_146627	36705567	36706506	1
chr2	36714933	36715866	Olfr351	933	-	NM_146942	36714933	36715866	1
chr2	36725087	36726035	Olfr352	948	+	NM_146940	36725087	36726035	1
chr2	36745430	36746366	Olfr353	936	-	NM_146941	36745430	36746366	1
chr2	36762467	36763421	Olfr354	954	+	NM_146939	36762467	36763421	1
chr2	36782699	36783632	Olfr355	933	-	NM_146625	36782699	36783632	1
chr2	36792640	36793588	Olfr356	948	+	NM_146624	36792640	36793588	1
chr2	36852331	36853258	Olfr357	927	+	NM_146623	36852331	36853258	1
chr2	36860139	36861132	Olfr358	993	-	NM_207235	36860139	36861132	1
chr2	36923826	36924780	Olfr360	954	+	NM_146622	36923826	36924780	1
chr2	36940297	36941266	Olfr361	969	-	NM_146368	36940297	36941266	1
chr2	36960214	36961168	Olfr362	954	-	NM_147051	36960214	36961168	1
chr2	37056762	37057701	Olfr365	939	+	NM_146662	37056762	37057701	1
chr2	37075010	37075940	Olfr366	930	+	NM_001005569	37075010	37075940	1
chr2	37122470	37126907	Olfr367-ps	4437	+	NM_001081010	37126064	37126907	2
chr2	37187268	37188252	Olfr368	984	+	NM_146374	37187268	37188252	1
chr2	37205593	37214852	Pdcl	9259	-	NM_026176	37207350	37212895	4
chr2	37225590	37278423	Rc3h2	52833	-	NM_001100591	37230752	37270266	22
chr2	37255580	37255648	Snord90	68	-	NR_028535	37255648	37255648	1
chr2	37281019	37286439	Zbtb6	5420	-	NM_146253	37284162	37285434	2
chr2	37287687	37298641	Zbtb26	10954	-	NM_199025	37291186	37292509	2
chr2	37298804	37421957	Rabgap1	123153	+	NM_146121	37324946	37420407	26
chr2	37372145	37374801	Gpr21	2656	+	NM_177383	37372963	37374013	2
chr2	37425387	37502805	Strbp	77418	-	NM_009261	37439549	37502638	17
chr2	37543720	37543804	Mir5128	84	-	NR_039590	37543804	37543804	1
chr2	37631768	37654623	Crb2	22855	+	NM_001163566	37631860	37652192	13
chr2	37654509	38142904	Dennd1a	488395	-	NM_146122	37655555	38142649	22
chr2	38194800	38225257	Lhx2	30457	+	NM_001290646	38208833	38224649	5
chr2	38367216	38443010	Nek6	75794	+	NM_021606	38406101	38440910	10
chr2	38443565	38499426	Psmb7	55861	-	NM_011187	38443696	38499422	8
chr2	38548179	38570062	Nr5a1	21883	-	NM_139051	38549536	38566277	7
chr2	38578893	38781981	Nr6a1	203088	-	NM_010264	38583346	38781737	11
chr2	38708254	38708330	Mir181a-2	76	+	NR_029568	38708330	38708330	1
chr2	38709349	38709435	Mir181b-2	86	+	NR_029904	38709435	38709435	1
chr2	38787499	38816105	Olfml2a	28606	+	NM_172854	38787596	38815839	8
chr2	38853828	38857104	Wdr38	3276	+	NM_029687	38853912	38856894	9
chr2	38857100	38860651	Rpl35	3551	-	NM_025592	38857135	38860606	4
chr2	38863658	38871392	Arpc5l	7734	+	NM_028809	38863715	38870640	4
chr2	38871675	38921061	Golga1	49386	-	NR_110968	38921061	38921061	24
chr2	38921734	39046250	Scai	124516	-	NM_178778	38930529	39046162	18
chr2	39013005	39017755	Gm16523	4750	-	NR_033526	39017755	39017755	1
chr2	39052317	39081858	Ppp6c	29541	-	NM_024209	39052860	39081761	7
chr2	40452292	42509118	Lrp1b	2056826	-	NM_053011	40452453	42508336	91
chr2	42302958	42303088	Mir6336	130	-	NR_105754	42303088	42303088	1
chr2	43410844	43538568	Kynu	127724	+	NM_027552	43418486	43536991	14
chr2	43604343	44251473	Arhgap15	647130	+	NM_001301831	43604408	44249854	15
chr2	43914757	43920844	Arhgap15os	6087	-	NR_040622	43920844	43920844	3
chr2	44419931	44717142	Gtdc1	297211	-	NM_172662	44420970	44681049	11
chr2	44839031	44968799	Zeb2	129768	-	NM_015753	44844092	44965608	10
chr2	44878619	44878697	Mir5129	78	-	NR_039591	44878697	44878697	1
chr2	44966657	44969604	Zeb2os	2947	+	NR_110572	44969604	44969604	3
chr2	45552124	45553967	1700019E08Rik	1843	+	NR_040497	45553967	45553967	4
chr2	48669628	48758784	Acvr2a	89156	+	NM_007396	48670291	48755308	11
chr2	48758273	48804787	Orc4	46514	-	NR_033442	48804787	48804787	14
chr2	48805027	49172589	Mbd5	367562	+	NM_029924	49101613	49171979	17
chr2	49307005	49407129	Epc2	100124	+	NM_172663	49307325	49405518	14
chr2	49474833	49630298	Kif5c	155465	+	NM_008449	49475181	49614436	26
chr2	49643205	49804366	Lypd6b	161161	+	NM_027990	49790327	49803113	10
chr2	49921948	50049089	Lypd6	127141	+	NR_033304	50049089	50049089	6
chr2	50135400	50152197	Mmadhc	16797	-	NM_133839	50135727	50151780	8
chr2	50152329	50289487	Gm13483	137158	+	NR_040362	50289487	50289487	3
chr2	50765203	50767366	Gm13498	2163	+	NR_033595	50767366	50767366	1
chr2	50985958	51004631	Rnd3	18673	-	NM_028810	50987813	51004394	5
chr2	51097350	51151465	Gm13497	54115	+	NR_040636	51151465	51151465	3
chr2	51276569	51293420	1700057H21Rik	16851	-	NR_130155	51293420	51293420	3
chr2	51483030	51483927	Tas2r134	897	+	NM_199158	51483030	51483927	1
chr2	51512485	51587529	Gm13490	75044	-	NR_040639	51587529	51587529	7
chr2	51779968	51790529	Rbm43	10561	-	NM_030243	51780695	51787922	5
chr2	51804018	51828728	Nmi	24710	-	NM_001141949	51804095	51816174	9
chr2	51893632	51912201	Tnfaip6	18569	+	NM_009398	51893695	51911491	6
chr2	51928356	51977901	Rif1	49545	+	NM_175238	51928669	51976723	36
chr2	51992166	52194318	Neb	202152	-	NM_010889	51992777	52190001	157
chr2	52146521	52170760	4930573O16Rik	24239	+	NR_040620	52170760	52170760	4
chr2	52253470	52280394	Arl5a	26924	-	NM_182994	52257903	52280155	6
chr2	52283839	52532128	Cacnb4	248289	-	NM_001037099	52290008	52531849	14
chr2	52547724	52601183	Stam2	53459	-	NM_019667	52550227	52601134	14
chr2	52716901	52993236	Fmnl2	276335	+	NM_172409	52717176	52990912	27
chr2	52997508	53050221	Prpf40a	52713	-	NM_018785	52998211	53050221	26
chr2	53051117	53078255	Arl6ip6	27138	+	NM_022989	53051156	53076422	4
chr2	53936503	53937963	Rprm	1460	-	NM_023396	53937385	53937715	1
chr2	54288797	54970155	Galnt13	681358	+	NM_173030	54368950	54965372	13
chr2	55288380	55450556	Kcnj3	162176	+	NM_008426	55289611	55447808	4
chr2	56638221	56638318	Mir195b	97	+	NR_105751	56638318	56638318	1
chr2	56959636	56976414	Nr4a2	16778	-	NM_001139509	56960566	56964850	8
chr2	56979887	57034165	BB557941	54278	-	NR_040356	57034165	57034165	3
chr2	57034241	57040668	4930555B11Rik	6427	+	NR_040633	57040668	57040668	4
chr2	57090088	57223130	Gpd2	133042	+	NM_001145820	57120391	57219888	17
chr2	57850565	57891582	Galnt5	41017	+	NM_172855	57850800	57891363	10
chr2	57897525	57905163	Ermn	7638	-	NM_029972	57900164	57905127	3
chr2	57981549	58012533	Cytip	30984	-	NM_139200	57986137	58012466	8
chr2	58016384	58029474	Gm13546	13090	+	NR_045895	58029474	58029474	4
chr2	58119863	58210169	Acvr1c	90306	-	NM_001111030	58127328	58210091	9
chr2	58129189	58139313	Gm13544	10124	+	NR_040365	58139313	58139313	4
chr2	58298848	58419239	Acvr1	120391	-	NM_001110204	58299949	58352961	13
chr2	58419744	58645382	Upp2	225638	+	NM_001289660	58419828	58644241	8
chr2	58674108	58998684	Ccdc148	324576	-	NM_001001178	58675964	58861554	15
chr2	58998906	59193262	Pkp4	194356	+	NM_026361	59052739	59192505	22
chr2	59220549	59224739	5330411J11Rik	4190	-	NR_040510	59224739	59224739	3
chr2	59322709	59343078	Dapl1	20369	+	NM_029723	59322765	59342884	4
chr2	59450098	59684270	Tanc1	234172	+	NM_198294	59537423	59682180	27
chr2	59690421	59720663	Wdsub1	30242	-	NM_028118	59690860	59716584	11
chr2	59737419	59963797	Baz2b	226378	-	NM_001001182	59738705	59844244	36
chr2	60047992	60086442	March7	38450	+	NM_020575	60066986	60085966	10
chr2	60090049	60122541	Cd302	32492	-	NM_001290660	60090348	60122177	6
chr2	60131816	60221288	Ly75	89472	-	NM_013825	60131816	60221288	35
chr2	60249581	60250631	Gm13580	1050	+	NR_046065	60250631	60250631	3
chr2	60255599	60391365	Pla2r1	135766	-	NM_008867	60258069	60391187	30
chr2	60436348	60560660	Itgb6	124312	-	NM_001159564	60438541	60511519	18
chr2	60590009	60801261	Rbms1	211252	-	NM_020296	60591793	60800822	14
chr2	60802432	60813208	Gm13582	10776	-	NR_045335	60813208	60813208	4
chr2	61416642	61492226	Tank	75584	+	NM_011529	61416697	61491612	8
chr2	61549750	61638433	Psmd14	88683	+	NM_021526	61560770	61638137	12
chr2	61642509	61652170	Tbr1	9661	+	NM_009322	61642764	61650495	6
chr2	61884571	62164800	Slc4a10	280229	+	NM_001242380	61884701	62155545	27
chr2	62168129	62250288	Dpp4	82159	-	NM_010074	62170674	62249848	26
chr2	62312586	62321710	Gcg	9124	-	NM_008100	62313034	62318613	6
chr2	62338992	62412078	Fap	73086	-	NM_007986	62339240	62411908	26
chr2	62433849	62484312	Ifih1	50463	-	NM_027835	62435965	62483987	16
chr2	62502383	62532166	Gca	29783	+	NM_145523	62502489	62529647	8
chr2	62541002	63022344	Kcnh7	481342	-	NM_133207	62541002	63022134	16
chr2	63809564	63936095	Fign	126531	-	NM_001267847	63816701	63818948	4
chr2	64750539	64860823	Grb14	110284	-	NM_016719	64750763	64860701	14
chr2	64926395	65076683	Cobll1	150288	-	NM_177025	64927527	65076496	14
chr2	65154689	65202083	Slc38a11	47394	-	NM_177074	65154826	65201976	12
chr2	65202352	65202457	Mir6337	105	-	NR_105755	65202457	65202457	1
chr2	65295174	65405549	Scn3a	110375	-	NM_018732	65298613	65374733	27
chr2	65508501	65605504	Scn2a1	97003	+	NM_001099298	65508552	65602886	26
chr2	65683823	65869603	Csrnp3	185780	+	NM_153409	65716096	65861080	7
chr2	65920822	65962850	Galnt3	42028	-	NM_015736	65922226	65945421	11
chr2	66022383	66094674	Ttc21b	72291	-	NM_001047604	66022822	66094591	29
chr2	66108838	66278894	Scn1a	170056	-	NM_018733	66110941	66189234	27
chr2	66278936	66385529	Gm13629	106593	+	NR_033495	66385529	66385529	4
chr2	66318137	66473019	Scn9a	154882	-	NM_001290675	66321474	66406321	27
chr2	66511482	66622967	Scn7a	111485	-	NM_009135	66513554	66595414	25
chr2	67011890	67024269	Gm1322	12379	+	NM_001033477	67012080	67022967	2
chr2	67284058	67364663	Xirp2	80605	+	NM_001024618	67314866	67364308	9
chr2	67513513	67513573	Mir7224	60	+	NR_106083	67513573	67513573	1
chr2	67619099	67619197	Mir6335	98	+	NR_105752	67619197	67619197	1
chr2	67942728	67960939	B3galt1	18211	+	NM_020283	67955999	67956980	2
chr2	68048503	68310038	Stk39	261535	-	NM_016866	68049975	68309934	18
chr2	68420469	68454520	4933409G03Rik	34051	+	NM_177651	68426871	68454398	17
chr2	68495940	68586522	4932414N04Rik	90582	+	NM_183113	68546993	68586426	29
chr2	68699613	68949347	Cers6	249734	+	NM_172856	68699692	68946651	10
chr2	68973856	69027386	Nostrin	53530	+	NM_181547	68973946	69027190	16
chr2	69031951	69044270	Spc25	12319	-	NM_001199123	69032477	69043221	7
chr2	69049129	69066050	G6pc2	16921	+	NM_001289856	69061008	69065136	5
chr2	69076338	69180673	Abcb11	104335	-	NM_021022	69077140	69167402	28
chr2	69218518	69241143	Dhrs9	22625	+	NM_175512	69230966	69239514	5
chr2	69262391	69424124	Lrp2	161733	-	NM_001081088	69263701	69423950	79
chr2	69485311	69505626	Bbs5	20315	+	NM_028284	69485340	69505262	12
chr2	69508176	69522296	Klhl41	14120	+	NM_001081087	69508253	69521656	6
chr2	69524880	69550663	Fastkd1	25783	-	NM_177244	69525101	69550518	14
chr2	69561144	69592116	Ppig	30972	+	NM_001081086	69570270	69588439	14
chr2	69596113	69627543	Ccdc173	31430	-	NM_001077684	69596177	69627520	9
chr2	69627793	69635225	Phospho2	7432	+	NM_028521	69633558	69634284	4
chr2	69660426	69674708	Klhl23	14282	+	NM_177784	69661844	69672042	4
chr2	69699618	69709903	Ssb	10285	+	NM_001110145	69701306	69709267	12
chr2	69709251	69723672	Mettl5	14421	-	NM_029280	69709334	69723414	7
chr2	69735302	69862067	Ubr3	126765	+	NM_177783	69735351	69859717	39
chr2	69877182	70267252	Myo3b	390070	+	NM_177376	69877202	70265018	35
chr2	70312979	70315783	Sp5	2804	+	NM_022435	70313322	70315226	2
chr2	70327996	70401414	Gad1os	73418	-	NR_040496	70401414	70401414	3
chr2	70346875	70378941	Erich2	32066	+	NM_025744	70347159	70378868	13
chr2	70400185	70440071	Gad1	39886	+	NM_008077	70401888	70438853	17
chr2	70499565	70529782	Gorasp2	30217	+	NR_027343	70529782	70529782	11
chr2	70550464	70663537	Tlk1	113073	-	NM_172664	70552045	70663388	20
chr2	70802619	70893663	Mettl8	91044	-	NM_145524	70803572	70856419	10
chr2	70893800	70937199	Dcaf17	43399	+	NM_001165981	70894050	70927986	15
chr2	70956110	70980983	Cybrd1	24873	+	NM_028593	70956176	70976714	4
chr2	71049762	71101359	Dync1i2	51597	+	NM_001198873	71052504	71100818	19
chr2	71112351	71205611	Slc25a12	93260	-	NM_172436	71113211	71205581	18
chr2	71227316	71279679	Hat1	52363	+	NM_026115	71227354	71279392	11
chr2	71291394	71363248	Metap1d	71854	+	NM_025633	71291415	71363018	10
chr2	71367501	71372038	Dlx1	4537	+	NM_010053	71368050	71370575	3
chr2	71368694	71375948	Dlx1as	7254	-	NR_002854	71375948	71375948	2
chr2	71381464	71384811	Dlx2	3347	-	NM_010054	71382576	71384449	3
chr2	71557473	71569023	Platr26	11550	+	NR_037979	71569023	71569023	4
chr2	71624995	71696484	Itga6	71489	+	NM_008397	71625195	71691698	26
chr2	71711280	71741915	Pdk1	30635	+	NM_172665	71711426	71738181	11
chr2	71819271	72095531	Rapgef4	276260	+	NM_001204165	71819343	72094433	31
chr2	72123693	72280667	Zak	156974	+	NM_023057	72136278	72279995	20
chr2	72314275	72324947	Cdca7	10672	+	NM_025866	72314347	72323807	9
chr2	72541566	72567525	8430437L04Rik	25959	+	NR_040503	72567525	72567525	7
chr2	72583902	72651774	6430710C18Rik	67872	-	NR_102348	72651774	72651774	6
chr2	72774489	72818503	Sp3	44014	-	NM_001018042	72776122	72818313	7
chr2	72817488	72827306	Sp3os	9818	+	NR_045269	72827306	72827306	3
chr2	72930857	73052504	Ola1	121647	-	NM_025942	72931679	73051017	11
chr2	73109982	73113828	Sp9	3846	+	NM_001005343	73110127	73112615	2
chr2	73121928	73150649	Cir1	28721	-	NM_025854	73122416	73150545	10
chr2	73150708	73175864	Scrn3	25156	+	NM_029022	73153490	73173938	8
chr2	73179562	73224537	Gpr155	44975	-	NM_001190297	73181513	73220334	17
chr2	73267666	73367544	Wipf1	99878	-	NM_153138	73270466	73285956	8
chr2	73401337	73418395	Chrna1	17058	-	NM_007389	73404232	73418344	9
chr2	73434582	73454069	Chn1os3	19487	+	NR_040623	73454069	73454069	4
chr2	73448716	73613403	Chn1	164687	-	NM_001113246	73451081	73613098	13
chr2	73654565	73730696	Atf2	76131	-	NM_001025093	73656978	73701273	15
chr2	73746503	73749383	Atp5g3	2880	-	NM_001301721	73746649	73749050	5
chr2	74136996	74145774	4930441J16Rik	8778	-	NR_040501	74145774	74145774	5
chr2	74352893	74417005	Lnp	64112	-	NM_001110209	74360345	74411621	14
chr2	74491047	74497614	Evx2	6567	-	NM_007967	74493672	74497476	3
chr2	74506366	74509656	Hoxd13	3290	+	NM_008275	74506366	74508193	2
chr2	74513069	74515762	Hoxd12	2693	+	NM_008274	74513143	74514109	2
chr2	74517614	74525073	Hoxd11	7459	+	NR_073086	74525073	74525073	2
chr2	74529947	74533163	Hoxd10	3216	+	NM_013554	74530036	74532425	2
chr2	74535819	74538265	Hoxd9	2446	+	NM_013555	74536112	74537478	2
chr2	74542671	74545989	Hoxd8	3318	+	NM_001290731	74544150	74544869	3
chr2	74548100	74554187	Hoxd3os1	6087	-	NR_027899	74554187	74554187	3
chr2	74550049	74586328	Hoxd3	36279	+	NM_010468	74582068	74585136	3
chr2	74560034	74567216	Hoxd4	7182	+	NM_010469	74565335	74566644	6
chr2	74564126	74564194	Mir10b	68	+	NR_029566	74564194	74564194	1
chr2	74586478	74600953	Haglr	14475	-	NR_110445	74600953	74600953	3
chr2	74590740	74591799	LOC102634401	1059	+	NR_110447	74591799	74591799	2
chr2	74601036	74603199	Hoxd1	2163	+	NM_010467	74601158	74602446	2
chr2	74663868	74714805	Mtx2	50937	+	NM_016804	74664060	74714531	10
chr2	75274113	75282236	9430019J16Rik	8123	-	NR_040635	75282236	75282236	3
chr2	75497315	75507464	Hnrnpa3	10149	+	NM_146130	75497374	75503343	11
chr2	75497346	75503813	Gm6793	6467	+	NR_033513	75503813	75503813	11
chr2	75513569	75542720	Nfe2l2	29151	-	NM_010902	75514017	75542465	5
chr2	75670233	75769407	Agps	99174	+	NM_172666	75670269	75764100	20
chr2	75773906	75776519	Ttc30b	2613	-	NM_028235	75774469	75776464	1
chr2	75814228	75816236	Ttc30a2	2008	-	NM_001081228	75814228	75816223	1
chr2	75817162	75820024	Ttc30a1	2862	-	NM_030188	75817799	75819794	1
chr2	75829188	76176710	Pde11a	347522	-	NM_001081033	75829188	76176664	20
chr2	76191998	76198510	Cyct	6512	-	NM_009989	76192144	76194305	4
chr2	76208040	76221824	Rbm45	13784	+	NM_153405	76208185	76218614	10
chr2	76244564	76438704	Osbpl6	194140	+	NM_145525	76362099	76434039	27
chr2	76467993	76486051	Prkra	18058	-	NM_011871	76468467	76485913	8
chr2	76488329	76496611	Dfnb59	8282	+	NM_001080711	76488478	76496602	6
chr2	76501090	76511155	Fkbp7	10065	-	NM_010222	76501247	76511071	4
chr2	76513371	76535392	Plekha3	22021	+	NM_031256	76513651	76533559	8
chr2	76542040	76820604	Ttn	278564	-	NM_011652	76543087	76818239	313
chr2	76847962	77008692	Ccdc141	160730	-	NM_001025576	76849546	77008543	24
chr2	77018396	77118649	Sestd1	100253	-	NM_175465	77025187	77083128	18
chr2	77248688	77654873	Zfp385b	406185	-	NM_178723	77249981	77557796	10
chr2	77300700	77318995	Gm13944	18295	+	NR_040368	77318995	77318995	3
chr2	77733709	77784413	Cwc22	50704	-	NM_030560	77734063	77774676	21
chr2	77889233	78034587	4930440I19Rik	145354	+	NR_108098	78034587	78034587	7
chr2	78077703	78142387	Gm14461	64684	+	NM_177843	78141848	78142157	6
chr2	78709203	78760740	Ube2e3	51537	+	NM_009454	78710641	78760212	6
chr2	79095582	79173271	Itga4	77689	+	NM_010576	79095816	79166772	28
chr2	79172647	79269145	Cerkl	96498	-	NM_001048176	79172731	79269048	13
chr2	79292797	79296793	Neurod1	3996	-	NM_010894	79294120	79295194	2
chr2	79475581	79513121	Ssfa2	37540	+	NM_080558	79475696	79510991	18
chr2	79547936	79658703	Ppp1r1c	110767	+	NR_110979	79658703	79658703	5
chr2	79674609	79969569	Pde1a	294960	-	NM_001159582	79679084	79968991	16
chr2	80132626	80135515	Prdx6b	2889	+	NM_177256	80133005	80133680	1
chr2	80155622	80194212	Dnajc10	38590	+	NM_024181	80157552	80193027	23
chr2	80231520	80238373	Gm13752	6853	+	NR_040370	80238373	80238373	4
chr2	80252126	80287553	Frzb	35427	-	NM_011356	80253518	80286997	6
chr2	80340668	80421339	Nckap1	80671	-	NM_001290745	80341451	80421122	32
chr2	80457370	80471818	Dusp19	14448	+	NM_024438	80457540	80471188	4
chr2	80468861	80468947	Mir684-1	86	-	NR_030454	80468947	80468947	1
chr2	80478968	80500228	Nup35	21260	+	NM_027091	80479049	80498555	9
chr2	81893814	82100035	Zfp804a	206221	+	NM_175513	81893947	82099588	4
chr2	83484734	83504773	Zc3h15	20039	+	NM_026934	83484809	83504167	10
chr2	83564553	83647074	Itgav	82521	+	NM_008402	83564891	83643492	30
chr2	83652884	83721515	Fam171b	68631	+	NM_175514	83652905	83720608	8
chr2	83755235	83781383	Zswim2	26148	-	NM_027964	83755353	83781335	9
chr2	84170782	84265423	Calcrl	94641	-	NM_018782	84173610	84215502	16
chr2	84273016	84314331	Tfpi	41315	-	NM_011576	84273252	84298288	9
chr2	84340904	84347030	Gm13710	6126	-	NR_046046	84347030	84347030	3
chr2	84440937	84490897	Ctnnd1	49960	-	NM_007615	84443048	84464621	20
chr2	84499235	84508938	Btbd18	9703	+	NM_001145100	84501633	84508348	5
chr2	84509377	84510865	2700094K13Rik	1488	-	NM_001037279	84510172	84510743	4
chr2	84511467	84518985	Tmx2	7518	-	NM_025868	84512545	84518196	9
chr2	84518558	84528372	Med19	9814	+	NM_025885	84518601	84527091	5
chr2	84528076	84555321	Zdhhc5	27245	-	NM_144887	84529435	84550578	12
chr2	84563278	84567425	Clp1	4147	-	NM_133840	84563702	84566291	3
chr2	84574360	84578034	Ypel4	3674	+	NM_001005342	84576981	84577942	5
chr2	84581271	84581335	Mir130a	64	-	NR_029544	84581335	84581335	1
chr2	84605516	84615586	Serping1	10070	-	NM_009776	84605730	84614947	8
chr2	84638984	84650160	Ube2l6	11176	+	NM_019949	84639062	84649313	4
chr2	84651332	84662809	Smtnl1	11477	-	NM_024230	84651551	84659065	8
chr2	84667177	84670370	Timm10	3193	+	NM_013899	84667799	84670148	3
chr2	84679564	84703743	Slc43a1	24179	+	NM_001081349	84679722	84703186	15
chr2	84712102	84726849	Rtn4rl2	14747	-	NM_199223	84712102	84726849	3
chr2	84776802	84798666	Slc43a3	21864	+	NM_021398	84777842	84797941	13
chr2	84820617	84823789	Prg2	3172	+	NM_008920	84821494	84823675	6
chr2	84828371	84834043	Prg3	5672	+	NM_016914	84828888	84833923	6
chr2	84836708	84875991	P2rx3	39283	-	NM_145526	84839169	84875456	12
chr2	84877276	84887271	Ssrp1	9995	+	NM_182990	84878072	84886871	17
chr2	84890616	84913205	Tnks1bp1	22589	+	NM_001081260	84891036	84912313	12
chr2	84913770	84926618	4930443O20Rik	12848	-	NR_040504	84926618	84926618	3
chr2	84976516	84980080	Aplnr	3564	+	NM_011784	84976789	84977923	1
chr2	85028227	85036856	Lrrc55	8629	-	NM_001033346	85032066	85036835	3
chr2	85171123	85172053	Olfr987	930	-	NM_001011785	85171123	85172053	1
chr2	85193151	85194081	Olfr988	930	-	NM_001011534	85193151	85194081	1
chr2	85239758	85240688	Olfr992	930	-	NM_146865	85239758	85240688	1
chr2	85254089	85255034	Olfr993	945	-	NM_146435	85254089	85255034	1
chr2	85270039	85270984	Olfr994	945	-	NM_146433	85270039	85270984	1
chr2	85278365	85279313	Olfr995	948	-	NM_146434	85278365	85279313	1
chr2	85324248	85359092	4833423E24Rik	34844	-	NM_001081664	85324300	85358923	12
chr2	85419371	85420439	Olfr996	1068	+	NM_146437	85419397	85420342	1
chr2	85430666	85431678	Olfr998	1012	+	NM_146436	85430698	85431643	1
chr2	85448120	85449065	Olfr1000	945	-	NM_001011695	85448120	85449065	1
chr2	85487519	85488476	Olfr1002	957	-	NM_146573	85487519	85488476	1
chr2	85503533	85504612	Olfr154	1079	-	NM_013728	85503632	85504589	1
chr2	85514367	85518898	Olfr1006	4531	-	NM_146570	85514367	85515306	2
chr2	85529587	85530529	Olfr1008	942	+	NM_146866	85529587	85530529	1
chr2	85561563	85562508	Olfr1009	945	+	NM_146572	85561563	85562508	1
chr2	85593519	85594463	Olfr1010	944	+	NM_207149	85593519	85594463	2
chr2	85599595	85600531	Olfr1012	936	-	NM_146568	85599595	85600531	1
chr2	85609959	85610877	Olfr1013	918	+	NM_146762	85609959	85610877	1
chr2	85616742	85617660	Olfr1014	918	+	NM_146569	85616742	85617660	1
chr2	85625630	85626646	Olfr1015	1016	+	NM_146571	85625669	85626608	1
chr2	85639495	85640425	Olfr1016	930	-	NM_001011758	85639495	85640425	1
chr2	85663129	85664065	Olfr1018	936	+	NM_146586	85663129	85664065	1
chr2	85681013	85681946	Olfr1019	933	-	NM_147015	85681013	85681946	1
chr2	85689576	85690655	Olfr1020	1079	+	NM_146580	85689610	85690564	1
chr2	85708750	85709698	Olfr1022	948	+	NM_146589	85708750	85709698	1
chr2	85726958	85727894	Olfr1023	936	+	NM_146587	85726958	85727894	1
chr2	85744225	85745209	Olfr1024	984	-	NM_001005230	85744225	85745209	1
chr2	85763426	85764350	Olfr1026	924	+	NM_146584	85763426	85764350	1
chr2	85791221	85792196	Olfr1028	975	+	NM_001011774	85791221	85792196	1
chr2	85815369	85816430	Olfr1029	1061	+	NM_001011852	85815401	85816376	1
chr2	85819468	85824955	Olfr1030	5487	+	NM_146588	85823998	85824955	2
chr2	85831975	85832986	Olfr1031	1011	+	NM_001011759	85831975	85832986	1
chr2	85847934	85848867	Olfr1032	933	+	NM_146579	85847934	85848867	1
chr2	85860796	85884965	Olfr1033	24169	+	NM_146578	85881473	85882406	3
chr2	85886600	85887623	Olfr1034	1023	+	NM_001011872	85886640	85887573	1
chr2	85914860	85915875	Olfr1036	1015	+	NM_207142	85914898	85915831	1
chr2	85924886	85926011	Olfr1037	1125	-	NM_001011532	85924966	85925932	1
chr2	85960380	85963194	Olfr1038-ps	2814	+	NM_147013	85962081	85963039	2
chr2	85970858	85971818	Olfr1039	960	-	NM_001011784	85970858	85971818	1
chr2	85985947	85986889	Olfr1040	942	-	NM_207561	85985947	85986889	1
chr2	85999501	86000598	Olfr1042	1097	-	NM_001011777	85999583	86000525	1
chr2	86002159	86003104	Olfr1043	945	-	NM_146577	86002159	86003104	1
chr2	86011027	86011972	Olfr1044	945	-	NM_147011	86011027	86011972	1
chr2	86021306	86022266	Olfr52	960	-	NM_146583	86021306	86022266	1
chr2	86037959	86038907	Olfr1045	948	-	NM_147017	86037959	86038907	1
chr2	86056914	86057865	Olfr1046	951	-	NM_146582	86056914	86057865	1
chr2	86068166	86069126	Olfr1047	960	-	NM_147012	86068166	86069126	1
chr2	86076027	86076990	Olfr1048	963	-	NM_147014	86076027	86076990	1
chr2	86094921	86095848	Olfr1049	927	-	NM_147016	86094921	86095848	1
chr2	86115715	86116642	Olfr1051	927	-	NM_207562	86115715	86116642	1
chr2	86137974	86138913	Olfr1052	939	+	NM_147010	86137974	86138913	1
chr2	86154499	86155442	Olfr1053	943	-	NM_001177857	86154499	86155441	1
chr2	86172572	86173511	Olfr1054	939	-	NM_147019	86172572	86173511	1
chr2	86186880	86187921	Olfr1055	1041	-	NM_001310551	86186880	86187921	1
chr2	86195515	86196594	Olfr1056	1079	-	NM_147018	86195595	86196537	1
chr2	86214619	86215567	Olfr1057	948	-	NM_207563	86214619	86215567	1
chr2	86225622	86226573	Olfr1058	951	-	NM_146391	86225622	86226573	1
chr2	86253265	86254207	Olfr1061	942	-	NM_207134	86253265	86254207	1
chr2	86262875	86263831	Olfr1062	956	-	NM_147078	86262883	86263831	1
chr2	86285169	86286161	Olfr1065	992	-	NM_146408	86285195	86286137	1
chr2	86295484	86296426	Olfr1066	942	-	NM_001011735	86295484	86296426	1
chr2	86322955	86323897	Olfr228	942	-	NM_146405	86322955	86323897	1
chr2	86348617	86349559	Olfr1076	942	+	NM_146406	86348617	86349559	1
chr2	86365819	86368584	Olfr1077-ps1	2765	-	NR_033507	86368584	86368584	2
chr2	86378122	86379070	Olfr1079	948	-	NM_146407	86378122	86379070	1
chr2	86393337	86398295	Olfr1080	4958	-	NM_146409	86393337	86394279	2
chr2	86434041	86438966	Olfr1082	4925	-	NM_207674	86434041	86434983	2
chr2	86478921	86479875	Olfr1084	954	-	NM_207135	86478921	86479863	1
chr2	86497671	86498613	Olfr1085	942	-	NM_146590	86497671	86498613	1
chr2	86516555	86517488	Olfr1086	933	-	NM_146592	86516555	86517488	1
chr2	86530188	86531130	Olfr1087	942	-	NM_146846	86530188	86531130	1
chr2	86572831	86573767	Olfr1089	936	-	NM_001011771	86572831	86573767	1
chr2	86593951	86594893	Olfr1090	942	-	NM_146847	86593951	86594893	1
chr2	86625888	86626857	Olfr1093	969	+	NM_146366	86625888	86626857	1
chr2	86646177	86647154	Olfr141	977	-	NM_181818	86646206	86647154	1
chr2	86668832	86669979	Olfr1094	1147	+	NM_146365	86668910	86669903	1
chr2	86690926	86691853	Olfr1095	927	-	NM_146730	86690926	86691853	1
chr2	86730382	86732320	Olfr1097	1938	-	NM_146843	86730382	86731330	2
chr2	86762739	86763687	Olfr1098	948	-	NM_146845	86762739	86763687	1
chr2	86798674	86799613	Olfr1099	939	-	NM_146768	86798674	86799613	1
chr2	86817985	86818951	Olfr1100	966	-	NM_146594	86817985	86818951	1
chr2	86828398	86829331	Olfr1101	933	-	NM_146591	86828398	86829331	1
chr2	86842088	86843151	Olfr1102	1063	+	NM_207154	86842127	86843102	1
chr2	86861766	86862699	Olfr1104	933	-	NM_146767	86861766	86862699	1
chr2	86873437	86874376	Olfr1105	939	-	NM_001011825	86873437	86874376	1
chr2	86888452	86889391	Olfr1106	939	-	NM_146752	86888452	86889391	1
chr2	86911272	86912380	Olfr1107	1108	-	NM_146844	86911350	86912289	1
chr2	86932613	86933552	Olfr1109	939	-	NM_146766	86932613	86933552	1
chr2	86947603	86948542	Olfr259	939	-	NM_146770	86947603	86948542	1
chr2	86975537	86976476	Olfr1110	939	-	NM_146769	86975537	86976476	1
chr2	86989876	86990816	Olfr1111	940	-	NM_146593	86989877	86990816	1
chr2	87031845	87032802	Olfr1112	957	+	NM_146661	87031845	87032802	1
chr2	87053050	87054031	Olfr1113	981	+	NM_207565	87053050	87054031	1
chr2	87091996	87093098	Olfr1115	1102	+	NM_146297	87092095	87093076	1
chr2	87109002	87109926	Olfr1116	924	+	NM_001011734	87109002	87109926	1
chr2	87148920	87149916	Olfr1118	996	+	NM_207632	87148947	87149871	1
chr2	87197602	87198547	Olfr1120	945	+	NM_147029	87197602	87198547	1
chr2	87211690	87212635	Olfr1121	945	+	NM_146348	87211690	87212635	1
chr2	87227863	87228844	Olfr1122	981	+	NM_147031	87227863	87228844	1
chr2	87258206	87259178	Olfr1123	972	+	NM_146350	87258206	87259178	1
chr2	87274645	87275602	Olfr1124	957	+	NM_147028	87274645	87275602	1
chr2	87297323	87298268	Olfr1126	945	+	NM_146837	87297323	87298268	1
chr2	87329244	87332575	Pramel7	3331	-	NM_178250	87329664	87332575	3
chr2	87348614	87351022	Pramel6	2408	+	NM_178249	87348614	87350940	3
chr2	87372191	87373115	Olfr153	924	+	NM_206823	87372191	87373115	1
chr2	87384763	87385699	Olfr1128	936	-	NM_146349	87384763	87385699	1
chr2	87415242	87416187	Olfr1129	945	+	NM_001011836	87415242	87416187	1
chr2	87446368	87448491	Olfr1130	2123	+	NM_146838	87447546	87448491	2
chr2	87468621	87469551	Olfr1131	930	+	NM_146658	87468621	87469551	1
chr2	87474975	87475902	Olfr1132	927	-	NM_146836	87474975	87475902	1
chr2	87485336	87486278	Olfr1133	942	-	NM_146351	87485336	87486278	1
chr2	87496081	87498614	Olfr1134	2533	-	NM_147030	87496137	87497076	2
chr2	87511589	87512522	Olfr1135	933	-	NM_146660	87511589	87512522	1
chr2	87533037	87534104	Olfr1136	1067	-	NM_146659	87533104	87534037	1
chr2	87551128	87552061	Olfr1137	933	-	NM_001011833	87551128	87552061	1
chr2	87577543	87578479	Olfr1138	936	-	NM_146639	87577543	87578479	1
chr2	87586317	87587337	Olfr1140	1020	+	NM_146642	87586354	87587290	1
chr2	87593212	87594148	Olfr1141	936	-	NM_146637	87593212	87594148	1
chr2	87622692	87623643	Olfr152	951	+	NM_146646	87622692	87623643	1
chr2	87642547	87643492	Olfr1143	945	+	NM_146293	87642547	87643492	1
chr2	87649978	87650956	Olfr1145	978	+	NM_146320	87649978	87650956	1
chr2	87673197	87674142	Olfr1148	945	+	NM_001011519	87673197	87674142	1
chr2	87697333	87698260	Olfr1151	927	+	NM_146638	87697333	87698260	1
chr2	87708149	87709082	Olfr1152	933	+	NM_001011834	87708149	87709082	1
chr2	87736333	87737290	Olfr1153	957	+	NM_146640	87736333	87737290	1
chr2	87742898	87743831	Olfr1154	933	-	NM_146647	87742898	87743831	1
chr2	87782838	87783783	Olfr1155	945	-	NM_146643	87782838	87783783	1
chr2	87789346	87790422	Olfr1156	1076	-	NM_146817	87789416	87790388	1
chr2	87802108	87808414	Olfr1157	6306	-	NM_146849	87802108	87803047	2
chr2	87813863	87814820	Olfr74	957	-	NM_054091	87813863	87814820	1
chr2	87830269	87831211	Olfr1158	942	+	NM_146645	87830269	87831211	1
chr2	87845973	87846933	Olfr1160	960	-	NM_146649	87845973	87846933	1
chr2	87864858	87865870	Olfr1161	1012	+	NM_146848	87864880	87865846	1
chr2	87874352	87875294	Olfr73	942	-	NM_054090	87874352	87875294	1
chr2	87889834	87890779	Olfr1162	945	-	NM_001011835	87889834	87890779	1
chr2	87910521	87911564	Olfr1163	1043	-	NM_146644	87910586	87911537	1
chr2	87933011	87934123	Olfr1164	1112	-	NM_146641	87933110	87934091	1
chr2	87963516	87965150	Olfr1166	1634	-	NM_146650	87964189	87965140	1
chr2	87989140	87990240	Olfr1167	1100	-	NM_146294	87989223	87990174	1
chr2	88025035	88025974	Olfr1168	939	+	NM_146531	88025035	88025974	1
chr2	88064236	88065187	Olfr1170	951	-	NM_146532	88064236	88065187	1
chr2	88114265	88115204	Olfr1173	939	-	NM_207566	88114265	88115204	1
chr2	88179723	88180671	Olfr1176	948	+	NM_146771	88179723	88180671	1
chr2	88231405	88232377	Olfr1178	972	+	NM_001011868	88231405	88232377	1
chr2	88242165	88243089	Olfr1179	924	-	NM_146917	88242165	88243089	1
chr2	88251783	88252846	Olfr1180	1063	-	NM_146918	88251883	88252813	1
chr2	88263244	88264180	Olfr1181	936	-	NM_001011816	88263244	88264180	1
chr2	88286175	88289278	Olfr1182	3103	-	NM_001011535	88286175	88287093	3
chr2	88301498	88302410	Olfr1183	912	+	NM_146529	88301498	88302410	1
chr2	88326890	88327826	Olfr1184	936	+	NM_146823	88326890	88327826	1
chr2	88365657	88366747	Olfr1186	1090	+	NM_146530	88365741	88366653	1
chr2	88399607	88400575	Olfr1188	968	+	NM_146919	88399627	88400566	1
chr2	88431962	88432883	Olfr1189	921	+	NM_146772	88431962	88432883	1
chr2	88518013	88518970	Olfr1193	957	+	NM_001011517	88518013	88518970	1
chr2	88522960	88523887	Olfr1195	927	-	NM_146753	88522960	88523887	1
chr2	88540539	88541484	Olfr1196	945	-	NM_146464	88540539	88541484	1
chr2	88568809	88569754	Olfr1197	945	-	NM_001005225	88568809	88569754	1
chr2	88586116	88587043	Olfr1198	927	-	NM_207567	88586116	88587043	1
chr2	88595897	88596830	Olfr1199	933	-	NM_146458	88595897	88596830	1
chr2	88607459	88608470	Olfr1200	1011	-	NM_001005227	88607459	88608470	1
chr2	88634540	88635464	Olfr1201	924	+	NM_146895	88634540	88635464	1
chr2	88657329	88658259	Olfr1202	930	+	NM_146462	88657329	88658259	1
chr2	88669913	88672199	Olfr1205	2286	+	NM_146896	88671275	88672199	2
chr2	88692108	88693038	Olfr1204	930	+	NM_146463	88692108	88693038	1
chr2	88704763	88705687	Olfr1206	924	+	NM_001001810	88704763	88705687	1
chr2	88736825	88737752	Olfr1208	927	-	NM_146778	88736825	88737752	1
chr2	88749615	88750548	Olfr1209	933	-	NM_146461	88749615	88750548	1
chr2	88769534	88770470	Olfr1211	936	-	NM_001011804	88769534	88770470	1
chr2	88798624	88799560	Olfr1212	936	+	NM_207140	88798624	88799560	1
chr2	88813110	88820424	Olfr1213	7314	-	NM_146898	88813110	88814046	3
chr2	88827421	88828357	Olfr1214	936	-	NM_146897	88827421	88828357	1
chr2	88841504	88842447	Olfr1215	943	-	NM_146459	88841504	88842443	1
chr2	88853283	88854219	Olfr1216	936	-	NM_146893	88853283	88854219	1
chr2	88863151	88864256	Olfr1217	1105	-	NM_146901	88863243	88864158	1
chr2	88894645	88895581	Olfr1218	936	-	NM_146818	88894645	88895581	1
chr2	88914310	88915246	Olfr1219	936	-	NM_146899	88914310	88915246	1
chr2	88937094	88938120	Olfr1220	1026	-	NM_146900	88937146	88938082	1
chr2	88951731	88952667	Olfr1221	936	-	NM_146902	88951731	88952667	1
chr2	88964950	88965886	Olfr1222	936	-	NM_001011860	88964950	88965886	1
chr2	88984242	88991493	Olfr1223	7251	-	NM_146892	88984242	88985178	2
chr2	89010375	89011402	Olfr1225	1027	-	NM_146891	89010431	89011367	1
chr2	89033256	89034189	Olfr1226	933	-	NM_146967	89033256	89034189	1
chr2	89088877	89089849	Olfr1228	972	-	NM_146971	89088877	89089849	1
chr2	89122352	89123288	Olfr1229	936	-	NM_001011761	89122352	89123288	1
chr2	89136507	89137425	Olfr1230	918	-	NM_146789	89136507	89137425	1
chr2	89142805	89143747	Olfr1231	942	-	NM_146454	89142805	89143747	1
chr2	89165399	89166335	Olfr1232	936	-	NM_146323	89165399	89166335	1
chr2	89179539	89180457	Olfr1233	918	-	NM_146972	89179539	89180457	1
chr2	89202639	89203584	Olfr1234	945	-	NM_146973	89202639	89203584	1
chr2	89246286	89247234	Olfr1238	948	-	NM_146790	89246286	89247234	1
chr2	89257650	89258568	Olfr1239	918	-	NM_146970	89257650	89258568	1
chr2	89279426	89280500	Olfr1240	1074	-	NM_146808	89279489	89280434	1
chr2	89322345	89323290	Olfr1241	945	-	NM_146455	89322345	89323290	1
chr2	89333450	89334503	Olfr1242	1053	-	NM_146968	89333546	89334467	1
chr2	89367647	89368565	Olfr1243	918	-	NM_146969	89367647	89368565	1
chr2	89414868	89415930	Olfr1245	1062	-	NM_146788	89414957	89415881	1
chr2	89430225	89431303	Olfr1246	1078	-	NM_146792	89430325	89431270	1
chr2	89449245	89450310	Olfr1247	1065	-	NM_146966	89449312	89450257	1
chr2	89457324	89458402	Olfr1248	1078	-	NM_146791	89457423	89458347	1
chr2	89470096	89471053	Olfr1249	957	-	NM_001011796	89470096	89471053	1
chr2	89496651	89497596	Olfr1250	945	-	NM_146965	89496651	89497596	1
chr2	89507084	89508041	Olfr1251	957	-	NM_001011529	89507084	89508041	1
chr2	89561321	89562266	Olfr1252	945	-	NM_207568	89561321	89562266	1
chr2	89592026	89592983	Olfr1253	957	-	NM_146373	89592026	89592983	1
chr2	89628562	89629507	Olfr1254	945	-	NM_146476	89628562	89629507	1
chr2	89656484	89657417	Olfr1255	933	+	NM_146977	89656484	89657417	1
chr2	89675179	89676100	Olfr1256	921	-	NM_146983	89675179	89676100	1
chr2	89684222	89685128	Olfr48	906	-	NM_010990	89684222	89685128	1
chr2	89720984	89721914	Olfr1257	930	+	NM_146982	89720984	89721914	1
chr2	89769967	89770903	Olfr1258	936	+	NM_146978	89769967	89770903	1
chr2	89783340	89784270	Olfr1259	930	-	NM_146341	89783340	89784270	1
chr2	89817936	89818869	Olfr1260	933	+	NM_146981	89817936	89818869	1
chr2	89833551	89834472	Olfr1261	921	+	NM_146474	89833551	89834472	1
chr2	89842564	89843479	Olfr1262	915	+	NM_146974	89842564	89843479	1
chr2	89855088	89856009	Olfr1263	921	+	NM_146794	89855088	89856009	1
chr2	89861294	89862221	Olfr1264	927	-	NM_021368	89861294	89862221	1
chr2	89877077	89878007	Olfr1265	930	+	NM_146343	89877077	89878007	1
chr2	89891570	89892479	Olfr140	909	-	NM_020515	89891570	89892479	1
chr2	89958823	89959753	Olfr1269	930	-	NM_146342	89958823	89959753	1
chr2	89978336	89982450	Olfr32	4114	-	NM_010980	89978367	89979294	5
chr2	89989175	89990193	Olfr1270	1018	-	NM_146985	89989246	89990161	1
chr2	90061723	90064628	Gm13769	2905	-	NM_001270423	90061723	90062653	2
chr2	90092225	90093143	Olfr142	918	-	NM_146984	90092225	90093143	1
chr2	90105667	90106585	Olfr1271	918	-	NM_146793	90105667	90106585	1
chr2	90121803	90122730	Olfr1272	927	-	NM_146980	90121803	90122730	1
chr2	90136092	90137016	Olfr1273-ps	924	-	NM_146975	90136092	90137016	1
chr2	90162378	90165283	Olfr1506	2905	+	NM_146265	90164353	90165283	2
chr2	90240796	90241831	Olfr1274-ps	1035	+	NM_146263	90240819	90241749	1
chr2	90273045	90420804	Ptprj	147759	-	NM_008982	90276566	90420744	24
chr2	90517371	90576485	Nup160	59114	+	NM_021512	90519565	90575661	37
chr2	90585526	90621177	Fnbp4	35651	+	NM_018828	90585613	90619808	17
chr2	90622900	90656388	Agbl2	33488	+	NM_178755	90624182	90655670	18
chr2	90687311	90706967	Mtch2	19656	+	NM_001317242	90687455	90705427	13
chr2	90725942	90730683	C1qtnf4	4741	+	NM_026161	90729541	90730522	2
chr2	90734792	90744878	Ndufs3	10086	-	NM_026688	90734866	90744804	7
chr2	90744896	90750718	Kbtbd4	5822	+	NM_001311116	90744950	90750034	4
chr2	90750869	90758207	Ptpmt1	7338	-	NM_025576	90751341	90758143	4
chr2	90780553	90859654	Celf1	79101	+	NM_017368	90827902	90853522	15
chr2	90875783	90885886	Rapsn	10103	+	NM_009023	90875953	90885675	8
chr2	90894172	90899595	Psmc3	5423	+	NM_008948	90894404	90899521	12
chr2	90901937	90910472	Slc39a13	8535	-	NM_026721	90903059	90908888	10
chr2	90936953	90955913	Spi1	18960	+	NM_011355	90937105	90955551	5
chr2	90958300	90976673	Mybpc3	18373	+	NM_008653	90958325	90976271	32
chr2	90977516	91023204	Madd	45688	-	NM_001177719	90978888	91019394	35
chr2	91024217	91035273	Nr1h3	11056	-	NM_001177730	91024492	91033816	10
chr2	91043068	91054255	Acp2	11187	+	NM_007387	91043091	91050897	11
chr2	91051738	91077223	Ddb2	25485	-	NM_028119	91052104	91076973	10
chr2	91077302	91078514	A330069E16Rik	1212	+	NR_015464	91078514	91078514	2
chr2	91096321	91104837	Pacsin3	8516	+	NM_001289677	91100364	91104463	10
chr2	91105271	91117528	Arfgap2	12257	+	NM_001166024	91105489	91115942	17
chr2	91113396	91284871	1110051M20Rik	171475	-	NM_001311144	91117131	91284771	9
chr2	91297687	91354058	Lrp4	56371	+	NM_172668	91297857	91351918	38
chr2	91386478	91460822	Ckap5	74344	+	NM_029437	91386515	91460381	43
chr2	91436237	91436335	Snord67	98	+	NR_028553	91436335	91436335	1
chr2	91465476	91476614	F2	11138	-	NM_010168	91465589	91476553	14
chr2	91483844	91489948	Zfp408	6104	-	NM_001033451	91485131	91489328	4
chr2	91490274	91512477	Arhgap1	22203	+	NR_027371	91512477	91512477	14
chr2	91514768	91550749	Atg13	35981	-	NM_145528	91516542	91536143	16
chr2	91551106	91561723	Harbi1	10617	+	NM_178724	91552352	91560890	3
chr2	91570294	91759006	Ambra1	188712	+	NM_001080754	91606722	91757980	19
chr2	91762345	91769986	Chrm4	7641	+	NM_007699	91767405	91768845	2
chr2	91769961	91772454	Mdk	2493	-	NM_010784	91770246	91771604	5
chr2	91772978	91803720	Dgkz	30742	-	NM_138306	91773565	91803603	31
chr2	91785026	91785087	Mir6999	61	-	NR_105965	91785087	91785087	1
chr2	91822484	91864327	Creb3l1	41843	-	NM_011957	91823127	91864262	12
chr2	92024338	92204823	Phf21a	180485	+	NM_138755	92061718	92200580	18
chr2	92032133	92032231	Mir1955	98	+	NR_035480	92032231	92032231	1
chr2	92205202	92211214	Gyltl1b	6012	-	NM_001290773	92205442	92210995	15
chr2	92214832	92221377	Pex16	6545	+	NR_028114	92221377	92221377	11
chr2	92223074	92223760	1700029I15Rik	686	+	NM_183112	92223104	92223726	3
chr2	92223832	92241420	Mapk8ip1	17588	-	NM_011162	92224505	92241283	12
chr2	92227540	92227603	Mir7000	63	-	NR_105966	92227603	92227603	1
chr2	92243803	92274226	Cry2	30423	-	NM_009963	92251784	92274180	12
chr2	92249048	92272465	D930015M05Rik	23417	+	NR_040621	92272465	92272465	4
chr2	92292921	92300675	Slc35c1	7754	-	NM_145832	92294371	92299316	3
chr2	92432362	92432434	Mir7221	72	+	NR_106080	92432434	92432434	1
chr2	92434758	92434833	Mir7222	75	+	NR_106081	92434833	92434833	1
chr2	92439863	92455409	Chst1	15546	+	NM_023850	92453341	92454577	3
chr2	92755257	92796208	Syt13	40951	+	NM_030725	92755343	92793824	6
chr2	92815062	92886301	Prdm11	71239	-	NM_001177536	92815062	92854040	7
chr2	92869504	92873602	4631405J19Rik	4098	+	NR_110333	92873602	92873602	6
chr2	93027740	93041914	Trp53i11	14174	+	NM_001025246	93037776	93040076	8
chr2	93041916	93174644	Tspan18	132728	-	NM_183180	93044531	93062931	10
chr2	93243703	93257987	Gm13807	14284	+	NR_040529	93257987	93257987	6
chr2	93259258	93303107	Cd82	43849	-	NM_001136055	93260021	93277607	10
chr2	93262085	93262164	Mir7001	79	-	NR_105967	93262164	93262164	1
chr2	93292975	93310031	Gm10804	17056	+	NR_040532	93310031	93310031	5
chr2	93482590	93521496	Alx4	38906	+	NM_007442	93482815	93517718	4
chr2	93535787	93662725	Ext2	126938	-	NM_010163	93536289	93654091	14
chr2	93673623	93690100	Accs	16477	-	NM_001290782	93675887	93688364	15
chr2	93695516	93709314	Accsl	13798	-	NM_001033452	93695884	93709200	15
chr2	93795966	93797257	Gm13889	1291	-	NM_001145034	93796543	93796915	1
chr2	93820190	93823732	Alkbh3os1	3542	+	NR_045827	93823732	93823732	4
chr2	93820790	93850887	Alkbh3	30097	-	NM_026944	93821041	93848678	10
chr2	93872853	93998066	Hsd17b12	125213	-	NM_019657	93873713	93998026	11
chr2	94081520	94081610	Mir129-2	90	-	NR_029752	94081610	94081610	1
chr2	94081534	94081599	Mir129b	65	+	NR_106139	94081599	94081599	1
chr2	94101456	94101556	Mir670	100	-	NR_030431	94101556	94101556	1
chr2	94140922	94246846	Ttc17	105924	-	NM_183106	94141892	94246822	25
chr2	94246863	94251837	2810002D19Rik	4974	+	NR_027831	94251837	94251837	2
chr2	94251883	94278343	Api5	26460	-	NM_001305258	94253860	94278149	14
chr2	96158325	97471821	Lrrc4c	1313496	+	NM_001289742	97469187	97471110	8
chr2	101400937	101469143	B230118H07Rik	68206	-	NM_026592	101402346	101450813	7
chr2	101464904	101472685	Rag2	7781	+	NM_009020	101469503	101471087	3
chr2	101478410	101489689	Rag1	11279	-	NM_009019	101481829	101484952	2
chr2	101518576	101541825	Traf6	23249	+	NM_009424	101524657	101537656	8
chr2	101554441	101679137	Prr5l	124696	-	NM_001110849	101557222	101612450	10
chr2	101726418	101741796	Commd9	15378	+	NM_029635	101726425	101741225	6
chr2	101790357	102026617	Ldlrad3	236260	-	NM_178886	101793094	102026482	6
chr2	102140275	102241057	Trim44	100782	-	NM_020267	102144633	102240841	5
chr2	102289522	102291949	Fjx1	2427	-	NM_010218	102290392	102291745	1
chr2	102390177	102483197	Pamr1	93020	+	NM_173749	102390348	102482677	11
chr2	102498839	102630941	Slc1a2	132102	+	NM_001077514	102499441	102621691	11
chr2	102651299	102741822	Cd44	90523	-	NM_009851	102654289	102741503	19
chr2	102861212	102913670	Pdhx	52458	-	NM_175094	102862167	102913606	11
chr2	102913831	102932806	Apip	18975	+	NM_019735	102913944	102932721	7
chr2	103103589	103143353	Ehf	39764	-	NM_007914	103106928	103123774	9
chr2	103178757	103212921	A930006I01Rik	34164	-	NR_040332	103212921	103212921	3
chr2	103217800	103229201	BC016548	11401	-	NR_130965	103229201	103229201	3
chr2	103252254	103291145	Elf5	38891	+	NM_001145813	103270449	103289817	7
chr2	103294060	103325310	Cat	31250	-	NM_009804	103294912	103325195	13
chr2	103406466	103558580	Abtb2	152114	+	NM_178890	103406883	103557514	17
chr2	103561415	103601407	Nat10	39992	-	NM_153126	103561979	103597935	29
chr2	103603101	103637797	Caprin1	34696	-	NM_016739	103606955	103637097	19
chr2	103644608	103650779	4930547E08Rik	6171	-	NR_040514	103650779	103650779	4
chr2	103741107	103754125	Lincred1	13018	+	NR_131913	103754125	103754125	7
chr2	103798151	103822035	Lmo2	23884	+	NM_001142337	103810828	103821251	4
chr2	103867955	103903394	Fbxo3	35439	+	NM_212433	103868019	103900242	11
chr2	103911166	103925114	Cd59b	13948	+	NM_181858	103919032	103924805	4
chr2	103935957	103955567	Cd59a	19610	+	NM_001111060	103944345	103954337	5
chr2	103962925	103964903	A930018P22Rik	1978	+	NM_026634	103962987	103964731	2
chr2	103983231	104250491	D430041D05Rik	267260	-	NM_001033347	103988937	104250320	21
chr2	104266638	104334646	Hipk3	68008	-	NM_001145824	104270011	104312002	16
chr2	104269017	104269097	Mir1902	80	-	NR_035432	104269097	104269097	1
chr2	104399340	104411586	Platr14	12246	+	NR_040322	104411586	104411586	4
chr2	104430640	104505582	Cstf3	74942	+	NM_145529	104430832	104505076	21
chr2	104520136	104552319	Tcp11l1	32183	-	NM_177190	104521912	104546675	10
chr2	104554082	104556447	Pin1rt1	2365	-	NM_001033768	104554462	104554942	2
chr2	104561943	104582958	Depdc7	21015	-	NM_144804	104562081	104582911	9
chr2	104594949	104656853	Qser1	61904	-	NM_001123327	104598621	104630352	12
chr2	104670897	104690007	Prrg4	19110	-	NM_178695	104672735	104689335	6
chr2	104726480	104839894	Ccdc73	113414	+	NM_177600	104747717	104839341	18
chr2	104839813	104857184	Eif3m	17371	-	NM_145380	104839877	104857144	11
chr2	104916694	104966667	Wt1os	49973	-	NR_015462	104966667	104966667	7
chr2	104966685	105013771	Wt1	47086	+	NM_144783	104966953	105012501	10
chr2	105064498	105220017	Them7	155519	+	NM_028747	105124792	105219165	4
chr2	105226104	105239476	Rcn1	13372	-	NM_009037	105228075	105239362	6
chr2	105376236	105510487	Pax6os1	134251	-	NR_002867	105510487	105510487	4
chr2	105498018	105501500	Paupar	3482	-	NR_117095	105501500	105501500	1
chr2	105509052	105538567	Pax6	29515	+	NM_001244198	105520454	105536512	13
chr2	105537476	105744721	Elp4	207245	-	NM_023876	105542886	105744645	10
chr2	105744794	105805715	Immp1l	60921	+	NM_028260	105770904	105805489	7
chr2	105806864	105843706	Dnajc24	36842	-	NM_026992	105807120	105842193	5
chr2	106303979	106363260	Gm14015	59281	-	NR_040637	106363260	106363260	3
chr2	106533615	106708517	Mpped2	174902	+	NM_001143683	106539564	106707223	7
chr2	106802685	106814554	Arl14ep	11869	-	NM_001025102	106804972	106809651	5
chr2	106896142	106899808	Fshb	3666	-	NM_008045	106897436	106899114	3
chr2	107130745	107138661	Kcna4	7916	+	NM_021275	107135079	107137044	2
chr2	108932456	109118447	Mettl15	185991	-	NM_029790	108933011	109114815	6
chr2	109120894	109181903	Kif18a	61009	+	NM_139303	109127998	109181397	17
chr2	109514856	109567200	Bdnf	52344	+	NM_007540	109515493	109564309	2
chr2	109731034	109741093	Lin7c	10059	+	NM_011699	109731041	109737558	5
chr2	109742552	109753476	Platr8	10924	-	NR_033473	109753476	109753476	5
chr2	109757803	109854414	Lgr4	96611	+	NM_172671	109758277	109852684	18
chr2	109857973	109885482	Ccdc34	27509	+	NM_026613	109858024	109884558	6
chr2	109871406	109890636	Ccdc34os	19230	-	NR_040508	109890636	109890636	5
chr2	110105239	110145882	Bbox1	40643	-	NM_130452	110105610	110145789	7
chr2	110201081	110203150	Fibin	2069	-	NM_026271	110202298	110202952	1
chr2	110437455	110489502	Slc5a12	52047	+	NM_001003915	110437758	110486573	15
chr2	110495357	110790401	Ano3	295044	-	NM_001128103	110498296	110790260	27
chr2	110561650	110579694	Muc15	18044	+	NM_172979	110571377	110577664	4
chr2	111033410	111069757	4930430A15Rik	36347	-	NM_026248	111033602	111069569	16
chr2	111071009	111071948	Olfr1275	939	-	NM_001011795	111071009	111071948	1
chr2	111097273	111098212	Olfr1276	939	+	NM_146395	111097273	111098212	1
chr2	111109610	111110522	Olfr1277	912	-	NM_146396	111109610	111110522	1
chr2	111132426	111133368	Olfr1278	942	+	NM_146394	111132426	111133368	1
chr2	111146357	111147299	Olfr1279	942	+	NM_146393	111146357	111147299	1
chr2	111155637	111156555	Olfr1280	918	+	NM_146908	111155637	111156555	1
chr2	111168577	111169495	Olfr1281	918	+	NM_001005568	111168577	111169495	1
chr2	111175315	111176233	Olfr1282	918	-	NM_146907	111175315	111176233	1
chr2	111208790	111209708	Olfr1283	918	+	NM_207236	111208790	111209708	1
chr2	111219158	111220094	Olfr1284	936	+	NM_146381	111219158	111220094	1
chr2	111260188	111261106	Olfr1286	918	-	NM_207254	111260188	111261106	1
chr2	111289298	111290216	Olfr1287	918	+	NM_001011773	111289298	111290216	1
chr2	111318942	111319881	Olfr1288	939	+	NM_146400	111318942	111319881	1
chr2	111323588	111324485	Olfr1289	897	+	NM_146404	111323588	111324485	1
chr2	111329374	111333972	Olfr1290	4598	-	NM_146262	111329374	111330313	3
chr2	111377505	111378444	Olfr1294	939	-	NM_146885	111377505	111378444	1
chr2	111404660	111405599	Olfr1295	939	-	NM_146403	111404660	111405599	1
chr2	111461290	111462229	Olfr1297	939	-	NM_146888	111461290	111462229	1
chr2	111485213	111486152	Olfr1298	939	-	NM_146886	111485213	111486152	1
chr2	111501609	111505323	Olfr1299	3714	+	NM_146884	111504384	111505323	2
chr2	111507593	111533476	Olfr1300-ps1	25883	+	NR_033534	111533476	111533476	4
chr2	111594407	111595346	Olfr1301	939	+	NM_146887	111594407	111595346	1
chr2	111620469	111621417	Olfr1302	948	+	NM_146889	111620469	111621417	1
chr2	111653942	111654881	Olfr1303	939	-	NM_146402	111653942	111654881	1
chr2	111713071	111714010	Olfr1305	939	-	NM_146401	111713071	111714010	1
chr2	111752146	111753085	Olfr1306	939	-	NM_001011803	111752146	111753085	1
chr2	111784672	111785611	Olfr1307	939	-	NM_001011787	111784672	111785611	1
chr2	111800265	111801228	Olfr1308	963	-	NM_207151	111800265	111801228	1
chr2	111823290	111824253	Olfr1309	963	-	NM_146447	111823290	111824253	1
chr2	111848402	111849341	Olfr1310	939	-	NM_146449	111848402	111849341	1
chr2	111861070	111862009	Olfr1311	939	-	NM_146274	111861070	111862009	1
chr2	111882233	111883187	Olfr1312	954	-	NM_146362	111882233	111883187	1
chr2	111911802	111912738	Olfr1313	936	-	NM_207150	111911802	111912738	1
chr2	111931917	111932856	Olfr1314	939	-	NM_146450	111931917	111932856	1
chr2	111970027	111970972	Olfr1316	945	-	NM_146742	111970027	111970972	1
chr2	111982103	111983054	Olfr1317	951	+	NM_146448	111982103	111983054	1
chr2	111996054	111997164	Olfr1318	1110	+	NM_001011802	111996109	111997072	1
chr2	112079997	112087268	Lpcat4	7271	+	NM_207206	112080100	112087044	14
chr2	112088104	112099448	Nutm1	11344	-	NM_172521	112088344	112099338	7
chr2	112102082	112103055	Nop10	973	+	NM_025403	112102180	112102610	2
chr2	112106470	112203320	Slc12a6	96850	+	NM_133649	112106978	112200664	25
chr2	112203175	112208184	Emc4	5009	-	NM_026519	112203475	112208061	5
chr2	112219367	112254394	Katnbl1	35027	+	NM_024254	112244331	112252572	10
chr2	112295181	112307593	Emc7	12412	+	NM_133749	112295224	112307290	5
chr2	112319228	112320974	Chrm5	1746	-	NM_205783	112319327	112320926	1
chr2	112333120	112471410	Aven	138290	+	NM_028844	112333147	112471051	6
chr2	112471538	112870488	Ryr3	398950	-	NM_177652	112472279	112870488	104
chr2	113125888	113137347	Tmco5b	11459	+	NM_029232	113126832	113137166	12
chr2	113167892	113556924	Fmn1	389032	+	NM_010230	113204113	113549617	20
chr2	113531209	113548707	4930533B01Rik	17498	-	NR_040614	113548707	113548707	6
chr2	113588831	113598805	Grem1	9974	-	NM_011824	113589756	113590311	2
chr2	113616469	113669248	Scg5	52779	-	NM_009162	113616957	113667721	6
chr2	113671649	113688818	Arhgap11a	17169	-	NM_181416	113673129	113688246	12
chr2	113835336	113839355	Gjd2	4019	-	NM_010290	113836764	113838870	2
chr2	113839300	113858028	A530058N18Rik	18728	+	NR_028423	113858028	113858028	5
chr2	113873019	113878611	Actc1	5592	-	NM_009608	113873201	113877767	7
chr2	113880131	113887238	C130080G10Rik	7107	+	NR_028422	113887238	113887238	3
chr2	113926896	114001075	Aqr	74179	-	NM_009702	113927174	114000902	35
chr2	113976251	113976306	Mir7002	55	-	NR_105968	113976306	113976306	1
chr2	114019196	114027168	Zfp770	7972	-	NM_175466	114021204	114023322	2
chr2	114342153	114480664	Dph6	138511	-	NM_025675	114343974	114480589	9
chr2	115155001	115170016	4930528P14Rik	15015	-	NR_040516	115170016	115170016	3
chr2	115319248	115337937	3110099E03Rik	18689	-	NR_030712	115337937	115337937	3
chr2	115407451	115604504	BC052040	197053	+	NM_001145898	115407620	115602767	11
chr2	115464460	115464549	Mir1951	89	+	NR_035476	115464549	115464549	1
chr2	115686999	115890794	Meis2	203795	-	NM_001136072	115692581	115890549	13
chr2	115900283	115901832	2810405F15Rik	1549	-	NR_033447	115901832	115901832	1
chr2	116704426	116718236	Tmco5	13810	+	NM_026104	116705019	116718047	12
chr2	116725887	116738527	D330050G23Rik	12640	+	NR_040335	116738527	116738527	4
chr2	116946806	117008013	Spred1	61207	+	NM_033524	116947460	117003685	7
chr2	117010862	117010962	Mir674	100	+	NR_030440	117010962	117010962	1
chr2	117075474	117097276	Fam98b	21802	+	NM_026620	117075503	117096734	8
chr2	117105728	117168613	Rasgrp1	62885	-	NM_011246	117108277	117168445	17
chr2	117630384	117638538	Gm13985	8154	-	NR_126427	117638538	117638538	3
chr2	117647663	117734872	4930412B13Rik	87209	+	NR_040631	117734872	117734872	6
chr2	117683026	117936938	Gm13986	253912	-	NR_126479	117936938	117936938	10
chr2	117937611	117952869	Thbs1	15258	+	NM_011580	117938378	117950765	22
chr2	118030623	118082702	Fsip1	52079	-	NM_027759	118030820	118079153	11
chr2	118102833	118199155	Gpr176	96322	-	NM_201367	118104964	118198923	3
chr2	118130649	118133902	1700054M17Rik	3253	+	NR_045919	118133902	118133902	3
chr2	118214352	118300970	Eif2ak4	86618	+	NM_013719	118214444	118300796	39
chr2	118301578	118305432	Srp14	3854	-	NM_009273	118301953	118305350	5
chr2	118354492	118375414	Bmf	20922	-	NM_138313	118358293	118375398	5
chr2	118423946	118467328	Bub1b	43382	+	NM_009773	118424183	118467055	23
chr2	118489312	118523756	Pak6	34444	+	NM_001033254	118514537	118522310	11
chr2	118524838	118529699	Ankrd63	4861	-	NM_001081971	118528001	118529174	1
chr2	118533252	118554174	Plcb2	20922	-	NM_177568	118534734	118554057	32
chr2	118571493	118574546	Inafm2	3053	+	NM_001301269	118571850	118572309	1
chr2	118579880	118588397	A430105I19Rik	8517	-	NM_001001982	118582949	118588388	11
chr2	118598504	118603900	Phgr1	5396	+	NM_001145644	118600418	118603771	4
chr2	118605454	118620911	Disp2	15457	+	NM_170593	118611797	118618562	8
chr2	118639738	118661948	Knstrn	22210	+	NM_026412	118639836	118659867	9
chr2	118687735	118707093	Ivd	19358	+	NM_019826	118687756	118706322	12
chr2	118727350	118750260	Bahd1	22910	+	NM_001045523	118741637	118748308	7
chr2	118752232	118754319	Chst14	2087	+	NM_028117	118752387	118753518	1
chr2	118843514	118855129	Ccdc32	11615	-	NM_199310	118844761	118853117	4
chr2	118860525	118867933	Rpusd2	7408	+	NM_173450	118860559	118864495	3
chr2	118872854	118929857	Casc5	57003	+	NM_029617	118883032	118929813	24
chr2	118938552	118961806	Rad51	23254	+	NM_011234	118942049	118960908	10
chr2	118962733	118982770	Rmdn3	20037	-	NM_001033136	118963437	118982280	13
chr2	118993523	118998125	Gchfr	4602	+	NM_177157	118993573	118997801	3
chr2	118998235	119034531	Dnajc17	36296	-	NM_139139	118998301	119034501	11
chr2	119000244	119003311	Gm14137	3067	+	NM_001039223	119000697	119001243	1
chr2	119034455	119042786	Zfyve19	8331	+	NM_028054	119034865	119042443	11
chr2	119043854	119055601	Ppp1r14d	11747	-	NM_001290796	119044071	119055535	5
chr2	119063095	119075249	Spint1	12154	+	NM_016907	119063522	119074698	11
chr2	119094936	119096962	Rhov	2026	-	NM_145530	119095779	119096859	3
chr2	119114477	119124189	Vps18	9712	+	NM_172269	119114775	119123355	5
chr2	119146934	119151933	Gm14207	4999	-	NR_030683	119151933	119151933	4
chr2	119151519	119161402	Dll4	9883	+	NM_019454	119151876	119160369	11
chr2	119176977	119180062	Chac1	3085	+	NM_026929	119177138	119179326	3
chr2	119198778	119303365	Ino80	104587	-	NM_026574	119200099	119283959	36
chr2	119345139	119373363	Exd1	28224	-	NM_172857	119345801	119367227	13
chr2	119373442	119412758	Chp1	39316	+	NM_019769	119373586	119410896	7
chr2	119420031	119426480	1700020I14Rik	6449	+	NR_015473	119426480	119426480	3
chr2	119435267	119444241	Oip5	8974	-	NM_001042653	119436054	119444197	6
chr2	119444033	119475896	Nusap1	31863	+	NM_133851	119444538	119474725	11
chr2	119481186	119488534	Ndufaf1	7348	-	NM_027175	119481378	119486319	5
chr2	119500803	119561143	Rtf1	60340	+	NM_030112	119500803	119558627	18
chr2	119568072	119576989	Itpka	8917	+	NM_146125	119568114	119576603	7
chr2	119577061	119586167	Ltk	9106	-	NM_203345	119577337	119586030	20
chr2	119589694	119613273	Rpap1	23579	-	NM_177294	119590030	119609650	26
chr2	119623475	119643839	Tyro3	20364	+	NM_001290800	119624698	119642770	20
chr2	119722963	119795317	Mga	72354	+	NM_013720	119728408	119790701	24
chr2	119798434	119853139	Mapkbp1	54705	+	NM_011941	119798787	119851067	30
chr2	119843252	119843315	Mir7665	63	+	NR_106125	119843315	119843315	1
chr2	119853218	119858340	Jmjd7	5122	+	NM_001114637	119853248	119857938	8
chr2	119853218	119868768	Gm28042	15550	+	NR_104353	119868768	119868768	27
chr2	119859168	119868768	Pla2g4b	9600	+	NM_145378	119859233	119867351	20
chr2	119915222	119980311	Ehd4	65089	-	NM_133838	119916883	119980211	6
chr2	119992147	120071071	Pla2g4e	78924	-	NM_177845	119993568	120070643	20
chr2	120091604	120114805	Pla2g4d	23201	-	NM_001024137	120092374	120114767	20
chr2	120125692	120139901	Pla2g4f	14209	-	NM_001024145	120126140	120139792	20
chr2	120142196	120178869	Vps39	36673	-	NM_147153	120143769	120178723	26
chr2	120181044	120229852	Tmem87a	48808	-	NM_001110496	120182232	120229796	20
chr2	120229631	120286588	Ganc	56957	+	NM_172672	120230766	120285661	24
chr2	120281433	120295103	4931402G19Rik	13670	-	NR_040608	120295103	120295103	5
chr2	120289328	120330655	Capn3	41327	+	NM_007601	120289608	120330235	24
chr2	120332565	120389567	Zfp106	57002	-	NM_011743	120335821	120381020	22
chr2	120393406	120426458	Snap23	33052	+	NM_001177792	120410044	120425077	9
chr2	120429973	120435244	Lrrc57	5271	-	NM_001159610	120430952	120435120	6
chr2	120435117	120447295	Haus2	12178	+	NM_025475	120435188	120444917	6
chr2	120541889	120557253	Cdan1	15364	-	NM_026891	120544537	120557237	28
chr2	120558551	120676320	Ttbk2	117769	-	NM_080788	120565467	120676269	16
chr2	120676391	120692426	AV039307	16035	+	NR_038349	120692426	120692426	4
chr2	120686011	120796451	Ubr1	110440	-	NM_009461	120688385	120796338	47
chr2	120802797	120833578	Tmem62	30781	+	NM_175285	120803034	120832881	14
chr2	120834143	120842648	Ccndbp1	8505	+	NM_010761	120834245	120842249	11
chr2	120843626	120862613	Epb42	18987	-	NM_013513	120845186	120862329	13
chr2	120871846	120911495	Tgm5	39649	-	NM_028799	120872114	120911407	13
chr2	120919324	120935527	Tgm7	16203	-	NM_001160424	120919324	120935527	12
chr2	120963027	120966434	Lcmt2	3407	-	NM_177846	120964275	120966336	1
chr2	120966163	120982416	Adal	16253	+	NM_001290811	120968894	120981283	10
chr2	120984008	120996861	Zscan29	12853	-	NM_001290819	120986431	120995860	5
chr2	120996903	121024506	Tubgcp4	27603	+	NR_077245	121024506	121024506	19
chr2	121020570	121097143	Trp53bp1	76573	-	NM_013735	121024155	121097014	28
chr2	121115337	121136568	Map1a	21231	+	NM_032393	121115370	121133823	7
chr2	121136296	121176749	Ppip5k1	40453	-	NM_178795	121137391	121176359	30
chr2	121184376	121189473	Ckmt1	5097	+	NM_009897	121184585	121189350	9
chr2	121189462	121206676	Strc	17214	-	NM_080459	121189711	121206598	29
chr2	121220090	121239528	Catsper2	19438	-	NM_153075	121220191	121238024	13
chr2	121239637	121264422	Pdia3	24785	+	NM_007952	121239774	121263435	13
chr2	121264762	121268337	Ell3	3575	-	NM_145973	121265174	121268263	11
chr2	121274933	121279156	Serf2	4223	+	NM_011354	121275170	121276520	3
chr2	121276912	121282500	Serinc4	5588	-	NM_001025371	121277756	121282289	12
chr2	121282823	121284176	Hypk	1353	+	NM_026318	121282841	121283980	4
chr2	121287401	121299759	Mfap1b	12358	-	NM_001081975	121287857	121299648	7
chr2	121318416	121332392	Mfap1a	13976	-	NM_026220	121320400	121332277	7
chr2	121332458	121370595	Wdr76	38137	+	NM_001290986	121336505	121368298	13
chr2	121371264	121632793	Frmd5	261529	-	NM_172673	121373684	121632567	15
chr2	121692705	121761943	Casc4	69238	+	NM_001205369	121692940	121759284	10
chr2	121779506	121781828	Mageb3	2322	-	NM_008545	121779962	121780955	1
chr2	121781736	121841062	Ctdspl2	59326	+	NM_001290992	121804644	121836364	13
chr2	121854315	121879368	Eif3j1	25053	+	NM_144545	121854408	121877834	8
chr2	121854318	121879367	Eif3j2	25049	+	NM_001256055	121854408	121877834	8
chr2	121879261	121944122	Spg11	64861	-	NM_145531	121879615	121944104	40
chr2	121945843	122011925	Patl2	66082	-	NM_026251	121946920	121955252	18
chr2	121973422	121978818	B2m	5396	+	NM_009735	121973473	121977396	4
chr2	121986435	122004763	Trim69	18328	+	NM_080510	121986626	122004699	7
chr2	122012007	122032129	4933406J08Rik	20122	+	NM_028914	122012024	122030692	7
chr2	122060574	122091073	Sord	30499	+	NM_146126	122060628	122089942	9
chr2	122106172	122123901	Duox2	17729	-	NM_177610	122106172	122123901	32
chr2	122124635	122128621	Duoxa2	3986	+	NM_025777	122124776	122128133	6
chr2	122129284	122139466	Duoxa1	10182	-	NM_001305262	122129480	122132562	10
chr2	122141407	122173708	Duox1	32301	+	NM_001099297	122141438	122173128	33
chr2	122174627	122194654	Shf	20027	-	NM_001013829	122175088	122185217	6
chr2	122252212	122286866	Slc28a2	34654	+	NM_172980	122267310	122286273	19
chr2	122292318	122293533	Bambi-ps1	1215	-	NR_027919	122293533	122293533	1
chr2	122310676	122353776	Gm14085	43100	+	NM_001085518	122312395	122353185	18
chr2	122420208	122437013	Gatm	16805	-	NM_025961	122421232	122436952	9
chr2	122456360	122458440	Spata5l1	2080	+	NM_001033256	122456421	122458440	2
chr2	122463622	122466812	AA467197	3190	+	NM_001004174	122463833	122466505	5
chr2	122466538	122466617	Mir147	79	+	NR_030547	122466617	122466617	1
chr2	122506968	122528399	Slc30a4	21431	-	NM_011774	122510914	122528156	7
chr2	122564240	122575223	Bloc1s6	10983	+	NM_019788	122564358	122572366	5
chr2	122591094	122635287	Sqrdl	44193	+	NM_001162503	122610696	122635074	10
chr2	123915704	124493525	Sema6d	577821	+	NM_001290997	124479370	124491045	21
chr2	123949371	123955692	4930517E11Rik	6321	-	NR_040611	123955692	123955692	3
chr2	124043414	124048094	4930583P06Rik	4680	-	NR_040612	124048094	124048094	3
chr2	124893862	124914413	Slc24a5	20551	+	NM_175034	124893916	124914022	9
chr2	124912006	124949396	Myef2	37390	-	NM_001162417	124914609	124949254	19
chr2	124962427	124973577	Ctxn2	11150	+	NM_001162934	124973190	124973439	2
chr2	124978335	125055737	Slc12a1	77402	+	NM_001079690	124979664	125054598	27
chr2	125072983	125084785	Dut	11802	+	NM_001159646	125073007	125083149	7
chr2	125126329	125332174	Fbn1	205845	-	NM_007993	125127321	125331339	66
chr2	125388823	125450849	Cep152	62026	-	NM_001081091	125389135	125446995	28
chr2	125453182	125549884	Shc4	96702	-	NM_199022	125455350	125549113	12
chr2	125498835	125501378	Eid1	2543	+	NM_025613	125498927	125499407	1
chr2	125562721	125608606	Secisbp2l	45885	-	NM_177608	125566000	125608358	18
chr2	125656037	125684818	Cops2	28781	-	NM_009939	125657928	125684725	13
chr2	125684844	125810034	Galk2	125190	+	NM_175154	125685093	125808998	10
chr2	125809218	125977740	Fam227b	168522	-	NM_029455	125809363	125971987	17
chr2	125860393	125916921	Fgf7	56528	+	NM_008008	125861450	125915297	4
chr2	125977876	125991013	Dtwd1	13137	+	NM_026981	125980332	125990710	5
chr2	126146708	126317289	Atp8b4	170581	-	NM_001080944	126148545	126315146	28
chr2	126378759	126413979	Slc27a2	35220	+	NM_011978	126378890	126413672	10
chr2	126419395	126444414	Hdc	25019	-	NM_008230	126419696	126444305	12
chr2	126454642	126501328	Gabpb1	46686	-	NM_001271467	126455965	126484313	10
chr2	126533063	126585050	Usp8	51987	+	NM_001252580	126543796	126584342	19
chr2	126586785	126609196	Usp50	22411	-	NM_029163	126587187	126609023	7
chr2	126617293	126701997	Trpm7	84704	-	NM_001164325	126618561	126701712	39
chr2	126716130	126758971	Sppl2a	42841	-	NM_023220	126719947	126758748	15
chr2	126727985	126728121	Mir3473g	136	-	NR_106202	126728121	126728121	1
chr2	126834446	126895550	Ap4e1	61104	+	NM_175550	126834489	126892438	21
chr2	126896392	126922820	Blvra	26428	+	NM_026678	126906382	126922729	8
chr2	126929545	126959690	Ncaph	30145	-	NM_144818	126929956	126959603	18
chr2	126964504	126969193	Itpripl1	4689	-	NM_001163527	126966292	126967936	2
chr2	127012090	127034016	1810024B03Rik	21926	-	NM_198630	127012410	127013013	2
chr2	127034139	127066187	Snrnp200	32048	+	NM_177214	127034229	127065948	45
chr2	127066673	127073552	Ciao1	6879	-	NM_025296	127068532	127073356	7
chr2	127073710	127086500	Tmem127	12790	+	NM_175145	127074301	127083000	4
chr2	127095964	127124670	Stard7	28706	+	NM_139308	127096317	127123027	8
chr2	127161894	127164113	Dusp2	2219	+	NM_010090	127161973	127163531	4
chr2	127164374	127183391	Astl	19017	+	NM_172539	127168094	127182510	9
chr2	127189021	127192957	Adra2b	3936	+	NM_009633	127189300	127190662	1
chr2	127250934	127261828	Gpat2	10894	+	NM_001081089	127253044	127261697	22
chr2	127261950	127270301	Fahd2a	8351	-	NM_029629	127262079	127267854	8
chr2	127282233	127347830	Kcnip3	65597	-	NR_110989	127347830	127347830	9
chr2	127352688	127367153	Prom2	14465	-	NM_138750	127354490	127367056	24
chr2	127401268	127410413	Zfp661	9145	-	NM_028141	127402670	127407244	6
chr2	127413161	127429722	Mrps5	16561	+	NM_029963	127413163	127429589	12
chr2	127458961	127482431	Mal	23470	-	NM_010762	127460715	127481869	4
chr2	127530125	127555633	Mall	25508	-	NM_145532	127531596	127555602	4
chr2	127566467	127614627	Nphp1	48160	-	NM_016902	127566651	127614590	20
chr2	127617113	127618224	1500011K16Rik	1111	-	NR_015476	127618224	127618224	2
chr2	127625935	127657595	Bub1	31660	-	NM_009772	127626978	127657481	25
chr2	127680363	127949628	Acoxl	269265	+	NM_028765	127680569	127948872	18
chr2	127951773	127988283	Bcl2l11	36510	+	NM_207681	127954368	127984065	5
chr2	128124398	128255087	Gm14005	130689	-	NR_028589	128255087	128255087	3
chr2	128418076	128422579	Spdye4c	4503	+	NM_001310641	128418076	128422579	9
chr2	128435818	128513131	Anapc1	77313	-	NM_008569	128438683	128511772	48
chr2	128524732	128627924	Mertk	103192	+	NM_008587	128524781	128627403	19
chr2	128644038	128679997	Tmem87b	35959	+	NM_028248	128644074	128677079	19
chr2	128689667	128722770	Fbln7	33103	+	NM_024237	128689808	128721325	8
chr2	128752003	128769756	Zc3h8	17753	-	NM_020594	128754631	128769660	9
chr2	128793137	128844299	Zc3h6	51162	+	NM_178404	128793540	128843320	12
chr2	128891682	128922019	Ttl	30337	+	NM_027192	128891882	128918791	7
chr2	128926731	128952331	Polr1b	25600	+	NM_009086	128926822	128951832	15
chr2	128955435	128959847	Chchd5	4412	+	NM_025395	128955591	128959034	4
chr2	129003883	129006409	AI847159	2526	-	NR_045264	129006409	129006409	3
chr2	129024508	129037348	Slc20a1	12840	+	NM_015747	129025454	129036581	11
chr2	129044704	129061342	A730036I17Rik	16638	+	NR_045838	129061342	129061342	5
chr2	129093945	129122948	Ckap2l	29003	-	NM_181589	129094773	129122877	9
chr2	129123105	129133562	Gm14023	10457	+	NR_040371	129133562	129133562	5
chr2	129125345	129135708	Il1a	10363	-	NM_010554	129126446	129134837	7
chr2	129190313	129196875	Il1b	6562	-	NM_008361	129190764	129196066	7
chr2	129195637	129201469	Il1bos	5832	+	NR_015474	129201469	129201469	3
chr2	129284094	129362338	F830045P16Rik	78244	-	NM_177653	129285028	129362198	7
chr2	129418574	129457964	Sirpa	39390	+	NM_001291020	129419348	129455920	9
chr2	129512284	129525674	Pdyn	13390	-	NM_018863	129513736	129515604	4
chr2	129624104	129627195	4932416H05Rik	3091	-	NR_029452	129627195	129627195	1
chr2	129626252	129658021	Stk35	31769	+	NM_183262	129626276	129636936	4
chr2	129838075	129876135	Tgm3	38060	+	NM_009374	129838138	129874136	13
chr2	129842027	129842144	Mir6339	117	-	NR_105757	129842144	129842144	1
chr2	129926129	129929111	AU015228	2982	+	NM_001033197	129926259	129927579	1
chr2	129938151	129979968	Tgm6	41817	+	NM_001289748	129964689	129978849	13
chr2	129997371	130005100	Snrpb	7729	-	NM_009225	129997668	130004972	7
chr2	130020929	130090181	Tmc2	69252	+	NM_138655	130022278	130089953	20
chr2	130100147	130105049	Nop56	4902	+	NM_024193	130100209	130104959	12
chr2	130101250	130101309	Snord110	59	+	NR_028547	130101309	130101309	1
chr2	130103761	130103824	Snord57	63	+	NR_028528	130103824	130103824	1
chr2	130105044	130110187	Idh3b	5143	-	NM_130884	130105375	130110153	12
chr2	130121674	130196217	Ebf4	74543	+	NM_001110513	130121748	130195244	17
chr2	130216510	130223365	Cpxm1	6855	-	NM_019696	130216639	130223242	14
chr2	130230994	130231810	1700020A23Rik	816	+	NM_029375	130231281	130231754	3
chr2	130232257	130233530	Tmem239	1273	+	NM_025753	130232459	130232915	2
chr2	130243419	130250377	Pced1a	6958	-	NM_001114541	130244821	130249271	8
chr2	130250055	130270005	Vps16	19950	+	NM_030559	130250130	130269394	24
chr2	130276013	130380036	Ptpra	104023	+	NM_008980	130329215	130379204	22
chr2	130369526	130389485	4930473A02Rik	19959	-	NR_040348	130389485	130389485	9
chr2	130389492	130391130	Mrps26	1638	+	NM_207207	130389514	130390793	4
chr2	130401904	130402789	Oxt	885	+	NM_011025	130401945	130402668	3
chr2	130406355	130408324	Avp	1969	-	NM_009732	130406412	130408277	3
chr2	130415731	130455774	Ubox5	40043	-	NM_001255993	130417541	130428346	7
chr2	130439573	130455763	Fastkd5	16190	-	NM_001146084	130439980	130442404	3
chr2	130458500	130468580	Lzts3	10080	-	NM_001291028	130460501	130463692	5
chr2	130479818	130490381	Ddrgk1	10563	-	NM_029832	130479891	130490301	9
chr2	130493576	130507350	Itpa	13774	+	NM_025922	130493605	130506817	8
chr2	130509843	130523255	Slc4a11	13412	-	NM_001081162	130510169	130521822	21
chr2	130531935	130665881	4930402H24Rik	133946	-	NM_029432	130534935	130665782	37
chr2	130627701	130629837	Gm14057	2136	-	NR_024097	130629837	130629837	1
chr2	130698276	130732132	A730017L22Rik	33856	-	NR_015523	130732132	130732132	3
chr2	130732231	130856062	Atrn	123831	+	NM_009730	130732296	130851677	29
chr2	130865367	130868824	Gfra4	3457	-	NM_001136063	130865911	130868824	6
chr2	130866054	130866134	Mir6973b	80	-	NR_105969	130866134	130866134	1
chr2	130876552	130889550	Adam33	12998	-	NM_033615	130877023	130889250	21
chr2	130894955	130912501	Siglec1	17546	-	NM_011426	130895587	130911852	21
chr2	130953147	130971719	Hspa12b	18572	+	NM_028306	130959815	130970954	13
chr2	130972050	130985817	1700037H04Rik	13767	-	NM_001311138	130972610	130979348	6
chr2	130995996	131000546	Spef1	4550	-	NM_027641	130997418	131000409	7
chr2	131003024	131005803	Cenpb	2779	-	NM_007682	131003812	131005612	1
chr2	131012683	131024247	Cdc25b	11564	+	NM_023117	131012916	131023105	16
chr2	131036095	131039250	Ap5s1	3155	+	NM_027129	131037033	131038842	4
chr2	131059798	131073760	Mavs	13962	+	NM_001206382	131068899	131072525	8
chr2	131088235	131124924	Pank2	36689	+	NM_153501	131088304	131122059	7
chr2	131113787	131113873	Mir103-2	86	+	NR_029755	131113873	131113873	1
chr2	131124223	131178628	Rnf24	54405	-	NM_178607	131129177	131139041	6
chr2	131317597	131350919	Smox	33322	+	NM_001177836	131337745	131350616	8
chr2	131371092	131388021	Adra1d	16929	-	NM_013460	131371680	131387904	2
chr2	131645741	131673392	5330413P13Rik	27651	-	NR_029381	131673392	131673392	3
chr2	131679413	131685483	Erv3	6070	-	NM_001166206	131681570	131682173	2
chr2	131735663	131764172	Prnp	28509	+	NM_001278256	131762165	131762930	4
chr2	131735663	131781867	Prn	46204	+	NM_001278259	131772162	131779291	5
chr2	131776596	131781867	Prnd	5271	+	NM_001126338	131778751	131779291	3
chr2	131818585	131855724	Rassf2	37139	-	NM_175445	131822119	131838356	11
chr2	131878231	131970844	Slc23a2	92613	-	NM_018824	131882404	131927315	16
chr2	132065227	132073524	Tmem230	8297	-	NM_027478	132066221	132071790	4
chr2	132075021	132078916	Pcna	3895	-	NM_011045	132075351	132078772	6
chr2	132088883	132137786	Cds2	48903	+	NM_138651	132089179	132131021	13
chr2	132196064	132211183	Prokr2	15119	-	NM_144944	132199129	132207356	3
chr2	132250476	132278235	4921508D12Rik	27759	+	NR_045802	132278235	132278235	4
chr2	132316463	132349793	1700026D11Rik	33330	+	NR_028286	132349793	132349793	4
chr2	132354817	132403984	Gpcpd1	49167	-	NM_028802	132356288	132397969	20
chr2	132423931	132478800	AU019990	54869	+	NR_033468	132478800	132478800	6
chr2	132516018	132576791	1110034G24Rik	60773	+	NM_028637	132517689	132576391	3
chr2	132607013	132620808	Chgb	13795	+	NM_007694	132607469	132620565	5
chr2	132629950	132641790	Trmt6	11840	-	NM_175113	132631156	132641670	11
chr2	132641876	132669924	Mcm8	28048	+	NM_001291054	132642833	132669303	19
chr2	132672401	132692504	Crls1	20103	+	NM_001024385	132672552	132691660	7
chr2	132694251	132706598	Lrrn4	12347	-	NM_177303	132695435	132705631	5
chr2	132729914	132771772	Fermt1	41858	-	NM_198029	132732403	132767823	15
chr2	133377894	133388632	Bmp2	10738	+	NM_007553	133380161	133387451	3
chr2	133390443	133390530	Mir3090	87	+	NR_037273	133390530	133390530	1
chr2	134323096	134380088	Hao1	56992	-	NM_010403	134323992	134380068	8
chr2	134420241	134469857	Tmx4	49616	-	NM_029148	134424260	134469741	8
chr2	134611899	135300994	Plcb1	689095	+	NM_019677	134612268	135225083	33
chr2	134995308	135041352	4930545L23Rik	46044	-	NR_040517	135041352	135041352	6
chr2	135406265	135408956	9630028H03Rik	2691	-	NR_015544	135408956	135408956	2
chr2	135567565	135838804	Plcb4	271239	+	NM_013829	135703133	135838770	37
chr2	135883662	135895653	Lamp5	11991	+	NM_029530	135884048	135894927	6
chr2	135906823	136213703	Pak7	306880	-	NM_172858	135908956	136000000	10
chr2	136358056	136381590	Ankef1	23534	+	NM_175667	136362867	136381564	11
chr2	136539185	136608164	Snap25	68979	+	NM_011428	136581865	136606879	8
chr2	136699515	136717142	Mkks	17627	-	NM_001286981	136700001	136706971	7
chr2	136716953	136895385	Slx4ip	178432	+	NM_028201	136731309	136894064	6
chr2	136907186	136942256	Jag1	35070	-	NM_013822	136908759	136941993	26
chr2	138082319	138113158	Btbd3	30839	+	NM_001025431	138104850	138110226	5
chr2	138645664	138645743	Mir1952	79	+	NR_035477	138645743	138645743	1
chr2	139319655	139463410	Sptlc3	143755	+	NM_175467	139319941	139462550	13
chr2	139503913	139584317	Ism1	80404	+	NM_001276489	139504405	139583230	6
chr2	139659214	139892541	Tasp1	233327	-	NM_001159640	139660090	139883167	14
chr2	139945616	139996294	Esf1	50678	-	NM_001081090	139946347	139994150	14
chr2	139996381	140030988	Ndufaf5	34607	+	NM_027093	139996447	140029354	11
chr2	140055593	140215446	Sel1l2	159853	-	NM_001033296	140055667	140215368	20
chr2	140221165	142215786	Macrod2	1994621	+	NM_001013802	140221411	142210124	19
chr2	140483933	140497212	Flrt3	13279	-	NM_178382	140485492	140487442	3
chr2	142444080	142727200	Kif16b	283120	-	NM_001081133	142445493	142727107	26
chr2	142728700	142729308	Kif16bos	608	+	NR_131921	142729308	142729308	2
chr2	142888804	142897788	Snrpb2	8984	+	NM_021335	142890302	142897291	7
chr2	142904227	142907435	Otor	3208	+	NM_020595	142904235	142906914	4
chr2	143361211	143373573	Pcsk2os1	12362	-	NR_040354	143373573	143373573	3
chr2	143371868	143642018	Pcsk2	270150	+	NM_008792	143372226	143639547	12
chr2	143573318	143614922	Pcsk2os2	41604	-	NR_040625	143614922	143614922	3
chr2	143652263	143688909	Bfsp1	36646	-	NM_009751	143652401	143688667	8
chr2	143741066	143769060	Dstn	27994	+	NM_019771	143741380	143767972	4
chr2	143773130	143836999	Rrbp1	63869	-	NM_024281	143773626	143815981	24
chr2	143858837	143899715	Banf2	40878	+	NM_001044750	143891143	143899649	3
chr2	143998885	144015026	Gm5535	16141	-	NM_001033778	144000050	144004822	4
chr2	144075858	144096638	Snx5	20780	-	NM_001199188	144076917	144096163	14
chr2	144091717	144091938	Snord17	221	-	NR_030762	144091938	144091938	1
chr2	144096639	144106963	Mgme1	10324	+	NM_028984	144097715	144105378	5
chr2	144130911	144157816	Ovol2	26905	-	NM_026924	144131338	144157596	4
chr2	144194718	144199073	Pet117	4355	+	NM_001164813	144194797	144199073	2
chr2	144194767	144233411	Csrp2bp	38644	+	NM_001166640	144206448	144232532	11
chr2	144285015	144293530	Zfp133-ps	8515	+	NR_033459	144293530	144293530	3
chr2	144290911	144292468	Gm38402	1557	+	NR_038065	144292468	144292468	1
chr2	144296292	144353134	Dzank1	56842	-	NM_172859	144300659	144351424	21
chr2	144353480	144367515	Polr3f	14035	+	NM_029763	144353599	144364425	9
chr2	144368000	144376595	Rbbp9	8595	-	NM_015754	144369518	144376514	5
chr2	144381964	144416489	Sec23b	34525	+	NM_019787	144384956	144416111	20
chr2	144419800	144421101	Gm561	1301	+	NM_001033297	144419826	144420992	2
chr2	144425688	144594483	Dtd1	168795	+	NM_025314	144425784	144572789	6
chr2	144649401	144650151	Scp2d1	750	+	NM_025490	144649478	144649949	1
chr2	145068346	145467675	Slc24a3	399329	+	NM_053195	145070707	145466097	17
chr2	145076788	145209256	Mir6240	132468	-	NR_105748	145209256	145209256	3
chr2	145375190	145380718	Gm14092	5528	-	NM_001037929	145376536	145380589	3
chr2	145526930	145579408	BC039771	52478	+	NR_033220	145579408	145579408	4
chr2	145611851	145713352	Rin2	101501	+	NM_028724	145648474	145711659	13
chr2	145728976	145742161	Naa20	13185	+	NM_001141965	145729045	145741625	6
chr2	145743217	145760436	Crnkl1	17219	-	NM_025820	145744159	145760340	14
chr2	145760519	145789962	Cfap61	29443	+	NM_175280	145765584	145789271	7
chr2	146047732	146050754	Insm1	3022	+	NM_016889	146048001	146049567	1
chr2	146067034	146337740	Ralgapa2	270706	-	NM_001033348	146073939	146337635	41
chr2	146085021	146092896	A930019D19Rik	7875	+	NR_040619	146092896	146092896	4
chr2	146368666	146371844	4933406D12Rik	3178	+	NR_040502	146371844	146371844	4
chr2	146681624	146795825	Kiz	114201	+	NM_001033298	146681657	146795796	14
chr2	146838795	146903733	Xrn2	64938	+	NM_011917	146838857	146903284	30
chr2	146909611	146911081	Nkx2-4	1470	-	NM_023504	146909611	146911081	2
chr2	147003281	147012138	Nkx2-2	8857	-	NM_001077632	147003504	147011754	3
chr2	147009818	147157417	Nkx2-2os	147599	+	NR_030769	147157417	147157417	6
chr2	147013159	147014218	6430503K07Rik	1059	+	NR_108091	147014218	147014218	3
chr2	147187278	147188529	AI646519	1251	-	NR_040330	147188529	147188529	2
chr2	147190729	147200784	Pax1	10055	+	NM_008780	147190783	147199541	5
chr2	147536428	147543368	A530006G24Rik	6940	+	NR_046014	147543368	147543368	3
chr2	147868612	147872705	Foxa2	4093	-	NM_010446	147869249	147871631	3
chr2	148221112	148222500	Sstr4	1388	+	NM_009219	148221206	148222364	1
chr2	148230206	148233924	Thbd	3718	-	NM_009378	148231948	148233682	1
chr2	148262386	148269271	Cd93	6885	-	NM_010740	148266978	148269160	2
chr2	148498350	148501762	Nxt1	3412	+	NM_019761	148501076	148501499	2
chr2	148506855	148518685	Gzf1	11830	+	NM_028986	148509346	148516784	6
chr2	148520392	148558156	Napb	37764	-	NM_019632	148523131	148558099	11
chr2	148576096	148581114	Cstl1	5018	+	NM_177655	148576662	148581083	4
chr2	148594353	148597233	Cst11	2880	-	NM_030059	148594445	148597139	3
chr2	148607744	148611672	8030411F24Rik	3928	+	NM_030135	148607843	148611563	3
chr2	148615096	148619173	Cst12	4077	+	NM_027054	148615096	148619053	3
chr2	148624574	148631320	Cst8	6746	+	NM_009978	148625720	148631236	4
chr2	148645834	148656146	Cst13	10312	+	NM_027024	148648822	148656068	4
chr2	148660882	148664473	Cst9	3591	+	NM_009979	148660946	148664265	3
chr2	148672449	148676670	9230104L09Rik	4221	-	NM_029960	148672651	148676616	3
chr2	148697457	148701248	Cst3	3791	-	NM_009976	148697695	148701113	3
chr2	149230984	149236014	Cst10	5030	+	NM_021405	149231101	149235789	3
chr2	149656518	149830128	Syndig1	173610	+	NM_001085521	149725231	149829071	4
chr2	149940142	149962414	Zfp120	22272	-	NM_181266	149942891	149962378	4
chr2	150007490	150019015	Gm14139	11525	+	NM_001145863	150007603	150018888	4
chr2	150043834	150070610	Zfp937	26776	+	NM_001142411	150043931	150065299	4
chr2	150083252	150096036	Gm14124	12784	+	NM_001142410	150083361	150095275	4
chr2	150136672	150188501	3300002I08Rik	51829	-	NM_027017	150136755	150188380	4
chr2	150228649	150277237	Zfp442	48588	-	NM_001310645	150233712	150277140	4
chr2	150296726	150310799	Zfp345	14073	-	NM_001034900	150297665	150310718	4
chr2	150396150	150404680	Cst7	8530	+	NM_009977	150396254	150404233	4
chr2	150408816	150434259	Apmap	25443	-	NM_027977	150409714	150434215	9
chr2	150443846	150493976	Acss1	50130	-	NM_080575	150445348	150493933	14
chr2	150493229	150494668	E130215H24Rik	1439	+	NR_040331	150494668	150494668	2
chr2	150506439	150514873	Vsx1	8434	-	NM_054068	150508736	150514696	5
chr2	150574816	150597410	Entpd6	22594	+	NM_172117	150578777	150596463	14
chr2	150612531	150657484	Pygb	44953	+	NM_153781	150612603	150656250	20
chr2	150658250	150730467	Abhd12	72217	-	NM_024465	150658836	150730283	13
chr2	150735329	150757016	Gins1	21687	+	NM_027014	150735454	150756645	7
chr2	150760254	150835134	Ninl	74880	-	NM_207204	150760983	150805916	24
chr2	150855420	150865115	Nanp	9695	-	NM_026086	150855995	150865062	2
chr2	150912521	150918086	Gm14151	5565	-	NM_001097977	150913289	150915723	4
chr2	151127774	151141739	4930442J19Rik	13965	+	NR_040747	151141739	151141739	6
chr2	151206385	151258185	LOC100125594	51800	-	NR_131976	151258185	151258185	7
chr2	151296277	151301887	4921509C19Rik	5610	-	NM_198655	151297058	151299492	4
chr2	151319917	151337046	Nsfl1c	17129	+	NM_198326	151320043	151336805	9
chr2	151368218	151387427	Fkbp1a	19209	+	NM_001302080	151369803	151385322	6
chr2	151398358	151415741	Sdcbp2	17383	+	NM_145535	151408447	151415323	9
chr2	151416284	151458329	Snph	42045	-	NM_198214	151419155	151426763	6
chr2	151471139	151494269	Rad21l	23130	-	NM_001276400	151471139	151494269	13
chr2	151527743	151533046	Tmem74b	5303	+	NM_001160363	151532090	151532789	2
chr2	151541797	151567046	Psmf1	25249	-	NM_212446	151544369	151566875	7
chr2	151668662	151700404	Rspo4	31742	+	NM_001040689	151668809	151698867	5
chr2	151737067	151770390	Angpt4	33323	+	NM_009641	151737067	151770390	9
chr2	151793264	151793353	Mir1953	89	-	NR_035478	151793353	151793353	1
chr2	151795131	151805955	Fam110a	10824	-	NM_146127	151795693	151796584	2
chr2	151822246	151834994	Slc52a3	12748	+	NM_027172	151829856	151833894	5
chr2	151907264	151921538	Scrt2	14274	+	NM_001160410	151907785	151919600	2
chr2	151931259	151937112	Srxn1	5853	+	NM_029688	151931419	151934928	2
chr2	151969344	151974832	Tcf15	5488	+	NM_009328	151969361	151974506	2
chr2	152052575	152107587	Csnk2a1	55012	+	NM_007788	152076246	152104820	13
chr2	152119607	152138326	Tbc1d20	18719	+	NM_024196	152119709	152137701	8
chr2	152142069	152158375	Rbck1	16306	-	NM_019705	152142569	152157791	13
chr2	152163160	152169796	Trib3	6636	-	NM_175093	152163942	152169063	4
chr2	152171404	152201058	Gm14164	29654	+	NR_033505	152201058	152201058	5
chr2	152194493	152202302	Nrsn2	7809	-	NM_001009948	152195236	152200017	3
chr2	152219347	152223782	Sox12	4435	-	NM_011438	152222489	152223434	1
chr2	152237691	152240780	Zcchc3	3089	-	NM_175126	152239310	152240513	1
chr2	152241322	152270066	6820408C15Rik	28744	+	NM_177656	152253490	152269869	12
chr2	152284790	152290356	Defb23	5566	-	NM_001037933	152284885	152290328	2
chr2	152302798	152305670	Defb20	2872	+	NM_176950	152302858	152305331	2
chr2	152311401	152315874	Defb22	4473	-	NM_001002791	152311459	152315847	2
chr2	152333491	152337472	Defb26	3981	-	NM_001039120	152333533	152337428	2
chr2	152343990	152347183	Defb28	3193	+	NM_001037502	152344002	152347068	3
chr2	152364449	152365777	Defb29	1328	-	NM_001001444	152364586	152365746	2
chr2	152398479	152400679	Defb21	2200	+	NM_207276	152399504	152400644	3
chr2	152401821	152406048	Defb19	4227	-	NM_145157	152401898	152405983	2
chr2	152418926	152422221	Defb45	3295	-	NM_001037752	152419021	152422129	2
chr2	152430062	152438465	Defb36	8403	+	NM_001037247	152430223	152438362	2
chr2	152448091	152448789	Defb25	698	-	NM_001039122	152448142	152448763	2
chr2	152452743	152460927	Rem1	8184	+	NM_009047	152453831	152460453	5
chr2	152495196	152534404	H13	39208	+	NM_001159551	152495317	152529881	13
chr2	152512883	152513678	Mcts2	795	+	NM_025543	152513006	152513552	1
chr2	152561986	152563146	Id1	1160	+	NM_010495	152562076	152562749	2
chr2	152579908	152590773	Cox4i2	10865	+	NM_053091	152580890	152590617	5
chr2	152584467	152656453	Bcl2l1	71986	-	NM_001289739	152591498	152655726	5
chr2	152673699	152721057	Tpx2	47358	+	NM_001141975	152692987	152719427	18
chr2	152690802	152690862	Mir5622	60	+	NR_049195	152690862	152690862	1
chr2	152737087	152748801	Mylk2	11714	+	NM_001081044	152737283	152747891	12
chr2	152757633	152758944	Foxs1	1311	-	NM_010226	152757877	152758867	1
chr2	152766730	152777318	Dusp15	10588	-	NM_001159376	152768916	152777091	7
chr2	152788220	152834218	Ttll9	45998	+	NM_001083618	152788276	152832721	15
chr2	152834625	152841119	Pdrg1	6494	-	NM_178939	152835389	152841056	5
chr2	152857587	152881511	Xkr7	23924	+	NM_001011732	152857750	152880706	3
chr2	152891690	152907471	Ccm2l	15781	+	NM_145536	152891742	152906764	9
chr2	152934203	152977177	Hck	42974	+	NM_001172117	152949906	152976885	13
chr2	152987036	153036199	Tm9sf4	49163	+	NM_133847	152987292	153034492	18
chr2	153048105	153051177	Tspyl3	3072	-	NM_198617	153050047	153051052	1
chr2	153053504	153067094	Plagl2	13590	-	NM_018807	153057224	153061795	3
chr2	153067267	153095985	Pofut1	28718	+	NM_080463	153067322	153091619	7
chr2	153117151	153159125	Kif3b	41974	+	NM_008444	153142016	153155891	9
chr2	153166892	153171546	2500004C02Rik	4654	-	NR_040318	153171546	153171546	2
chr2	153171874	153229743	Asxl1	57869	+	NM_001039939	153172069	153227809	12
chr2	153233196	153355707	Nol4l	122511	-	NM_001134300	153237347	153355498	11
chr2	153442665	153458517	Commd7	15852	-	NM_001195390	153445171	153454228	10
chr2	153475184	153513466	Dnmt3b	38282	+	NM_001003961	153487166	153512135	24
chr2	153567022	153599050	Mapre1	32028	+	NM_007896	153571994	153592666	7
chr2	153606614	153620918	Efcab8	14304	+	NR_036629	153620918	153620918	8
chr2	153681923	153696820	Sun5	14897	-	NM_001305048	153681947	153696734	13
chr2	153700780	153721006	Bpifb2	20226	+	NM_025631	153701641	153720766	16
chr2	153726123	153738529	Bpifb6	12406	+	NM_199303	153728376	153738358	17
chr2	153743965	153758732	Bpifb3	14767	+	NM_194357	153745368	153758473	16
chr2	153766597	153789588	Bpifb4	22991	+	NM_001034875	153766612	153789342	16
chr2	153800680	153826231	Bpifa6	25551	+	NM_001080811	153808642	153825817	11
chr2	153834011	153841809	Bpifa2	7798	+	NM_008953	153834856	153840698	9
chr2	153956071	153964095	Bpifa3	8024	+	NM_028528	153956271	153963905	7
chr2	153968615	153974953	Bpifa1	6338	+	NM_011126	153969502	153973826	9
chr2	153988342	153994182	Bpifa5	5840	+	NM_025990	153989235	153993427	9
chr2	154016553	154046079	Bpifb1	29526	+	NM_001012392	154028350	154045949	16
chr2	154049477	154066638	Bpifb5	17161	+	NM_144890	154049520	154066517	15
chr2	154083614	154096979	Bpifb9a	13365	+	NM_175167	154085720	154096768	15
chr2	154132979	154146378	Bpifb9b	13399	+	NM_001025574	154135096	154146167	15
chr2	154161121	154198455	Cdk5rap1	37334	-	NM_025876	154161266	154196672	14
chr2	154202049	154233820	Snta1	31771	-	NM_009228	154202551	154233707	8
chr2	154262219	154365092	Cbfa2t2	102873	+	NM_001285446	154341693	154360916	11
chr2	154370140	154384589	Necab3	14449	-	NM_021546	154370874	154384575	13
chr2	154374639	154375784	1700003F12Rik	1145	+	NM_029305	154374677	154375683	3
chr2	154377511	154379012	Actl10	1501	+	NM_001171640	154377865	154378906	1
chr2	154385135	154395628	E2f1	10493	-	NM_007891	154386423	154395470	7
chr2	154412779	154429409	Pxmp4	16630	-	NM_021534	154413564	154429365	4
chr2	154439103	154472553	Zfp341	33450	+	NM_199304	154439107	154471874	15
chr2	154482761	154520519	Chmp4b	37758	+	NM_029362	154482917	154519744	5
chr2	154616845	154692997	Raly	76152	+	NM_001139513	154683013	154691688	9
chr2	154697145	154718642	Eif2s2	21497	-	NM_026030	154698460	154718440	9
chr2	154839305	154876748	a	37443	+	NM_015770	154871357	154876534	4
chr2	154885047	154900233	Ahcy	15186	-	NM_016661	154886184	154900128	10
chr2	154923526	154925815	2310005A03Rik	2289	-	NR_040634	154925815	154925815	3
chr2	154959216	155052591	Itch	93375	+	NM_001243712	154989149	155050202	26
chr2	155062268	155076013	Dynlrb1	13745	+	NM_025947	155062350	155075700	4
chr2	155102099	155103809	Map1lc3a	1710	+	NM_025735	155102342	155103373	4
chr2	155103987	155183160	Pigu	79173	-	NM_001004721	155104271	155183131	12
chr2	155182552	155182661	Mir695	109	+	NR_030475	155182661	155182661	1
chr2	155207591	155215583	Trp53inp2	7992	+	NM_178111	155211076	155212528	4
chr2	155216391	155266519	Ncoa6	50128	-	NM_019825	155216912	155263830	14
chr2	155316115	155340582	Ggt7	24467	-	NM_144786	155316688	155340533	15
chr2	155343778	155388479	Acss2	44701	+	NM_019811	155343842	155387816	18
chr2	155372775	155382666	Acss2os	9891	-	NR_040613	155382666	155382666	4
chr2	155388916	155418546	Gss	29630	-	NM_008180	155389331	155413306	13
chr2	155436978	155460043	Myh7b	23065	+	NM_001085378	155437393	155459827	42
chr2	155448615	155448694	Mir499	79	+	NR_030757	155448694	155448694	1
chr2	155460012	155518120	Trpc4ap	58108	-	NM_019828	155460738	155518042	19
chr2	155527408	155555211	Edem2	27803	-	NM_145537	155527830	155555073	11
chr2	155576952	155581214	Procr	4262	+	NM_011171	155577133	155580620	4
chr2	155601079	155644102	Mmp24	43023	+	NM_010808	155601208	155641784	9
chr2	155643467	155644939	BC029722	1472	-	NR_015528	155644939	155644939	2
chr2	155645572	155652661	Eif6	7089	-	NM_010579	155645837	155652169	6
chr2	155654918	155660590	Fam83c	5672	-	NM_027788	155654918	155660584	4
chr2	155672621	155756046	Uqcc1	83425	-	NR_024487	155756046	155756046	10
chr2	155766760	155771100	Gdf5	4340	-	NM_008109	155767278	155770791	2
chr2	155782293	155824636	Cep250	42343	+	NM_008383	155787707	155824167	34
chr2	155826178	155833713	6430550D23Rik	7535	-	NM_001145352	155828203	155829218	5
chr2	155833860	155844015	Ergic3	10155	+	NM_025516	155833876	155843886	13
chr2	155844875	155878683	Fer1l4	33808	-	NM_001136556	155844995	155878683	45
chr2	155890948	155895235	Spag4	4287	+	NM_139151	155891097	155895214	12
chr2	155897576	155937701	Cpne1	40125	-	NM_170588	155899256	155905200	17
chr2	155920617	155937701	Rbm12	17084	-	NM_170598	155921107	155924086	3
chr2	155949372	155969922	Nfs1	20550	-	NM_010911	155949999	155969876	13
chr2	155969888	155971530	Romo1	1642	+	NM_001164217	155970194	155971446	3
chr2	155972975	156005974	Rbm39	32999	-	NM_133242	155973826	156004963	17
chr2	156022382	156135689	Phf20	113307	+	NM_172674	156049102	156133172	18
chr2	156137581	156138440	Scand1	859	-	NM_020255	156137655	156138084	2
chr2	156138208	156201374	Cnbd2	63166	+	NM_027585	156138268	156201350	13
chr2	156213798	156218715	2900097C17Rik	4917	-	NR_024329	156218715	156218715	1
chr2	156246644	156368950	Epb41l1	122306	+	NM_001291120	156319653	156365554	23
chr2	156373311	156394708	Aar2	21397	+	NM_001164818	156376428	156392768	5
chr2	156434933	156439158	Gm14169	4225	-	NR_040372	156439158	156439158	4
chr2	156439432	156590099	Dlgap4	150667	+	NM_146128	156526414	156588639	13
chr2	156540274	156546645	4930405A21Rik	6371	-	NR_040505	156546645	156546645	4
chr2	156601199	156607393	Myl9	6194	+	NM_172118	156604280	156606898	4
chr2	156665742	156681305	Tgif2	15563	+	NM_001291124	156669925	156679386	4
chr2	156678138	156688681	5430405H02Rik	10543	-	NR_027914	156688681	156688681	3
chr2	156688857	156699298	1110008F13Rik	10441	+	NM_026124	156689039	156698820	4
chr2	156698657	156712814	Sla2	14157	-	NM_029983	156700155	156709412	8
chr2	156753077	156817847	Ndrg3	64770	-	NM_180956	156754435	156795829	17
chr2	156820797	156832811	Dsn1	12014	-	NM_025853	156821931	156831608	11
chr2	156836177	156905001	Soga1	68824	-	NM_001164663	156844088	156904645	15
chr2	156912790	156922217	Tldc2	9427	+	NM_001177439	156912790	156922217	6
chr2	156923264	156960958	Samhd1	37694	-	NM_001139520	156927095	156960918	17
chr2	156971629	157030270	Rbl1	58641	-	NM_011249	156973241	157030191	22
chr2	157034283	157105285	Mroh8	71002	-	NM_001039557	157037408	157105211	25
chr2	157104833	157152054	Rpn2	47221	+	NM_019642	157105058	157151459	17
chr2	157155231	157172391	Ghrh	17160	-	NM_010285	157155332	157159508	5
chr2	157193329	157222499	Manbal	29170	+	NM_026968	157204840	157221753	3
chr2	157250028	157297574	Src	47546	+	NM_009271	157282820	157295697	15
chr2	157382097	157392097	Blcap	10000	-	NM_016916	157383625	157383889	2
chr2	157385813	157388261	Nnat	2448	+	NM_001291130	157385924	157387370	3
chr2	157563136	157717639	Ctnnbl1	154503	+	NM_025680	157563265	157716729	16
chr2	157740388	157770455	Vstm2l	30067	+	NM_198627	157740546	157769859	4
chr2	157807538	157835096	Tti1	27558	-	NM_029282	157808009	157835053	7
chr2	157854232	157903943	Rprd1b	49711	+	NM_001291135	157854630	157896350	8
chr2	157896099	157917533	2010009K17Rik	21434	-	NR_040609	157917533	157917533	4
chr2	157942140	157972128	Tgm2	29988	-	NM_009373	157943536	157972036	13
chr2	158008268	158054960	D630003M21Rik	46692	-	NM_001131021	158011893	158054822	16
chr2	158017743	158021470	1700060C20Rik	3727	+	NR_036606	158021470	158021470	3
chr2	158069239	158069301	Mir7685	62	-	NR_106156	158069301	158069301	1
chr2	158083976	158110267	Bpi	26291	+	NM_177850	158084030	158110003	15
chr2	158132228	158158588	Lbp	26360	+	NM_008489	158132405	158157686	15
chr2	158179435	158187258	Snhg17	7823	-	NR_027887	158187258	158187258	6
chr2	158201373	158211881	Snhg11	10508	+	NM_175692	158201935	158206564	5
chr2	158235588	158324989	Ralgapb	89401	+	NM_001291137	158246579	158321380	31
chr2	158328347	158333934	Adig	5587	+	NM_145635	158328478	158331643	3
chr2	158338531	158376364	Arhgap40	37833	+	NM_001145015	158338540	158376364	15
chr2	158421207	158436459	Gm14204	15252	-	NR_040359	158436459	158436459	3
chr2	158436493	158441483	Slc32a1	4990	+	NM_009508	158436977	158440740	2
chr2	158450648	158464947	Actr5	14299	+	NM_175419	158450877	158464626	9
chr2	158464318	158464376	Mir3474	58	+	NR_037312	158464376	158464376	1
chr2	158492468	158592070	Ppp1r16b	99602	+	NM_153089	158521696	158587599	11
chr2	158593834	158612373	Fam83d	18539	+	NM_027975	158593849	158611886	4
chr2	158620542	158683956	Dhx35	63414	+	NM_001291144	158643113	158682860	22
chr2	159773076	159807025	4933416E03Rik	33949	+	NR_040498	159807025	159807025	7
chr2	159842388	159866356	9130015L21Rik	23968	+	NR_040499	159866356	159866356	4
chr2	160137136	160153230	Gm826	16094	-	NM_001033411	160137796	160153123	3
chr2	160189412	160192801	Mafb	3389	-	NM_010658	160191440	160192412	1
chr2	160471632	160548499	Top1	76867	+	NM_009408	160471965	160547290	21
chr2	160557045	160601496	Plcg1	44451	+	NM_021280	160557552	160601104	34
chr2	160596182	160698726	Zhx3	102544	-	NM_177263	160597350	160607981	4
chr2	160706405	160731736	Lpin3	25331	+	NM_022883	160717932	160731138	20
chr2	160732173	160738075	Emilin3	5902	-	NM_001291145	160733286	160737907	4
chr2	160772713	160934822	Chd6	162109	-	NM_173368	160775035	160885687	37
chr2	161347723	162486883	Ptprt	1139160	-	NM_001291151	161355251	162486635	31
chr2	162216548	162219682	Ptprtos	3134	+	NR_040617	162219682	162219682	3
chr2	162486898	162500940	9430021M05Rik	14042	+	NR_033569	162500940	162500940	4
chr2	162757243	162762856	Srsf6	5613	+	NM_026499	162757406	162760493	6
chr2	162769200	162800258	L3mbtl1	31058	+	NM_001081338	162772924	162800258	23
chr2	162813216	162839875	Sgk2	26659	+	NM_013731	162818700	162838810	14
chr2	162843207	162871871	Ift52	28664	+	NM_172150	162848116	162871096	13
chr2	162880370	162910423	Mybl2	30053	+	NM_008652	162880564	162909030	14
chr2	162893825	162893891	Mir7003	66	+	NR_105970	162893891	162893891	1
chr2	162912766	162915337	Gtsf1l	2571	-	NM_026630	162912841	162913297	2
chr2	163051189	163148838	Tox2	97649	+	NM_001098799	163051203	163148746	9
chr2	163161977	163223729	Jph2	61752	-	NM_001205076	163164354	163223262	7
chr2	163231557	163245206	Oser1	13649	-	NM_025699	163232140	163241347	4
chr2	163264202	163281060	Gdap1l1	16858	+	NM_144891	163264281	163279663	6
chr2	163294438	163298365	Fitm2	3927	-	NM_173397	163295238	163298311	2
chr2	163298280	163298739	2310001K24Rik	459	+	NR_028122	163298739	163298739	1
chr2	163318053	163328348	R3hdml	10295	+	NM_001099331	163318227	163328190	5
chr2	163319539	163367457	Hnf4aos	47918	-	NR_027970	163367457	163367457	4
chr2	163332592	163398643	Hnf4a	66051	+	NM_001312906	163362754	163395827	11
chr2	163428049	163444749	Ttpal	16700	+	NM_029512	163432962	163441377	5
chr2	163449008	163470879	Serinc3	21871	-	NM_012032	163451176	163470772	10
chr2	163470585	163471536	0610039K10Rik	951	+	NR_028113	163471536	163471536	1
chr2	163484121	163551894	Pkig	67773	+	NM_001039390	163546886	163551272	5
chr2	163552306	163575975	Ada	23669	-	NM_007398	163553295	163575827	12
chr2	163646569	163658883	Wisp2	12314	+	NM_016873	163647057	163658173	5
chr2	163679485	163684610	Kcnk15	5125	+	NM_001030292	163679485	163684610	2
chr2	163689616	163744419	Rims4	54803	-	NM_183023	163689638	163744419	6
chr2	163820932	163844323	Ywhab	23391	+	NM_018753	163837340	163842461	6
chr2	163850959	163876274	Pabpc1l	25315	+	NM_001114079	163851216	163875775	14
chr2	163879275	163896905	Tomm34	17630	-	NM_001291155	163880138	163896775	7
chr2	163899913	163981257	Stk4	81344	+	NM_021420	163899948	163977567	11
chr2	163989354	163996849	Kcns1	7495	-	NM_008435	163990283	163994573	4
chr2	164002060	164008478	Wfdc5	6418	-	NM_145369	164004225	164008389	4
chr2	164014966	164016294	Wfdc12	1328	-	NM_138684	164015394	164016255	3
chr2	164024607	164025853	Wfdc15a	1246	-	NM_183271	164025394	164025772	3
chr2	164040189	164047399	Wfdc15b	7210	-	NM_138685	164040849	164041205	4
chr2	164061664	164064077	Svs2	2413	-	NM_017390	164062593	164063979	3
chr2	164080098	164082379	Svs3b	2281	-	NM_173377	164081337	164082357	3
chr2	164101691	164104043	Svs4	2352	-	NM_009300	164102808	164104021	3
chr2	164115002	164117236	Svs3a	2234	+	NM_001311114	164115024	164116044	3
chr2	164142486	164144186	Svs6	1700	+	NM_013679	164142503	164143354	4
chr2	164158500	164160130	Svs5	1630	+	NM_009301	164158521	164159334	3
chr2	164179805	164182243	Slpi	2438	-	NM_011414	164180612	164182008	4
chr2	164180048	164180119	Mir7678	71	-	NR_106143	164180119	164180119	1
chr2	164215128	164230660	Matn4	15532	-	NM_001252563	164215391	164227420	11
chr2	164228693	164240948	Rbpjl	12255	+	NM_009036	164228796	164240143	12
chr2	164249746	164268688	Sdc4	18942	-	NM_011521	164251585	164268664	5
chr2	164286470	164291010	Sys1	4540	+	NM_025575	164286867	164290098	4
chr2	164295803	164299224	Trp53tg5	3421	-	NM_001271575	164296536	164299150	5
chr2	164311639	164318823	Dbndd2	7184	+	NM_001048227	164313749	164315835	4
chr2	164323024	164333801	Pigt	10777	+	NM_133779	164323058	164333027	12
chr2	164388215	164394006	Wfdc2	5791	+	NM_026323	164388225	164391437	5
chr2	164395194	164398956	Spint3	3762	-	NM_001177401	164395320	164398795	2
chr2	164405018	164410947	Wfdc6a	5929	-	NM_001033240	164405325	164410590	5
chr2	164413842	164419071	Eppin	5229	-	NM_029325	164414137	164419016	4
chr2	164421957	164439126	Wfdc8	17169	-	NM_001276431	164422289	164434395	8
chr2	164439199	164443713	Wfdc6b	4514	+	NM_001012725	164439252	164443406	4
chr2	164460207	164464302	Wfdc16	4095	-	NM_001012723	164460912	164464073	4
chr2	164475124	164480466	Wfdc9	5342	-	NM_001160414	164475286	164477263	4
chr2	164481545	164482868	Wfdc10	1323	+	NM_001039501	164481607	164482846	2
chr2	164488393	164499587	Wfdc11	11194	-	NM_001161806	164488536	164491035	5
chr2	164510606	164513206	Wfdc13	2600	+	NM_001012704	164510718	164512490	2
chr2	164524000	164527948	Spint4	3948	+	NM_030058	164524050	164526468	4
chr2	164540804	164543568	Spint5	2764	+	NM_001040055	164540844	164543483	4
chr2	164556725	164568767	Wfdc3	12042	-	NM_027961	164556971	164568586	4
chr2	164571514	164593719	Dnttip1	22205	+	NM_133763	164571553	164593501	13
chr2	164595428	164598402	Ube2c	2974	+	NM_026785	164595479	164598062	6
chr2	164602661	164605234	Tnnc2	2573	-	NM_009394	164602801	164605165	6
chr2	164611520	164618270	Snx21	6750	+	NM_133924	164611565	164617887	3
chr2	164618267	164630381	Acot8	12114	-	NM_133240	164618391	164630317	6
chr2	164630613	164647627	Zswim3	17014	+	NM_178375	164630776	164647189	2
chr2	164648185	164652367	Zswim1	4182	+	NM_028028	164650329	164651697	2
chr2	164652881	164654034	Spata25	1153	-	NM_029370	164652908	164653959	2
chr2	164656229	164659096	Neurl2	2867	-	NM_001082974	164656371	164658940	2
chr2	164658371	164666532	Ctsa	8161	+	NM_001038492	164659529	164664734	15
chr2	164665017	164683208	Pltp	18191	-	NM_011125	164665205	164682486	16
chr2	164704867	164716937	Pcif1	12070	+	NM_146129	164709595	164716617	17
chr2	164717391	164737250	Zfp335	19859	-	NM_199027	164717663	164736322	28
chr2	164773718	164781349	Mmp9	7631	+	NM_013599	164773756	164780406	13
chr2	164793487	164825231	Slc12a5	31744	+	NM_020333	164793902	164822971	26
chr2	164825856	164860279	Ncoa5	34423	-	NM_144892	164827081	164848683	8
chr2	164881135	164897154	Cd40	16019	+	NM_011611	164881207	164896413	9
chr2	164904192	164916250	1700025C18Rik	12058	-	NR_033448	164916250	164916250	3
chr2	164937006	165060237	Cdh22	123231	-	NM_174988	164937657	165006649	12
chr2	165102021	165113338	Slc35c2	11317	-	NR_045544	165113338	165113338	11
chr2	165113530	165151979	Elmo2	38449	-	NM_207706	165115860	165141816	22
chr2	165176796	165187619	Zfp663	10823	-	NM_001005425	165177826	165185479	5
chr2	165202935	165213759	Zfp334	10824	-	NM_178411	165205581	165212440	5
chr2	165220949	165225894	Ocstamp	4945	-	NM_029021	165221345	165225831	3
chr2	165230794	165298697	Slc13a3	67903	-	NM_054055	165232179	165298661	13
chr2	165315611	165318814	Trp53rka	3203	-	NM_001007581	165316732	165318802	2
chr2	165329396	165345417	Slc2a10	16021	+	NM_130451	165329544	165343742	5
chr2	165420527	165597227	Eya2	176700	+	NM_001271963	165490295	165596614	16
chr2	165609651	165710338	Zmynd8	100687	-	NM_027230	165611089	165710121	24
chr2	165818136	165898742	Ncoa3	80606	+	NM_008679	165872974	165895643	23
chr2	165899398	165981183	Sulf2	81785	-	NM_028072	165900287	165958262	21
chr2	166099407	166120331	Gm11468	20924	+	NR_033467	166120331	166120331	3
chr2	166272950	166284270	5031425F14Rik	11320	+	NR_015558	166284270	166284270	3
chr2	166391844	166539332	Prex1	147488	-	NM_177782	166393307	166539218	40
chr2	166498217	166547652	Mir6364	49435	+	NR_105783	166547652	166547652	3
chr2	166619266	166624992	Trp53rkb	5726	+	NM_023815	166619312	166621360	2
chr2	166631080	166723551	Arfgef2	92471	+	NM_001085495	166631214	166720288	39
chr2	166731595	166771889	Cse1l	40294	+	NM_023565	166740679	166771293	25
chr2	166773048	166821799	Stau1	48751	-	NM_001291160	166775239	166790158	12
chr2	166840812	166860445	Ddx27	19633	+	NM_153065	166840833	166860157	21
chr2	166861296	166888515	Znfx1	27219	-	NM_001033196	166862224	166885592	14
chr2	166888433	166891362	Zfos1	2929	+	NM_001081005	166890687	166891349	5
chr2	166890792	166890858	Snord12	66	+	NR_028540	166890858	166890858	1
chr2	166921468	167014318	Kcnb1	92850	-	NM_008420	166929852	167014123	2
chr2	167028695	167066037	Ptgis	37342	-	NM_008968	167028823	167065920	10
chr2	167123944	167174678	B4galt5	50734	-	NM_019835	167126835	167174532	9
chr2	167247209	167302500	Slc9a8	55291	+	NM_001304540	167266636	167299635	17
chr2	167306635	167318374	Spata2	11739	-	NM_170756	167308849	167310975	3
chr2	167318144	167341666	Rnf114	23522	+	NM_030743	167328958	167340231	8
chr2	167363694	167368311	Snai1	4617	+	NM_011427	167363789	167367583	3
chr2	167433138	167457505	Ube2v1	24367	-	NM_001311131	167434600	167454769	5
chr2	167468724	167487044	Tmem189	18320	-	NM_145538	167469560	167486996	6
chr2	167514414	167515932	Cebpb	1518	+	NM_009883	167514521	167515412	1
chr2	167516258	167522913	A530013C23Rik	6655	+	NR_110334	167522913	167522913	2
chr2	167757826	167804885	Ptpn1	47059	+	NM_011201	167757993	167802138	9
chr2	167806285	167836093	Fam65c	29808	-	NM_001080708	167806322	167831776	22
chr2	167906503	167926703	Pard6b	20200	+	NM_021409	167906793	167924710	3
chr2	167978102	167980013	E130018N17Rik	1911	-	NR_040327	167980013	167980013	2
chr2	168006464	168032612	Adnp	26148	-	NM_001310086	168007546	168014889	5
chr2	168006464	168055879	Dpm1-adnp	49415	-	NR_132310	168055879	168055879	12
chr2	168034547	168055879	Dpm1	21332	-	NM_010072	168036031	168055853	9
chr2	168056121	168057803	Mocs3	1682	+	NM_001160330	168056134	168057517	1
chr2	168087197	168094831	Kcng1	7634	-	NM_001081134	168087879	168094742	2
chr2	168301909	168427157	Nfatc2	125248	-	NM_001291169	168312227	168427038	11
chr2	168459937	168567636	Atp9a	107699	-	NM_001289446	168460271	168567601	28
chr2	168466195	168466259	Mir7004	64	-	NR_105971	168466259	168466259	1
chr2	168573831	168592701	Sall4	18870	-	NM_175303	168575528	168592529	4
chr2	168750860	168781087	Zfp64	30227	-	NM_009564	168751159	168780664	6
chr2	168803768	168804406	1700017J07Rik	638	+	NR_040326	168804406	168804406	2
chr2	169459145	169714004	Tshz2	254859	+	NM_080455	169459239	169712078	2
chr2	169787512	169788687	AY702102	1175	-	NR_131974	169788687	169788687	1
chr2	169886739	169896171	A630075F10Rik	9432	-	NR_033634	169896171	169896171	3
chr2	169934142	169968175	Zfp217	34033	-	NM_001159683	169938004	169945905	7
chr2	170172490	170253345	Bcas1	80855	-	NM_029815	170173573	170246162	13
chr2	170181860	170205935	Bcas1os2	24075	+	NR_040610	170205935	170205935	8
chr2	170308456	170322645	Cyp24a1	14189	-	NM_009996	170311176	170322274	12
chr2	170321927	170344570	Pfdn4	22643	+	NM_001013369	170342088	170344304	4
chr2	170324856	170337427	Gm16796	12571	-	NR_040367	170337427	170337427	3
chr2	170404917	170427517	4930470P17Rik	22600	-	NR_027825	170427517	170427517	2
chr2	170557306	170705275	Dok5	147969	+	NM_029761	170557622	170704738	8
chr2	171782378	171788299	1700028P15Rik	5921	-	NR_040509	171788299	171788299	6
chr2	171861835	171868966	Cbln4	7131	-	NM_175631	171862869	171867798	3
chr2	172073991	172076614	Mc3r	2623	+	NM_008561	172074359	172075331	1
chr2	172171076	172181249	Fam210b	10173	+	NM_025912	172171161	172178302	3
chr2	172181689	172196070	Aurka	14381	-	NM_011497	172182295	172195955	9
chr2	172196502	172206586	Cstf1	10084	+	NM_024199	172198460	172206119	6
chr2	172219293	172259257	Cass4	39964	+	NM_001080820	172219469	172258143	7
chr2	172266077	172295399	Rtfdc1	29322	+	NM_025542	172266170	172294274	9
chr2	172275812	172284096	Gcnt7	8284	-	NM_001039560	172276563	172280402	4
chr2	172298053	172299816	Fam209	1763	+	NM_029608	172298092	172299719	2
chr2	172375092	172384121	Tfap2c	9029	+	NM_009335	172375334	172382876	7
chr2	172693512	172765822	Bmp7	72310	-	NM_007557	172695637	172765570	7
chr2	172805342	172819077	Spo11	13735	+	NM_012046	172805394	172818604	13
chr2	172825617	172841240	Rae1	15623	+	NM_175112	172828164	172840870	12
chr2	172847402	172860232	Rbm38	12830	+	NM_019547	172847540	172859310	4
chr2	172919109	172945026	Ctcfl	25917	-	NM_001081387	172920167	172944289	11
chr2	172950249	172958705	Ctcflos	8456	+	NR_040321	172958705	172958705	3
chr2	172978573	172984754	Pck1	6181	+	NM_011044	172978889	172984147	10
chr2	173032113	173044423	Zbp1	12310	-	NM_021394	173032717	173044276	8
chr2	173049965	173102034	Pmepa1	52069	-	NM_022995	173053322	173101685	4
chr2	173348092	173354003	1700021F07Rik	5911	+	NM_028158	173348164	173353845	4
chr2	173394161	173403842	Ankrd60	9681	-	NM_027303	173394269	173403842	4
chr2	173404820	173485040	Ppp4r1l-ps	80220	-	NR_027957	173485040	173485040	15
chr2	173485345	173527683	Rab22a	42338	+	NM_024436	173485606	173526620	7
chr2	173526530	173526649	Mir6340	119	-	NR_105758	173526649	173526649	1
chr2	173544915	173547587	1700010B08Rik	2672	+	NM_029308	173545400	173547485	3
chr2	173563071	173609837	Vapb	46766	+	NM_019806	173563193	173603722	6
chr2	173902551	173925272	Stx16	22721	+	NM_001102424	173902558	173922524	9
chr2	173935851	173948203	Npepl1	12352	+	NM_213733	173935923	173947753	12
chr2	173950538	174009419	Gm10714	58881	-	NR_040530	174009419	174009419	4
chr2	174092547	174092626	Mir296	79	-	NR_029646	174092626	174092626	1
chr2	174093004	174093086	Mir298	82	-	NR_029649	174093086	174093086	1
chr2	174106737	174120937	Nespas	14200	-	NR_002846	174120937	174120937	5
chr2	174109820	174172243	Gnas	62423	+	NM_022000	174110174	174110936	13
chr2	174241304	174253003	Nelfcd	11699	+	NM_020580	174241370	174252566	15
chr2	174252994	174264540	Ctsz	11546	-	NM_022325	174253372	174264399	6
chr2	174276095	174283881	Tubb1	7786	+	NM_001080971	174276245	174283383	4
chr2	174286575	174289602	Atp5e	3027	-	NM_025983	174288003	174289497	3
chr2	174290591	174298442	Slmo2	7851	-	NM_025531	174291314	174298364	6
chr2	174469034	174536331	Zfp831	67297	+	NM_001099328	174469034	174531413	5
chr2	174586258	174609543	Edn3	23285	+	NM_007903	174586467	174607419	5
chr2	174887049	174893270	Gm14393	6221	-	NM_001085546	174887049	174893203	4
chr2	175018480	175032418	Gm6710	13938	-	NM_001164689	175020414	175028562	5
chr2	175100624	175109351	Gm14288	8727	+	NM_001033123	175100701	175109195	3
chr2	175100625	175112306	Gm14440	11681	+	NM_001199308	175100701	175109195	3
chr2	175197962	175210780	Gm8898	12818	+	NM_001177407	175198014	175208704	4
chr2	175197962	175210780	Gm14431	12818	+	NM_001177406	175198014	175208704	4
chr2	175244891	175261278	Gm4724	16387	-	NM_001256480	175247800	175257683	5
chr2	175244891	175261278	Gm14308	16387	-	NM_001099349	175247800	175257683	5
chr2	175244891	175261278	Gm14430	16387	-	NM_001100415	175247800	175257683	5
chr2	175244891	175261278	Gm14434	16387	-	NM_001101804	175247800	175257683	5
chr2	175295525	175306054	Gm8923	10529	+	NM_001242944	175295563	175305754	4
chr2	175295560	175308823	Gm14436	13263	+	NM_001242943	175295563	175305754	4
chr2	175432866	175468174	2210418O10Rik	35308	-	NR_130971	175468174	175468174	6
chr2	175432867	175468174	Gm14296	35307	-	NR_130970	175468174	175468174	6
chr2	175594788	176850107	Gm14405	1255319	-	NR_040256	176850107	176850107	5
chr2	175868369	175987706	Gm14391	119337	+	NM_001177480	175872232	175987166	5
chr2	176082748	176097171	OTTMUSG00000016609	14423	-	NM_001100416	176083704	176093584	5
chr2	176083704	176097171	Gm14305	13467	-	NM_001099327	176083704	176093584	5
chr2	176266768	176598837	0610010B08Rik	332069	+	NM_001177543	176270357	176280240	6
chr2	176583304	176593409	Gm14295	10105	+	NM_001205057	176586937	176592464	4
chr2	177249446	177263899	Gm14420	14453	+	NM_001177568	177249550	177260908	4
chr2	177282930	177297016	Gm14403	14086	+	NR_036450	177297016	177297016	5
chr2	177493992	177507980	Gm14322	13988	+	NM_001243903	177497602	177505177	5
chr2	177563695	177575023	Gm14325	11328	-	NM_001024849	177566495	177574944	4
chr2	177631867	177662555	Gm14327	30688	+	NR_038101	177662555	177662555	2
chr2	177637768	177660355	C330013J21Rik	22587	-	NM_183135	177638316	177660266	3
chr2	177670697	177691993	Gm14326	21296	-	NM_001282028	177671242	177688389	5
chr2	177757988	177770564	Etohi1	12576	+	NM_001177399	177758083	177768727	4
chr2	177801582	177813130	Zfp931	11548	-	NM_001162922	177802399	177813065	4
chr2	177853679	178073197	Phactr3	219518	+	NM_001177789	177853904	178070226	13
chr2	178080000	178142363	Sycp2	62363	-	NM_177191	178081037	178139376	44
chr2	178145910	178149168	Ppp1r3d	3258	-	NM_001085501	178148072	178148912	1
chr2	178149238	178156866	Fam217b	7628	+	NM_001081289	178152270	178156113	4
chr2	178165219	178222071	Cdh26	56852	+	NM_198656	178165492	178221653	15
chr2	179149640	179151585	4930591A17Rik	1945	+	NM_026596	179150544	179151479	3
chr2	179177135	179634080	Cdh4	456945	+	NM_009867	179177326	179630623	16
chr2	179646850	179711351	Taf4a	64501	-	NM_001081092	179648143	179711351	15
chr2	179711557	179713718	4921531C22Rik	2161	+	NR_033782	179713718	179713718	2
chr2	179759691	179770166	Lsm14b	10475	+	NM_177727	179759890	179768562	9
chr2	179771071	179777169	Psma7	6098	-	NM_011969	179771185	179777078	7
chr2	179777187	179804906	Ss18l1	27719	+	NM_178750	179777504	179802063	11
chr2	179805297	179820607	Mtg2	15310	+	NM_181424	179813327	179820479	10
chr2	179834169	179839112	Hrh3	4943	-	NR_102309	179839112	179839112	3
chr2	179854070	179897385	Osbpl2	43315	+	NM_144500	179871780	179896296	14
chr2	179906292	179910988	Adrm1	4696	+	NM_019822	179906739	179910885	10
chr2	179911077	179960564	Lama5	49487	-	NM_001081171	179911251	179960507	79
chr2	179914459	179914528	Mir7005	69	-	NR_105972	179914528	179914528	1
chr2	179992083	179993149	Rps21	1066	+	NM_025587	179992338	179993092	6
chr2	179992240	179992316	Mir3091	76	+	NR_037274	179992316	179992316	1
chr2	179993243	180008170	Cables2	14927	-	NM_145851	179994747	180008160	10
chr2	180012350	180024584	Rbbp8nl	12234	-	NM_173031	180012647	180019552	13
chr2	180059792	180069384	Gata5	9592	-	NM_008093	180061569	180069074	6
chr2	180067561	180075437	Gata5os	7876	+	NR_045877	180075437	180075437	5
chr2	180105562	180120590	B230312C02Rik	15028	-	NR_040745	180120590	180120590	7
chr2	180120308	180136507	Gm6307	16199	+	NR_045331	180136507	180136507	4
chr2	180123752	180123829	Mir1a-1	77	+	NR_029528	180123829	180123829	1
chr2	180133083	180133187	Mir133a-2	104	+	NR_029901	180133187	180133187	1
chr2	180195682	180209557	Slco4a1	13875	+	NM_148933	180198731	180208949	12
chr2	180234680	180279684	Ntsr1	45004	+	NM_018766	180235122	180277485	4
chr2	180316008	180320339	Mrgbp	4331	+	NM_028479	180317512	180320193	6
chr2	180324111	180330542	Ogfr	6431	+	NM_031373	180324185	180330230	7
chr2	180332926	180356890	Col9a3	23964	+	NM_009936	180332964	180356125	32
chr2	180356661	180377396	Tcfl5	20735	-	NM_178254	180357296	180377294	6
chr2	180392667	180436807	Dido1	44140	-	NM_175551	180394043	180424358	16
chr2	180444930	180456304	Gid8	11374	+	NM_001289652	180447907	180452716	5
chr2	180460043	180476983	Slc17a9	16940	+	NM_183161	180460064	180476151	13
chr2	180509085	180511605	Bhlhe23	2520	-	NM_080641	180510776	180511448	1
chr2	180628744	180628812	Mir124a-3	68	+	NR_029538	180628812	180628812	1
chr2	180639081	180655641	Ythdf1	16560	-	NM_173761	180640346	180655415	5
chr2	180663727	180668715	Birc7	4988	+	NM_001163247	180663851	180668035	7
chr2	180669476	180689404	Nkain4	19928	-	NM_021426	180669724	180689329	7
chr2	180701929	180717229	Arfgap1	15300	+	NM_145760	180705759	180716075	14
chr2	180721239	180752245	Col20a1	31006	+	NM_028518	180721239	180751033	36
chr2	180757015	180773882	Chrna4	16867	-	NM_015730	180759458	180773778	6
chr2	180810283	180869994	Kcnq2	59711	-	NM_001003824	180810862	180869797	17
chr2	180882396	180891720	Eef1a2	9324	-	NM_007906	180882683	180890111	8
chr2	180922047	180923209	Ppdpf	1162	+	NM_025598	180922386	180923004	5
chr2	180929828	180937494	Ptk6	7666	-	NM_009184	180930473	180937209	8
chr2	180940267	180947876	Srms	7609	-	NM_011481	180940891	180947477	8
chr2	180954720	180957556	BC051628	2836	+	NM_199312	180956108	180957285	3
chr2	180962319	180976732	Helz2	14413	-	NM_183162	180963449	180975703	19
chr2	180986155	181022671	Gmeb2	36516	-	NM_198169	180988487	181012784	10
chr2	181041163	181049205	Stmn3	8042	-	NM_009133	181041468	181048917	5
chr2	181054428	181091321	Rtel1	36893	+	NM_001001882	181055660	181090795	34
chr2	181092394	181100109	Arfrp1	7715	-	NM_029702	181094178	181099402	8
chr2	181099635	181115498	Zgpat	15863	+	NM_144894	181100376	181115218	7
chr2	181115939	181118333	Lime1	2394	+	NM_023684	181116921	181118166	5
chr2	181118954	181122301	Slc2a4rg-ps	3347	+	NR_045164	181122301	181122301	3
chr2	181145251	181194131	Zbtb46	48880	-	NM_028125	181146317	181159060	3
chr2	181227910	181229685	Abhd16b	1775	+	NM_183181	181228011	181229436	1
chr2	181231846	181252667	Tpd52l2	20821	+	NM_025482	181232018	181249880	8
chr2	181255189	181287585	Dnajc5	32396	+	NM_001271585	181281086	181284081	6
chr2	181303858	181316678	Uckl1	12820	-	NM_026765	181304015	181316673	15
chr2	181313184	181319820	Uckl1os	6636	+	NR_027289	181319820	181319820	3
chr2	181316807	181327166	Zfp512b	10359	-	NM_001164597	181319526	181325688	17
chr2	181322604	181322673	Mir7006	69	-	NR_105973	181322673	181322673	1
chr2	181329923	181333852	Samd10	3929	-	NM_172676	181331287	181333727	5
chr2	181336023	181390366	Prpf6	54343	+	NM_133701	181336165	181390279	21
chr2	181404541	181406345	Sox18	1804	-	NM_009236	181404907	181406226	2
chr2	181415014	181422756	Tcea2	7742	+	NM_009326	181415111	181422590	10
chr2	181423123	181428682	Rgs19	5559	-	NM_026446	181423811	181426224	6
chr2	181431499	181433147	Lkaaear1	1648	-	NM_199023	181431574	181432360	4
chr2	181449720	181455690	Oprl1	5970	+	NR_045542	181455690	181455690	5
chr2	181498036	181562480	Myt1	64444	+	NM_001171615	181498100	181560749	23
chr2	181572558	181592165	Pcmtd2	19607	+	NM_153594	181577103	181590016	7
chr2	181599064	181605531	Polr3k	6467	+	NM_025901	181599163	181603036	3
chr2	181725930	181735792	Gm14496	9862	+	NM_001205282	181725930	181735792	6
chr3	3508029	3659800	Hnf4g	151771	+	NM_013920	3508328	3657176	10
chr3	4798707	4814911	1110015O18Rik	16204	+	NR_045272	4814911	4814911	4
chr3	5177823	5220823	2700069I18Rik	43000	-	NR_045905	5220823	5220823	3
chr3	5218553	5415855	Zfhx4	197302	+	NM_030708	5241715	5413147	11
chr3	5560187	5576248	Pex2	16061	-	NM_008994	5560829	5561747	6
chr3	6615412	6620443	1700008P02Rik	5031	-	NM_027048	6617298	6620392	4
chr3	7366603	7445365	Pkia	78762	+	NM_008862	7437364	7442090	3
chr3	7503425	7553848	Zc2hc1a	50423	+	NM_173181	7503511	7551548	9
chr3	7572027	7613760	Il7	41733	-	NM_001313889	7573839	7577248	7
chr3	7925302	7954887	1700010I02Rik	29585	-	NR_040587	7954887	7954887	4
chr3	8461386	8463098	Gm6194	1712	-	NR_033512	8463098	8463098	1
chr3	8509526	8561604	Stmn2	52078	+	NM_025285	8509611	8560325	5
chr3	8663358	8667038	Hey1	3680	-	NM_010423	8664495	8666870	5
chr3	8802145	8923857	Mrps28	121712	-	NM_025434	8802245	8923796	3
chr3	8929435	9004515	Tpd52	75080	-	NM_001025264	8931051	9004423	7
chr3	9061963	9071076	4930539M17Rik	9113	+	NR_040597	9071076	9071076	3
chr3	9250566	9285332	Zbtb10	34766	+	NM_177660	9251129	9281033	6
chr3	9403077	9413903	C030034L19Rik	10826	+	NR_015499	9413903	9413903	2
chr3	9427009	9610085	Zfp704	183076	-	NM_133218	9438786	9609719	9
chr3	9687481	9833679	Pag1	146198	-	NM_001195031	9693766	9706213	9
chr3	10012584	10016610	Fabp5	4026	+	NM_010634	10012639	10016120	4
chr3	10088276	10092562	Gm9833	4286	+	NR_045710	10092562	10092562	2
chr3	10179850	10183885	Pmp2	4035	-	NM_001030305	10180749	10183819	4
chr3	10193623	10197283	Fabp9	3660	-	NM_011598	10193751	10197164	4
chr3	10204342	10208576	Fabp4	4234	-	NM_024406	10204519	10208511	4
chr3	10244208	10301183	Fabp12	56975	-	NM_029310	10246001	10252309	6
chr3	10311955	10331439	Impa1	19484	-	NM_018864	10315185	10329005	9
chr3	10331733	10335656	Slc10a5	3923	-	NM_001010834	10334293	10335598	1
chr3	10339955	10351301	Zfand1	11346	-	NM_025512	10340734	10351296	8
chr3	10366972	10391005	Chmp4c	24033	+	NM_025519	10367031	10389973	5
chr3	10417816	10440130	Snx16	22314	-	NM_029068	10419126	10438185	8
chr3	11823228	11844359	Gm10745	21131	-	NR_040751	11844359	11844359	5
chr3	13471654	14182287	Ralyl	710633	+	NM_178631	13776847	14181055	10
chr3	13597138	13652865	4930539N22Rik	55727	-	NR_040598	13652865	13652865	4
chr3	14363116	14374239	Gm6300	11123	+	NR_033591	14374239	14374239	3
chr3	14480698	14505818	Slc7a12	25120	+	NM_080852	14480796	14505587	4
chr3	14533787	14572658	Lrrcc1	38871	+	NM_028915	14533933	14572427	19
chr3	14578670	14606309	E2f5	27639	+	NM_007892	14578819	14605717	8
chr3	14606288	14611256	1810022K09Rik	4968	-	NM_001099674	14606345	14609654	4
chr3	14641726	14663002	Car13	21276	+	NM_024495	14641808	14661574	7
chr3	14766213	14808365	Car1	42152	-	NM_009799	14766535	14778384	8
chr3	14863537	14872373	Car3	8836	+	NM_007606	14863571	14871661	7
chr3	14886425	14900770	Car2	14345	+	NM_009801	14886752	14900090	7
chr3	14971200	15002727	A930001A20Rik	31527	+	NR_040549	15002727	15002727	5
chr3	15296550	15332302	Gm9733	35752	-	NM_001076679	15296551	15332222	3
chr3	15371826	15426427	Sirpb1a	54601	-	NM_001002898	15378994	15426405	6
chr3	15495753	15575065	Sirpb1b	79312	-	NM_001173460	15503103	15574950	6
chr3	15695146	15748487	LOC100038947	53341	-	NM_001173459	15702490	15748413	6
chr3	15848069	15906332	Gm5150	58263	-	NM_001081687	15848072	15906322	4
chr3	16083182	16117038	Ythdf3	33856	+	NR_027375	16117038	16117038	6
chr3	17689920	17700071	2610100L16Rik	10151	+	NR_033490	17700071	17700071	3
chr3	17695661	17695770	Mir124a-2	109	+	NR_029814	17695770	17695770	1
chr3	17848443	17848952	Cypt12	509	+	NM_029289	17848464	17848824	1
chr3	17954324	17957514	Bhlhe22	3190	+	NM_021560	17954787	17955855	1
chr3	17971949	18143338	Cyp7b1	171389	-	NM_007825	17972456	18143203	6
chr3	18368284	18380477	4930433B08Rik	12193	-	NR_040544	18380477	18380477	4
chr3	19032143	19063065	Armc1	30922	-	NM_028840	19034031	19057654	7
chr3	19087328	19120817	Mtfr1	33489	+	NM_001253391	19100101	19119106	8
chr3	19123108	19211322	Pde7a	88214	-	NM_001122759	19127635	19211001	13
chr3	19408594	19510862	Dnajc5b	102268	+	NM_001163536	19446740	19510639	5
chr3	19544459	19591599	Trim55	47140	+	NM_001081281	19544608	19591599	10
chr3	19593400	19595396	Crh	1996	-	NM_205769	19593912	19594476	2
chr3	19794870	19798984	4632415L05Rik	4114	+	NR_027985	19798984	19798984	1
chr3	19857053	19909750	Cp	52697	+	NM_001276250	19857283	19905558	20
chr3	19895944	19935310	Hps3	39366	-	NM_001146323	19896901	19935265	17
chr3	19957810	20018377	Hltf	60567	+	NM_009210	19957987	20016610	25
chr3	20021969	20055015	Gyg	33046	-	NM_013755	20022576	20054890	8
chr3	20115514	20142080	Cpa3	26566	-	NM_007753	20115703	20142070	11
chr3	20122188	20122258	Mir7007	70	-	NR_105974	20122258	20122258	1
chr3	20149382	20174651	Cpb1	25269	-	NM_029706	20149549	20174572	11
chr3	20213394	20266099	Agtr1b	52705	-	NM_175086	20214282	20215362	2
chr3	21975573	22115516	Tbl1xr1	139943	+	NM_030732	22078169	22109349	16
chr3	22150291	22150529	Rprl2	238	+	NR_004439	22150529	22150529	1
chr3	25330762	26230831	Nlgn1	900069	-	NM_138666	25332559	26032656	8
chr3	26536552	26882134	Spata16	345582	+	NM_029150	26566253	26881964	11
chr3	26996143	27052800	Ect2	56657	-	NM_001177626	26997320	27049080	24
chr3	27052947	27055941	1700125G22Rik	2994	+	NR_040548	27055941	27055941	3
chr3	27081925	27143833	Nceh1	61908	+	NM_178772	27081999	27140740	5
chr3	27215998	27238587	Tnfsf10	22589	+	NM_009425	27216068	27234589	5
chr3	27270272	27276932	Ghsr	6660	+	NM_177330	27270718	27273844	3
chr3	27315083	27609361	Fndc3b	294278	-	NM_173182	27318212	27541983	26
chr3	27483821	27483917	Mir3092	96	-	NR_037275	27483917	27483917	1
chr3	27764986	27795290	Tmem212	30304	-	NM_001164437	27765114	27795265	4
chr3	27837601	28032284	Pld1	194683	+	NM_001164056	27923115	28030660	27
chr3	28162135	28569507	Tnik	407372	+	NM_026910	28162564	28566904	33
chr3	28318864	28318940	Mir466q	76	+	NR_130342	28318940	28318940	1
chr3	28596824	28627282	Slc2a2	30458	+	NM_031197	28596938	28626398	11
chr3	28680232	28697768	Eif5a2	17536	+	NM_177586	28680973	28693377	5
chr3	28704432	28706337	Rpl22l1	1905	+	NM_026517	28704456	28706253	4
chr3	28791538	28825646	Gm1527	34108	+	NM_001033479	28794514	28825627	15
chr3	28981498	29589978	Egfem1	608480	+	NM_029412	28981771	29589334	15
chr3	29315744	29315842	Mir551b	98	+	NR_030422	29315842	29315842	1
chr3	29535665	29535773	Mir21b	108	+	NR_105796	29535773	29535773	1
chr3	29789938	29823113	Mannr	33175	+	NR_110437	29823113	29823113	2
chr3	30135490	30408409	Mecom	272919	-	NM_021442	30136154	30408388	3
chr3	30495994	30498792	Actrt3	2798	-	NM_029690	30496755	30498771	2
chr3	30501008	30518795	Mynn	17787	+	NM_030557	30502456	30515735	8
chr3	30523188	30546740	Lrrc34	23552	-	NM_027941	30523620	30544226	11
chr3	30543428	30571353	Lrriq4	27925	+	NM_026668	30544251	30571215	8
chr3	30577475	30598765	Lrrc31	21290	-	NM_001309233	30577961	30598672	9
chr3	30645214	30666096	Samd7	20882	+	NM_029489	30649991	30664363	8
chr3	30691797	30720185	Sec62	28388	+	NM_027016	30692269	30717888	8
chr3	30754871	30796116	Gpr160	41245	+	NM_027965	30794702	30795713	4
chr3	30798216	30868337	Phc3	70121	-	NM_001165956	30806257	30868309	16
chr3	30894692	30951662	Prkci	56970	+	NM_008857	30894906	30949199	18
chr3	30937887	30937950	Mir7008	63	+	NR_105975	30937950	30937950	1
chr3	30993979	31021845	Skil	27866	+	NM_001271772	30996252	31017535	9
chr3	31048841	31063248	Cldn11	14407	+	NM_008770	31049071	31062230	3
chr3	31101777	31209241	Slc7a14	107464	-	NM_172861	31107997	31156791	8
chr3	31801624	32099102	Kcnmb2	297478	+	NM_028231	32055035	32097281	6
chr3	32233715	32264587	Zmat3	30872	-	NM_009517	32240405	32260081	6
chr3	32264410	32266360	4930429B21Rik	1950	+	NR_027966	32266360	32266360	1
chr3	32335072	32367408	Pik3ca	32336	+	NM_008839	32335127	32361753	20
chr3	32371242	32390891	Kcnmb3	19649	-	NM_001195074	32371242	32390891	4
chr3	32409471	32419755	Zfp639	10284	+	NM_001161818	32414216	32419607	7
chr3	32428403	32478147	Mfn1	49744	+	NM_024200	32430826	32476063	18
chr3	32482449	32515457	Gnb4	33008	-	NM_013531	32484041	32501023	10
chr3	32607467	32625893	Actl6a	18426	+	NM_019673	32607777	32625524	14
chr3	32626418	32635677	Mrpl47	9259	-	NM_029017	32626515	32635661	7
chr3	32635984	32650481	Ndufb5	14497	+	NM_025316	32636003	32650071	6
chr3	32716547	32834179	Usp13	117632	+	NM_001013024	32716632	32832155	21
chr3	32846847	33042113	Pex5l	195266	-	NM_001163516	32849590	33041791	13
chr3	32923698	32987529	4930419G24Rik	63831	+	NR_040595	32987529	32987529	8
chr3	33699104	33713782	Ttc14	14678	+	NM_027619	33699200	33708511	12
chr3	33711282	33743232	Ccdc39	31950	-	NM_026222	33711968	33743116	20
chr3	33919000	33968266	Fxr1	49266	+	NM_001113188	33919034	33968009	17
chr3	33956201	33980276	Dnajc19	24075	-	NM_001026211	33956842	33980110	6
chr3	34459302	34576915	Sox2ot	117613	+	NR_015580	34576915	34576915	5
chr3	34537385	34537464	Mir1897	79	+	NR_035433	34537464	34537464	1
chr3	34548916	34551382	Sox2	2466	+	NM_011443	34549337	34550297	1
chr3	34598561	34615584	Gm3143	17023	-	NR_038347	34615584	34615584	5
chr3	34670996	34681268	Gm38509	10272	+	NR_110488	34681268	34681268	2
chr3	34821466	34821573	Mir6378	107	-	NR_105799	34821573	34821573	1
chr3	35496073	35565085	Gm6639	69012	-	NR_040748	35565085	35565085	19
chr3	35653059	35755198	Atp11b	102139	+	NM_029570	35653305	35754108	30
chr3	35791026	35831888	Dcun1d1	40862	-	NM_001205361	35794541	35831709	7
chr3	35858230	35899600	Mccc1	41370	-	NM_023644	35858934	35899479	19
chr3	35898834	35907750	Mccc1os	8916	+	NR_029456	35907750	35907750	3
chr3	35906168	35952469	Ccdc144b	46301	-	NM_178418	35909581	35949632	12
chr3	35964921	35991779	Acad9	26858	+	NM_172678	35965030	35989853	18
chr3	36050001	36069263	D3Ertd254e	19262	+	NM_001101478	36050114	36065142	4
chr3	36078347	36121197	Qrfpr	42850	-	NM_198192	36078810	36121161	6
chr3	36347845	36374809	Anxa5	26964	-	NM_009673	36348265	36374354	13
chr3	36374382	36374446	Mir7009	64	-	NR_105976	36374446	36374446	1
chr3	36374858	36381221	1810062G17Rik	6363	+	NM_028183	36375056	36380898	3
chr3	36398725	36405731	Gm11548	7006	-	NR_040590	36405731	36405731	4
chr3	36413978	36420367	Gm11549	6389	-	NR_040411	36420367	36420367	3
chr3	36451527	36464649	Exosc9	13122	+	NM_019393	36451607	36464429	12
chr3	36463786	36470918	Ccna2	7132	-	NM_009828	36465155	36470745	8
chr3	36472064	36512311	Bbs7	40247	-	NM_027810	36472410	36512207	19
chr3	36519403	36589089	Trpc3	69686	-	NM_019510	36520176	36588901	12
chr3	36762027	36951955	4932438A13Rik	189928	+	NM_172679	36768949	36951462	86
chr3	36962577	37010434	Adad1	47857	+	NM_009350	36962644	37010389	12
chr3	37019641	37024876	Il2	5235	-	NM_008366	37020025	37024828	4
chr3	37121680	37131558	Il21	9878	-	NM_021782	37124258	37131487	5
chr3	37207548	37211368	Cetn4	3820	-	NM_145825	37208013	37211281	5
chr3	37211475	37220373	Bbs12	8898	+	NM_001008502	37217981	37220108	2
chr3	37247574	37303752	Fgf2	56178	+	NM_008006	37247771	37303719	3
chr3	37303903	37318518	Nudt6	14615	-	NM_001291044	37304018	37318492	5
chr3	37318871	37478018	Spata5	159147	+	NM_001310473	37319262	37428928	17
chr3	37508812	37514198	4930594O21Rik	5386	+	NR_130162	37514198	37514198	3
chr3	37538868	37543521	Spry1	4653	+	NM_011896	37541531	37542473	3
chr3	37613111	37623282	Gm5148	10171	-	NM_198657	37613526	37613991	3
chr3	37797734	37891650	Gm20755	93916	+	NR_040559	37891650	37891650	4
chr3	38102072	38107041	5430434I15Rik	4969	-	NR_040541	38107041	38107041	3
chr3	38348182	38383738	Ankrd50	35556	-	NM_001167883	38351338	38382124	4
chr3	38785861	38910905	Fat4	125044	+	NM_183221	38785881	38909764	17
chr3	40403786	40421834	1700017G19Rik	18048	-	NR_040445	40421834	40421834	6
chr3	40439688	40508696	Intu	69008	+	NM_175515	40439785	40505235	16
chr3	40512792	40530016	Slc25a31	17224	+	NM_178386	40512913	40528990	6
chr3	40549534	40594287	Hspa4l	44753	+	NM_011020	40549599	40593311	19
chr3	40603872	40620805	Plk4	16933	+	NM_173169	40604175	40620339	16
chr3	40622093	40650776	Mfsd8	28683	-	NM_028140	40623435	40650627	12
chr3	40650920	40679531	Gm2011	28611	+	NR_038067	40679531	40679531	6
chr3	40657397	40659207	Gm10731	1810	-	NR_045392	40659207	40659207	1
chr3	40698198	40740229	Abhd18	42031	+	NM_026622	40708823	40739315	13
chr3	40704120	40706465	1700034I23Rik	2345	-	NR_045380	40706465	40706465	1
chr3	40754552	40781715	Larp1b	27163	+	NM_001040399	40766108	40781149	10
chr3	40870247	40886968	Pgrmc2	16721	-	NM_027558	40872548	40886916	3
chr3	41291602	41297121	Platr4	5519	-	NR_040385	41297121	41297121	2
chr3	41304852	41332396	2400006E01Rik	27544	-	NR_130791	41332396	41332396	6
chr3	41359655	41420786	Jade1	61131	+	NM_001130184	41385142	41417925	11
chr3	41430626	41546436	Sclt1	115810	-	NM_001081411	41431093	41545950	21
chr3	41546536	41562863	D3Ertd751e	16327	+	NM_001291048	41550469	41562549	5
chr3	45084360	45182182	2610316D01Rik	97822	-	NR_045172	45182182	45182182	9
chr3	45182319	45238501	Pcdh10	56182	+	NM_001098170	45183174	45236466	5
chr3	45220505	45243231	1700027H10Rik	22726	-	NR_040594	45243231	45243231	4
chr3	46246118	46251863	Pabpc4l	5745	-	NM_001101479	46250016	46251129	2
chr3	46704589	46704704	Mir6379	115	-	NR_105800	46704704	46704704	1
chr3	47829933	47830681	Gm7977	748	-	NR_040408	47830681	47830681	1
chr3	48409652	48413022	1700018B24Rik	3370	-	NR_003617	48413022	48413022	1
chr3	49547217	49561238	Pcdh18	14021	-	NM_130448	49548528	49560786	4
chr3	50168857	50247535	Slc7a11	78678	-	NM_011990	50176223	50247183	12
chr3	51028368	51055576	Noct	27208	+	NM_009834	51029025	51054454	3
chr3	51056641	51144566	Elf2	87925	-	NM_023502	51060282	51127215	10
chr3	51080682	51082329	4930577N17Rik	1647	+	NR_073429	51082329	51082329	1
chr3	51192334	51200469	Mgarp	8135	-	NM_026358	51192673	51200430	4
chr3	51209400	51212877	Ndufc1	3477	-	NM_025523	51211274	51212852	4
chr3	51219937	51279907	Naa15	59970	+	NM_053089	51220244	51276722	20
chr3	51287887	51300134	Rab33b	12247	+	NM_016858	51288253	51297718	2
chr3	51319239	51364745	Setd7	45506	-	NM_080793	51325228	51364479	8
chr3	51363678	51371038	5031434O11Rik	7360	+	NR_033624	51371038	51371038	5
chr3	51465100	51486596	Mgst2	21496	+	NM_174995	51465170	51486508	5
chr3	51491534	51908928	Maml3	417394	-	NM_001004176	51493775	51908065	5
chr3	52072258	52154031	Foxo1	81773	+	NM_019739	52072723	52150298	3
chr3	52543645	52580576	Gm2447	36931	+	NR_038079	52580576	52580576	4
chr3	52710677	52731588	Gm20750	20911	-	NR_040555	52731588	52731588	5
chr3	52786044	52821145	Cog6	35101	-	NM_026225	52786965	52821120	19
chr3	52845468	53065601	Lhfp	220133	+	NM_175386	52847228	53064531	4
chr3	53255917	53267180	Nhlrc3	11263	-	NM_172501	53256318	53267065	7
chr3	53267738	53285677	Proser1	17939	+	NM_173382	53268196	53284556	13
chr3	53292714	53311574	Stoml3	18860	+	NM_153156	53292714	53311574	7
chr3	53317859	53461277	Frem2	143418	-	NM_172862	53320453	53461006	24
chr3	53657297	53667729	Ufm1	10432	-	NM_026435	53661849	53667672	6
chr3	53959978	54122393	Trpc4	162415	+	NM_001253682	53998604	54122078	12
chr3	54165028	54194963	Postn	29935	+	NM_001198765	54165064	54194221	22
chr3	54497026	54520759	Supt20	23733	+	NM_019995	54499126	54520573	20
chr3	54532600	54539286	Exosc8	6686	-	NM_027148	54532699	54538946	11
chr3	54539460	54553717	Alg5	14257	+	NM_025442	54539505	54553266	10
chr3	54559503	54605191	Smad9	45688	+	NM_019483	54586282	54601423	6
chr3	54607036	54611713	Rfxap	4677	-	NM_133231	54608386	54611597	3
chr3	54700990	54719809	Sertm1	18819	-	NM_177854	54703200	54703524	3
chr3	54849390	54858977	Ccna1	9587	-	NM_007628	54849578	54858419	9
chr3	54859163	54887924	4931419H13Rik	28761	+	NR_040593	54887924	54887924	8
chr3	54916029	54941254	Spg20	25225	+	NM_144895	54920907	54939602	9
chr3	54941260	54976858	Ccdc169	35598	+	NM_001290138	54954716	54975286	8
chr3	54985965	55013879	Sohlh2	27914	+	NM_028937	54985988	55012958	11
chr3	55046447	55342990	Dclk1	296543	+	NM_019978	55051072	55337656	17
chr3	55429119	55987623	Nbea	558504	-	NM_030595	55430825	55987157	58
chr3	55586431	55589209	Mab21l1	2778	+	NM_010750	55586915	55587995	1
chr3	55651026	55651987	4933417G07Rik	961	+	NR_033592	55651987	55651987	1
chr3	57090985	57105841	Tm4sf1	14856	-	NM_008536	57091677	57098710	7
chr3	57229331	57245597	Tm4sf4	16266	+	NM_145539	57229536	57245013	5
chr3	57259565	57379832	Wwtr1	120267	-	NM_001168281	57262847	57379802	7
chr3	57420530	57420644	Mir6377	114	+	NR_105797	57420644	57420644	1
chr3	57448270	57455606	Commd2	7336	-	NM_175095	57450600	57455575	5
chr3	57471343	57496459	Ankub1	25116	-	NM_001033349	57472332	57496268	4
chr3	57539983	57639347	Rnf13	99364	+	NR_130743	57639347	57639347	10
chr3	57645816	57651679	Pfn2	5863	-	NM_019410	57647138	57651404	3
chr3	57945628	57967729	1700007F19Rik	22101	-	NR_040538	57967729	57967729	6
chr3	58219610	58270709	Tsc22d2	51099	+	NM_001081229	58219610	58264190	4
chr3	58325892	58329806	Serp1	3914	-	NM_030685	58327749	58329415	3
chr3	58329742	58361423	Eif2a	31681	+	NM_001005509	58329980	58361108	14
chr3	58380579	58397466	Selt	16887	+	NM_001040396	58380658	58394213	6
chr3	58420221	58441129	Erich6	20908	-	NM_001081262	58420231	58441086	14
chr3	58455963	58457963	Gm8234	2000	+	NR_004433	58457963	58457963	1
chr3	58478870	58496310	Siah2	17440	-	NM_009174	58479807	58495737	2
chr3	58496510	58592446	4930593A02Rik	95936	+	NR_045167	58592446	58592446	8
chr3	58647949	58689134	Clrn1	41185	-	NM_153384	58650107	58688962	4
chr3	58810899	59122334	Med12l	311435	+	NM_177855	58810923	59118671	44
chr3	58900369	58905743	Gpr171	5374	-	NM_173398	58901314	58902274	2
chr3	58918544	58957414	P2ry14	38870	-	NM_001287119	58918942	58919959	3
chr3	58950217	58957550	F630111L10Rik	7333	-	NR_045641	58957550	58957550	1
chr3	58982835	58999026	Gpr87	16191	-	NM_001302203	58982927	58988341	3
chr3	59011813	59014804	P2ry13	2991	-	NM_028808	59013263	59014277	2
chr3	59020192	59066753	P2ry12	46561	-	NM_027571	59021130	59022174	4
chr3	59120656	59148178	Igsf10	27522	-	NM_001162884	59122387	59145254	7
chr3	59533707	59556319	Gm5538	22612	+	NM_001101531	59533740	59556255	5
chr3	59664972	59681235	Gm8298	16263	+	NM_001243003	59664972	59681235	5
chr3	59729135	59741871	C130079G13Rik	12736	+	NM_177661	59735580	59740651	6
chr3	59756230	59777516	Gm9696	21286	+	NR_037189	59777516	59777516	5
chr3	59810664	59829342	Aadacl2	18678	+	NM_001128091	59810899	59829193	5
chr3	59835709	59844079	Aadac	8370	+	NM_023383	59835728	59844001	5
chr3	59885790	59891488	Sucnr1	5698	+	NM_032400	59885847	59890928	2
chr3	60276751	60433672	Mbnl1	156921	+	NM_001253713	60399617	60429102	10
chr3	60806706	60812904	P2ry1	6198	+	NM_008772	60807363	60808485	2
chr3	61168428	61172625	Rap2b	4197	+	NM_028712	61168978	61169530	1
chr3	62142698	62266143	Arhgef26	123445	+	NM_001081295	62143418	62264268	14
chr3	62272563	62310910	Dhx36	38347	-	NM_028136	62274483	62310861	25
chr3	62333884	62409062	Gpr149	75178	-	NM_177346	62334457	62408498	4
chr3	63099356	63187635	Mme	88279	+	NM_001289462	63104056	63184254	23
chr3	63500155	63654913	Plch1	154758	-	NM_001177733	63503204	63654913	24
chr3	63718617	63733307	E130311K13Rik	14690	-	NM_177856	63719258	63733292	5
chr3	63746245	63768655	Slc33a1	22410	-	NM_001272035	63747170	63768112	7
chr3	63780064	63823000	Gmps	42936	+	NM_001033300	63780205	63820656	16
chr3	63885563	63909380	Vmn2r1	23817	+	NM_019918	63885563	63909380	6
chr3	63920353	63941402	Vmn2r2	21049	-	NM_001104592	63920353	63941393	5
chr3	64062882	64091339	Vmn2r3	28457	-	NM_001104614	64062882	64091333	6
chr3	64192542	64213979	Vmn2r4	21437	-	NM_001104615	64192542	64213970	5
chr3	64294742	64311607	Vmn2r5	16865	-	NM_001104618	64294742	64311598	5
chr3	64341482	64363740	Vmn2r6	22258	-	NM_001104619	64341482	64363731	5
chr3	64436784	64648665	Vmn2r-ps11	211881	-	NR_003962	64648665	64648665	9
chr3	64494581	64523524	Vmn2r7	28943	-	NM_175674	64494581	64523515	5
chr3	64913289	65182147	Kcnab1	268858	+	NM_010597	64913693	65180490	14
chr3	64936980	65106607	A330015K06Rik	169627	-	NR_126080	65106607	65106607	5
chr3	65127941	65153351	A730090N16Rik	25410	-	NR_040390	65153351	65153351	4
chr3	65183578	65196475	Ssr3	12897	-	NM_026155	65185889	65196459	5
chr3	65331406	65333336	4931440P22Rik	1930	-	NR_027955	65333336	65333336	2
chr3	65332368	65359440	Tiparp	27072	+	NM_178892	65335186	65357487	6
chr3	65463209	65463348	Mir8120	139	+	NR_106200	65463348	65463348	1
chr3	65470149	65635084	Lekr1	164935	+	NM_001166659	65473052	65635081	13
chr3	65750072	65762147	Ccnl1	12075	-	NM_019937	65750521	65762050	11
chr3	65857479	66100759	Veph1	243280	-	NM_145820	65861026	66067941	14
chr3	66023808	66029728	Ptx3	5920	+	NM_008987	66023983	66029127	3
chr3	66775644	66785693	Shox2	10049	-	NM_001302357	66777571	66785478	5
chr3	66789593	67162325	Rsrc1	372732	+	NM_025822	66798440	67160235	10
chr3	67178018	67203922	Mlf1	25904	+	NM_001039543	67178137	67203729	8
chr3	67234036	67278990	Gfm1	44954	+	NM_138591	67234160	67278772	18
chr3	67261920	67267829	Lxn	5909	-	NM_016753	67262150	67267636	6
chr3	67282807	67319445	Rarres1	36638	-	NM_001164763	67283258	67319337	6
chr3	67386689	67408153	Mfsd1	21464	+	NM_025813	67386739	67406620	16
chr3	67696141	67860515	Iqcj	164374	+	NM_177585	67696234	67859362	4
chr3	67696141	68430404	Gm21949	734263	+	NM_001113419	67696234	68429780	11
chr3	67868723	68430404	Schip1	561681	+	NM_001113421	67868863	68429780	8
chr3	68494565	68502472	Il12a	7907	+	NM_001159424	68494660	68501972	8
chr3	68673507	68676085	1110032F04Rik	2578	+	NM_001167996	68673629	68674373	1
chr3	68696420	68808492	Ift80	112072	-	NM_026641	68697992	68798459	20
chr3	68808893	68838545	Smc4	29652	+	NM_133786	68810002	68838448	24
chr3	68813693	68813757	Mir15b	64	+	NR_029529	68813757	68813757	1
chr3	68813823	68813918	Mir16-2	95	+	NR_029735	68813918	68813918	1
chr3	68839215	68848664	Trim59	9449	-	NM_025863	68840715	68841927	3
chr3	68876142	68931014	Kpna4	54872	-	NM_008467	68878010	68930722	17
chr3	68935154	68961099	Gm1647	25945	+	NR_126533	68961099	68961099	3
chr3	69026340	69027540	Arl14	1200	+	NM_027843	69026443	69027022	1
chr3	69120839	69359318	Ppm1l	238479	+	NM_178726	69121488	69357096	4
chr3	69377840	69402882	B3galnt1	25042	-	NM_020026	69378852	69379848	3
chr3	69525976	69552968	Nmd3	26992	+	NM_133787	69526344	69552824	16
chr3	69623460	69663816	Sptssb	40356	-	NM_001286959	69624652	69625024	4
chr3	69811534	69832630	Otol1	21096	+	NM_001018031	69822415	69832047	5
chr3	70576300	70611213	Gm6634	34913	-	NR_040556	70611213	70611213	4
chr3	72692481	72770788	Sis	78307	-	NM_001081137	72692911	72770788	47
chr3	72852046	72860865	Slitrk3	8819	-	NM_198864	72852416	72855359	2
chr3	72870272	73398752	Gm20754	528480	+	NR_040557	73398752	73398752	5
chr3	73155127	73285573	4930509J09Rik	130446	-	NR_040547	73285573	73285573	8
chr3	73439730	73512337	Bche	72607	-	NM_009738	73443838	73506013	4
chr3	73813140	73821199	Gm20356	8059	-	NR_040450	73821199	73821199	4
chr3	74841816	74947694	Zbbx	105878	-	NM_172515	74841884	74943532	17
chr3	75046278	75074000	Serpini2	27722	-	NM_026460	75046429	75071904	9
chr3	75320411	75360774	Pdcd10	40363	-	NM_019745	75321441	75345177	8
chr3	75361454	75446445	Serpini1	84991	+	NM_009250	75417019	75444673	9
chr3	75451362	75459653	Platr10	8291	-	NR_040539	75459653	75459653	3
chr3	75680104	75760871	Golim4	80767	-	NM_001291069	75681952	75760220	16
chr3	75878482	76513927	Fstl5	635445	+	NM_178673	75948886	76512099	16
chr3	78866432	78949797	Rapgef2	83365	-	NM_001099624	78868457	78949746	24
chr3	79016840	79057835	4921511C10Rik	40995	+	NR_045502	79057835	79057835	3
chr3	79149297	79268050	Gm17359	118753	+	NM_001142953	79149401	79267947	5
chr3	79259892	79371601	Fnip2	111709	-	NM_001162999	79263584	79371525	17
chr3	79395310	79407572	Ppid	12262	+	NM_026352	79395394	79407041	10
chr3	79407709	79432689	Etfdh	24980	-	NM_025794	79407923	79432473	13
chr3	79433000	79436741	4930579G24Rik	3741	+	NM_029482	79433098	79435206	2
chr3	79448637	79541716	Rxfp1	93079	-	NM_212452	79448637	79541716	18
chr3	79617074	79646584	Tmem144	29510	-	NM_027495	79617984	79643168	12
chr3	79689851	79750200	Fam198b	60349	+	NM_133187	79690148	79745424	4
chr3	80488857	80606713	Gria2	117856	-	NM_013540	80493027	80606306	16
chr3	80647520	80717582	Glrb	70062	-	NM_010298	80648885	80716011	10
chr3	80840337	81017953	Pdgfc	177616	+	NM_019971	80841358	81016500	6
chr3	81736537	81760647	Ctso	24110	+	NM_177662	81736586	81758182	8
chr3	81762335	81779650	Tdo2	17315	-	NM_019911	81762712	81779615	12
chr3	81800843	81825155	Asic5	24312	+	NM_021370	81800872	81825015	10
chr3	81835925	81878633	Gucy1b3	42708	-	NM_001161796	81837192	81878496	14
chr3	81896348	81949799	Gucy1a3	53451	-	NM_021896	81898616	81923067	9
chr3	81910168	81910231	Mir7010	63	-	NR_105977	81910231	81910231	1
chr3	82161993	82199190	Map9	37197	+	NM_001081230	82162971	82195172	14
chr3	82342304	82352007	Npy2r	9703	-	NM_001205099	82344242	82345388	3
chr3	82640444	82680405	Rbm46	39961	-	NM_001277170	82646399	82670558	6
chr3	82680626	82747560	Rbm46os	66934	+	NR_040382	82747560	82747560	4
chr3	82696503	82707896	Lrat	11393	-	NM_023624	82700894	82707634	2
chr3	82811645	82818978	Fgg	7333	+	NM_133862	82811829	82818771	10
chr3	82830074	82837539	Fga	7465	+	NM_001111048	82830136	82837332	6
chr3	82846167	82853785	Fgb	7618	-	NM_181849	82846324	82853683	8
chr3	82859459	82876213	Plrg1	16754	+	NM_016784	82859567	82876092	15
chr3	83359288	83378040	1700028M03Rik	18752	-	NR_036591	83378040	83378040	5
chr3	83570242	83578236	Sfrp2	7994	+	NM_009144	83570463	83577344	3
chr3	83640193	83645530	Tlr2	5337	-	NM_011905	83640341	83642696	3
chr3	83702208	83844083	D930015E06Rik	141875	-	NM_172681	83702262	83844022	35
chr3	83891855	83959708	Mnd1	67853	-	NM_029797	83891989	83959586	8
chr3	83964360	84108697	Trim2	144337	-	NM_001271726	83969018	84014228	12
chr3	83978559	83979115	Gm6525	556	+	NR_036654	83979115	83979115	1
chr3	84153297	84183843	4930565D16Rik	30546	-	NR_040752	84183843	84183843	4
chr3	84246117	84284361	Fhdc1	38244	-	NM_001033301	84248388	84278562	12
chr3	84300014	84386547	Arfip1	86533	-	NM_001081093	84301657	84351948	9
chr3	84397495	84400954	Tigd4	3459	+	NM_207278	84397699	84399241	1
chr3	84470113	84508497	Tmem154	38384	+	NM_177260	84470273	84505861	7
chr3	84619498	84783120	Fbxw7	163622	+	NM_001177773	84707491	84781463	14
chr3	84768977	84769502	Dear1	525	-	NM_001040461	84769009	84769285	1
chr3	85121440	85135949	1700036G14Rik	14509	+	NR_040542	85135949	85135949	3
chr3	85271298	85271420	Mir466k	122	+	NR_130326	85271420	85271420	1
chr3	85378050	85458392	Gatb	80342	+	NM_144896	85378065	85457774	13
chr3	85463984	85550131	Fam160a1	86147	-	NM_172682	85464886	85545177	12
chr3	85673767	85691440	Glt28d2	17673	-	NM_177130	85675588	85676086	2
chr3	85797731	85806413	Prss48	8682	-	NM_001001650	85797741	85806413	6
chr3	85888355	85934443	Sh3d19	46088	+	NM_001082414	85888588	85930633	15
chr3	85941861	85946590	Rps3a1	4729	-	NM_016959	85941910	85946491	6
chr3	85942712	85942780	Snord73a	68	-	NR_004417	85942780	85942780	1
chr3	85944538	85944609	Rnu73b	71	-	NR_004418	85944609	85944609	1
chr3	86028611	86586616	Lrba	558005	+	NM_030695	86029210	86585583	57
chr3	86349502	86352205	Mab21l2	2703	-	NM_011839	86350533	86351613	1
chr3	86590071	86724806	Dclk2	134735	-	NM_001195498	86591317	86724092	18
chr3	86790507	86793454	Cd1d2	2947	+	NM_007640	86790566	86793279	6
chr3	86799757	86803262	Cd1d1	3505	-	NM_007639	86800501	86803174	6
chr3	86882513	86978669	Kirrel	96156	-	NM_001170985	86887065	86945031	16
chr3	87054886	87067446	Fcrls	12560	-	NM_030707	87055298	87067397	8
chr3	87161802	87174996	Cd5l	13194	+	NM_009690	87161923	87174139	6
chr3	87180308	87206856	Fcrl1	26548	+	NM_001310545	87180416	87205151	11
chr3	87239703	87304600	Fcrl5	64897	+	NM_001113238	87239806	87261758	12
chr3	87329499	87344080	Etv3	14581	+	NM_001083318	87331192	87340574	5
chr3	87422672	87541955	Arhgef11	119283	+	NM_001003912	87422682	87541024	40
chr3	87540844	87552545	Lrrc71	11701	-	NM_028971	87542996	87552386	15
chr3	87553018	87572875	Pear1	19857	-	NM_001289601	87554067	87561068	25
chr3	87582165	87599084	Ntrk1	16919	-	NM_001033124	87582335	87599066	17
chr3	87600872	87620023	Insrr	19151	+	NM_011832	87601345	87619297	22
chr3	87650676	87659644	Sh2d2a	8968	+	NM_021309	87650995	87656330	7
chr3	87662824	87689484	Prcc	26660	-	NM_033573	87663181	87689264	7
chr3	87710242	87720054	Hdgf	9812	+	NM_008231	87710549	87718830	6
chr3	87723465	87727355	Mrpl24	3890	+	NM_026591	87725787	87727268	6
chr3	87726522	87734117	Rrnad1	7595	-	NM_153562	87727712	87733888	8
chr3	87734235	87744608	Isg20l2	10373	+	NM_177663	87735405	87743273	4
chr3	87752614	87757294	Crabp2	4680	+	NM_007759	87752762	87756959	4
chr3	87775014	87784373	Nes	9359	+	NM_016701	87775124	87783952	4
chr3	87791452	87804278	Bcan	12826	-	NM_007529	87791793	87801757	14
chr3	87825671	87831433	Hapln2	5762	-	NM_022031	87826463	87828339	7
chr3	87847027	87859916	Gpatch4	12889	+	NM_025663	87855132	87859651	9
chr3	87860444	87862417	Apoa1bp	1973	-	NM_144897	87860495	87862412	6
chr3	87873331	87882226	Ttc24	8895	-	NM_172526	87873948	87878845	10
chr3	87885972	87924970	Iqgap3	38998	+	NM_001033484	87885977	87924198	38
chr3	87946293	87976013	Mef2d	29720	+	NM_001310587	87959730	87972565	12
chr3	87975481	87981707	1700113A16Rik	6226	-	NR_045997	87981707	87981707	3
chr3	88019092	88019179	Mir3093	87	+	NR_037276	88019179	88019179	1
chr3	88019519	88019608	Mir9-1	89	+	NR_029817	88019608	88019608	1
chr3	88046795	88058606	Rhbg	11811	-	NM_021375	88047301	88058568	10
chr3	88086681	88100760	Tsacc	14079	-	NM_029801	88086688	88099349	4
chr3	88101056	88125688	Cct3	24632	+	NM_009836	88101157	88125470	14
chr3	88128944	88132553	Glmp	3609	+	NM_020003	88129003	88132290	6
chr3	88132574	88138355	Tmem79	5781	-	NM_024246	88133640	88137561	4
chr3	88140181	88166259	Smg5	26078	+	NM_178246	88140345	88165030	22
chr3	88168510	88172463	Paqr6	3953	+	NM_198410	88168974	88171885	8
chr3	88172537	88176663	Bglap3	4126	-	NM_001305448	88172677	88173458	7
chr3	88181657	88182623	Bglap2	966	-	NM_001032298	88181791	88182572	4
chr3	88187416	88188388	Bglap	972	-	NM_007541	88187556	88188337	4
chr3	88198059	88214319	Pmf1	16260	-	NM_025928	88198438	88214229	5
chr3	88214415	88229063	Slc25a44	14648	-	NM_001145876	88216627	88225047	4
chr3	88239883	88265104	Sema4a	25221	-	NM_001163489	88240581	88258739	15
chr3	88244800	88244873	Mir7011	73	-	NR_105978	88244873	88244873	1
chr3	88285069	88307274	Lmna	22205	-	NM_001002011	88285995	88307025	12
chr3	88336316	88345316	Mex3a	9000	+	NM_001029890	88336316	88341103	2
chr3	88340222	88340304	Mir1905	82	-	NR_035434	88340304	88340304	1
chr3	88345950	88352201	Rab25	6251	-	NM_016899	88346164	88351997	5
chr3	88353740	88356849	Lamtor2	3109	-	NM_031248	88353869	88356785	4
chr3	88357637	88373647	Ubqln4	16010	+	NM_033526	88357726	88372155	11
chr3	88383592	88392335	Ssr2	8743	+	NM_025448	88383801	88391913	5
chr3	88420128	88451974	Arhgef2	31846	+	NM_001198911	88420558	88450785	23
chr3	88455819	88457064	Rxfp4	1245	-	NM_181817	88455819	88457064	1
chr3	88489715	88516855	2810403A07Rik	27140	+	NM_028814	88489771	88515751	14
chr3	88520775	88534970	Rit1	14195	+	NR_028056	88534970	88534970	6
chr3	88548622	88576521	Syt11	27899	-	NM_018804	88551621	88576246	4
chr3	88580978	88633293	5830417I10Rik	52315	+	NR_028359	88633293	88633293	18
chr3	88625931	88636409	1500004A13Rik	10478	-	NR_015498	88636409	88636409	2
chr3	88639152	88714021	Gon4l	74869	+	NM_001242372	88640937	88713309	33
chr3	88713537	88717872	Msto1	4335	-	NM_144898	88713617	88717798	14
chr3	88724724	88754204	Dap3	29480	-	NM_022994	88727749	88753792	13
chr3	88769733	88883297	Ash1l	113564	+	NM_138679	88769833	88881004	27
chr3	88887900	88897285	Rusc1	9385	-	NM_028188	88888403	88896395	11
chr3	88897509	88905889	Fdps	8380	-	NM_001253751	88897564	88905021	11
chr3	88940063	88950516	Pklr	10453	+	NM_013631	88940104	88949495	11
chr3	88950696	88964079	Hcn3	13383	-	NM_008227	88951520	88963981	8
chr3	88968716	88981009	Clk2	12293	+	NM_007712	88970956	88980501	13
chr3	88968716	88986692	Clk2-scamp3	17976	+	NM_001310016	88970956	88986367	20
chr3	88981312	88986692	Scamp3	5380	+	NM_011886	88981513	88986367	9
chr3	88987146	88993211	Fam189b	6065	+	NM_001014995	88987645	88992661	12
chr3	89006846	89012888	Gba	6042	+	NM_008094	89007408	89012544	12
chr3	89013002	89018257	Mtx1	5255	-	NM_013604	89013128	89018247	8
chr3	89019108	89030759	Thbs3	11651	+	NM_013691	89019167	89030506	23
chr3	89031037	89031120	Mir92b	83	-	NR_030579	89031120	89031120	1
chr3	89032977	89037303	Muc1	4326	+	NM_013605	89033041	89037020	7
chr3	89038098	89049819	Trim46	11721	-	NM_183037	89038820	89049699	10
chr3	89050359	89053651	Krtcap2	3292	+	NM_025327	89050433	89053613	5
chr3	89070382	89071001	Dpm3	619	+	NM_026767	89070655	89070934	2
chr3	89072167	89074492	Slc50a1	2325	-	NM_009057	89072418	89074387	6
chr3	89075651	89084873	Efna1	9222	-	NM_001162425	89076413	89080250	5
chr3	89118872	89126801	Efna3	7929	-	NM_010108	89119358	89126755	5
chr3	89137314	89141950	Efna4	4636	-	NM_007910	89138211	89141872	4
chr3	89143561	89153932	Adam15	10371	-	NM_001037722	89143832	89153809	23
chr3	89154140	89169175	Dcst1	15035	-	NM_029974	89154184	89169076	16
chr3	89181567	89197125	Zbtb7b	15558	-	NM_009565	89183447	89185431	3
chr3	89195785	89202701	Gm15417	6916	+	NR_040403	89202701	89202701	2
chr3	89205817	89206572	Lenep	755	-	NM_020517	89206375	89206561	2
chr3	89206594	89215785	Flad1	9191	-	NM_177041	89207087	89215166	8
chr3	89219393	89222213	Cks1b	2820	-	NM_016904	89219832	89222135	3
chr3	89222472	89233951	Shc1	11479	+	NM_011368	89226102	89232367	13
chr3	89234135	89239052	Pygo2	4917	+	NM_001293768	89234548	89237436	3
chr3	89240625	89254874	Pbxip1	14249	+	NM_146131	89243472	89252688	11
chr3	89258462	89272931	Pmvk	14469	+	NM_001310640	89268283	89272572	4
chr3	89324085	89476416	Kcnn3	152331	+	NM_080466	89324390	89471303	8
chr3	89518943	89557377	Adar	38434	+	NM_001038587	89539479	89555097	15
chr3	89557369	89568554	Chrnb2	11185	-	NM_009602	89561021	89568328	6
chr3	89571432	89577322	4632404H12Rik	5890	-	NR_130957	89577322	89577322	2
chr3	89577530	89587919	Ube2q1	10389	+	NM_027315	89577633	89586210	13
chr3	89635291	89662768	She	27477	+	NM_172530	89635425	89658636	6
chr3	89673245	89717118	Il6ra	43873	-	NM_001310676	89675082	89716961	10
chr3	89743402	89767254	Atp8b2	23852	-	NM_001081182	89745074	89765027	28
chr3	89799367	89802638	Hax1	3271	-	NM_011826	89799546	89802502	7
chr3	89802681	89805247	Gm19710	2566	+	NR_045749	89805247	89805247	4
chr3	89803510	89856397	Ubap2l	52887	-	NM_028475	89804136	89851781	29
chr3	89815074	89815132	Mir7669	58	-	NR_106129	89815132	89815132	1
chr3	89855557	89867263	4933434E20Rik	11706	+	NM_001287087	89856975	89865755	9
chr3	89866717	89872269	1700094D03Rik	5552	+	NM_028567	89866757	89869533	4
chr3	89873941	89874021	Mir190b	80	+	NR_030543	89874021	89874021	1
chr3	89876572	89904824	Tpm3	28252	+	NM_022314	89876655	89903532	9
chr3	89908053	90015939	Nup210l	107886	+	NM_029937	89908088	90015939	40
chr3	90016588	90017569	Rps27rt	981	-	NM_001190258	90016646	90017537	4
chr3	90016588	90017570	Rps27	982	-	NM_027015	90016646	90017537	4
chr3	90017636	90030309	Rab13	12673	+	NM_001293741	90027506	90029505	8
chr3	90035518	90039762	Jtb	4244	+	NM_206924	90035879	90039461	5
chr3	90041419	90047434	Creb3l4	6015	-	NM_030080	90041652	90046754	10
chr3	90052113	90057534	Slc39a1	5421	+	NM_013901	90052898	90056264	4
chr3	90058202	90068047	Crtc2	9845	+	NM_028881	90058327	90067622	14
chr3	90070435	90084587	Dennd4b	14152	+	NM_201407	90070578	90083844	28
chr3	90074070	90074134	Mir7012	64	+	NR_105979	90074134	90074134	1
chr3	90145575	90162042	Gatad2b	16467	+	NM_139304	90145578	90161924	10
chr3	90189154	90193860	Slc27a3	4706	-	NM_001316688	90189278	90193303	10
chr3	90195301	90237558	Ints3	42257	-	NM_178876	90195949	90236872	31
chr3	90254513	90269788	Npr1	15275	-	NM_008727	90255041	90269425	22
chr3	90280122	90292301	Ilf2	12179	+	NM_026374	90280162	90291541	14
chr3	90291947	90294935	Snapin	2988	-	NM_133854	90293413	90294896	4
chr3	90302460	90313420	Chtop	10960	-	NM_001293782	90303823	90310173	6
chr3	90314955	90318252	S100a1	3297	-	NM_011309	90315142	90316058	3
chr3	90318356	90328503	S100a13	10147	+	NM_009113	90318795	90328418	4
chr3	90330770	90332757	S100a14	1987	+	NM_025393	90331185	90332137	4
chr3	90345144	90347073	S100a16	1929	+	NM_026416	90345941	90346508	3
chr3	90394168	90395430	S100a2	1262	+	NM_001195760	90394168	90395430	2
chr3	90404136	90406624	S100a3	2488	+	NM_011310	90405706	90406277	3
chr3	90407691	90409967	S100a4	2276	+	NM_011311	90408933	90409826	3
chr3	90412443	90415702	S100a5	3259	+	NM_011312	90413745	90415576	3
chr3	90416815	90418336	S100a6	1521	+	NM_011313	90417688	90418244	3
chr3	90458223	90462052	S100a7a	3829	+	NM_199422	90459429	90461748	3
chr3	90472992	90473956	S100a8	964	+	NM_013650	90473463	90473889	3
chr3	90496551	90499643	S100a9	3092	-	NM_001281852	90496667	90499207	3
chr3	90530827	90545439	Pglyrp4	14612	+	NM_001165968	90530873	90544384	8
chr3	90875583	90879114	4930529C04Rik	3531	+	NR_033593	90879114	90879114	1
chr3	90892058	90894727	9130204L05Rik	2669	-	NM_001101461	90892236	90894328	3
chr3	91818504	91835506	Pglyrp3	17002	+	NM_207247	91818548	91835485	7
chr3	91884192	91887064	Lor	2872	-	NM_008508	91884438	91885899	2
chr3	91926125	91927869	Prr9	1744	-	NM_175424	91926902	91927253	2
chr3	91938915	91946676	Lelp1	7761	-	NM_027042	91939299	91939662	2
chr3	92054568	92061226	Sprr2a1	6658	+	NM_011468	92057826	92058078	2
chr3	92054568	92061226	Sprr2a2	6658	+	NM_001164787	92057826	92058078	2
chr3	92089225	92093186	Sprr2a3	3961	+	NM_001309382	92092509	92092761	2
chr3	92120626	92122007	Sprr2b	1381	+	NM_011469	92121370	92121667	2
chr3	92143061	92144795	Sprr2d	1734	+	NM_011470	92144175	92144433	2
chr3	92156064	92157371	Sprr2e	1307	+	NM_011471	92156785	92157016	2
chr3	92169108	92170364	Sprr2f	1256	+	NM_011472	92169817	92170048	2
chr3	92177836	92179151	Sprr2g	1315	+	NR_003548	92179151	92179151	2
chr3	92189606	92191241	Sprr2h	1635	+	NM_011474	92190553	92190880	2
chr3	92211912	92213193	Sprr2i	1281	+	NM_011475	92212637	92212868	2
chr3	92222008	92223318	Sprr2j-ps	1310	+	NR_003185	92223318	92223318	2
chr3	92236503	92237849	Sprr2k	1346	+	NM_011477	92237266	92237473	2
chr3	92240730	92242701	Sprr1b	1971	-	NM_009265	92241027	92241489	2
chr3	92260423	92262642	Sprr3	2219	-	NM_011478	92260740	92261457	2
chr3	92287875	92289803	Sprr1a	1928	-	NM_009264	92288179	92288614	2
chr3	92304184	92304415	Sprr4	231	-	NM_173070	92304184	92304415	1
chr3	92374821	92377657	Ivl	2836	-	NM_008412	92375271	92376678	2
chr3	92387787	92392946	Smcp	5159	-	NM_008574	92388028	92392892	2
chr3	92424006	92425582	Lce6a	1576	-	NM_001166172	92424174	92424420	3
chr3	92450453	92452229	Lce1a1	1776	-	NM_025984	92450655	92451087	2
chr3	92459571	92460848	Lce1b	1277	-	NM_026822	92459732	92460146	2
chr3	92472534	92474237	Lce1a2	1703	-	NM_028625	92472725	92473175	2
chr3	92483168	92484840	Lce1c	1672	+	NM_028622	92484189	92484633	2
chr3	92489420	92491132	Lce1d	1712	-	NM_027137	92489624	92490026	2
chr3	92511321	92512996	Lce1e	1675	-	NM_026811	92511528	92511960	2
chr3	92522617	92524272	Lce1f	1655	-	NM_026394	92522826	92523270	2
chr3	92554072	92556260	Lce1g	2188	-	NM_025413	92554501	92554921	2
chr3	92567136	92568987	Lce1h	1851	-	NM_026335	92567342	92567765	2
chr3	92581131	92582821	Lce1i	1690	-	NM_029667	92581339	92581789	2
chr3	92592765	92594436	Lce1j	1671	-	NM_001281499	92592971	92593391	2
chr3	92610212	92611813	Lce1k	1601	-	NM_001254760	92610419	92610797	2
chr3	92626995	92631169	Kprp	4174	-	NM_028629	92627689	92629663	2
chr3	92653870	92655208	Lce1l	1338	-	NM_028628	92654063	92654471	2
chr3	92672280	92674127	2310050C09Rik	1847	-	NM_025621	92672453	92673296	2
chr3	92729208	92730152	Lce3a	944	-	NM_001039594	92729416	92729713	2
chr3	92736900	92738018	Lce3b	1118	+	NM_025501	92737521	92737818	2
chr3	92748407	92749652	Lce3c	1245	+	NM_033175	92749155	92749452	2
chr3	92761311	92762496	Lce3d	1185	+	NM_001270426	92762001	92762298	2
chr3	92770982	92772203	Lce3e	1221	+	NM_001254725	92771660	92771957	2
chr3	92796147	92797348	Lce3f	1201	+	NM_001018079	92796795	92797092	2
chr3	92818126	92819608	Crct1	1482	-	NM_028798	92818441	92818750	2
chr3	92821728	92822982	Lce1m	1254	-	NM_025420	92822001	92822550	2
chr3	92872744	92879427	Gm4858	6683	+	NM_001034860	92877488	92878555	3
chr3	92948708	92953393	Crnn	4685	+	NM_001081200	92950733	92953393	3
chr3	93001194	93025298	Flg2	24104	+	NM_001013804	93004131	93024715	8
chr3	93123670	93137494	Hrnr	13824	+	NM_133698	93124498	93136614	4
chr3	93197620	93203364	Rptn	5744	+	NM_009100	93198900	93202640	3
chr3	93246251	93252999	Tchh	6748	+	NM_001163098	93246251	93251976	2
chr3	93272675	93275902	Tchhl1	3227	+	NM_027762	93273419	93275829	3
chr3	93324417	93330210	S100a11	5793	+	NM_016740	93327980	93330069	3
chr3	93359038	93368567	S100a10	9529	+	NM_009112	93364885	93368326	3
chr3	93455463	93456608	Tdpoz2	1145	-	NM_001007222	93455502	93456585	1
chr3	93473254	93480205	Tdpoz1	6951	-	NM_148949	93474299	93475397	2
chr3	93600319	93601432	Tdpoz4	1113	+	NM_207272	93600319	93601432	1
chr3	93629941	93631039	Tdpoz3	1098	+	NM_207271	93629941	93631039	1
chr3	93740554	93747465	Gm9125	6911	-	NM_001163730	93741595	93742693	2
chr3	93764213	93765236	Gm10697	1023	-	NM_001163731	93764213	93765236	1
chr3	93764213	93765236	Tdpoz5	1023	-	NM_207273	93764213	93765236	1
chr3	93978333	93982115	Gm10696	3782	-	NM_001146107	93979350	93980424	2
chr3	94114053	94136454	Them4	22401	+	NM_029431	94114138	94135502	6
chr3	94146020	94151274	Them5	5254	+	NM_025416	94146180	94150930	6
chr3	94166365	94168489	C2cd4d	2124	+	NM_001136117	94167350	94168376	2
chr3	94176715	94202196	Rorc	25481	+	NM_011281	94176813	94201275	11
chr3	94203140	94208423	Lingo4	5283	+	NM_177250	94203338	94207535	2
chr3	94217239	94235421	Tdrkh	18182	+	NM_028307	94226749	94234531	13
chr3	94237309	94240573	Oaz3	3264	-	NM_016901	94237428	94240476	5
chr3	94247257	94252630	Mrpl9	5373	+	NM_030116	94247272	94251842	7
chr3	94268906	94277513	Riiad1	8607	-	NM_025506	94269734	94277236	7
chr3	94282216	94296120	Celf3	13904	+	NM_001289616	94288738	94293520	14
chr3	94301463	94386638	Snx27	85175	-	NM_001082484	94305145	94386471	12
chr3	94416674	94462794	Tuft1	46120	-	NM_011656	94418049	94462706	13
chr3	94464510	94471074	BC021767	6564	-	NR_033629	94471074	94471074	8
chr3	94497494	94508328	Selenbp2	10834	+	NM_019414	94497580	94508138	12
chr3	94563990	94590437	Cgn	26447	-	NM_001293727	94565281	94583912	21
chr3	94641488	94687489	Pogz	46001	+	NM_001165948	94657872	94684254	19
chr3	94688245	94690880	Psmb4	2635	-	NM_008945	94688349	94690830	7
chr3	94737004	94748680	Selenbp1	11676	+	NM_009150	94737080	94748490	12
chr3	94758936	94765483	Rfx5	6547	+	NM_017395	94758955	94763290	9
chr3	94778652	94810859	Pi4kb	32207	+	NM_001293715	94787932	94809862	12
chr3	94808089	94808161	Mir7013	72	+	NR_105980	94808161	94808161	1
chr3	94810623	94819160	Zfp687	8537	-	NM_030074	94811396	94816381	9
chr3	94836612	94846536	Psmd4	9924	-	NM_008951	94836735	94846455	10
chr3	94862451	94910852	Pip5k1a	48401	-	NM_008847	94864004	94910373	15
chr3	94914963	94926973	Vps72	12010	+	NM_009336	94915019	94926700	6
chr3	94928435	94933130	Tmod4	4695	+	NM_016712	94929476	94933032	10
chr3	94933640	94937934	Scnm1	4294	-	NM_027013	94934114	94937817	7
chr3	94938009	94943447	Lysmd1	5438	+	NM_153121	94938738	94942456	3
chr3	94942981	94943108	Mir8099-1	127	-	NR_106175	94943108	94943108	1
chr3	94942981	94943108	Mir8099-2	127	-	NR_106201	94943108	94943108	1
chr3	94943442	94946282	Tnfaip8l2	2840	-	NM_027206	94943917	94944472	2
chr3	94964341	94977972	Sema6c	13631	+	NM_001272024	94968314	94977210	21
chr3	94985689	95021864	Gabpb2	36175	-	NM_029885	94992591	95010492	10
chr3	95021378	95030580	Gm16740	9202	+	NR_108026	95030580	95030580	4
chr3	95022465	95032599	Mllt11	10134	-	NM_019914	95024106	95024379	2
chr3	95032345	95040346	Cdc42se1	8001	+	NM_172395	95035960	95037487	5
chr3	95040841	95045031	Gm128	4190	-	NM_001024841	95041130	95044903	2
chr3	95045214	95055115	Bnipl	9901	-	NM_134253	95045746	95054930	10
chr3	95057595	95085998	Prune	28403	-	NM_173347	95058917	95085545	8
chr3	95086856	95100086	Fam63a	13230	+	NM_199475	95091869	95099653	10
chr3	95100015	95111098	Anxa9	11083	-	NM_023628	95100711	95110328	13
chr3	95119173	95127490	Cers2	8317	+	NM_029789	95123984	95126711	11
chr3	95127446	95161124	Setdb1	33678	-	NM_001163641	95127994	95160115	22
chr3	95190379	95206763	4930558C23Rik	16384	-	NR_015490	95206763	95206763	2
chr3	95231270	95235007	Gm4349	3737	+	NR_033637	95235007	95235007	3
chr3	95238311	95301161	Arnt	62850	+	NM_001037737	95238458	95299315	22
chr3	95303131	95313309	Ctsk	10178	+	NM_007802	95304756	95312844	8
chr3	95330707	95360327	Ctss	29620	+	NM_021281	95330821	95360107	8
chr3	95363598	95391782	Hormad1	28184	+	NM_001289534	95365166	95389480	16
chr3	95392855	95423169	Golph3l	30314	+	NM_001177670	95392888	95421824	6
chr3	95428901	95436039	Ensa	7138	+	NM_019561	95429041	95435369	4
chr3	95462642	95467101	Mcl1	4459	+	NM_008562	95462778	95464746	4
chr3	95480124	95491840	Adamtsl4	11716	-	NM_144899	95480755	95489398	18
chr3	95538070	95543492	Ecm1	5422	-	NM_001252653	95538162	95543365	11
chr3	95538833	95538896	Mir7014	63	-	NR_105981	95538896	95538896	1
chr3	95543896	95558900	Tars2	15004	-	NM_027931	95544093	95558761	18
chr3	95563795	95622876	Rprd2	59081	-	NM_001081293	95567602	95622674	11
chr3	95634544	95659805	Prpf3	25261	-	NM_001316751	95634741	95657511	16
chr3	95666574	95674542	Mrps21	7968	-	NM_078479	95666674	95674499	2
chr3	95675444	95693016	C920021L13Rik	17572	+	NR_040446	95693016	95693016	4
chr3	95682427	95686151	Ciart	3724	-	NM_001033302	95682556	95685448	6
chr3	95688895	95695853	BC028528	6958	-	NM_153513	95688895	95695853	5
chr3	95697843	95702515	Aph1a	4672	+	NM_146134	95698093	95700681	7
chr3	95701722	95708562	Car14	6840	-	NM_011797	95702068	95708297	11
chr3	95733179	95751310	Anp32e	18131	+	NM_023210	95733519	95749173	7
chr3	95789432	95790890	Gm9054	1458	+	NR_045872	95790890	95790890	3
chr3	95792762	95799762	Plekho1	7000	-	NM_023320	95792851	95799720	6
chr3	95803754	95862378	Vps45	58624	-	NM_013841	95803986	95861697	15
chr3	95908449	95965052	Otud7b	56603	+	NM_001025613	95940462	95959891	13
chr3	95965892	95975641	Mtmr11	9749	+	NM_181409	95966115	95975155	17
chr3	95976428	95981487	Sf3b4	5059	+	NM_153053	95976496	95981089	6
chr3	95985149	95999103	Sv2a	13954	+	NM_022030	95988908	95997839	13
chr3	96000510	96001509	Bola1	999	-	NM_026975	96000785	96001199	2
chr3	96023838	96024276	Hist2h2ab	438	+	NM_178213	96023838	96024231	1
chr3	96024335	96024803	Hist2h2ac	468	-	NM_175662	96024377	96024767	1
chr3	96024994	96027661	Hist2h2be	2667	+	NM_178214	96025088	96025469	1
chr3	96043701	96044257	Hist2h2aa1	556	-	NM_013549	96043780	96044173	1
chr3	96043701	96044297	Hist2h2aa2	596	-	NM_178212	96043780	96044173	1
chr3	96050607	96051271	Hist2h3c1	664	+	NM_178216	96050808	96051219	1
chr3	96050622	96051271	Hist2h3c2	649	+	NM_054045	96050808	96051219	1
chr3	96066856	96067240	Hist2h4	384	-	NM_033596	96066915	96067227	1
chr3	96072576	96073078	Hist2h3b	502	+	NM_178215	96072616	96073027	1
chr3	96073622	96074115	Hist2h2bb	493	+	NM_175666	96073674	96074055	1
chr3	96086831	96097892	Fcgr1	11061	-	NM_010186	96088198	96097885	6
chr3	96218359	96218756	Terc	397	-	NR_001579	96218756	96218756	1
chr3	96237710	96256229	BC107364	18519	-	NM_001256180	96238299	96246074	5
chr3	96329107	96333139	Hfe2	4032	+	NM_027126	96330437	96332613	4
chr3	96359690	96370724	Gm15441	11034	-	NR_040409	96370724	96370724	4
chr3	96361879	96365780	Txnip	3901	+	NM_001009935	96362158	96364452	8
chr3	96381794	96398104	Polr3gl	16310	-	NM_027241	96382424	96386136	8
chr3	96400558	96403701	Ankrd34a	3143	+	NM_001024851	96401404	96402892	2
chr3	96405055	96429275	Lix1l	24220	+	NM_001163170	96405104	96427829	6
chr3	96410584	96433742	6330549D23Rik	23158	-	NR_003619	96433742	96433742	2
chr3	96433850	96437714	Rbm8a	3864	+	NM_001102407	96433884	96435657	6
chr3	96439279	96449304	Pex11b	10025	+	NR_027845	96449304	96449304	4
chr3	96449506	96468442	Itga10	18936	+	NM_001302471	96449557	96466953	30
chr3	96474053	96494957	Ankrd35	20904	+	NM_001081139	96474333	96494174	13
chr3	96500297	96509993	Pias3	9696	+	NM_146135	96503345	96509038	14
chr3	96509814	96512483	Nudt17	2669	-	NM_030094	96510291	96512442	8
chr3	96515817	96531362	Polr3c	15545	-	NM_028925	96515901	96529903	15
chr3	96531533	96595078	Rnf115	63545	+	NM_026406	96531731	96593929	9
chr3	96602685	96633274	Cd160	30589	-	NM_001163496	96604525	96612795	5
chr3	96633748	96635993	4930442L01Rik	2245	-	NR_015596	96635993	96635993	2
chr3	96633987	96674849	Pdzk1	40862	+	NM_021517	96654152	96674086	9
chr3	96674988	96709221	Gpr89	34233	-	NM_026229	96675310	96709146	14
chr3	96717488	96729974	Gja8	12486	-	NM_008123	96722944	96724267	2
chr3	96836324	96857557	Gja5	21233	+	NM_001271628	96854551	96855628	3
chr3	96962699	96980499	Acp6	17800	+	NM_019800	96963090	96980391	10
chr3	97007584	97031287	Bcl9	23703	-	NM_029933	97008782	97020288	10
chr3	97214139	97215102	Olfr1402	963	-	NM_146275	97214139	97215102	1
chr3	97364670	97414113	Chd1l	49443	-	NM_026539	97364937	97414094	23
chr3	97432726	97459210	Fmo5	26484	+	NM_001161763	97432983	97455750	9
chr3	97462134	97476990	Prkab2	14856	+	NM_182997	97462536	97473728	8
chr3	97493750	97692630	Pde4dip	198880	-	NM_001289701	97494734	97692593	47
chr3	97494431	97494485	Mir7225	54	-	NR_106084	97494485	97494485	1
chr3	97705149	97726241	Sec22b	21092	+	NM_011342	97705268	97725193	5
chr3	97734095	97770941	Gm5544	36846	+	NM_001033779	97770337	97770709	2
chr3	97817460	97954290	Notch2	136830	+	NM_010928	97817621	97951367	34
chr3	97964556	97968092	Adam30	3536	+	NM_027665	97964775	97966974	1
chr3	98026078	98040671	Reg4	14593	+	NM_026328	98028696	98040288	6
chr3	98084353	98114661	Hmgcs2	30308	+	NM_008256	98084406	98107194	10
chr3	98117093	98143892	Phgdh	26799	-	NM_016966	98117225	98143755	12
chr3	98186403	98235872	Zfp697	49469	+	NM_172863	98229182	98232553	3
chr3	98303002	98314490	Hsd3b4	11488	-	NM_008294	98303378	98313890	4
chr3	98356465	98367932	Gm10681	11467	-	NM_001270429	98356849	98367361	4
chr3	98422558	98449457	Hsd3b5	26899	-	NM_008295	98422929	98434121	4
chr3	98515029	98528466	Hsd3b2	13437	-	NM_153193	98515428	98520483	6
chr3	98545398	98567051	Hsd3b3	21653	-	NM_001161743	98545806	98557378	5
chr3	98609426	98618366	Hsd3b6	8940	-	NM_013821	98609782	98614969	4
chr3	98656116	98663717	Hsd3b1	7601	-	NM_008293	98656474	98661887	5
chr3	98678441	98697153	Hao2	18712	-	NM_019545	98679231	98688754	9
chr3	98853744	98857665	Gm12440	3921	+	NR_110516	98857665	98857665	4
chr3	98945012	99024126	Wars2	79114	+	NM_027462	98945021	99020830	6
chr3	99003267	99003376	Mir6481	109	-	NR_105852	99003376	99003376	1
chr3	99057682	99158183	Tbx15	100501	+	NM_009323	99057803	99156546	8
chr3	99689339	99947245	Spag17	257906	+	NM_028892	99689414	99929361	49
chr3	99942102	99966326	Wdr3	24224	-	NM_175552	99942609	99965113	27
chr3	99966385	100010912	Gdap2	44527	+	NM_010269	99973922	100009742	14
chr3	100230327	100241677	4930406D18Rik	11350	+	NR_040543	100241677	100241677	3
chr3	100275458	100293115	Fam46c	17657	-	NM_001142952	100276185	100277361	2
chr3	100366126	100489396	Man1a2	123270	-	NM_010763	100371532	100488785	13
chr3	100629381	100700845	Vtcn1	71464	+	NM_178594	100629481	100696599	6
chr3	100726415	100740848	Trim45	14433	+	NM_001165952	100726834	100735502	7
chr3	100742782	100773586	Ttf2	30804	-	NM_001013026	100743890	100773570	23
chr3	100797451	100833418	Cd101	35967	-	NM_001167906	100797587	100833418	9
chr3	100844158	100914089	Ptgfrn	69931	-	NM_011197	100847278	100914063	9
chr3	101079830	101091862	Cd2	12032	-	NM_013486	101079879	101091802	5
chr3	101181047	101266983	Igsf3	85936	+	NM_207205	101182372	101263960	11
chr3	101380141	101408630	Atp1a1	28489	-	NM_144900	101380478	101408337	23
chr3	101616998	101640146	Mab21l3	23148	-	NM_172295	101618941	101639165	7
chr3	101659693	101728376	Slc22a15	68683	-	NM_001039371	101664361	101728041	12
chr3	101814067	101819415	Nhlh2	5348	+	NM_178777	101816576	101816984	3
chr3	101890377	101950435	Casq2	60058	+	NM_009814	101890561	101949353	11
chr3	101959822	102008616	Vangl1	48794	-	NM_177545	101962159	102000785	8
chr3	102066327	102092694	A230001M10Rik	26367	+	NR_040391	102092694	102092694	4
chr3	102273841	102324936	Ngf	51095	+	NM_013609	102313698	102324771	4
chr3	102524153	102539340	Tspan2os	15187	-	NR_040588	102539340	102539340	4
chr3	102538692	102576233	Tspan2	37541	+	NM_027533	102538919	102572865	8
chr3	102581320	102586637	Tshb	5317	-	NM_009432	102581392	102582234	5
chr3	102622421	102740023	Sycp1	117602	-	NM_011516	102622747	102739574	33
chr3	102743580	102768056	Nr1h5	24476	-	NM_201619	102744792	102762306	11
chr3	102799662	102807837	Sike1	8175	+	NM_025679	102799731	102805732	5
chr3	102824468	102862109	Csde1	37641	+	NM_144901	102842614	102860856	20
chr3	102862207	102871837	Nras	9630	+	NM_010937	102862844	102867372	7
chr3	102877936	102903643	Ampd1	25707	+	NM_001033303	102878018	102903621	16
chr3	102931478	102973656	Dennd2c	42178	+	NM_177857	102935460	102971725	19
chr3	102975633	102983077	Bcas2	7444	+	NM_026602	102975695	102982404	7
chr3	103083215	103162693	Trim33	79478	+	NM_053170	103083801	103157832	20
chr3	103380048	103449490	Syt6	69442	+	NM_001276680	103389356	103449076	5
chr3	103539316	103541924	Olfml3	2608	-	NM_133859	103539765	103541858	3
chr3	103543737	103595486	Hipk1	51749	-	NM_001301304	103547870	103582220	16
chr3	103604527	103613310	Dclre1b	8783	-	NM_133865	103606890	103613011	4
chr3	103607051	103612363	Gm15471	5312	+	NR_040412	103612363	103612363	5
chr3	103613439	103625948	Ap4b1	12509	+	NM_001163552	103613867	103625683	11
chr3	103636618	103658541	Bcl2l15	21923	+	NM_001142960	103636754	103657198	4
chr3	103663717	103716175	Ptpn22	52458	+	NR_104070	103716175	103716175	23
chr3	103718042	103770543	Rsbn1	52501	+	NM_172684	103718373	103766535	7
chr3	103768458	103772239	Phtf1os	3781	-	NR_030676	103772239	103772239	1
chr3	103772032	103811414	Phtf1	39382	+	NM_001163467	103773008	103810931	19
chr3	103817187	104024329	Magi3	207142	-	NM_133853	103820565	104023889	22
chr3	104257905	104315841	Lrig2	57936	-	NM_001025067	104261687	104315614	18
chr3	104442586	104462385	Slc16a1	19799	+	NM_009196	104453223	104459645	5
chr3	104570322	104580465	Fam19a3	10143	-	NM_183224	104573651	104576850	7
chr3	104583973	104588935	Ppm1j	4962	+	NM_027982	104584004	104588770	10
chr3	104591951	104597377	Rhoc	5426	+	NM_001291859	104594814	104596961	5
chr3	104597749	104621481	Mov10	23732	-	NM_001163440	104598066	104621444	21
chr3	104625702	104667423	Capza1	41721	-	NM_009797	104627901	104667296	10
chr3	104667423	104732981	St7l	65558	+	NM_001253702	104668012	104729526	14
chr3	104747722	104764627	Wnt2b	16905	-	NM_009520	104749888	104764390	5
chr3	104804832	104856064	Cttnbp2nl	51232	-	NM_030249	104807567	104835669	6
chr3	104869761	104881724	4930564D02Rik	11963	+	NM_029228	104880737	104881501	5
chr3	105251107	105255873	Kcnd3os	4766	-	NR_040759	105255873	105255873	4
chr3	105255247	105476920	Kcnd3	221673	+	NM_001039347	105261733	105472127	7
chr3	105481379	105490489	Ddx20	9110	-	NM_017397	105481467	105490345	11
chr3	105507516	105523760	Fam212b	16244	+	NM_175398	105507686	105520132	2
chr3	105530177	105604299	Rap1a	74122	-	NM_145541	105534902	105553219	8
chr3	105618484	105620277	Gm5547	1793	+	NR_045845	105620277	105620277	3
chr3	105673775	105726962	Tmigd3	53187	+	NM_027025	105717149	105726851	7
chr3	105707338	105711846	Adora3	4508	+	NM_009631	105707717	105710813	2
chr3	105728808	105735582	I830077J02Rik	6774	-	NM_001033780	105729357	105731688	6
chr3	105745595	105763166	Atp5f1	17571	-	NM_001304719	105745903	105760789	10
chr3	105762415	105772678	Wdr77	10263	+	NM_027432	105762501	105770240	10
chr3	105776719	105790341	Ovgp1	13622	+	NM_007696	105776733	105789996	11
chr3	105799874	105817564	Pifo	17690	-	NM_001200028	105800048	105817523	6
chr3	105819836	105835813	Chil5	15977	-	NM_001080816	105820049	105835732	11
chr3	105916299	105935034	Chia1	18735	+	NM_023186	105916302	105934935	11
chr3	105950471	105970482	Chil3	20011	-	NM_009892	105950770	105970439	11
chr3	106004408	106022397	Chil4	17989	-	NM_145126	106004694	106022382	11
chr3	106190301	106209100	Chil6	18799	-	NM_178412	106190495	106208949	11
chr3	106284903	106288831	2010016I18Rik	3928	-	NR_033207	106288831	106288831	2
chr3	106285348	106305948	Dennd2d	20600	+	NM_001093754	106285573	106303524	12
chr3	106305177	106350720	Cept1	45543	-	NM_001293694	106306542	106342446	9
chr3	106350715	106378259	Dram2	27544	+	NM_001286986	106358095	106376603	9
chr3	106487904	106539494	Lrif1	51590	+	NM_001039478	106488003	106538766	3
chr3	106561778	106593067	Cd53	31289	-	NM_007651	106563721	106573662	8
chr3	106624524	106625475	Olfr266	951	-	NM_146489	106624524	106625475	1
chr3	106839079	106841047	Kcna3	1968	+	NM_008418	106839340	106840927	1
chr3	106842421	106857240	AI504432	14819	+	NR_033498	106857240	106857240	2
chr3	106904484	106917923	Kcna2	13439	+	NM_008417	106907022	106908522	3
chr3	106986060	106998639	Kcna10	12579	+	NM_001081140	106996972	106998508	2
chr3	107014212	107024650	Cym	10438	-	NM_001111143	107014280	107024624	9
chr3	107033531	107036949	A630076J17Rik	3418	+	NM_001256174	107033659	107036735	3
chr3	107038448	107042625	Prok1	4177	-	NM_001044382	107038486	107042567	3
chr3	107081775	107086999	Lamtor5	5224	+	NM_026774	107081834	107086613	4
chr3	107094209	107115033	Slc16a4	20824	+	NM_146136	107095356	107114505	9
chr3	107129027	107136207	Rbm15	7180	-	NM_001045807	107129199	107135998	2
chr3	107241220	107261816	Kcnc4	20596	-	NM_145922	107242338	107261808	4
chr3	107270465	107320936	Slc6a17	50471	-	NM_172271	107274098	107303571	12
chr3	107356615	107357991	Ubl4b	1376	-	NM_026261	107357293	107357860	1
chr3	107397948	107408793	Alx3	10845	+	NM_007441	107398093	107407997	4
chr3	107415449	107434628	Strip1	19179	-	NM_153563	107416136	107434598	21
chr3	107466037	107499466	Ahcyl1	33429	-	NM_145542	107468024	107499195	17
chr3	107543965	107563387	Csf1	19422	-	NM_001113529	107549656	107562981	9
chr3	107680147	107695818	Eps8l3	15671	+	NM_133867	107682288	107695512	19
chr3	107691767	107699131	4933431E20Rik	7364	-	NR_015459	107699131	107699131	3
chr3	107698771	107701603	Gstm5	2832	+	NM_010360	107698871	107701467	8
chr3	107729251	107734663	Gstm7	5412	-	NM_026672	107729808	107734572	8
chr3	107741765	107746667	Gstm6	4902	-	NM_008184	107742144	107746551	8
chr3	107766613	107772092	Gstm3	5479	-	NM_010359	107767124	107772058	8
chr3	107784619	107789354	Gstm2	4735	-	NM_008183	107784966	107789311	8
chr3	107815167	107820891	Gstm1	5724	-	NM_010358	107815606	107820693	8
chr3	107843325	107847777	Gstm4	4452	-	NM_001160411	107844153	107847280	8
chr3	107876979	107889584	Ampd2	12605	-	NM_001289719	107877832	107889145	19
chr3	107895983	107904348	Gnat2	8365	+	NM_008141	107896166	107903721	9
chr3	107910192	107949070	Gnai3	38878	-	NM_010306	107912339	107948923	9
chr3	107951238	107957850	Gpr61	6612	-	NM_001305461	107952911	107954261	3
chr3	107989206	107995204	Amigo1	5998	+	NM_001287093	107990104	107994655	3
chr3	107998688	108003752	Cyb561d1	5064	-	NM_028061	108002129	108003054	3
chr3	108005145	108013445	Atxn7l2	8300	-	NM_175183	108005276	108011376	12
chr3	108015183	108029517	Sypl2	14334	-	NM_008596	108017453	108029335	6
chr3	108059843	108082870	Psma5	23027	+	NM_011967	108060194	108082730	9
chr3	108086981	108164437	Sort1	77456	+	NM_001271599	108087058	108160161	21
chr3	108167828	108182975	Mybphl	15147	+	NM_026831	108167914	108181614	9
chr3	108182194	108186659	Gm12522	4465	-	NR_040560	108186659	108186659	3
chr3	108186721	108191149	Psrc1	4428	+	NM_001190161	108187184	108190520	8
chr3	108193765	108218412	Celsr2	24647	-	NM_001004177	108195412	108218412	34
chr3	108227781	108248177	Sars	20396	-	NM_011319	108229747	108248050	12
chr3	108260986	108339440	5330417C22Rik	78454	-	NM_001033304	108261317	108291908	21
chr3	108340501	108347615	1700013F07Rik	7114	+	NM_029314	108340536	108347565	5
chr3	108357259	108357320	Scarna2	61	-	NR_028538	108357320	108357320	1
chr3	108359342	108365384	Tmem167b	6042	-	NM_026198	108361795	108365198	3
chr3	108374616	108384986	Taf13	10370	+	NM_025444	108374639	108384095	4
chr3	108394195	108448637	Wdr47	54442	+	NM_181400	108412803	108447506	15
chr3	108456830	108481758	Clcc1	24928	+	NM_145543	108464284	108479854	12
chr3	108481555	108525217	Gpsm2	43662	-	NM_029522	108482496	108514250	15
chr3	108542575	108585227	Aknad1	42652	+	NM_177859	108554589	108584969	12
chr3	108596097	108643420	Stxbp3	47323	-	NM_011504	108596690	108643386	19
chr3	108656595	108692926	Fndc7	36331	-	NM_177091	108659284	108692624	13
chr3	108705724	108714622	Prpf38b	8898	-	NM_025845	108706836	108714360	6
chr3	108743001	108763694	Henmt1	20693	+	NM_025723	108744310	108763256	8
chr3	108773914	108830525	Fam102b	56611	-	NM_001163567	108778217	108830239	11
chr3	108883416	108919500	Slc25a54	36084	+	NM_029054	108883462	108919430	10
chr3	108926066	108971327	Slc25a24	45261	+	NM_172685	108926122	108969428	10
chr3	109143600	109488612	Vav3	345012	+	NM_020505	109143956	109486527	27
chr3	109582967	109946390	Ntng1	363423	-	NM_030699	109585599	109938426	8
chr3	110049021	110053917	Prmt6	4896	-	NR_024139	110053917	110053917	2
chr3	111684820	111884919	Gm6602	200099	+	NR_045362	111884919	111884919	4
chr3	112950573	112959645	Amy2b	9072	-	NM_001190403	112950607	112959628	10
chr3	113052095	113061617	Amy2a5	9522	-	NM_001042711	113052128	113061600	10
chr3	113082754	113094367	Amy2a2	11613	-	NM_001160152	113084795	113094212	10
chr3	113082754	113094367	Amy2a3	11613	-	NM_001160151	113084795	113094212	10
chr3	113082754	113094367	Amy2a4	11613	-	NM_001160150	113084795	113094212	10
chr3	113258869	113280668	Amy1	21799	-	NM_001110505	113258901	113272930	11
chr3	113307984	113333067	Rnpc3	25083	-	NM_001287015	113311272	113332972	15
chr3	113733457	113923674	Col11a1	190217	+	NM_007729	113733818	113921745	67
chr3	114606995	114828682	Olfm3	221687	+	NM_153458	114607400	114825775	6
chr3	115413350	115417973	S1pr1	4623	-	NM_007901	115414712	115415861	2
chr3	115584496	115591048	A930005H10Rik	6552	-	NR_015487	115591048	115591048	2
chr3	115591100	115632241	Dph5	41141	+	NM_027193	115591380	115631638	8
chr3	115641890	115710324	Slc30a7	68434	-	NM_023214	115649581	115710132	11
chr3	115682819	115682873	Mir669n	54	+	NR_130332	115682873	115682873	1
chr3	115710366	115731934	Extl2	21568	+	NM_021388	115713606	115730416	5
chr3	115812937	115832606	Vcam1	19669	-	NM_011693	115813794	115832285	9
chr3	115952571	115956402	Gpr88	3831	-	NM_022427	115954423	115955578	2
chr3	115975470	116126950	Cdc14a	151480	-	NM_001080818	115977596	116126403	16
chr3	116191881	116211093	Rtca	19212	-	NM_025517	116192154	116210907	11
chr3	116215996	116252899	Dbt	36903	+	NM_010022	116216058	116251118	11
chr3	116265890	116286052	Lrrc39	20162	+	NM_175413	116268725	116284203	9
chr3	116284253	116317505	Trmt13	33252	-	NM_030016	116284329	116297703	12
chr3	116297875	116333904	Sass6	36029	+	NM_001289568	116308658	116331732	18
chr3	116334084	116365595	Hiat1	31511	-	NM_008246	116335191	116365396	12
chr3	116373715	116415198	Slc35a3	41483	-	NM_144902	116376545	116397534	8
chr3	116442916	116511084	Agl	68168	-	NM_001081326	116447735	116510267	34
chr3	116562484	116606668	Frrs1	44184	+	NM_001113478	116581172	116606079	17
chr3	116621179	116671870	Palmd	50691	-	NM_023245	116621507	116671460	8
chr3	116671184	116687324	4930455H04Rik	16140	+	NR_040596	116687324	116687324	3
chr3	116763439	116780683	1700061I17Rik	17244	-	NR_038029	116780683	116780683	9
chr3	117022062	117063794	Plppr4	41732	-	NM_177664	117024823	117063166	7
chr3	117278144	117392426	Plppr5	114282	+	NM_001305451	117278613	117389566	6
chr3	117484414	117571854	Snx7	87440	-	NM_029655	117485216	117571823	9
chr3	118136774	118136847	Mir137	73	+	NR_029551	118136847	118136847	1
chr3	118265095	119135836	Dpyd	870741	+	NM_170778	118265193	119134575	23
chr3	119421659	119486306	Ptbp2	64647	-	NM_019550	119423245	119486127	14
chr3	120157251	120589650	6530403H02Rik	432399	-	NR_130170	120589650	120589650	19
chr3	120858319	120874613	Rwdd3	16294	-	NM_025637	120859105	120874594	7
chr3	120904927	120966234	Tmem56	61307	-	NM_178936	120910069	120938154	8
chr3	120994734	121064929	Alg14	70195	+	NM_024178	120994765	121064704	4
chr3	121129458	121161123	Cnn3	31665	+	NM_028044	121129689	121160344	7
chr3	121162445	121235262	Slc44a3	72817	-	NM_145394	121162889	121235117	15
chr3	121340043	121349371	A730020M07Rik	9328	-	NR_036458	121349371	121349371	3
chr3	121373680	121385900	4930432M17Rik	12220	+	NM_001033814	121374234	121385753	6
chr3	121426454	121437970	F3	11516	+	NM_010171	121426632	121437157	6
chr3	121461827	121518133	Abcd3	56306	-	NM_008991	121463149	121518036	23
chr3	121656243	121719071	Arhgap29	62828	+	NM_172525	121676828	121717893	23
chr3	121747377	121882979	Abca4	135602	+	NM_007378	121747464	121882751	50
chr3	121948474	121970133	Gclm	21659	+	NM_008129	121948903	121969315	7
chr3	121977331	121988189	Dnttip2	10858	+	NM_153806	121977336	121988068	7
chr3	121996502	121996621	Mir760	119	-	NR_030439	121996621	121996621	1
chr3	122122697	122233100	Bcar3	110403	+	NM_013867	122129373	122232678	12
chr3	122241636	122322632	Fnbp1l	80996	-	NM_001114665	122245022	122322471	16
chr3	122244542	122244599	Mir7657	57	-	NR_106117	122244599	122244599	1
chr3	122432075	122562292	Pde5a	130217	+	NM_153422	122432163	122558250	21
chr3	122498008	122504898	4930447N08Rik	6890	-	NR_045168	122504898	122504898	4
chr3	122585509	122627034	4933405D12Rik	41525	-	NR_046036	122627034	122627034	6
chr3	122597989	122602424	Fabp2	4435	+	NM_007980	122598330	122602199	4
chr3	122627314	122629112	1810037I17Rik	1798	+	NM_024461	122627377	122628397	2
chr3	122636518	122687365	Usp53	50847	-	NM_133857	122636639	122671650	16
chr3	122709123	122737905	Myoz2	28782	-	NM_021503	122709300	122737185	6
chr3	122779436	122939067	Synpo2	159631	-	NM_080451	122782636	122938925	5
chr3	122970413	123068554	Sec24d	98141	+	NM_027135	122972553	123067879	23
chr3	123071212	123088908	Mettl14	17696	-	NM_201638	123072303	123088745	11
chr3	123149830	123209520	Prss12	59690	+	NM_008939	123150076	123209445	11
chr3	123210469	123211254	Snhg8	785	-	NR_028574	123211254	123211254	1
chr3	123210854	123210984	Snora24	130	-	NR_028573	123210984	123210984	1
chr3	123229083	123393770	Ndst3	164687	-	NR_121616	123393770	123393770	14
chr3	124023954	124026178	Tram1l1	2224	+	NM_146140	124024110	124025202	1
chr3	124104072	124128946	1700006A11Rik	24874	-	NM_027939	124104307	124124370	12
chr3	124268808	124284009	1700003H04Rik	15201	-	NR_015460	124284009	124284009	4
chr3	125107008	125427904	Ndst4	320896	+	NM_022565	125140701	125427688	14
chr3	125568260	125641468	Ugt8a	73208	-	NM_011674	125570133	125618377	6
chr3	126066769	126143292	Arsj	76523	+	NM_173451	126067691	126142321	2
chr3	126299868	126549244	Camk2d	249376	+	NM_001293665	126482899	126544469	20
chr3	126624524	126701370	Ank2	76846	-	NM_178655	126626874	126691095	25
chr3	126864222	126871208	LOC100862268	6986	+	NR_105029	126871208	126871208	4
chr3	127239631	127256267	Larp7	16636	-	NM_138593	127239871	127250463	13
chr3	127248145	127248219	Mir302b	74	+	NR_030403	127248219	127248219	1
chr3	127248280	127248348	Mir302c	68	+	NR_030404	127248348	127248348	1
chr3	127248413	127248482	Mir302a	69	+	NR_029653	127248482	127248482	1
chr3	127248541	127248607	Mir302d	66	+	NR_030405	127248607	127248607	1
chr3	127248650	127248725	Mir367	75	+	NR_030268	127248725	127248725	1
chr3	127256406	127320941	Zgrf1	64535	+	NM_197997	127258282	127319721	26
chr3	127336062	127338549	Neurog2	2487	+	NM_009718	127336646	127337438	2
chr3	127373227	127483445	Alpk1	110218	-	NM_027808	127373849	127432309	14
chr3	127492830	127501307	Tifa	8477	+	NM_145133	127499499	127500054	3
chr3	127510182	127540410	Ap1ar	30228	-	NM_145964	127511408	127540143	10
chr3	127572605	127599241	5730508B09Rik	26636	-	NM_027482	127573672	127599101	2
chr3	127619088	127658138	9830132P13Rik	39050	+	NR_040552	127658138	127658138	5
chr3	127819932	127934523	D030025E07Rik	114591	-	NR_045704	127934523	127934523	6
chr3	128902795	128922512	Pitx2	19717	+	NM_001286942	128906864	128921815	5
chr3	128972094	129035667	Enpep	63573	-	NM_007934	128973196	129035399	20
chr3	129136590	129137630	Gm5712	1040	+	NR_033594	129137630	129137630	1
chr3	129235303	129341411	Elovl6	106108	+	NM_130450	129235597	129336408	5
chr3	129380494	129458240	Egf	77746	-	NM_010113	129381237	129457882	24
chr3	129456675	129466800	6330410L21Rik	10125	+	NR_040589	129466800	129466800	5
chr3	129491208	129506948	Lrit3	15740	-	NM_001287224	129491208	129506948	4
chr3	129511492	129525423	Rrh	13931	-	NM_009102	129511849	129525400	7
chr3	129527829	129534314	Gar1	6485	-	NM_026578	129528113	129533759	7
chr3	129539656	129578246	Cfi	38590	+	NM_007686	129539727	129578056	14
chr3	129581523	129598743	Pla2g12a	17220	+	NR_104611	129598743	129598743	5
chr3	129604332	129617030	Casp6	12698	+	NM_009811	129608396	129616491	7
chr3	129617877	129673124	Ccdc109b	55247	-	NM_025779	129618026	129672993	8
chr3	129686102	129763825	Sec24b	77723	-	NM_207209	129686809	129763586	24
chr3	129883762	130302801	Col25a1	419039	+	NM_029838	129884401	130298020	38
chr3	130320365	130338668	Etnppl	18303	+	NM_001163587	130320610	130337595	14
chr3	130398834	130412362	Ostc	13528	-	NM_025509	130399377	130412293	4
chr3	130429744	130433316	Rpl34	3572	-	NM_001005859	130429792	130432211	5
chr3	130429754	130433247	Rpl34-ps1	3493	-	NM_001199350	130429792	130432211	5
chr3	130813214	130927275	Lef1	114061	+	NM_010703	130814389	130907885	12
chr3	130936337	130975019	Hadh	38682	-	NM_008212	130937086	130974925	8
chr3	130993408	131006145	Cyp2u1	12737	-	NM_027816	130994046	131006045	5
chr3	131021903	131047841	Sgms2	25938	-	NM_028943	131026024	131045141	6
chr3	131227731	131306635	Papss1	78904	+	NM_001289479	131245376	131306066	14
chr3	131748255	131843268	Dkk2	95013	+	NM_020265	131748996	131841084	4
chr3	132293154	132307613	Gimd1	14459	+	NM_001270430	132297688	132307595	3
chr3	132323461	132346843	Aimp1	23382	-	NM_007926	132323538	132346758	7
chr3	132347107	132504652	Tbck	157545	+	NM_001163455	132349763	132501035	26
chr3	132505165	132541560	Gm29811	36395	-	NR_102298	132541560	132541560	4
chr3	132544708	132613255	Npnt	68547	-	NM_001287101	132547393	132613007	14
chr3	132645514	132754704	Gstcd	109190	-	NM_026231	132646046	132747968	12
chr3	132754916	132773949	Ints12	19033	+	NM_027927	132759720	132772383	7
chr3	132822494	132897853	Arhgef38	75359	-	NM_029953	132823678	132897787	4
chr3	132973073	133041199	Ppa2	68126	+	NM_146141	132973103	133040839	12
chr3	133126640	133207354	Tet2	80714	-	NM_001040400	133129700	133151635	11
chr3	133899458	133925053	Cxxc4	25595	+	NM_001004367	133902623	133921061	4
chr3	133903468	133903547	Mir1895	79	-	NR_035435	133903547	133903547	1
chr3	134067106	134086599	4930539C22Rik	19493	-	NR_040600	134086599	134086599	9
chr3	134491970	134597545	Tacr3	105575	+	NM_021382	134492236	134595406	5
chr3	134875526	134936504	Cenpe	60978	+	NM_173762	134875622	134936203	46
chr3	134944184	134967389	Bdh2	23205	+	NM_027208	134948559	134967185	10
chr3	134970663	135005731	Slc9b2	35068	+	NM_178877	134980067	135005264	13
chr3	135011000	135060791	Slc9b1	49791	+	NM_028946	135011732	135060772	13
chr3	135069375	135086397	Cisd2	17022	-	NM_025902	135071764	135086325	3
chr3	135099186	135101629	4930539J05Rik	2443	-	NR_030689	135101629	135101629	3
chr3	135101722	135130142	Ube2d3	28420	+	NM_025356	135102738	135128204	8
chr3	135148574	135234367	Manba	85793	+	NM_027288	135148644	135233403	17
chr3	135247618	135354511	Nfkb1	106893	-	NM_008689	135248318	135330749	25
chr3	135488242	135551536	Slc39a8	63294	+	NM_026228	135489435	135549918	9
chr3	135496657	135503233	4933401H06Rik	6576	-	NR_040540	135503233	135503233	5
chr3	135716327	135989030	Bank1	272703	-	NM_001033350	135717374	135988903	17
chr3	136098233	136112313	1700030L20Rik	14080	-	NR_040592	136112313	136112313	5
chr3	136333029	136600691	Ppp3ca	267662	+	NM_008913	136333807	136598189	14
chr3	137004041	137094033	Emcn	89992	+	NM_001163522	137004203	137090303	12
chr3	137213008	137215586	Gm4861	2578	-	NM_177665	137213486	137215186	3
chr3	137286635	137291296	Ddit4l	4661	+	NM_030143	137287146	137289420	3
chr3	137527450	137529886	H2afz	2436	+	NM_016750	137527657	137529411	5
chr3	137530638	137571895	Dnajb14	41257	+	NM_001033155	137530887	137571433	8
chr3	137581518	137591726	Lamtor3	10208	+	NM_019920	137581873	137590984	7
chr3	137593970	137644513	Dapp1	50543	-	NM_011932	137596084	137644383	9
chr3	137711724	137730352	Gm5105	18628	-	NR_037975	137730352	137730352	4
chr3	137752818	137806352	Mttp	53534	-	NM_001163457	137754018	137797069	20
chr3	137806501	137822784	Trmt10a	16283	+	NM_175389	137810343	137819907	8
chr3	137827098	137849677	4930579F01Rik	22579	-	NM_001163386	137827329	137839526	8
chr3	137873680	137902627	0610031O16Rik	28947	-	NR_045760	137902627	137902627	3
chr3	137880736	137895006	Adh7	14270	+	NM_009626	137880854	137894170	9
chr3	137940608	137953655	Adh1	13047	+	NM_007409	137940682	137953523	9
chr3	137976249	137994098	Adh6a	17849	+	NM_026945	137976308	137993944	9
chr3	138037084	138051255	Adh6-ps1	14171	+	NR_033581	138051255	138051255	4
chr3	138078460	138093856	Adh4	15396	+	NM_011996	138078495	138093713	9
chr3	138100163	138118463	Adh5	18300	+	NM_001288578	138113884	138118073	9
chr3	138121923	138152346	Metap1	30423	-	NM_175224	138123300	138152335	11
chr3	138189154	138222660	Eif4e	33506	+	NM_007917	138190260	138218468	8
chr3	138189384	138189449	Mir1956	65	+	NR_035481	138189449	138189449	1
chr3	138374498	138389948	4930425O10Rik	15450	-	NR_040545	138389948	138389948	4
chr3	138405171	138567397	Tspan5	162226	+	NM_019571	138405543	138565408	8
chr3	138588860	138738165	Rap1gds1	149305	-	NM_001286759	138590548	138738003	15
chr3	138868856	139373263	Stpg2	504407	+	NM_198659	138868862	139372137	14
chr3	139691212	139691334	Mir7j	122	+	NR_105798	139691334	139691334	1
chr3	140872967	140875319	Pdha2	2352	-	NM_008811	140873533	140874709	1
chr3	141128527	141497888	Unc5c	369361	+	NM_001293561	141128677	141491536	17
chr3	141500099	141832192	Bmpr1b	332093	-	NM_001277216	141503578	141543463	12
chr3	141902548	142058660	Pdlim5	156112	-	NM_001190852	141905643	142054772	16
chr3	142159897	142185308	Gbp5	25411	+	NM_153564	142163520	142184126	11
chr3	142193299	142213115	Gbp7	19816	+	NM_001083312	142197486	142209538	11
chr3	142223015	142236176	Gbp3	13161	+	NM_001289492	142224727	142235656	12
chr3	142257810	142282140	Gbp2b	24330	+	NM_010259	142261109	142281169	11
chr3	142283626	142300972	Gbp2	17346	+	NM_010260	142286657	142300457	11
chr3	142286823	142286910	Mir6381	87	-	NR_105802	142286910	142286910	1
chr3	142364011	142407875	Ccbl2	43864	+	NM_001293560	142369653	142407097	14
chr3	142428210	142446569	Gtf2b	18359	+	NM_145546	142428235	142446293	7
chr3	142453865	142544968	Pkn2	91103	-	NM_178654	142456774	142544622	22
chr3	142906018	142920960	A830019L24Rik	14942	+	NR_040551	142920960	142920960	4
chr3	143333855	143375107	Gm6260	41252	-	NR_040405	143375107	143375107	3
chr3	143851493	143868219	Lmo4	16726	-	NM_010723	143852260	143865012	5
chr3	144094070	144233180	Hs2st1	139110	-	NM_011828	144097451	144232821	7
chr3	144233390	144260640	Sep15	27250	+	NM_053102	144233688	144259918	5
chr3	144346641	144383299	Sh3glb1	36658	-	NM_001282042	144348100	144383017	10
chr3	144392640	144423941	Clca3a1	31301	-	NM_009899	144393575	144423686	14
chr3	144459522	144482458	Clca3a2	22936	-	NM_030601	144460442	144482433	14
chr3	144485586	144512266	Clca3b	26680	-	NM_139148	144485740	144512249	14
chr3	144542285	144558975	Clca4c-ps	16690	-	NR_126537	144558975	144558975	4
chr3	144573884	144595493	Clca4b	21609	-	NM_001033199	144574073	144595463	14
chr3	144615449	144638009	Clca4a	22560	-	NM_207208	144615638	144637978	14
chr3	144667500	144695740	Clca1	28240	-	NM_017474	144667662	144695709	14
chr3	144733228	144762005	Clca2	28777	-	NM_178697	144734243	144761928	14
chr3	144781552	144816879	Odf2l	35327	+	NM_001162538	144787232	144816476	17
chr3	144955435	145214975	Col24a1	259540	+	NM_001317733	145068031	145213670	60
chr3	145239171	145268209	Znhit6	29038	+	NM_001081094	145239331	145266939	10
chr3	145309934	145312949	Cyr61	3015	-	NM_010516	145310629	145312756	5
chr3	145421655	145557241	Ddah1	135586	+	NM_026993	145421825	145554522	6
chr3	145587225	145597328	Bcl10	10103	+	NM_009740	145587422	145596270	3
chr3	145600995	145607239	2410004B18Rik	6244	+	NM_025555	145601022	145606834	3
chr3	145650833	145684684	Syde2	33851	+	NM_001166064	145650962	145683263	7
chr3	145703489	145771000	Wdr63	67511	-	NM_172864	145703661	145766169	23
chr3	145784754	145803610	Mcoln3	18856	+	NM_134160	145784756	145803562	12
chr3	145812796	145858475	Mcoln2	45679	+	NM_026656	145812893	145857755	14
chr3	145883924	145949178	Lpar3	65254	+	NM_022983	145903532	145947957	3
chr3	146030116	146041908	Gm10636	11792	-	NR_033542	146041908	146041908	3
chr3	146067605	146103101	Ssx2ip	35496	+	NM_001253768	146080711	146101794	15
chr3	146113430	146128812	Ctbs	15382	+	NM_001293672	146113465	146127054	7
chr3	146120166	146162717	Spata1	42551	-	NM_027617	146126196	146156671	15
chr3	146162799	146168507	Gng5	5708	+	NM_010318	146162903	146166349	3
chr3	146169309	146184387	Rpf1	15078	-	NM_027371	146169497	146184360	9
chr3	146244336	146278562	Dnase2b	34226	-	NM_019957	146245237	146259364	7
chr3	146260112	146294447	Uox	34335	+	NM_009474	146260167	146293571	8
chr3	146304895	146314679	Gm16325	9784	+	NR_045949	146314679	146314679	4
chr3	146309222	146314281	4930503B20Rik	5059	-	NM_029144	146309365	146314115	2
chr3	146392542	146475910	Prkacb	83368	-	NM_011100	146395551	146475647	10
chr3	146515330	146646972	Ttll7	131642	+	NM_001302957	146557139	146642715	22
chr3	148478549	148617599	Adgrl2	139050	-	NM_001081298	148480137	148617599	24
chr3	148937700	148942944	Gm1653	5244	+	NR_040591	148942944	148942944	3
chr3	150686755	150686826	Mir3963	71	-	NR_039540	150686826	150686826	1
chr3	151100845	151208045	Adgrl4	107200	+	NM_133222	151100946	151206260	16
chr3	151393886	151412923	Ifi44	19037	-	NM_133871	151395343	151412550	8
chr3	151421700	151425855	Ifi44l	4155	-	NM_031367	151422604	151425855	4
chr3	151461573	151500492	Ptgfr	38919	-	NM_008966	151464587	151498833	3
chr3	151756804	151828864	Gipc2	72060	-	NM_016867	151757110	151828851	6
chr3	151846834	151873047	Dnajb4	26213	-	NM_027287	151848110	151856551	4
chr3	151873421	151899794	Fubp1	26373	+	NM_057172	151873556	151895367	20
chr3	151899947	151929284	Nexn	29337	-	NM_199465	151900529	151918275	13
chr3	151936423	152003371	Fam73a	66948	-	NM_174868	151939598	152000788	16
chr3	152009441	152056578	Usp33	47137	+	NM_001252486	152020854	152055330	24
chr3	152058966	152125790	Zzz3	66824	+	NM_001080755	152090270	152121362	14
chr3	152125778	152331104	Ak5	205326	-	NM_001081277	152126911	152330823	14
chr3	152329876	152344396	AI115009	14520	+	NR_040386	152344396	152344396	4
chr3	152377063	152451977	Pigk	74914	+	NM_178016	152377098	152448476	12
chr3	152483673	152645171	St6galnac5	161498	-	NM_012028	152484474	152644981	5
chr3	152810906	152815072	4930482G09Rik	4166	-	NR_108044	152815072	152815072	3
chr3	152865472	153388097	St6galnac3	522625	-	NM_011372	152868368	153388026	5
chr3	152959465	152961613	1700012D16Rik	2148	-	NR_126464	152961613	152961613	2
chr3	153452268	153455051	5730460C07Rik	2783	-	NR_045801	153455051	153455051	3
chr3	153507210	153516579	Asb17	9369	+	NM_025758	153507296	153516505	3
chr3	153513337	153515388	Asb17os	2051	-	NR_040373	153515388	153515388	2
chr3	153520104	153569102	Msh4	48998	-	NM_031870	153520406	153568948	20
chr3	153570252	153575930	Rabggtb	5678	-	NR_028094	153575930	153575930	10
chr3	153573530	153573575	Snord45b	45	-	NR_028561	153573575	153573575	1
chr3	153575092	153575153	Snord45c	61	-	NR_028525	153575153	153575153	1
chr3	153585316	153607607	Acadm	22291	-	NM_007382	153585894	153607389	12
chr3	153636399	153934684	Slc44a5	298285	+	NM_001081263	153636728	153933050	22
chr3	153969257	153993524	Lhx8	24267	-	NM_010713	153969922	153993316	9
chr3	153993784	153997651	AI606473	3867	+	NR_040387	153997651	153997651	3
chr3	154239483	154260062	Tyw3	20579	-	NM_172474	154243041	154259990	6
chr3	154259674	154286146	Cryz	26472	+	NM_009968	154267868	154285222	9
chr3	154374096	154411976	Erich3	37880	+	NM_175176	154374282	154411707	7
chr3	154449254	154718371	Tnni3k	269117	-	NM_177066	154449690	154718270	25
chr3	154747882	154756342	Fpgt	8460	-	NM_029330	154749579	154756320	4
chr3	154756397	154857242	Lrriq3	100845	+	NM_028938	154761668	154856731	8
chr3	155639317	155671556	9330178D15Rik	32239	+	NR_040553	155671556	155671556	5
chr3	156209716	156224651	4930570G19Rik	14935	-	NR_040399	156224651	156224651	4
chr3	156224757	156979428	Negr1	754671	+	NM_001039094	156225158	156975874	7
chr3	157197360	157211303	Zranb2	13943	+	NM_017381	157197382	157209702	10
chr3	157207242	157207313	Mir186	71	+	NR_029572	157207313	157207313	1
chr3	157229855	157307722	Ptger3	77867	+	NM_011196	157229981	157306919	3
chr3	157557211	157588027	Cth	30816	-	NM_145953	157557782	157587994	12
chr3	157610429	157669801	Ankrd13c	59372	+	NM_001013806	157610490	157668834	13
chr3	157673456	157699603	Srsf11	26147	-	NM_001093752	157674972	157699569	13
chr3	157699645	157730054	Lrrc40	30409	+	NM_024194	157699689	157729182	15
chr3	157745858	158225185	Lrrc7	479327	-	NM_001081358	157747402	158076094	28
chr3	158739327	158971044	Gm20752	231717	+	NR_040750	158971044	158971044	5
chr3	159158396	159192919	Depdc1a	34523	+	NM_029523	159158482	159192103	12
chr3	159262144	159288271	Rpe65	26127	+	NM_029987	159262196	159287763	15
chr3	159502658	159598139	Wls	95481	+	NR_037590	159598139	159598139	13
chr4	3099229	3100150	Vmn1r2	921	+	NM_001167534	3099229	3100150	1
chr4	3111531	3112452	Vmn1r3	921	-	NM_001167535	3111531	3112452	1
chr4	3464236	3464338	Mir3471-2	102	+	NR_037306	3464338	3464338	1
chr4	3476187	3501915	Tmem68	25728	-	NM_028097	3477621	3496835	8
chr4	3502025	3543770	Tgs1	41745	+	NM_054089	3502172	3542152	13
chr4	3583652	3590255	2210414B05Rik	6603	+	NR_040643	3590255	3590255	4
chr4	3605267	3718759	Lyn	113492	+	NM_001111096	3665876	3717091	13
chr4	3642110	3643953	6330407A03Rik	1843	+	NR_028126	3643953	3643953	1
chr4	3758730	3762802	Rps20	4072	-	NM_026147	3761647	3762633	4
chr4	3797804	3799252	Mos	1448	-	NM_020021	3797929	3798961	1
chr4	3828304	3865552	Plag1	37248	-	NM_019969	3830836	3832835	6
chr4	3866034	3878529	Chchd7	12495	+	NR_104355	3878529	3878529	9
chr4	3923088	3946810	Sdr16c5	23722	-	NM_181989	3923308	3943571	7
chr4	3983812	4004661	Sdr16c6	20849	-	NM_001080710	3983924	4004044	7
chr4	4060682	4065592	Penk	4910	-	NM_001002927	4060985	4065290	2
chr4	4454920	4456605	Gm11780	1685	-	NM_001277919	4455350	4455866	1
chr4	4691500	4720453	Impad1	28953	-	NM_177730	4694850	4720250	5
chr4	5559474	5569431	4930423M02Rik	9957	+	NR_038183	5569431	5569431	5
chr4	5571325	5727091	Fam110b	155766	+	NM_173426	5725730	5726831	3
chr4	6118251	6146935	Ubxn2b	28684	+	NM_026534	6118276	6143221	8
chr4	6192758	6202778	Cyp7a1	10020	-	NM_007824	6195358	6202718	6
chr4	6292826	6323269	Sdcbp	30443	+	NM_001098227	6304238	6321711	9
chr4	6323353	6381418	Nsmaf	58065	-	NM_010945	6323869	6381190	31
chr4	6614532	6917870	Tox	303338	-	NM_145711	6615571	6917638	9
chr4	7487834	7500948	8430436N08Rik	13114	+	NR_040645	7500948	7500948	3
chr4	8068639	8166188	Car8	97549	-	NM_007592	8096777	8166101	9
chr4	8462790	8534849	Rab2a	72059	+	NM_021518	8463009	8533650	8
chr4	8617552	8795596	Chd7	178044	+	NM_001277149	8678651	8793802	38
chr4	9196463	9378838	Clvs1	182375	+	NM_028940	9208704	9376624	6
chr4	9376231	9596491	Asph	220260	-	NM_001290367	9380441	9566423	23
chr4	9697731	9750558	4930412C18Rik	52827	+	NR_030693	9750558	9750558	4
chr4	9771518	9789492	Gdf6	17974	+	NM_013526	9771624	9787431	2
chr4	9843111	9844544	4930448K20Rik	1433	-	NR_004448	9844544	9844544	1
chr4	10435177	10724949	1700123O12Rik	289772	-	NR_045185	10724949	10724949	5
chr4	10801644	10826570	2610301B20Rik	24926	+	NM_026005	10801761	10825199	6
chr4	10915808	10934766	Plekhf2	18958	-	NM_175175	10917737	10918487	2
chr4	10978194	11003352	Ndufaf6	25158	-	NM_001085493	10978243	11003323	9
chr4	11061243	11061329	Mir684-2	86	+	NR_030455	11061329	11061329	1
chr4	11083587	11101524	Trp53inp1	17937	+	NM_001199105	11091604	11095065	5
chr4	11118497	11131926	Ccne2	13429	+	NM_001037134	11119850	11130245	12
chr4	11126304	11181406	Ints8	55102	-	NM_178112	11131613	11181257	28
chr4	11192225	11249278	Dpy19l4	57053	-	NM_001081201	11192924	11249162	19
chr4	11259079	11313930	Esrp1	54851	-	NM_194055	11265903	11313583	16
chr4	11413104	11478290	1110037F02Rik	65186	+	NM_001081183	11413189	11476846	25
chr4	11486066	11542955	Rad54b	56889	+	NM_001039556	11490489	11542801	15
chr4	11506808	11514949	Fsbp	8141	+	NM_001256142	11506880	11511349	2
chr4	11631593	11642140	Gem	10547	+	NM_010276	11633060	11640900	5
chr4	11685303	11745052	Cdh17	59749	+	NM_019753	11694902	11744221	18
chr4	11885331	11893597	Pdp1	8266	-	NM_001098230	11887719	11892791	3
chr4	11893720	11921442	1700123M08Rik	27722	+	NR_040577	11921442	11921442	5
chr4	11966503	12015154	Tmem67	48651	-	NR_110955	12015154	12015154	29
chr4	12016516	12023418	Rbm12b2	6902	+	NM_198957	12020289	12022794	4
chr4	12067263	12073892	Rbm12b1	6629	+	NM_028226	12071176	12073687	3
chr4	12080288	12099162	Fam92a	18874	-	NM_001310743	12081041	12099077	8
chr4	12833983	12908632	Triqk	74649	+	NM_001171801	12890109	12907665	5
chr4	13670448	13822202	Runx1t1	151754	+	NM_001111026	13670848	13817034	11
chr4	14139158	14218456	Gm2560	79298	-	NR_131155	14218456	14218456	3
chr4	14432343	14548925	Slc26a7	116582	-	NM_145947	14432613	14548531	19
chr4	14592900	14723199	Lrrc69	130299	-	NM_028499	14593059	14723192	8
chr4	14736651	14753734	Otud6b	17083	-	NM_152812	14738810	14753612	7
chr4	14791365	14842407	Tmem55a	51042	+	NM_028264	14791478	14841014	7
chr4	14857787	14880177	Gm11837	22390	+	NM_001243100	14863607	14879791	6
chr4	14879391	15076278	Necab1	196887	-	NM_178617	14883039	15076063	13
chr4	15192966	15213900	Tmem64	20934	+	NM_181401	15193098	15210497	3
chr4	15808410	15833856	Calb1	25446	+	NM_009788	15808545	15831910	11
chr4	15844386	15872654	Decr1	28268	-	NM_026172	15846181	15872498	10
chr4	15870046	15870138	Mir6400	92	-	NR_105826	15870138	15870138	1
chr4	15885113	15919736	Nbn	34623	+	NM_013752	15885220	15919608	16
chr4	15924267	15941024	Osgin2	16757	-	NM_145950	15925114	15940877	6
chr4	16050521	16090645	Ripk2	40124	-	NM_138952	16050700	16090543	11
chr4	16091256	16193372	A530072M11Rik	102116	+	NR_045765	16193372	16193372	7
chr4	17780628	18045881	Mmp16	265253	+	NM_019724	17780867	18043368	10
chr4	19207996	19437770	Cngb3	229774	+	NM_013927	19208079	19435230	18
chr4	19446398	19497251	Cpne3	50853	-	NM_027769	19450330	19482640	16
chr4	19502212	19534079	Rmdn1	31867	+	NM_025476	19502360	19533270	10
chr4	19535445	19636151	Wwp1	100706	-	NM_177327	19538860	19605561	25
chr4	19745873	19769360	Slc7a13	23487	+	NM_028746	19745948	19768738	4
chr4	19803984	19849713	Atp6v0d2	45729	-	NM_175406	19805365	19849644	8
chr4	19906591	19932886	4930480G23Rik	26295	-	NR_040768	19932886	19932886	5
chr4	19935389	19957969	Ttpa	22580	+	NM_001317723	19941780	19955728	5
chr4	19969198	19993258	Ggh	24060	+	NM_010281	19969320	19993008	9
chr4	20046020	20705815	Nkain3	659795	-	NM_001290410	20049789	20705462	6
chr4	21604626	21613110	Prdm13	8484	-	NM_001080771	21605370	21612945	4
chr4	21654847	21687069	Ccnc	32222	+	NM_001290420	21655030	21686575	12
chr4	21684528	21694358	Tstd3	9830	-	NM_029840	21685549	21694266	4
chr4	21703416	21765019	Usp45	61603	+	NM_152825	21707497	21761512	18
chr4	21773473	21775595	4930528A17Rik	2122	-	NR_028384	21775595	21775595	1
chr4	21774729	21803622	Pnisr	28893	+	NM_025669	21781504	21802090	12
chr4	21806821	21839273	Coq3	32452	+	NM_172687	21806834	21837786	7
chr4	21858472	21928608	Faxc	70136	+	NM_175234	21858710	21920734	6
chr4	22284689	22361238	Fbxl4	76549	+	NR_104379	22361238	22361238	10
chr4	22409241	22415513	Pou3f2	6272	-	NM_008899	22413940	22415278	1
chr4	22417694	22420273	Pnky	2579	+	NR_131335	22420273	22420273	3
chr4	24423608	24530095	Mms22l	106487	+	NM_199467	24424054	24529793	24
chr4	24544419	24778233	Klhl32	233814	-	NM_001163020	24544531	24727975	11
chr4	24825229	24832148	Ndufaf4	6919	+	NM_026742	24825313	24829122	3
chr4	24900565	24936380	Gpr63	35815	+	NM_030733	24934424	24935702	2
chr4	25127055	25170023	Fhl5	42968	-	NM_021318	25127124	25141922	6
chr4	25175732	25208968	Ufl1	33236	-	NM_026194	25177616	25208899	19
chr4	25536479	25727150	Fut9	190671	-	NM_010243	25546879	25547959	3
chr4	26251652	26273799	Manea	22147	-	NM_172865	26254797	26268107	5
chr4	26562966	26632596	4930548K13Rik	69630	-	NR_040656	26632596	26632596	3
chr4	28740280	28894653	Epha7	154373	+	NM_010141	28740533	28891153	17
chr4	30591745	30782894	4930556G01Rik	191149	+	NR_040655	30782894	30782894	7
chr4	32051081	32110441	Map3k7	59360	+	NM_009316	32051237	32106656	17
chr4	32504409	32673083	Bach2	168674	+	NM_001109661	32588599	32667271	5
chr4	32646654	32658637	Bach2os	11983	-	NR_026843	32658637	32658637	5
chr4	32687839	32689357	Gja10	1518	-	NM_010289	32687839	32689357	1
chr4	32702444	32740246	Casp8ap2	37802	+	NM_011997	32711086	32736204	11
chr4	32744093	32862192	Mdn1	118099	+	NM_001081392	32744225	32861114	102
chr4	32887233	32889229	Lyrm2	1996	+	NM_175364	32887265	32888198	3
chr4	32891009	33037801	Ankrd6	146792	-	NM_001012451	32893087	32947416	16
chr4	33069972	33109155	Rragd	39183	+	NM_027491	33070437	33105773	7
chr4	33114113	33118298	4933421O10Rik	4185	-	NR_036602	33118298	33118298	2
chr4	33118399	33139339	Ube2j1	20940	+	NM_019586	33118560	33136935	8
chr4	33150086	33182840	Gabrr2	32754	+	NM_008076	33150153	33182560	9
chr4	33219530	33250563	Gabrr1	31033	+	NM_008075	33219628	33249853	10
chr4	33257381	33276712	Pm20d2	19331	-	NM_001034867	33261300	33276355	7
chr4	33295965	33320315	Srsf12	24350	+	NM_177774	33296056	33318268	3
chr4	33332397	33335762	Pnrc1	3365	-	NM_001033225	33333038	33335372	2
chr4	33397285	33589589	Rngtt	192304	+	NM_001305273	33397435	33587389	16
chr4	33525055	33525184	Mir8118	129	+	NR_106198	33525184	33525184	1
chr4	34011606	34035806	Cnr1	24200	+	NM_007726	34030588	34032010	2
chr4	34111846	34137040	Spaca1	25194	-	NM_001290443	34112081	34136971	8
chr4	34497863	34514157	Akirin2	16294	+	NM_001007589	34498293	34513474	5
chr4	34514029	34562191	Orc3	48162	-	NM_001159563	34518161	34562158	20
chr4	34562206	34607416	Rars2	45210	+	NM_181406	34562239	34607319	20
chr4	34610505	34634687	Slc35a1	24182	-	NM_011895	34611354	34634508	8
chr4	34658580	34677455	Cfap206	18875	-	NM_027041	34658629	34676152	11
chr4	34691036	34703508	Gm136	12472	-	NM_001033255	34691104	34703260	5
chr4	34715920	34725586	Smim8	9666	-	NM_025471	34716237	34718641	4
chr4	34750358	34830197	Zfp292	79839	-	NM_013889	34752209	34830168	8
chr4	34841027	34854623	Cga	13596	+	NM_009889	34851255	34854392	4
chr4	34857037	34858730	Platr9	1693	-	NR_040652	34858730	34858730	3
chr4	34896322	35104733	Mob3b	208411	-	NM_178061	34901266	35031436	4
chr4	35099303	35101268	Ifnk	1965	+	NM_199157	35099322	35101067	2
chr4	35138530	35173129	3110043O21Rik	34599	-	NM_001081343	35140130	35166106	11
chr4	35653896	36898777	Lingo2	1244881	-	NM_001165999	35655406	35657227	8
chr4	36592405	36592486	Mir876	81	-	NR_030545	36592486	36592486	1
chr4	36615542	36615619	Mir873a	77	-	NR_030605	36615619	36615619	1
chr4	36615542	36615619	Mir873b	77	+	NR_105849	36615619	36615619	1
chr4	39397325	39398811	1700009N14Rik	1486	+	NM_001081095	39397828	39398479	2
chr4	40090297	40146042	Aco1	55745	+	NM_007386	40110781	40144700	21
chr4	40150809	40186858	Ddx58	36049	-	NM_172689	40152842	40186729	18
chr4	40206638	40216874	Topors	10236	-	NM_134097	40207213	40216709	3
chr4	40216611	40217254	Toporsos	643	+	NR_045265	40217254	40217254	2
chr4	40217623	40226454	Ndufb6	8831	-	NM_001033305	40217811	40226370	4
chr4	40260264	40264752	4930509K18Rik	4488	+	NR_040663	40264752	40264752	3
chr4	40419212	40422686	Tmem215	3474	+	NM_177175	40420957	40421665	2
chr4	40429872	40472581	4933428C19Rik	42709	-	NR_040644	40472581	40472581	7
chr4	40629110	40650227	Aptx	21117	-	NM_001025445	40633591	40642169	8
chr4	40667186	40669874	Gm6297	2688	-	NR_077226	40669874	40669874	3
chr4	40669500	40681998	Dnaja1	12498	+	NM_008298	40670745	40679979	9
chr4	40669949	40670028	Mir207	79	+	NR_029594	40670028	40670028	1
chr4	40682681	40704918	Smu1	22237	-	NM_021535	40684329	40704835	12
chr4	40751614	40801570	B4galt1	49956	-	NM_022305	40754217	40800838	6
chr4	40797088	40797171	Mir5123	83	-	NR_039584	40797171	40797171	1
chr4	40867088	40878428	Spink4	11340	+	NM_011463	40867127	40878335	4
chr4	40883430	40895327	Bag1	11897	-	NM_001171739	40883619	40894827	7
chr4	40895585	40912335	Chmp5	16750	+	NM_029814	40895640	40911678	8
chr4	40917975	40973025	Nfx1	55050	+	NM_023739	40918067	40971906	24
chr4	40940727	40940791	Mir3094	64	+	NR_037277	40940791	40940791	1
chr4	40980106	40995169	Aqp7	15063	-	NM_007473	40981278	40992411	8
chr4	41039756	41045216	Aqp3	5460	-	NM_016689	41040566	41045142	6
chr4	41061459	41071372	Nol6	9913	-	NM_139236	41062389	41071278	26
chr4	41083053	41140403	Ube2r2	57350	+	NM_026275	41083102	41137857	5
chr4	41141347	41222168	Ubap2	80821	-	NM_026872	41142183	41198666	29
chr4	41238332	41261934	Dcaf12	23602	-	NM_026893	41240088	41261598	9
chr4	41296028	41336799	Ubap1	40771	+	NM_023305	41313929	41335854	7
chr4	41337780	41411881	Kif24	74101	-	NM_024241	41339144	41375991	13
chr4	41412180	41427959	Nudt2	15779	+	NM_025539	41424553	41427595	3
chr4	41442633	41450108	AI464131	7475	-	NM_001085515	41444510	41446661	2
chr4	41452041	41464366	1110017D15Rik	12325	-	NM_001048005	41452600	41464195	7
chr4	41464469	41465962	Fam219aos	1493	+	NR_045726	41465962	41465962	3
chr4	41465961	41516560	Fam219a	50599	-	NM_027993	41467272	41516269	6
chr4	41516826	41585191	Dnaic1	68365	+	NM_175138	41517024	41585004	20
chr4	41585176	41587335	Enho	2159	-	NM_027147	41585644	41585875	2
chr4	41604528	41644123	Cntfr	39595	-	NM_016673	41605182	41622136	10
chr4	41659064	41660549	Rpp25l	1485	-	NM_027278	41659313	41659805	2
chr4	41661829	41670195	Dctn3	8366	-	NM_016890	41662201	41670162	7
chr4	41670867	41678174	Arid3c	7307	-	NM_001017362	41671264	41677225	8
chr4	41685365	41688232	Sigmar1	2867	-	NM_001286605	41687499	41688125	4
chr4	41702100	41706097	Galt	3997	+	NM_016658	41702500	41705456	11
chr4	41707315	41716346	Il11ra1	9031	+	NM_001172054	41710454	41715993	14
chr4	41716342	41721007	Ccl27a	4665	-	NM_001048179	41716370	41720655	6
chr4	41763293	42104673	Gm3893	341380	+	NR_033506	42104673	42104673	4
chr4	41774206	41775337	Ccl21c	1131	+	NM_023052	41774278	41774944	4
chr4	41774206	41775337	Gm10591	1131	+	NM_001193668	41774278	41774944	4
chr4	41774206	41775337	Gm13304	1131	+	NM_001193666	41774278	41774944	4
chr4	41774206	41775337	Gm21541	1131	+	NM_001270360	41774278	41774944	4
chr4	41774242	41775337	Ccl21b	1095	+	NM_011335	41774278	41774944	4
chr4	41812375	41813375	Gm20878	1000	+	NM_001270431	41812778	41813367	4
chr4	41812375	41813375	Gm21586	1000	+	NM_001270432	41812778	41813367	4
chr4	41812375	41813410	Gm13308	1035	+	NM_001177580	41812778	41813367	4
chr4	41836783	41842582	Fam205a2	5799	+	NM_001085530	41836845	41842441	4
chr4	42024167	42029569	Ccl27b	5402	+	NM_001199961	42024879	42029541	6
chr4	42024167	42029569	Gm13306	5402	+	NM_001199962	42024879	42029541	6
chr4	42024167	42029569	LOC100861978	5402	+	NM_001267702	42024879	42029541	6
chr4	42027472	42029569	Gm2506	2097	+	NM_001199966	42027772	42029541	3
chr4	42028838	42039327	Gm2002	10489	-	NM_001100596	42029918	42035457	14
chr4	42028838	42039327	Il11ra2	10489	-	NM_010550	42029918	42035457	14
chr4	42029564	42039326	Gm13305	9762	-	NM_001099348	42029918	42035457	14
chr4	42231042	42232176	Gm1987	1134	+	NM_001193667	42231117	42231783	4
chr4	42231044	42232176	Ccl21a	1132	+	NM_011124	42231117	42231783	4
chr4	42248503	42250497	Ccl19	1994	+	NM_011888	42248691	42250292	4
chr4	42860943	42866760	Fam205a1	5817	-	NM_001277167	42861081	42866698	4
chr4	42880874	42887075	Fam205c	6201	-	NM_177785	42881380	42887038	5
chr4	42930122	42954479	Phf24	24357	+	NM_172690	42946491	42952473	10
chr4	42965965	42971604	Dnajb5	5639	+	NM_019874	42966046	42970423	3
chr4	42982817	42987197	1700022I11Rik	4380	+	NM_026088	42982886	42987092	2
chr4	42992835	43013379	Vcp	20544	-	NM_009503	42993400	43013050	17
chr4	43015208	43023173	Fancg	7965	-	NM_001163233	43015855	43022969	14
chr4	43030497	43038686	Pigo	8189	-	NM_001305387	43030780	43037945	11
chr4	43040561	43044256	Stoml2	3695	-	NM_023231	43041036	43044245	10
chr4	43045285	43059092	Fam214b	13807	-	NM_172691	43046406	43049601	9
chr4	43071824	43277745	Unc13b	205921	+	NM_001081413	43072135	43276457	40
chr4	43280030	43386703	Atp8b5	106673	+	NM_177195	43284131	43385881	29
chr4	43394853	43439964	Rusc2	45111	+	NM_001037709	43427567	43439521	12
chr4	43439891	43442006	Fam166b	2115	-	NM_001162381	43440379	43441961	5
chr4	43455148	43460947	Tesk1	5799	+	NM_011571	43456306	43460369	10
chr4	43460595	43467498	Cd72	6903	-	NM_001110320	43461136	43467399	9
chr4	43494954	43496581	Sit1	1627	-	NM_019436	43495486	43496455	5
chr4	43505656	43505931	Rmrp	275	-	NR_001460	43505931	43505931	1
chr4	43506236	43508793	Ccdc107	2557	+	NM_001037913	43506302	43508774	6
chr4	43509015	43512532	Arhgef39	3517	-	NM_001013377	43509549	43512479	9
chr4	43519897	43526597	Car9	6700	+	NM_139305	43519927	43525982	11
chr4	43526597	43536426	Tpm2	9829	-	NM_009416	43528792	43536226	9
chr4	43544384	43575455	Tln1	31071	-	NM_011602	43544831	43569622	57
chr4	43575505	43579932	Creb3	4427	+	NM_013497	43575684	43579669	9
chr4	43579799	43591736	Gba2	11937	-	NM_172692	43580060	43591219	17
chr4	43591606	43600359	Rgp1	8753	+	NM_172866	43592265	43595955	9
chr4	43596087	43597366	Msmp	1279	-	NM_001099314	43596184	43597140	3
chr4	43644806	43664112	Npr2	19306	+	NM_173788	43645056	43663850	22
chr4	43664201	43666466	Spag8	2265	-	NM_001290462	43664331	43666413	7
chr4	43667098	43669317	Hint2	2219	-	NM_026871	43667191	43669311	5
chr4	43672493	43681731	Fam221b	9238	-	NM_175517	43672526	43679481	7
chr4	43681842	43705539	Tmem8b	23697	+	NM_001085508	43694877	43703234	13
chr4	43707871	43713679	Olfr70	5808	-	NM_019485	43709092	43710043	2
chr4	43718499	43719438	Olfr71	939	-	NM_019486	43718499	43719438	1
chr4	43740069	43740982	Hrct1	913	+	NM_027511	43740233	43740563	1
chr4	43742905	43747406	5430416O09Rik	4501	+	NR_033355	43747406	43747406	2
chr4	43764730	43772336	A630077J23Rik	7606	+	NR_040667	43772336	43772336	4
chr4	43782921	43783881	Olfr159	960	-	NM_019476	43782921	43783881	1
chr4	43794236	43795199	Olfr29-ps1	963	-	NR_033638	43795199	43795199	1
chr4	43833206	43834305	Olfr156	1099	-	NM_019474	43833274	43834231	1
chr4	43847623	43849389	Olfr157	1766	-	NM_019475	43848403	43849360	1
chr4	43867163	43868335	Olfr155	1172	+	NM_019473	43867182	43868142	1
chr4	43888401	43957678	Reck	69277	+	NM_016678	43888477	43956237	21
chr4	43970573	43991990	Glipr2	21417	+	NM_027450	43970632	43990495	5
chr4	43996375	43998405	Ccin	2030	+	NM_001002787	43996466	43998233	1
chr4	44025514	44045718	Clta	20204	+	NM_001080385	44025663	44045444	7
chr4	44046946	44097049	Gne	50103	-	NM_015828	44049989	44096970	12
chr4	44134764	44136995	Gm12504	2231	+	NR_040414	44136995	44136995	1
chr4	44139083	44181155	Rnf38	42072	-	NM_001038993	44142465	44165338	12
chr4	44234066	44234139	Mir5106	73	-	NR_039565	44234139	44234139	1
chr4	44313788	44377547	Melk	63759	+	NM_010790	44316480	44376759	18
chr4	44544377	44723312	Pax5	178935	-	NM_008782	44544377	44723280	10
chr4	44620362	44620440	Mir5120	78	-	NR_039580	44620440	44620440	1
chr4	44715671	44717982	5730488B01Rik	2311	+	NR_073462	44717982	44717982	1
chr4	44769430	44945086	Zcchc7	175656	+	NM_138590	44774745	44944347	9
chr4	44994265	45003606	Grhpr	9341	+	NM_001312880	44998209	45003370	9
chr4	45004114	45025284	Zbtb5	21170	-	NM_001163284	45006241	45008254	2
chr4	45031480	45047151	Polr1e	15671	+	NM_001285800	45031543	45044972	14
chr4	45047119	45097476	Fbxo10	50357	-	NM_001024142	45048779	45075396	11
chr4	45118081	45120985	Tomm5	2904	-	NM_001134646	45118501	45120905	3
chr4	45197777	45298808	Frmpd1	101031	+	NM_001081172	45242706	45298702	16
chr4	45247594	45256862	Frmpd1os	9268	-	NR_040666	45256862	45256862	3
chr4	45310039	45329003	Trmt10b	18964	+	NM_027266	45313316	45327993	9
chr4	45329501	45333475	Exosc3	3974	-	NM_025513	45329698	45333463	4
chr4	45354972	45392594	Dcaf10	37622	+	NM_153167	45355039	45387149	7
chr4	45408795	45421638	Slc25a51	12843	-	NM_001009949	45412112	45413009	3
chr4	45436147	45543700	Shb	107553	-	NM_001033306	45436811	45543132	6
chr4	45696460	45736578	Gm829	40118	+	NM_001033412	45696616	45731663	3
chr4	45775248	45777095	Gm12409	1847	-	NR_046068	45777095	45777095	3
chr4	45811893	45817480	Aldh1b1	5587	+	NM_028270	45815335	45816895	2
chr4	45822378	45839699	Igfbpl1	17321	-	NM_018741	45826272	45839665	5
chr4	45861687	45899882	Stra6l	38195	+	NM_001305421	45877820	45898271	19
chr4	45903174	45963646	Ccdc180	60472	+	NM_198660	45903237	45963623	38
chr4	45978206	46047637	Tdrd7	69431	+	NM_001290475	45978255	46047388	17
chr4	46052093	46128904	Tmod1	76811	+	NM_021883	46073886	46127250	10
chr4	46127618	46151347	Tstd2	23729	-	NM_173033	46129716	46148423	10
chr4	46151382	46185274	Ncbp1	33892	+	NM_001033201	46151724	46184878	23
chr4	46188093	46209183	Xpa	21090	-	NM_011728	46188138	46209092	6
chr4	46357065	46358181	Foxe1	1116	+	NM_183298	46357065	46358181	1
chr4	46389846	46402295	Trmo	12449	-	NM_029086	46389907	46402265	6
chr4	46406860	46417055	Hemgn	10195	-	NM_053149	46407468	46416865	4
chr4	46463988	46485395	Anp32b	21407	+	NM_130889	46464167	46485026	7
chr4	46502200	46516310	Nans	14110	+	NM_053179	46502230	46515516	6
chr4	46517943	46549013	Trim14	31070	-	NM_029077	46519763	46548952	6
chr4	46549808	46614801	Coro2a	64993	-	NM_001164804	46552007	46575967	12
chr4	46617261	46663071	Tbc1d2	45810	-	NM_198664	46618632	46662906	13
chr4	46676769	47004586	Gabbr2	327817	-	NM_001081141	46677655	47004297	19
chr4	47028560	47070178	Anks6	41618	-	NM_001024136	47029638	47070152	15
chr4	47104824	47135914	Galnt12	31090	+	NM_172693	47104844	47135449	10
chr4	47220883	47326037	Col15a1	105154	+	NM_009928	47221223	47325162	40
chr4	47366093	47427796	Tgfbr1	61703	+	NM_009370	47366183	47423649	9
chr4	47482704	47487239	Alg2	4535	-	NM_019998	47484430	47487158	2
chr4	47487532	47496105	Sec61b	8573	+	NM_024171	47487622	47495934	4
chr4	48058176	48099318	Nr4a3	41142	+	NM_015743	48064119	48096224	8
chr4	48137790	48199378	Stx17	61588	+	NM_026343	48144698	48194610	8
chr4	48206202	48292461	Erp44	86259	-	NM_029572	48207479	48292312	12
chr4	48225990	48226087	Mir1958	97	-	NR_035484	48226087	48226087	1
chr4	48292631	48444825	Invs	152194	+	NM_001281978	48409178	48442580	19
chr4	48443827	48486294	Tex10	42467	-	NM_172304	48443841	48482935	16
chr4	48552817	48574792	Msantd3	21975	+	NM_001145925	48565284	48574125	3
chr4	48598064	48676003	Tmeff1	77939	+	NM_021436	48598341	48674957	10
chr4	48676385	48686364	Murc	9979	+	NM_026509	48676493	48685517	2
chr4	49072333	49353133	Plppr1	280800	+	NM_178756	49219304	49350550	8
chr4	49392716	49421023	Acnat2	28307	-	NM_145368	49392985	49396423	5
chr4	49456403	49463981	Acnat1	7578	-	NM_001164565	49460200	49463981	3
chr4	49502289	49519430	Baat	17141	-	NM_007519	49502691	49515992	4
chr4	49525468	49533955	Mrpl50	8487	-	NM_178603	49527061	49533925	2
chr4	49534047	49544430	Zfp189	10383	+	NM_001289901	49534434	49543597	4
chr4	49548864	49562418	Aldob	13554	-	NM_144903	49549664	49557780	9
chr4	49597377	49610742	Tmem246	13365	-	NM_025944	49598826	49600038	2
chr4	49644931	49669758	Rnf20	24827	+	NM_182999	49646153	49668849	21
chr4	49674482	49858641	Grin3a	184159	-	NM_001033351	49678097	49857953	9
chr4	49691618	49694855	Ppp3r2	3237	-	NM_001004025	49694028	49694820	2
chr4	51229549	51242800	Cylc2	13251	+	NM_001162865	51229577	51242800	5
chr4	51980965	52063982	C630028M04Rik	83017	-	NR_040668	52063982	52063982	3
chr4	52443155	52451836	Smc2os	8681	-	NR_045175	52451836	52451836	2
chr4	52452092	52501237	Smc2	49145	+	NM_008017	52453127	52499527	25
chr4	52609145	52625035	Toporsl	15890	+	NM_026652	52622980	52625032	2
chr4	52827475	52841141	4930552N02Rik	13666	+	NR_040661	52841141	52841141	4
chr4	52838270	52839230	Olfr275	960	+	NM_146858	52838270	52839230	1
chr4	52868429	52869383	Olfr273	954	-	NM_146824	52868429	52869383	1
chr4	52923704	52924664	Olfr272	960	-	NM_146839	52923704	52924664	1
chr4	52983500	52984439	Olfr270	939	+	NM_146607	52983500	52984439	1
chr4	53002155	53013726	Nipsnap3a	11571	+	NM_028529	53002310	53013246	7
chr4	53024795	53034931	Nipsnap3b	10136	+	NM_025623	53024859	53034232	6
chr4	53043660	53172767	Abca1	129107	-	NM_013454	53046814	53156867	50
chr4	53259067	53263992	4930522O17Rik	4925	+	NR_040665	53263992	53263992	3
chr4	53274227	53283104	AI427809	8877	-	NR_033139	53283104	53283104	2
chr4	53453284	53635350	Slc44a1	182066	+	NM_133891	53453555	53634481	16
chr4	53644342	53719881	Fsd1l	75539	+	NM_001195284	53644469	53714035	13
chr4	53727053	53776143	Fktn	49090	+	NM_139309	53732976	53774259	10
chr4	53792576	53799757	Tal2	7181	+	NM_009317	53798692	53799019	2
chr4	53838916	53874890	Tmem38b	35974	+	NM_028053	53838980	53872972	6
chr4	54960816	55096435	Zfp462	135619	+	NM_172867	55020434	55093745	13
chr4	55362913	55405109	Rad23b	42196	+	NM_009011	55363233	55402869	10
chr4	55423314	55431714	Gm12505	8400	-	NR_040674	55431714	55431714	4
chr4	55540008	55545347	Klf4	5339	-	NM_010637	55540996	55544743	5
chr4	56752876	56754297	Actl7b	1421	-	NM_025271	56752971	56754228	1
chr4	56756293	56757797	Actl7a	1504	+	NM_009611	56756346	56757669	1
chr4	56762551	56815203	Ikbkap	52652	-	NM_026079	56764523	56812996	37
chr4	56815200	56822477	Fam206a	7277	+	NM_001081420	56815483	56819043	6
chr4	56823806	56878083	Ctnnal1	54277	-	NM_018761	56825200	56877986	19
chr4	56888884	56960301	Tmem245	71417	-	NM_175518	56893118	56960283	18
chr4	56908100	56908170	Mir32	70	-	NR_029789	56908170	56908170	1
chr4	56973007	57003263	Frrs1l	30256	-	NM_001142965	56975859	57003143	5
chr4	57074597	57156028	Epb41l4b	81431	-	NM_019427	57075976	57156025	16
chr4	57184942	57189426	Gm12530	4484	+	NR_040669	57189426	57189426	5
chr4	57203712	57314709	Ptpn3	110997	-	NM_011207	57207156	57283032	26
chr4	57372663	57377164	1700042G15Rik	4501	-	NR_038179	57377164	57377164	3
chr4	57581119	57730000	Palm2	148881	+	NM_172868	57581242	57723059	6
chr4	57581119	57909856	Pakap	328737	+	NM_001304544	57581242	57905839	9
chr4	57858119	57909856	Akap2	51737	+	NM_001035532	57867544	57905839	4
chr4	57921255	57929136	D630039A03Rik	7881	-	NM_178727	57922971	57928667	2
chr4	57956244	57969283	Txn1	13039	-	NM_011660	57956776	57969082	5
chr4	57996900	58021996	Txndc8	25096	-	NM_026132	57997039	58021979	6
chr4	58055667	58219468	Svep1	163801	-	NM_022814	58056018	58219248	48
chr4	58298833	58387175	Musk	88342	+	NM_001037127	58298983	58386585	16
chr4	58448123	58566363	Lpar1	118240	-	NM_010336	58450204	58517538	4
chr4	58453883	58453970	Mir3095	87	-	NR_037278	58453970	58453970	1
chr4	58797650	58798592	Olfr267	942	-	NM_146920	58797650	58798592	1
chr4	58812902	58925597	AI314180	112695	-	NM_172381	58813052	58925369	49
chr4	58956499	58971227	Zkscan16	14728	+	NM_001099323	58958998	58970778	6
chr4	58978461	58999950	Ptgr1	21489	-	NM_025968	58979524	58997721	10
chr4	59016064	59036270	Dnajc25	20206	+	NM_001033165	59016102	59035555	4
chr4	59048027	59054771	Gng10	6744	+	NM_025277	59048109	59052224	3
chr4	59202421	59235705	Ugcg	33284	+	NM_011673	59202515	59233265	9
chr4	59272922	59282016	Gm12596	9094	+	NR_105031	59282016	59282016	4
chr4	59327554	59451505	Susd1	123951	-	NM_001163288	59328280	59451195	17
chr4	59484739	59562236	Ptbp3	77497	-	NM_144904	59489754	59562027	15
chr4	59594434	59631566	Hsdl2	37132	+	NM_001301367	59607347	59630619	12
chr4	59639082	59767175	E130308A19Rik	128093	+	NM_001015681	59703039	59765911	4
chr4	59782518	59796727	Inip	14209	-	NM_001013577	59785235	59795150	5
chr4	59818521	59917612	Snx30	99091	+	NM_172468	59818941	59911839	9
chr4	59918770	59927928	Slc46a2	9158	-	NM_021053	59919255	59927793	4
chr4	59969677	59973537	Mup4	3860	-	NM_008648	59970736	59973471	7
chr4	60016420	60019086	Mup6	2666	+	NM_001081285	60016420	60019086	6
chr4	60079340	60083347	Mup7	4007	-	NM_001134675	60079490	60083172	7
chr4	60079340	60152730	Mup15	73390	-	NM_001200004	60080401	60152658	7
chr4	60231492	60235471	Mup8	3979	-	NM_001134676	60231640	60235341	7
chr4	60430918	60434824	Mup9	3906	-	NM_001281979	60431979	60434758	7
chr4	60510884	60514832	Mup1	3948	-	NM_031188	60511947	60514721	7
chr4	60591132	60595027	Mup10	3895	-	NM_001122647	60592192	60594960	7
chr4	60591132	60675237	Gm2083	84105	-	NM_001134644	60592192	60675172	7
chr4	60671338	60675267	Mup11	3929	-	NM_001164526	60672399	60675172	7
chr4	60732253	60736153	Mup12	3900	-	NM_001199995	60733316	60736087	7
chr4	60885338	60889318	Mup13	3980	-	NM_001134674	60885488	60889192	7
chr4	60961050	61100734	Mup2	139684	-	NM_008647	60962131	61100664	7
chr4	60961068	60965030	Mup14	3962	-	NM_001199999	60962131	60964921	7
chr4	61176624	61180518	Mup16	3894	-	NM_001199936	61177682	61180452	7
chr4	61252962	61256864	Mup17	3902	-	NM_001200006	61254020	61256792	7
chr4	61331211	61335128	Mup18	3917	-	NM_001199333	61332273	61335059	7
chr4	61439361	61443258	Mup19	3897	-	NM_001135127	61440420	61443192	7
chr4	61492352	61496214	Mup5	3862	-	NM_008649	61493395	61496156	7
chr4	61711268	61715151	Mup20	3883	-	NM_001012323	61712325	61715083	7
chr4	61744510	61748346	Mup3	3836	-	NM_001039544	61745601	61748265	7
chr4	61808865	61811875	Mup21	3010	-	NM_001009550	61808985	61811786	6
chr4	61850570	61869580	Zfp37	19010	-	NM_001290350	61852197	61869395	4
chr4	61947462	61959446	Slc31a2	11984	+	NM_025286	61947602	61958177	4
chr4	61961375	62021582	Fkbp15	60207	-	NM_001045528	61961940	62021456	28
chr4	62021734	62052803	Slc31a1	31069	+	NM_175090	62046565	62049833	5
chr4	62055622	62069657	Cdc26	14035	-	NM_139291	62055878	62063838	4
chr4	62069816	62088024	Prpf4	18208	+	NM_027297	62069908	62084445	14
chr4	62088575	62095760	Rnf183	7185	-	NM_153504	62089020	62089593	3
chr4	62113665	62131929	Wdr31	18264	-	NM_001290522	62114810	62125076	11
chr4	62141100	62158332	Bspry	17232	+	NM_138653	62141126	62158076	7
chr4	62160087	62163234	Hdhd3	3147	-	NM_024257	62160215	62160971	2
chr4	62167017	62181097	Alad	14080	-	NM_008525	62170282	62175220	12
chr4	62184834	62186048	Pole3	1214	-	NM_021498	62184977	62186030	4
chr4	62186402	62209027	4933430I17Rik	22625	+	NM_177607	62186851	62208796	15
chr4	62220880	62320881	Rgs3	100001	+	NM_019492	62242961	62318244	20
chr4	62626607	62795064	Zfp618	168457	+	NM_028326	62626707	62794879	15
chr4	62804308	62815206	Ambp	10898	-	NM_007443	62804408	62815089	10
chr4	62826663	62833165	Kif12	6502	-	NM_001317352	62826865	62833039	19
chr4	62876445	62996024	Col27a1	119579	+	NM_025685	62876859	62994342	61
chr4	62917884	62917966	Mir455	82	+	NR_030477	62917966	62917966	1
chr4	63005589	63009197	Orm1	3608	+	NM_008768	63005631	63009084	6
chr4	63017195	63020545	Orm3	3350	+	NM_013623	63017233	63020431	6
chr4	63023482	63026911	Orm2	3429	+	NM_011016	63023520	63026799	6
chr4	63028156	63064479	Akna	36323	-	NM_001045514	63029079	63059158	22
chr4	63075943	63157025	Whrn	81082	-	NM_001008791	63076517	63156267	13
chr4	63205798	63211735	Atp6v1g1	5937	+	NM_024173	63205951	63211152	3
chr4	63221393	63247387	6330416G13Rik	25994	+	NM_144905	63223556	63244999	10
chr4	63257934	63266295	Gm11213	8361	-	NR_028583	63266295	63266295	2
chr4	63268124	63283463	1700018C11Rik	15339	-	NM_029324	63268345	63273481	5
chr4	63385636	63406147	Tnfsf15	20511	-	NM_177371	63390622	63406118	4
chr4	63493857	63522318	Tnfsf8	28461	-	NM_009403	63495140	63522093	4
chr4	63620818	63708049	Tnc	87231	-	NM_011607	63621466	63681634	26
chr4	64785207	65018543	Pappa	233336	+	NM_021362	64785575	65012759	22
chr4	65041836	66065517	Astn2	1023681	-	NM_207109	65042485	66065394	23
chr4	65266019	65277274	Trim32	11255	+	NM_001161782	65274241	65276209	2
chr4	66488584	66507615	Tlr4	19031	+	NM_021297	66488865	66502513	3
chr4	68422405	68615431	Brinp1	193026	-	NM_019967	68423042	68565988	8
chr4	69877888	70071469	Cdk5rap2	193581	-	NM_145990	69884091	70071301	37
chr4	70092960	70195962	Megf9	103002	-	NM_172694	70094113	70195856	6
chr4	71770978	71861927	Tle1	90949	-	NM_011599	71779317	71861039	20
chr4	71862277	71864964	C630043F03Rik	2687	+	NR_027923	71864964	71864964	1
chr4	72511616	72513668	Aldoart1	2052	-	NM_001199270	72512343	72513603	1
chr4	73062065	73066106	Gm11487	4041	-	NM_001013393	73062206	73065989	6
chr4	73266577	73272959	Gm11238	6382	+	NM_001277512	73266577	73272835	6
chr4	73296797	73303176	Gm38423	6379	+	NM_001256481	73296797	73303055	6
chr4	73296797	73303179	Gm11236	6382	+	NM_001277531	73296797	73303055	6
chr4	73296797	73303179	Gm11237	6382	+	NM_001277575	73296797	73303055	6
chr4	73327081	73333464	Gm11239	6383	+	NM_001277487	73327081	73333340	6
chr4	73329417	73333463	Gm428	4046	+	NM_001081644	73329536	73333340	6
chr4	73360482	73436506	Rasef	76024	-	NM_001017427	73363571	73426326	18
chr4	73437147	73444282	Gm11240	7135	+	NR_046042	73444282	73444282	3
chr4	73518122	73522138	Gm13871	4016	-	NM_001177578	73518245	73522051	6
chr4	73518122	73522170	Gm11758	4048	-	NM_001097978	73518245	73522051	6
chr4	73518123	73522138	Gm11757	4015	-	NM_001085538	73518245	73522051	6
chr4	73585274	73596750	2310002L09Rik	11476	-	NM_027104	73585482	73596603	3
chr4	73659506	73848118	Frmd3	188612	+	NM_001163732	73659673	73847906	15
chr4	73888400	74051768	Kdm4c	163368	+	NM_001172095	73888510	74050901	22
chr4	74923257	74924190	Tmem261	933	-	NM_025849	74923608	74924155	2
chr4	75587140	77857799	Ptprd	2270659	-	NM_011211	75590861	75971168	40
chr4	78239950	78243388	A430085M09Rik	3438	+	NR_131142	78243388	78243388	3
chr4	80480116	80497640	Tyrp1	17524	+	NM_001282015	80480977	80496788	8
chr4	80556589	80600205	Lurap1l	43616	+	NM_026821	80557258	80599841	2
chr4	80924402	81088719	Mpdz	164317	-	NM_001305284	80925526	81067092	48
chr4	81711283	81748711	Gm5860	37428	+	NR_040659	81748711	81748711	3
chr4	81936076	82151683	Nfib	215607	-	NM_001113210	81942585	82150664	12
chr4	82444641	82505565	Zdhhc21	60924	-	NM_026647	82452232	82493600	9
chr4	82527654	82531055	Cer1	3401	-	NM_009887	82528509	82530987	2
chr4	82543823	82698071	Frem1	154248	-	NM_001198811	82546302	82666747	37
chr4	82866204	82970093	Ttc39b	103889	-	NM_027238	82873037	82970016	20
chr4	83024220	83036572	Gm11413	12352	-	NR_045450	83036572	83036572	3
chr4	83063647	83099244	Snapc3	35597	+	NM_029949	83063656	83099092	9
chr4	83101584	83132352	Psip1	30768	-	NM_133948	83102922	83131692	16
chr4	83171448	83510574	Ccdc171	339126	+	NM_001081012	83181794	83510351	26
chr4	83687943	83690783	6030471H07Rik	2840	-	NR_130998	83690783	83690783	2
chr4	83918445	84320990	Bnc2	402545	-	NM_172870	83921690	84320881	6
chr4	84530212	84777825	Cntln	247613	+	NM_175275	84530368	84776647	26
chr4	84851359	85035283	Sh3gl2	183924	+	NM_019535	84851480	85033657	9
chr4	85699818	86074286	Adamtsl1	374468	+	NM_029967	85699961	86071852	28
chr4	86090601	86204207	Saxo1	113606	-	NM_001081096	86090717	86203919	4
chr4	86204347	86205708	Saxo1os	1361	+	NR_131920	86205708	86205708	2
chr4	86221576	86223187	Rraga	1611	+	NM_178376	86221822	86222764	1
chr4	86227188	86257926	Haus6	30738	-	NM_173400	86227872	86257717	17
chr4	86232356	86232474	Scarna8	118	-	NR_028545	86232474	86232474	1
chr4	86302468	86315963	Plin2	13495	-	NM_007408	86302936	86314583	8
chr4	86394458	86496506	Dennd4c	102048	+	NM_184088	86420158	86494810	32
chr4	86500002	86503271	Rps6	3269	-	NM_009096	86500605	86503230	5
chr4	86520317	86578394	Acer2	58077	+	NM_001290543	86520392	86577954	6
chr4	86629029	86876444	Slc24a2	247415	-	NM_172426	86637247	86873719	11
chr4	87415828	87679311	Mllt3	263483	-	NM_027326	87419918	87678999	11
chr4	87740533	88056915	Focad	316382	+	NM_001081184	87767205	88056594	44
chr4	87767943	87768029	Mir491	86	+	NR_030478	87768029	87768029	1
chr4	88058833	88084830	Hacd4	25997	-	NM_025760	88060167	88084774	7
chr4	88167928	88168698	Ifnb1	770	-	NM_010510	88168129	88168678	1
chr4	88203576	88204149	Ifna15	573	-	NM_206870	88203576	88204149	1
chr4	88217132	88217702	Ifna14	570	-	NM_206975	88217132	88217702	1
chr4	88237716	88238289	Ifna9	573	-	NM_010507	88237716	88238289	1
chr4	88248483	88249280	Ifna12	797	-	NM_177361	88248642	88249212	1
chr4	88273223	88280090	C87499	6867	-	NM_198663	88273525	88280046	4
chr4	88289544	88290363	Ifna13	819	-	NM_177347	88289719	88290289	1
chr4	88322190	88322760	Ifna16	570	-	NM_206867	88322190	88322760	1
chr4	88329110	88329683	Ifna2	573	-	NM_010503	88329110	88329683	1
chr4	88336502	88337172	Ifnab	670	-	NM_008336	88336558	88337131	1
chr4	88364195	88368412	Klhl9	4217	-	NM_172871	88366052	88367906	1
chr4	88400771	88401320	Gm13271	549	+	NM_001085528	88400771	88401320	1
chr4	88403747	88404296	Gm13286	549	+	NM_001243150	88403747	88404284	1
chr4	88406677	88407488	Gm13283	811	+	NM_001085531	88406677	88407226	1
chr4	88419737	88420705	Gm13289	968	+	NM_001243165	88419897	88420446	1
chr4	88419897	88420446	Gm13285	549	+	NM_001161609	88419897	88420446	1
chr4	88422665	88423633	Gm13290	968	+	NM_001243155	88422825	88423374	1
chr4	88425753	88426564	Gm13272	811	+	NM_001161608	88425753	88426302	1
chr4	88428034	88429496	Ifnz	1462	+	NM_197889	88428689	88429238	1
chr4	88430957	88432419	Gm13276	1462	+	NM_001085532	88431612	88432161	1
chr4	88433880	88435342	Gm13277	1462	+	NM_001098840	88434535	88435084	1
chr4	88442645	88444107	Gm13278	1462	+	NM_001098841	88443300	88443849	1
chr4	88443140	88444108	Gm13279	968	+	NM_001243166	88443300	88443849	1
chr4	88445478	88447034	Gm13275	1556	+	NM_001085533	88446223	88446772	1
chr4	88446223	88446772	Gm13287	549	+	NM_001161610	88446223	88446772	1
chr4	88451434	88454284	Gm13288	2850	+	NM_001243167	88452089	88452638	1
chr4	88462128	88462704	Ifna7	576	+	NM_008334	88462131	88462704	1
chr4	88465822	88466469	Ifna11	647	+	NM_008333	88465862	88466435	1
chr4	88473319	88473889	Ifna6	570	+	NM_206871	88473319	88473889	1
chr4	88481428	88481998	Ifna5	570	+	NM_010505	88481428	88481998	1
chr4	88487719	88488363	Ifna4	644	+	NM_010504	88487764	88488325	1
chr4	88495990	88496560	Ifna1	570	+	NM_010502	88495990	88496560	1
chr4	88525441	88526105	Ifne	664	-	NM_177348	88525504	88526083	1
chr4	88555757	88587946	LOC106557447	32189	-	NR_132734	88587946	88587946	4
chr4	88556460	88556566	Mir31	106	-	NR_029747	88556566	88556566	1
chr4	88696210	88730514	Gm12603	34304	+	NR_033533	88730514	88730514	3
chr4	88783273	88826994	Mtap	43721	+	NM_024433	88783395	88825410	8
chr4	88920376	88940523	Cdkn2a	20147	-	NM_009877	88922569	88940427	3
chr4	88941083	89185312	Gm12610	244229	+	NR_132431	89185312	89185312	10
chr4	88952197	88956941	Cdkn2b	4744	-	NM_007670	88952962	88956706	2
chr4	89354888	89361457	Dmrta1	6569	+	NM_175647	89354999	89358968	2
chr4	89885510	89892378	Zfp352	6868	+	NM_153102	89890315	89891971	2
chr4	90026315	90028005	Gm12633	1690	-	NR_033610	90028005	90028005	1
chr4	90917456	91066675	Elavl2	149219	-	NM_207685	90919930	91066155	8
chr4	91039974	91040054	Mir6402	80	-	NR_105828	91040054	91040054	1
chr4	91811008	91813912	Izumo3	2904	-	NM_027034	91811236	91813669	7
chr4	93000838	93002202	Tusc1	1364	-	NM_026954	93001493	93002111	1
chr4	94166769	94223487	Caap1	56718	-	NM_026368	94167715	94223395	6
chr4	94231829	94269938	Plaa	38109	-	NM_172695	94236037	94269716	14
chr4	94260340	94267010	Gm12657	6670	+	NM_001081019	94266075	94266486	2
chr4	94281181	94359924	Ift74	78743	+	NM_026319	94284672	94359760	20
chr4	94303350	94316835	Lrrc19	13485	-	NM_175305	94304914	94310064	5
chr4	94331847	94331928	Mir872	81	+	NR_030604	94331928	94331928	1
chr4	94405979	94541667	Tek	135688	+	NM_001290549	94406331	94540689	23
chr4	94573957	94595534	Eqtn	21577	-	NM_001290623	94574139	94595443	9
chr4	94608731	94645791	Mysm1	37060	-	NM_177239	94613655	94645756	20
chr4	94715726	94718913	Jun	3187	-	NM_010591	94716957	94717962	1
chr4	95224197	95593630	Fggy	369433	+	NM_001113412	95251934	95593495	16
chr4	95626401	95634346	9530080O11Rik	7945	-	NR_045776	95634346	95634346	2
chr4	95634069	95690965	Hook1	56896	+	NM_030014	95634184	95689028	22
chr4	95709350	95744231	Cyp2j13	34881	-	NM_145548	95712140	95744159	9
chr4	95766008	95807843	Cyp2j12	41835	-	NM_001100182	95766333	95807733	9
chr4	95961198	96015371	Cyp2j11	54173	-	NM_001004141	95961505	96015258	9
chr4	96111278	96174077	Cyp2j8	62799	-	NM_001104927	96111286	96174077	9
chr4	96182828	96220342	Cyp2j6	37514	-	NM_010008	96184717	96220142	9
chr4	96235119	96258176	Cyp2j9	23057	-	NM_028979	96235414	96258036	9
chr4	96294122	96330810	Cyp2j5	36688	-	NM_010007	96296158	96330701	9
chr4	96390577	96451851	Gm12695	61274	-	NM_001081284	96390577	96451851	11
chr4	97234565	97251282	E130114P18Rik	16717	-	NR_015513	97251282	97251282	3
chr4	97248633	97785567	Nfia	536934	+	NM_001122952	97248667	97777926	11
chr4	98022060	98049956	Tm2d1	27896	-	NM_053157	98024627	98049927	7
chr4	98062516	98386294	Inadl	323778	+	NM_172696	98072103	98384627	44
chr4	98393444	98405177	L1td1	11733	+	NM_001081202	98399893	98404807	5
chr4	98421582	98484228	Kank4	62646	-	NM_172872	98423153	98452365	10
chr4	98460458	98465728	Kank4os	5270	+	NR_040437	98465728	98465728	3
chr4	98590500	98602233	Usp1	11733	+	NM_001301414	98593195	98601496	9
chr4	98603349	98787606	Dock7	184257	-	NM_001290636	98603948	98787453	49
chr4	98697644	98704883	Angptl3	7239	+	NM_013913	98697695	98704693	7
chr4	98860624	98926478	Atg4c	65854	+	NM_175029	98879326	98925255	11
chr4	99322989	99325362	Foxd3	2373	+	NM_010425	99323315	99324725	1
chr4	99382320	99430151	Alg6	47831	+	NM_001081264	99385842	99428759	15
chr4	99432092	99495809	Itgb3bp	63717	-	NM_026348	99436185	99495778	9
chr4	99496190	99585388	Efcab7	89198	+	NM_145549	99498084	99585215	12
chr4	99602055	99659899	Pgm2	57844	+	NM_028132	99602170	99659369	11
chr4	99768395	100117411	Ror1	349016	+	NM_013845	99768823	100114850	9
chr4	100151471	100222750	Ube2u	71279	+	NM_001033773	100151786	100222607	10
chr4	100449283	100676353	Cachd1	227070	+	NM_198037	100449733	100675705	27
chr4	100741642	100824975	Raver2	83333	+	NM_183024	100741718	100823083	12
chr4	100824578	100937887	Jak1	113309	-	NM_146145	100826099	100866393	25
chr4	101019128	101028853	E130102H24Rik	9725	-	NR_040708	101028853	101028853	2
chr4	101019549	101019632	Mir101a	83	-	NR_029537	101019632	101019632	1
chr4	101026387	101071790	0610043K17Rik	45403	+	NR_040640	101071790	101071790	4
chr4	101091893	101140376	Ak4	48483	+	NM_001177602	101092425	101136272	6
chr4	101169252	101315404	Dnajc6	146152	+	NM_198412	101270422	101313178	20
chr4	101320387	101331963	Leprot	11576	+	NM_175036	101320414	101330559	4
chr4	101390011	101487959	Lepr	97948	+	NM_146146	101400634	101487874	19
chr4	101507573	101516627	B020004J07Rik	9054	-	NM_001033790	101507975	101510717	4
chr4	101613011	101615788	Gm12794	2777	+	NM_001085516	101613011	101615788	3
chr4	101659444	101662836	Gm12789	3392	+	NM_001085520	101660720	101662619	4
chr4	101927543	102279867	Pde4b	352324	+	NM_019840	101927825	102277944	15
chr4	102432739	102645287	Sgip1	212548	+	NM_001285852	102433160	102642684	26
chr4	102639870	102662360	Gm12709	22490	-	NR_040444	102662360	102662360	4
chr4	102658983	102678199	Tctex1d1	19216	+	NM_001163767	102661177	102676949	5
chr4	102676710	102684570	BB031773	7860	-	NR_028391	102684570	102684570	4
chr4	102690477	102699447	Insl5	8970	-	NM_001290648	102690718	102699447	3
chr4	102710669	102786904	Wdr78	76235	-	NM_146254	102711895	102786761	17
chr4	102786994	102838359	Mier1	51365	+	NM_027696	102790860	102835356	15
chr4	102844322	102887489	Slc35d1	43167	-	NM_177732	102846276	102887471	10
chr4	102903050	102963468	4921539E11Rik	60418	-	NM_027612	102903574	102957067	9
chr4	102963563	102984437	4930456L15Rik	20874	+	NR_045887	102984437	102984437	4
chr4	102986450	103039033	Oma1	52583	+	NM_025909	102991645	103038790	9
chr4	103055104	103164793	Gm12718	109689	+	NR_040673	103164793	103164793	4
chr4	104040142	104417449	Dab1	377307	+	NR_104385	104417449	104417449	16
chr4	104438921	104477153	C8b	38232	+	NM_133882	104439002	104476765	12
chr4	104488284	104549003	C8a	60719	-	NM_001316667	104488491	104548961	12
chr4	104586060	104689468	1700024P16Rik	103408	+	NR_104376	104689468	104689468	21
chr4	104702254	104782503	Prkaa2	80249	-	NM_178143	104708696	104782403	9
chr4	104829951	104905372	Plpp3	75421	+	NM_080555	104830429	104903627	6
chr4	105988817	106113932	Usp24	125115	+	NM_183225	105989076	106111444	68
chr4	106114938	106136930	Pcsk9	21992	-	NM_153565	106115950	106136515	12
chr4	106156062	106164848	Bsnd	8786	-	NM_080458	106157650	106164646	4
chr4	106233642	106261718	Dhcr24	28076	+	NM_053272	106233771	106259370	9
chr4	106263513	106289843	Lexm	26330	-	NM_183182	106264219	106289824	10
chr4	106295053	106312792	Ttc22	17739	+	NM_177667	106295155	106312066	7
chr4	106323673	106327887	Pars2	4214	+	NM_172272	106325735	106327163	2
chr4	106334412	106351549	Ttc4	17137	-	NM_028209	106335739	106351468	10
chr4	106353021	106400535	Mroh7	47514	-	NM_001126487	106353242	106394084	24
chr4	106406519	106420897	Fam151a	14378	+	NM_146149	106406566	106420874	8
chr4	106417165	106472436	Acot11	55271	-	NM_025590	106420933	106472321	16
chr4	106584074	106722299	Ssbp3	138225	+	NM_023672	106584461	106720658	18
chr4	106728478	106739471	Mrpl37	10993	-	NM_025500	106728631	106739400	7
chr4	106742772	106757410	Cyb5rl	14638	+	NM_175471	106743131	106756935	6
chr4	106769495	106780353	Cdcp2	10858	+	NM_172873	106770312	106779843	4
chr4	106806766	106850971	Tceanc2	44205	-	NM_025617	106812215	106850268	5
chr4	106851234	106873601	Tmem59	22367	+	NM_029565	106851333	106873128	8
chr4	106881784	106890519	Ldlrad1	8735	+	NM_001081272	106882074	106890519	5
chr4	106906118	106926138	Lrrc42	20020	-	NM_029985	106906335	106920371	8
chr4	106926538	106952493	Hspb11	25955	+	NM_028394	106935086	106952443	6
chr4	106964069	106979748	Dio1	15679	-	NM_007860	106964934	106979723	4
chr4	106986967	107032428	Yipf1	45461	+	NM_145550	106988416	107023108	10
chr4	107040388	107086943	Ndc1	46555	+	NM_028355	107040693	107086694	18
chr4	107107323	107307664	Glis1	200341	+	NM_147221	107108286	107307351	11
chr4	107348894	107356767	Dmrtb1	7873	-	NM_019872	107349609	107356767	4
chr4	107474863	107549445	Lrp8	74582	+	NR_033496	107549445	107549445	21
chr4	107552359	107560029	Magoh	7670	+	NM_001282737	107552462	107559881	5
chr4	107562503	107570407	0610037L13Rik	7904	+	NM_028754	107562609	107569553	7
chr4	107576586	107596194	Cpt2	19608	-	NM_009949	107576836	107596071	5
chr4	107626536	107633326	4930407G08Rik	6790	+	NR_131071	107633326	107633326	3
chr4	107640938	107686137	Slc1a7	45199	+	NM_146255	107641150	107685054	11
chr4	107687397	107704695	Podn	17298	-	NM_001285958	107690337	107699895	13
chr4	107716434	107791152	Scp2	74718	-	NM_011327	107717354	107791052	16
chr4	107759961	107760054	Mir6397	93	+	NR_105823	107760054	107760054	1
chr4	107838041	107851913	Echdc2	13872	+	NM_026728	107838133	107851589	10
chr4	107854538	107890527	Zyg11a	35989	-	NM_001167936	107854706	107890527	14
chr4	107900359	107973695	Zyg11b	73336	-	NM_001033634	107908608	107973525	14
chr4	108000756	108013323	Coa7	12567	+	NM_027250	108000789	108011176	3
chr4	108040381	108056260	Fam159a	15879	-	NM_001099303	108040398	108055948	3
chr4	108072821	108079318	Gpx7	6497	-	NM_024198	108073438	108079282	3
chr4	108132030	108232020	Zcchc11	99990	+	NM_175472	108151568	108231390	31
chr4	108237471	108251941	Prpf38a	14470	-	NM_172697	108237829	108251719	10
chr4	108252058	108287436	Orc1	35378	+	NM_011015	108261291	108287080	17
chr4	108292560	108306727	Cc2d1b	14167	+	NM_177045	108294133	108305904	25
chr4	108311863	108396481	Zfyve9	84618	-	NM_183300	108311863	108396432	16
chr4	108392253	108454509	3110021N24Rik	62256	+	NM_001254730	108400135	108453501	4
chr4	108486899	108506189	Btf3l4	19290	-	NM_027453	108489444	108503176	6
chr4	108507282	108534724	Txndc12	27442	+	NM_025334	108507370	108534051	7
chr4	108520461	108522017	Kti12	1556	+	NM_029571	108520495	108521551	1
chr4	108551674	108615929	Rab3b	64255	+	NM_023537	108562912	108613418	5
chr4	108615447	108644682	8030443G20Rik	29235	-	NR_040664	108644682	108644682	6
chr4	108673409	108734376	Nrd1	60967	+	NM_146150	108673437	108733735	31
chr4	108690259	108690335	Mir761	76	+	NR_030432	108690335	108690335	1
chr4	108733749	108874877	Osbpl9	141128	-	NM_133885	108734862	108874820	23
chr4	108891017	108927182	Calr4	36165	+	NM_001285895	108891017	108926606	9
chr4	108952879	109060421	Eps15	107542	+	NM_007943	108953016	109058070	25
chr4	109074883	109078862	Ttc39aos1	3979	-	NR_131195	109078862	109078862	4
chr4	109079704	109117350	Ttc39a	37646	+	NM_153392	109079776	109116810	18
chr4	109125461	109149110	Rnf11	23649	-	NM_013876	109126855	109148837	3
chr4	109177936	109203902	4930522H14Rik	25966	-	NM_026291	109178032	109203832	5
chr4	109333480	109339361	Cdkn2c	5881	-	NM_001301368	109333853	109337751	3
chr4	109349231	109636565	Faf1	287334	+	NM_007983	109349632	109634487	19
chr4	109650629	109656289	Dmrta2	5660	+	NM_172296	109652467	109655258	3
chr4	109876341	110024516	Elavl4	148175	-	NM_001163397	109878936	110024419	6
chr4	110070302	111335629	Agbl4	1265327	+	NM_001284190	110070476	111335629	13
chr4	111087610	111132903	Bend5	45293	+	NM_026279	111087779	111132512	6
chr4	111392614	111501745	Spata6	109131	+	NM_026470	111392811	111500971	13
chr4	111547981	111575401	Slc5a9	27420	-	NM_145551	111550142	111571304	15
chr4	111592159	111622961	Skint8	30802	+	NM_001100466	111599783	111622920	7
chr4	111645531	111660826	Skint7	15295	+	NM_001142775	111650025	111660785	7
chr4	111678873	111702143	Skint1	23270	+	NM_001102662	111683282	111702058	8
chr4	111754074	111840681	Skint4	86607	+	NM_178786	111754304	111838363	11
chr4	111904849	111973073	Skint3	68224	+	NM_177578	111908345	111970812	8
chr4	112058573	112106590	Skint9	48017	-	NM_177864	112058913	112091777	7
chr4	112286344	112324853	Skint2	38509	+	NM_001285965	112289127	112324780	8
chr4	112383434	112447466	Skint10	64032	-	NM_177668	112384058	112447426	7
chr4	112477220	112959578	Skint6	482358	-	NM_001103199	112477267	112956247	49
chr4	113150495	113672108	Skint5	521613	-	NM_001167876	113150552	113668262	59
chr4	113835988	113917633	Skint11	81645	+	NM_001166027	113864084	113917491	7
chr4	114079328	114287703	Trabd2b	208375	+	NM_001085549	114079422	114282734	7
chr4	114494324	114528771	Gm12830	34447	+	NR_033617	114528771	114528771	4
chr4	114578884	114581503	Foxd2	2619	-	NM_008593	114579947	114581426	1
chr4	114581893	114593723	Foxd2os	11830	+	NR_030721	114593723	114593723	4
chr4	114597751	114598618	Foxe3	867	-	NM_015758	114597751	114598618	1
chr4	114633217	114659833	Cmpk1	26616	-	NM_025647	114634318	114659738	6
chr4	114672722	114715803	Stil	43081	+	NM_001304553	114696176	114714568	18
chr4	114729030	114744360	Tal1	15330	+	NM_011527	114735735	114741330	5
chr4	114761312	114766499	Pdzk1ip1	5187	+	NM_001164558	114761750	114766153	5
chr4	114781286	114806582	Cyp4x1	25296	-	NM_001003947	114781286	114806582	12
chr4	114806436	114810469	Cyp4x1os	4033	+	NR_131922	114810469	114810469	4
chr4	114914688	114927162	Cyp4a29	12474	+	NM_001100183	114914688	114927162	12
chr4	114971650	115005420	Cyp4a12a	33770	+	NM_177406	114971732	115004607	12
chr4	115084228	115111639	Cyp4a12b	27411	+	NM_172306	115084287	115110830	12
chr4	115125208	115143667	Cyp4a30b	18459	+	NM_001100185	115125208	115143667	12
chr4	115158804	115168746	Cyp4a14	9942	-	NM_007822	115159747	115168718	12
chr4	115190891	115206254	Cyp4a10	15363	+	NM_010011	115190926	115205304	13
chr4	115236253	115251620	Cyp4a31	15367	+	NM_201640	115236321	115250709	12
chr4	115254642	115255732	Cyp4b1-ps2	1090	-	NR_033575	115255732	115255732	3
chr4	115273542	115294971	Cyp4a32	21429	+	NM_001100181	115273579	115294207	13
chr4	115297332	115320310	Cyp4b1	22978	-	NM_007823	115297649	115320292	12
chr4	115410677	115449932	Efcab14	39255	+	NM_172698	115411263	115447808	12
chr4	115452438	115453639	Tex38	1201	-	NM_029196	115452603	115453592	2
chr4	115457418	115484919	Atpaf1	27501	+	NM_181040	115457583	115483801	9
chr4	115500696	115508788	Mob3c	8092	+	NM_175308	115503876	115506756	4
chr4	115511802	115551861	Mknk1	40059	+	NM_001285487	115527596	115550789	15
chr4	115557004	115560569	Kncn	3565	+	NM_001039124	115557342	115560331	4
chr4	115587723	115612531	Dmbx1	24808	-	NM_001025567	115590555	115596407	5
chr4	115669260	115690507	Faah	21247	-	NM_010173	115671091	115690262	15
chr4	115704374	115726481	Nsun4	22107	-	NM_028142	115706639	115726381	6
chr4	115739569	115747675	Uqcrh	8106	-	NM_025641	115739744	115747574	4
chr4	115747873	115769714	Lrrc41	21841	+	NM_153521	115748013	115769147	10
chr4	115769559	115796295	Rad54l	26736	-	NM_001122959	115769765	115795669	19
chr4	115796444	115811446	2510003B16Rik	15002	+	NR_131048	115811446	115811446	3
chr4	115809332	115817221	Lurap1	7889	-	NM_026547	115809917	115817099	2
chr4	115823122	115832449	Pomgnt1	9327	+	NM_026651	115823728	115831872	22
chr4	115834485	115840203	Tspan1	5718	-	NM_133681	115835592	115839669	8
chr4	115845976	115846902	1700042G07Rik	926	+	NM_001099295	115846005	115846812	2
chr4	115894518	115975661	Pik3r3	81143	+	NM_181585	115894912	115972437	10
chr4	115979364	116136786	Mast2	157422	-	NM_001042743	115979419	116136520	30
chr4	116180153	116210840	Ipp	30687	+	NM_008389	116183176	116210629	9
chr4	116224132	116228548	Tmem69	4416	-	NM_177670	116225638	116227414	3
chr4	116230331	116266487	Gpbp1l1	36156	+	NM_029868	116243528	116265563	12
chr4	116262337	116270235	C530005A16Rik	7898	-	NR_029450	116270235	116270235	3
chr4	116269334	116272871	Ccdc17	3537	+	NM_001037916	116269391	116272623	13
chr4	116273656	116300556	Nasp	26900	-	NM_016777	116274320	116299995	16
chr4	116309114	116324279	Akr1a1	15165	-	NM_021473	116309208	116318192	9
chr4	116357569	116358627	AV051173	1058	-	NR_040442	116358627	116358627	3
chr4	116358203	116372605	Prdx1	14402	+	NM_011034	116360022	116371861	6
chr4	116375038	116380990	Mmachc	5952	-	NM_025962	116376061	116380923	4
chr4	116381534	116387709	Ccdc163	6175	+	NM_026714	116381621	116387563	10
chr4	116393559	116476853	Tesk2	83294	+	NM_146151	116414301	116475917	11
chr4	116476607	116480164	Toe1	3557	-	NM_026654	116477039	116480124	8
chr4	116480338	116492036	Mutyh	11698	+	NM_001159581	116486929	116491985	17
chr4	116492511	116494113	Hpdl	1602	-	NM_146256	116492751	116493867	1
chr4	116550006	116661710	Zswim5	111704	+	NM_001029912	116550064	116659938	14
chr4	116662569	116667018	Urod	4449	-	NM_009478	116662891	116666955	10
chr4	116667952	116677882	Hectd3	9930	+	NM_175244	116668007	116675971	21
chr4	116692012	116759457	Eif2b3	67445	+	NM_001111277	116694769	116759346	12
chr4	116768660	116788706	Ptch2	20046	+	NM_008958	116768960	116787436	22
chr4	116791822	116798330	Btbd19	6508	-	NR_024078	116798330	116798330	7
chr4	116799417	116801335	Tctex1d4	1918	+	NM_175030	116800586	116801246	4
chr4	116801259	116806568	Plk3	5309	-	NM_001313916	116801591	116806469	15
chr4	116826440	116828737	Rps8	2297	-	NM_009098	116826482	116828666	6
chr4	116827120	116827179	Snord38a	59	-	NR_028524	116827179	116827179	1
chr4	116828375	116828453	Snord55	78	-	NR_030704	116828453	116828453	1
chr4	116832240	116855229	Kif2c	22989	-	NM_134471	116832771	116855096	20
chr4	116885937	116924522	Gm1661	38585	-	NM_001145637	116886119	116910446	13
chr4	116924555	116941193	Tmem53	16638	+	NM_001285815	116940530	116941148	4
chr4	116944067	117169657	Rnf220	225590	-	NM_025739	116944908	117162818	15
chr4	117222928	117346902	Eri3	123974	+	NM_001285901	117237248	117346428	8
chr4	117347290	117354830	Dmap1	7540	-	NM_023178	117347339	117354542	11
chr4	117429263	117438271	Klf17	9008	-	NM_029416	117431711	117438150	3
chr4	117507862	117541910	Slc6a9	34048	+	NM_008135	117515710	117540847	14
chr4	117541866	117545075	Ccdc24	3209	-	NM_001034876	117542228	117544751	8
chr4	117545604	117556081	B4galt2	10477	-	NR_045570	117556081	117556081	9
chr4	117556934	117559934	Atp6v0b	3000	-	NM_033617	117557219	117559841	8
chr4	117561247	117564608	Dph2	3361	-	NM_026344	117562156	117564461	6
chr4	117567097	117587604	Ipo13	20507	-	NM_146152	117567165	117586976	20
chr4	117598764	117602368	Artn	3604	-	NM_001284191	117599197	117600288	6
chr4	117604757	117807551	St3gal3	202794	-	NM_009176	117605651	117780268	12
chr4	117809608	117852648	Kdm4a	43040	-	NM_001161823	117810834	117850137	22
chr4	117880817	117964002	Ptprf	83185	-	NM_011213	117882425	117950044	33
chr4	117883109	117883169	Mir7226	60	-	NR_106085	117883169	117883169	1
chr4	118032603	118035349	Hyi	2746	+	NM_026601	118032637	118035262	8
chr4	118035344	118081868	Szt2	46524	-	NM_198170	118035932	118081794	72
chr4	118081941	118088429	Med8	6488	+	NM_173719	118081985	118087393	8
chr4	118100697	118105557	Elovl1	4860	+	NM_019422	118103114	118104724	8
chr4	118105505	118109948	Cdc20	4443	-	NM_023223	118105567	118109726	10
chr4	118115019	118130118	Mpl	15099	-	NM_010823	118116033	118130076	12
chr4	118143795	118162454	Tie1	18659	-	NM_011587	118144125	118162310	23
chr4	118199879	118202822	2610528J11Rik	2943	+	NM_025572	118201897	118202400	3
chr4	118213545	118216331	Tmem125	2786	-	NM_172383	118214186	118214837	4
chr4	118227155	118293010	Cfap57	65855	-	NM_026789	118227300	118293010	22
chr4	118293403	118300381	Ebna1bp2	6978	+	NM_026932	118293536	118298475	9
chr4	118299008	118304520	D4Ertd617e	5512	+	NR_029469	118304520	118304520	3
chr4	118338123	118339071	Olfr62	948	+	NM_146315	118338123	118339071	1
chr4	118362107	118363055	Olfr1342	948	-	NM_146713	118362107	118363055	1
chr4	118382013	118382952	Olfr1341	939	+	NM_146853	118382013	118382952	1
chr4	118398853	118399801	Olfr1340	948	+	NM_146304	118398853	118399801	1
chr4	118407135	118408083	Olfr1339	948	+	NM_146852	118407135	118408083	1
chr4	118426199	118427141	Olfr1338	942	-	NM_207152	118426199	118427141	1
chr4	118454240	118455191	Olfr1337	951	-	NM_146309	118454240	118455188	1
chr4	118481459	118482467	Olfr1335	1008	-	NM_207703	118481459	118482467	1
chr4	118502089	118503043	Olfr1333	954	-	NM_207157	118502089	118503043	1
chr4	118541387	118542341	Olfr1331	954	+	NM_001011856	118541387	118542341	1
chr4	118565689	118566637	Olfr1330	948	+	NM_146334	118565689	118566637	1
chr4	118589128	118590070	Olfr1329	942	-	NM_001011870	118589128	118590070	1
chr4	118606503	118607445	Olfr1328	942	-	NM_146399	118606503	118607445	1
chr4	118634571	118641515	Lao1	6944	+	NM_133892	118634603	118641161	7
chr4	118727394	118741716	Gm12866	14322	-	NR_131914	118741716	118741716	2
chr4	118781349	118809934	Slc2a1	28585	+	NM_011400	118781559	118809051	10
chr4	118842122	118846800	Zfp691	4678	-	NM_001145936	118842786	118843638	2
chr4	118848061	118862616	Ermap	14555	-	NM_013848	118850615	118861536	13
chr4	118867914	118873903	Svbp	5989	+	NM_024462	118868512	118873588	3
chr4	118877659	118890822	4930538K18Rik	13163	-	NM_029198	118878278	118889783	7
chr4	118897742	118905329	AU022252	7587	-	NM_001012400	118898946	118905266	5
chr4	118905519	118921582	P3h1	16063	+	NM_019782	118905561	118920858	16
chr4	118928045	118935043	Cldn19	6998	+	NM_153105	118928177	118931575	4
chr4	118949931	118967118	Ybx1	17187	-	NM_011732	118951569	118966968	8
chr4	118972614	118993128	Ppih	20514	-	NM_028677	118983383	118993079	10
chr4	118995497	119088126	Ccdc30	92629	-	NM_029286	118996602	119076843	15
chr4	119091137	119095025	Ppcs	3888	-	NM_026494	119091574	119094958	3
chr4	119095288	119126504	Zmynd12	31216	+	NM_001014900	119095490	119126293	8
chr4	119137890	119165203	Rimkla	27313	-	NM_177572	119140672	119165064	5
chr4	119202922	119211374	AA415398	8452	-	NM_001004178	119203221	119203905	4
chr4	119212265	119301724	Foxj3	89459	+	NM_172699	119233224	119299009	13
chr4	119310336	119312070	Guca2a	1734	+	NM_008190	119310355	119311880	3
chr4	119329207	119331550	Guca2b	2343	-	NM_008191	119329396	119331460	3
chr4	119487282	119808016	Hivep3	320734	+	NM_010657	119767093	119806956	9
chr4	119834028	119839965	Edn2	5937	+	NM_007902	119834114	119839335	5
chr4	119939682	119959866	Foxo6	20184	-	NM_194060	119940521	119959857	2
chr4	120077885	120202804	Scmh1	124919	+	NM_001159630	120134684	120202495	18
chr4	120204835	120209266	Slfnl1	4431	+	NM_177570	120205758	120209125	5
chr4	120212472	120242881	Ctps	30409	-	NM_016748	120213901	120240020	19
chr4	120261349	120282277	Gm8439	20928	+	NM_001101603	120261409	120282209	3
chr4	120339167	120340425	Cited4	1258	+	NM_019563	120339407	120339956	1
chr4	120370077	120419781	Kcnq4	49704	-	NM_001081142	120370498	120419781	14
chr4	120430039	120504184	Nfyc	74145	-	NM_001048168	120430781	120463086	10
chr4	120442138	120442227	Mir30c-1	89	-	NR_029716	120442227	120442227	1
chr4	120445210	120445302	Mir30e	92	-	NR_029602	120445302	120445302	1
chr4	120445210	120445302	Mir30f	92	+	NR_105851	120445302	120445302	1
chr4	120550473	120564165	Rims3	13692	+	NM_182929	120550473	120564112	6
chr4	120593806	120597610	Exo5	3804	-	NM_028457	120594149	120595271	2
chr4	120602741	120624306	Zfp69	21565	-	NM_001005788	120602957	120622039	6
chr4	120640921	120689852	Smap2	48931	-	NM_133716	120642143	120689456	10
chr4	120645863	120645927	Mir7015	64	-	NR_105982	120645927	120645927	1
chr4	120712170	120727930	Col9a2	15760	+	NM_007741	120712319	120727400	32
chr4	120731842	120770848	Zmpste24	39006	-	NM_172700	120733600	120770604	10
chr4	120778255	120781831	Tmco2	3576	-	NM_001081312	120778341	120781762	2
chr4	120817977	120861139	Rlf	43162	-	NM_001081013	120818959	120860963	6
chr4	120988920	120997522	Gm12888	8602	-	NM_001033791	120989717	120997498	4
chr4	121087339	121095704	Gm12886	8365	-	NM_001144948	121088106	121095682	4
chr4	121286608	121294730	Gm12887	8122	-	NM_001099309	121286875	121294708	4
chr4	122366501	122382378	9530002B09Rik	15877	+	NM_023865	122366609	122379628	5
chr4	122513469	122536418	Ppt1	22949	+	NM_008917	122513498	122534875	9
chr4	122536290	122563300	Cap1	27010	-	NM_007598	122537376	122549686	13
chr4	122624093	122638431	Mfsd2a	14338	-	NM_029662	122624483	122638276	14
chr4	122673173	122679723	Mycl	6550	+	NM_001303121	122673312	122677758	3
chr4	122693839	122732177	Trit1	38338	+	NM_025873	122693852	122731535	11
chr4	122782403	122803337	Bmp8b	20934	+	NM_007559	122782593	122801780	7
chr4	122793490	122795243	Oxct2b	1753	+	NM_181859	122793531	122795094	1
chr4	122804367	122817184	Ppie	12817	-	NM_019489	122804620	122817175	10
chr4	122860746	122871942	Hpcal4	11196	+	NM_174998	122865964	122868098	5
chr4	122878795	122893450	Nt5c1a	14655	+	NM_001085502	122878800	122893450	6
chr4	122910798	122927113	Heyl	16315	+	NM_013905	122911109	122923873	5
chr4	122960153	122976076	Pabpc4	15923	+	NM_130881	122960857	122975324	15
chr4	122989890	123020495	Bmp8a	30605	-	NM_007558	122990509	123019951	7
chr4	122999117	123000922	Oxct2a	1805	-	NM_022033	122999266	123000829	1
chr4	123026875	123361603	Macf1	334728	-	NM_001199136	123028131	123361432	98
chr4	123080843	123089154	D830031N03Rik	8311	-	NM_001167918	123084602	123087950	1
chr4	123293662	123293764	Mir6398	102	+	NR_105824	123293764	123293764	1
chr4	123389952	123395404	BC002163	5452	-	NR_002445	123395404	123395404	3
chr4	123389952	123395429	Ndufs5	5477	-	NM_001030274	123390064	123393322	3
chr4	123412437	123427542	Akirin1	15105	-	NM_023423	123414096	123427407	5
chr4	123465117	123507147	Rhbdl2	42030	+	NM_183163	123487176	123506956	8
chr4	123582255	123589493	Mycbp	7238	+	NM_019660	123582315	123588380	5
chr4	123594675	123614240	Rragc	19565	+	NM_017475	123594776	123612932	7
chr4	124126868	124163202	1700057H15Rik	36334	-	NR_040774	124163202	124163202	4
chr4	124246421	124252781	4933407E24Rik	6360	+	NR_045819	124252781	124252781	3
chr4	124334888	124337899	Pou3f1	3011	+	NM_011141	124334949	124336300	2
chr4	124356007	124370798	Utp11l	14791	-	NM_026031	124356146	124370746	8
chr4	124377942	124385855	Fhl3	7913	+	NM_010213	124382877	124385214	6
chr4	124392104	124409666	Sf3a3	17562	+	NM_029157	124392138	124409509	17
chr4	124408937	124409046	Mir697	109	+	NR_030479	124409046	124409046	1
chr4	124419093	124478755	Inpp5b	59662	+	NR_126474	124478755	124478755	25
chr4	124421024	124421133	Mir698	109	+	NR_030480	124421133	124421133	1
chr4	124479792	124527044	Mtf1	47252	+	NM_008636	124481954	124521587	11
chr4	124526728	124527974	1110065P20Rik	1246	-	NM_001142727	124527110	124527523	3
chr4	124528002	124532486	Yrdc	4484	+	NM_153566	124528018	124531791	5
chr4	124532482	124539415	Maneal	6933	-	NM_001007573	124533846	124539411	4
chr4	124559028	124595044	Epha10	36016	+	NM_001256432	124559118	124592972	17
chr4	124568131	124572026	1700125G02Rik	3895	-	NR_040651	124572026	124572026	3
chr4	124595708	124614161	Cdca8	18453	-	NM_026560	124596229	124613926	10
chr4	124614291	124621905	9930104L06Rik	7614	+	NM_177573	124615686	124619906	5
chr4	124663673	124686343	Rspo1	22670	+	NM_138683	124668576	124685789	6
chr4	124707257	124732626	Gnl2	25369	+	NM_145552	124707374	124732580	16
chr4	124732582	124742901	Dnali1	10319	-	NM_175223	124733832	124742842	6
chr4	124743936	124751287	Snip1	7351	+	NM_175246	124743996	124750174	4
chr4	124762377	124787314	Meaf6	24937	+	NM_001290701	124762420	124786551	7
chr4	124795657	124805125	Zc3h12a	9468	-	NM_153159	124796522	124804292	6
chr4	125168074	125391417	Grik3	223343	+	NM_001081097	125168074	125385335	16
chr4	125181992	125182101	Mir692-2	109	+	NR_109835	125182101	125182101	1
chr4	125181992	125182101	Mir692-3	109	+	NR_035409	125182101	125182101	1
chr4	125565094	125599554	2610028E06Rik	34460	-	NR_015560	125599554	125599554	6
chr4	125701902	125722219	Csf3r	20317	+	NM_007782	125704580	125721082	17
chr4	125724171	125732780	Mrps15	8609	+	NM_025544	125724313	125732761	8
chr4	125735808	125766578	Oscp1	30770	+	NM_172701	125735924	125765682	10
chr4	125773896	125775828	Lsm10	1932	+	NM_001163266	125775096	125775465	2
chr4	125781200	125818273	Stk40	37073	+	NM_001145827	125795550	125816272	13
chr4	125825246	125827118	Eva1b	1872	+	NM_172145	125826222	125826907	3
chr4	125827845	125840585	Sh3d21	12740	-	NM_001162533	125827968	125840472	16
chr4	125841326	125879954	Thrap3	38628	-	NM_146153	125842639	125863815	11
chr4	125909411	125933563	Map7d1	24152	-	NM_001145970	125909999	125933306	17
chr4	125939648	125953127	Trappc3	13479	+	NM_013718	125939739	125952505	5
chr4	125964037	125991574	Col8a2	27537	+	NM_199473	125986859	125989542	4
chr4	125993594	125998947	Adprhl2	5353	-	NM_133883	125993816	125998914	6
chr4	125999364	126002443	Tekt2	3079	-	NM_011902	125999449	126002202	10
chr4	126017921	126106786	Ago3	88865	-	NM_153402	126022717	126106530	19
chr4	126112255	126145827	Ago1	33572	-	NM_001317173	126116632	126145665	19
chr4	126166786	126210702	Ago4	43916	-	NM_153177	126170466	126210447	18
chr4	126234223	126271147	Clspn	36924	+	NM_175554	126234357	126270006	26
chr4	126237103	126237162	Mir7119	59	+	NR_106067	126237162	126237162	1
chr4	126287097	126291615	5730409E04Rik	4518	+	NM_001013755	126288924	126289617	2
chr4	126354886	126386959	Psmb2	32073	+	NM_011970	126354998	126386830	6
chr4	126393246	126413513	Tfap2e	20267	-	NM_198960	126393756	126413235	7
chr4	126420993	126430673	Ncdn	9680	-	NM_011986	126422078	126430247	7
chr4	126430798	126546938	AU040320	116140	+	NM_001035525	126434170	126546635	24
chr4	126539064	126645167	Zmym4	106103	-	NM_001114399	126541353	126645098	30
chr4	126698544	126714258	Sfpq	15714	+	NR_045010	126714258	126714258	12
chr4	126724337	126738376	Zmym1	14039	-	NM_026670	126724885	126736230	8
chr4	126754626	126801618	Zmym6	46992	+	NR_104366	126801618	126801618	16
chr4	126803286	126806904	Gm12942	3618	+	NM_001099319	126803332	126806264	3
chr4	126846447	126914266	Dlgap3	67819	+	NM_198618	126871856	126913612	12
chr4	126921027	126925053	Smim12	4026	+	NM_030252	126924151	126924430	2
chr4	126988663	126991283	Gja4	2620	-	NM_008120	126989210	126990212	2
chr4	127002478	127008080	Gjb3	5602	-	NM_001160012	127003168	127003981	2
chr4	127028329	127031325	Gjb4	2996	-	NM_008127	127028589	127029390	2
chr4	127032052	127035408	Gjb5	3356	-	NM_010291	127032777	127033593	2
chr4	127604835	127648085	CK137956	43250	-	NM_001134733	127605246	127648078	7
chr4	127665287	128244900	Csmd2	579613	+	NM_001281955	127665313	128241412	71
chr4	127810766	127844211	Csmd2os	33445	-	NM_029137	127810873	127841424	5
chr4	127937455	127938139	Hmgb4	684	-	NM_027036	127937471	127938017	1
chr4	127938287	127940234	Hmgb4os	1947	+	NR_130980	127940234	127940234	3
chr4	128260782	128287342	Zscan20	26560	-	NM_177758	128262847	128281847	8
chr4	128292689	128295863	Tlr12	3174	-	NM_205823	128292978	128295699	1
chr4	128331945	128430125	Phc2	98180	+	NM_001195130	128382295	128428898	15
chr4	128436501	128446542	A3galt2	10041	+	NM_001009819	128437152	128444916	5
chr4	128450328	128483356	Zfp362	33028	-	NM_001081098	128451764	128472132	9
chr4	128561383	128588570	Trim62	27187	+	NM_178110	128561413	128586830	5
chr4	128607476	128639699	Azin2	32223	-	NM_001301841	128608178	128628010	9
chr4	128670467	128688773	Ak2	18306	+	NM_016895	128670587	128687811	7
chr4	128735514	128761770	Rnf19b	26256	+	NM_029219	128735514	128761434	9
chr4	128782773	128788870	Tmem54	6097	+	NM_025452	128782959	128788632	6
chr4	128788813	128799169	Hpca	10356	-	NM_001286081	128789671	128795985	4
chr4	128814303	128821837	Fndc5	7534	+	NM_027402	128814322	128819784	6
chr4	128828068	128866726	S100pbp	38658	-	NM_029036	128828193	128859774	7
chr4	128867038	128896851	Yars	29813	+	NM_134151	128867151	128895785	13
chr4	128896821	128938648	C77080	41827	-	NM_001285867	128898698	128902659	7
chr4	128964864	128985803	Sync	20939	+	NM_023485	128964982	128985296	5
chr4	128984343	129012614	Rbbp4	28271	-	NM_009030	128987335	129012477	12
chr4	129013269	129024273	Zbtb8os	11004	+	NM_025970	129013286	129024134	7
chr4	129030875	129055272	Zbtb8a	24397	-	NM_028603	129031415	129037943	5
chr4	129103008	129118062	Zbtb8b	15054	-	NM_153541	129104756	129110515	4
chr4	129138922	129165676	Bsdc1	26754	+	NM_133889	129138938	129164317	11
chr4	129166251	129168014	Tssk3	1763	-	NM_080442	129166314	129167850	2
chr4	129168433	129169200	Fam229a	767	+	NM_001085491	129168442	129169038	3
chr4	129190824	129193225	Marcksl1	2401	+	NM_010807	129191073	129192476	2
chr4	129193347	129219890	Hdac1	26543	-	NM_008228	129193852	129219873	14
chr4	129225587	129250885	Lck	25298	-	NM_001162433	129226041	129235429	13
chr4	129234926	129235055	Mir8119	129	-	NR_106199	129235055	129235055	1
chr4	129254058	129255824	Fam167b	1766	-	NM_182783	129254308	129255619	2
chr4	129269217	129277892	Eif3i	8675	-	NM_018799	129269296	129277840	11
chr4	129277950	129285123	Tmem234	7173	+	NM_029748	129277959	129284794	5
chr4	129285574	129291501	Dcdc2b	5927	-	NM_001195730	129285574	129291501	7
chr4	129292860	129296337	Iqcc	3477	-	NM_198026	129293707	129296299	5
chr4	129296517	129301152	Ccdc28b	4635	-	NM_025455	129296635	129300007	6
chr4	129303320	129318309	Txlna	14989	-	NM_001199695	129306124	129317665	11
chr4	129321222	129350011	Kpna6	28789	-	NM_008468	129325235	129349924	14
chr4	129353598	129374082	Tmem39b	20484	-	NM_199305	129353809	129373962	9
chr4	129361743	129361815	Mir7016	72	-	NR_105983	129361815	129361815	1
chr4	129380412	129419547	Khdrbs1	39135	-	NR_045036	129419547	129419547	12
chr4	129497722	129527247	Ptp4a2	29525	+	NM_008974	129516826	129525066	6
chr4	129583469	129586240	E330017L17Rik	2771	+	NR_045190	129586240	129586240	3
chr4	129637617	129642382	1700003M07Rik	4765	+	NR_040647	129642382	129642382	4
chr4	129662113	129699877	Adgrb2	37764	+	NM_001290714	129669312	129699582	28
chr4	129725083	129776521	Col16a1	51438	+	NM_028266	129726910	129776336	70
chr4	129784799	129805378	Pef1	20579	+	NM_026441	129784870	129804726	5
chr4	129807460	129816406	Hcrtr1	8946	-	NM_001305392	129808084	129813005	10
chr4	129842843	129852366	Tinagl1	9523	-	NM_023476	129843308	129851443	12
chr4	129886352	129899539	Gm853	13187	-	NM_001034872	129887112	129898997	10
chr4	129930740	129952830	Serinc2	22090	-	NM_172702	129931173	129952740	10
chr4	129986021	129992707	Fabp3	6686	+	NM_010174	129986021	129992469	4
chr4	129993328	130037190	Zcchc17	43862	-	NM_153160	129993890	130031449	8
chr4	130037378	130067278	Snrnp40	29900	+	NM_025645	130037452	130066841	10
chr4	130125704	130169623	Nkain1	43919	+	NM_025998	130125858	130167849	7
chr4	130219273	130337479	Pum1	118206	+	NM_030722	130224850	130335818	22
chr4	130305552	130305617	Snord85	65	+	NR_028565	130305617	130305617	1
chr4	130348451	130382233	Sdc3	33782	+	NM_011520	130348585	130378724	5
chr4	130469248	130492063	Laptm5	22815	+	NM_010686	130469262	130490465	8
chr4	130500299	130511391	Matn1	11092	+	NM_010769	130500338	130510931	8
chr4	130556746	130566389	A930031H19Rik	9643	-	NR_130167	130566389	130566389	5
chr4	131324371	131394193	Ptpru	69822	-	NM_001083119	131325412	131394071	31
chr4	131399385	131423702	Mecr	24317	+	NM_025297	131399417	131423519	10
chr4	131429553	131457640	Srsf4	28087	+	NM_020587	131429678	131456987	6
chr4	131455392	131475944	Gm12992	20552	-	NR_102393	131475944	131475944	5
chr4	131477685	131479055	Tmem200b	1370	+	NM_001201367	131477685	131478540	1
chr4	131479340	131631228	Epb41	151888	-	NM_001128607	131482424	131559553	18
chr4	131666640	131700401	Oprd1	33761	-	NM_013622	131669441	131700300	3
chr4	131740830	131768171	Ythdf2	27341	-	NM_145393	131742838	131767841	5
chr4	131775807	131776504	Rps15a-ps4	697	-	NR_036572	131776504	131776504	1
chr4	131776939	131817464	Gmeb1	40525	-	NM_001122992	131781679	131807717	11
chr4	131825993	131826101	Rnu11	108	-	NR_002865	131826101	131826101	1
chr4	131830289	131849244	Taf12	18955	+	NM_025579	131838792	131848577	6
chr4	131858108	131859271	Rab42	1163	-	NM_001081651	131858176	131859252	2
chr4	131864592	131866939	Snhg12	2347	+	NR_029468	131866939	131866939	5
chr4	131865379	131865515	Snora16a	136	+	NR_029412	131865515	131865515	1
chr4	131865867	131865984	Snora44	117	+	NR_034050	131865984	131865984	1
chr4	131866221	131866283	Snora61	62	+	NR_034046	131866283	131866283	1
chr4	131866617	131866673	Snord99	56	+	NR_028537	131866673	131866673	1
chr4	131867677	131885453	Trnau1ap	17776	-	NM_027925	131867784	131885294	9
chr4	131887833	131901665	Rcc1	13832	-	NM_001197082	131888741	131895912	11
chr4	131907847	131909601	Snhg3	1754	-	NR_003270	131909601	131909601	3
chr4	131911838	131978361	Phactr4	66523	-	NM_175306	131914183	131969000	14
chr4	132014643	132019836	Med18	5193	-	NM_026039	132015474	132018852	3
chr4	132048721	132066371	Sesn2	17650	-	NM_144907	132049630	132066068	10
chr4	132086469	132091329	Atpif1	4860	-	NM_007512	132086596	132089483	4
chr4	132091473	132109657	Dnajc8	18184	+	NM_172400	132091500	132109054	9
chr4	132119981	132138601	Ptafr	18620	+	NM_001081211	132135215	132136241	2
chr4	132194960	132280680	Eya3	85720	+	NM_010166	132217824	132277274	18
chr4	132280818	132288461	Xkr8	7643	-	NM_201368	132283769	132288380	3
chr4	132288880	132313086	Smpdl3b	24206	-	NM_133888	132289308	132312960	8
chr4	132324274	132334661	Rpa2	10387	+	NM_011284	132324371	132333789	9
chr4	132338271	132352279	Themis2	14008	-	NM_001033308	132338810	132352268	6
chr4	132382838	132399084	Ppp1r8	16246	-	NM_001290725	132383767	132399027	7
chr4	132409978	132440373	Stx12	30395	-	NM_133887	132411380	132440280	9
chr4	132455127	132478466	Fam76a	23339	-	NM_145553	132457136	132478353	9
chr4	132530009	132557797	Fgr	27788	+	NM_010208	132542077	132556258	13
chr4	132567420	132634025	Ahdc1	66605	+	NM_146155	132617364	132622149	7
chr4	132686547	132754245	Wasf2	67698	+	NM_153423	132732397	132751789	9
chr4	132751569	132751631	Mir7017	62	+	NR_105984	132751631	132751631	1
chr4	132765254	132768451	Gpr3	3197	-	NM_008154	132766281	132767274	2
chr4	132776723	132780469	Cd164l2	3746	+	NM_027152	132776894	132780173	6
chr4	132796732	132808843	Map3k6	12111	+	NM_016693	132797003	132808657	29
chr4	132809004	132819002	Sytl1	9998	-	NM_031393	132809083	132816958	15
chr4	132821959	132833705	Tmem222	11746	-	NM_025667	132822748	132833639	6
chr4	132848380	132895230	Wdtc1	46850	-	NM_199306	132850102	132879790	16
chr4	132925686	132979613	Slc9a1	53927	+	NM_016981	132926458	132978242	12
chr4	132925690	132925779	Mir5122	89	+	NR_039582	132925779	132925779	1
chr4	133036047	133043855	Fam46b	7808	+	NM_175307	133036214	133043018	2
chr4	133047014	133054465	Trnp1	7451	-	NM_001081156	133053700	133054372	2
chr4	133074877	133086705	Kdf1	11828	+	NM_133707	133083888	133086284	4
chr4	133088456	133101942	Nudc	13486	-	NM_010948	133088662	133101800	8
chr4	133109290	133112601	Nr0b2	3311	+	NM_011850	133109339	133112151	2
chr4	133130659	133140157	Gpatch3	9498	+	NM_172876	133130674	133139747	7
chr4	133140287	133147650	Gpn2	7363	+	NM_001290742	133140373	133147313	5
chr4	133156470	133158083	Sfn	1613	-	NM_018754	133156937	133157684	1
chr4	133162906	133189344	Zdhhc18	26438	-	NM_001017968	133164570	133189304	8
chr4	133217339	133228562	Pigv	11223	-	NM_001145955	133218424	133225730	4
chr4	133234922	133309526	Arid1a	74604	-	NM_001080819	133236245	133309526	20
chr4	133272964	133273023	Mir7227	59	-	NR_106086	133273023	133273023	1
chr4	133403205	133443712	Rps6ka1	40507	-	NM_009097	133403966	133443547	22
chr4	133520653	133523906	Hmgn2	3253	-	NM_016957	133521452	133523724	6
chr4	133524971	133556779	Dhdds	31808	-	NM_026144	133526931	133556246	9
chr4	133559244	133574731	Lin28a	15487	-	NM_145833	133562019	133574656	4
chr4	133624366	133648419	Aim1l	24053	+	NM_001162970	133628372	133648322	20
chr4	133649452	133650988	Cd52	1536	-	NM_013706	133649641	133650899	2
chr4	133658497	133682695	Ubxn11	24198	+	NM_026257	133664199	133682672	15
chr4	133683320	133684668	Sh3bgrl3	1348	-	NM_080559	133683655	133684578	3
chr4	133685772	133743000	Cep85	57228	-	NM_144527	133687193	133728779	14
chr4	133746718	133758919	Gm7534	12201	-	NM_001080712	133747004	133758907	8
chr4	133767882	133783298	Catsper4	15416	-	NM_177866	133768234	133783252	11
chr4	133783956	133794314	Cnksr1	10358	-	NM_001081047	133784229	133794223	21
chr4	133799220	133801506	Zfp593	2286	-	NM_024215	133800703	133801418	3
chr4	133799677	133801788	E130218I03Rik	2111	+	NR_040436	133801788	133801788	5
chr4	133807024	133810021	Grrp1	2997	-	NM_001099296	133807264	133808080	2
chr4	133830920	133843761	Pdik1l	12841	-	NM_146156	133834290	133840445	3
chr4	133871034	133885544	Trim63	14510	+	NM_001039048	133871138	133884830	9
chr4	133898960	133910399	Slc30a2	11439	+	NM_001039677	133899201	133908443	8
chr4	133912287	133928462	Extl1	16175	-	NM_019578	133913562	133927633	11
chr4	133952234	133983327	Pafah2	31093	+	NM_133880	133958929	133981482	11
chr4	134004679	134006086	1700021N21Rik	1407	-	NR_045800	134006086	134006086	3
chr4	134024234	134029758	Stmn1	5524	+	NM_019641	134026077	134029318	5
chr4	134052675	134066152	Paqr7	13477	+	NM_001285846	134062748	134063786	4
chr4	134066913	134079837	Aunip	12924	+	NM_001081099	134067006	134079683	3
chr4	134081469	134091302	Mtfr1l	9833	-	NM_029759	134082321	134088556	7
chr4	134093806	134108081	Sepn1	14275	-	NM_029100	134095530	134108034	12
chr4	134117604	134260205	Man1c1	142601	-	NM_207237	134119620	134259384	12
chr4	134123637	134123766	Mir6403	129	-	NR_105829	134123766	134123766	1
chr4	134301326	134323919	Ldlrap1	22593	-	NM_145554	134302966	134323815	9
chr4	134358675	134409260	Tmem57	50585	-	NM_025382	134360276	134409032	11
chr4	134420450	134452087	Rhd	31637	+	NM_011270	134420515	134451895	10
chr4	134453763	134470831	Tmem50a	17068	-	NM_027935	134454345	134469098	7
chr4	134479539	134483285	Rsrp1	3746	+	NM_023665	134479841	134482962	5
chr4	134486894	134493452	Syf2	6558	+	NM_026780	134486909	134492920	7
chr4	134676559	134733905	Runx3	57346	+	NM_019732	134677020	134731747	6
chr4	134769884	134828675	Clic4	58791	-	NM_013885	134773015	134828504	6
chr4	134876398	134909129	Srrm1	32731	-	NM_001130477	134877261	134909032	18
chr4	134925491	134954142	Ncmap	28651	-	NM_001243306	134926483	134936083	6
chr4	134968223	134989720	Rcan3	21497	-	NM_022980	134972334	134981323	5
chr4	134972469	134972548	Mir700	79	-	NR_030481	134972548	134972548	1
chr4	135004815	135050419	Nipal3	45604	-	NM_028995	135008287	135046952	12
chr4	135051901	135093718	Stpg1	41817	+	NM_030189	135062323	135092568	9
chr4	135097802	135129535	Grhl3	31733	-	NM_001013756	135098573	135129339	16
chr4	135182569	135186113	1700029M20Rik	3544	+	NR_015613	135186113	135186113	3
chr4	135242371	135264095	Ifnlr1	21724	+	NM_174851	135242456	135261777	7
chr4	135284073	135311298	Il22ra1	27225	+	NM_178257	135284134	135307280	7
chr4	135315629	135371482	Myom3	55853	+	NM_001085509	135318434	135370334	37
chr4	135411985	135425814	Srsf10	13829	+	NM_001284196	135412141	135423101	6
chr4	135426840	135429761	Pnrc2	2921	-	NM_026383	135427928	135428351	3
chr4	135451103	135476134	Cnr2	25031	+	NM_009924	135472527	135473571	2
chr4	135476640	135496215	Fuca1	19575	+	NM_024243	135476718	135495129	8
chr4	135502367	135518532	Hmgcl	16165	+	NM_008254	135502395	135518125	9
chr4	135521079	135524093	Gale	3014	+	NM_178389	135521253	135523774	10
chr4	135524139	135528509	Lypla2	4370	-	NM_011942	135524931	135526852	10
chr4	135531516	135543159	Pithd1	11643	-	NM_025411	135532309	135543050	6
chr4	135559284	135577564	Tceb3	18280	-	NM_013736	135561530	135577540	11
chr4	135605862	135609286	Rpl11	3424	-	NM_025919	135605901	135609268	6
chr4	135699736	135701307	Id3	1571	+	NM_008321	135699793	135700268	3
chr4	135728188	135751971	E2f2	23783	+	NM_177733	135728695	135748952	7
chr4	135762279	135802488	Asap3	40209	+	NM_001008232	135762433	135799775	25
chr4	135803871	135830814	Tcea3	26943	+	NM_011542	135803963	135830703	11
chr4	135841983	135849857	Zfp46	7874	+	NM_009557	135843124	135847130	3
chr4	135866856	135901894	Hnrnpr	35038	+	NM_028871	135870013	135895943	11
chr4	135979438	136000316	Htr1d	20878	+	NM_001285483	135998376	135999501	3
chr4	136025675	136105233	Luzp1	79558	+	NM_024452	136096382	136101308	5
chr4	136106447	136158638	Kdm1a	52191	-	NM_133872	136106762	136158500	19
chr4	136166351	136169128	4930549C01Rik	2777	+	NM_026300	136166413	136169018	2
chr4	136178535	136194025	Lactbl1	15490	+	NM_001243262	136179260	136193999	8
chr4	136203455	136391927	Ephb2	188472	-	NM_001290753	136211236	136391745	16
chr4	136436060	136442092	C1qb	6032	-	NM_009777	136436203	136438222	3
chr4	136445716	136448829	C1qc	3113	-	NM_007574	136445957	136448477	3
chr4	136451830	136454759	C1qa	2929	-	NM_007572	136452068	136453752	3
chr4	136485333	136512731	Epha8	27398	-	NM_007939	136486962	136512662	17
chr4	136535646	136604610	Zbtb40	68964	-	NM_198248	136538964	136574635	19
chr4	136714996	136720981	Gm13003	5985	-	NR_040443	136720981	136720981	4
chr4	136833549	136855416	Wnt4	21867	+	NM_009523	136833594	136852694	5
chr4	136875610	136913674	Cdc42	38064	-	NM_009861	136877017	136891994	6
chr4	136957468	136965706	Cela3a	8238	-	NM_001126318	136957542	136965674	8
chr4	136976922	136986435	Cela3b	9513	-	NM_026419	136976988	136986414	8
chr4	137009210	137011376	1700013G24Rik	2166	+	NM_027063	137010450	137011311	2
chr4	137024717	137126545	Hspg2	101828	+	NM_008305	137024776	137125579	97
chr4	137094200	137094285	Mir7018	85	+	NR_105985	137094285	137094285	1
chr4	137126790	137131095	Ldlrad2	4305	-	NM_001033979	137127997	137130484	4
chr4	137150103	137214452	Usp48	64349	+	NM_130879	137150297	137212059	28
chr4	137220640	137285776	Rap1gap	65136	+	NM_029563	137265819	137284451	24
chr4	137297645	137352299	Alpl	54654	-	NM_007431	137298351	137314547	12
chr4	137418151	137521144	Ece1	102993	+	NM_199307	137469682	137518821	20
chr4	137549370	137762994	Eif4g3	213624	+	NM_001256195	137638873	137762069	35
chr4	137693494	137694433	1700095J12Rik	939	-	NR_126429	137694433	137694433	2
chr4	137719123	137719207	Mir6399	84	+	NR_105825	137719207	137719207	1
chr4	137772526	137800597	Hp1bp3	28071	+	NM_001285478	137777542	137797655	13
chr4	137806325	137816883	Sh2d5	10558	+	NM_001099631	137809786	137815172	10
chr4	137818165	137857888	Kif17	39723	+	NM_010623	137818417	137857342	15
chr4	137860652	137868526	Ddost	7874	+	NM_007838	137860793	137867898	11
chr4	137869324	137882211	Pink1	12887	-	NM_026880	137869870	137882134	8
chr4	137872046	137872115	Mir7019	69	-	NR_105986	137872115	137872115	1
chr4	137894442	137923870	Cda	29428	-	NM_028176	137894798	137923858	4
chr4	137950006	137952373	Fam43b	2367	-	NM_001081672	137950929	137951922	1
chr4	137990586	137998180	Mul1	7594	+	NM_026689	137990674	137995595	4
chr4	138011062	138016041	Camk2n1	4979	+	NM_025451	138011100	138012703	2
chr4	138124883	138179907	Vwa5b1	55024	-	NM_029401	138124981	138168859	22
chr4	138274440	138294353	Ubxn10	19913	-	NM_001285929	138276444	138277278	3
chr4	138281239	138300490	Pla2g2c	19251	+	NM_008868	138287499	138299677	6
chr4	138306447	138313513	Pla2g2f	7066	-	NM_012045	138308126	138313388	5
chr4	138331649	138338058	Pla2g2d	6409	+	NM_011109	138331728	138336308	4
chr4	138355161	138419384	Pla2g5	64223	-	NM_001122954	138356454	138362139	6
chr4	138387771	138391104	Pla2g2a	3333	+	NR_002926	138391104	138391104	5
chr4	138426906	138429879	Gm13030	2973	-	NM_001308487	138427093	138429843	3
chr4	138433856	138438729	Pla2g2e	4873	+	NM_012044	138435371	138438472	5
chr4	138451293	138469862	Otud3	18569	-	NM_028453	138451652	138469742	8
chr4	138523026	138524281	Rnf186	1255	+	NM_025786	138523065	138523908	1
chr4	138528197	138615086	Tmco4	86889	+	NM_001305423	138546465	138614431	16
chr4	138617323	138630704	Htr6	13381	-	NM_021358	138617334	138630676	3
chr4	138638206	138648885	Nbl1	10679	-	NM_008675	138639259	138641535	4
chr4	138657728	138687028	Minos1	29300	-	NM_001163006	138659918	138686900	4
chr4	138731321	138736570	Gm16287	5249	-	NR_033543	138736570	138736570	3
chr4	138748813	138847735	Capzb	98922	+	NM_001037761	138748940	138844878	10
chr4	138853919	138866615	Pqlc2	12696	-	NM_145384	138854806	138862521	9
chr4	138866658	138874701	Akr7a5	8043	+	NM_025337	138866669	138874168	7
chr4	138903354	138908491	Mrto4	5137	-	NM_001290810	138903570	138908211	8
chr4	138908501	138934650	Emc1	26149	+	NM_146157	138908534	138931440	24
chr4	138936573	139045447	Ubr4	108874	+	NM_001160319	138936601	139045146	106
chr4	139086462	139176297	Iffo2	89835	+	NM_183148	139159152	139172348	12
chr4	139178808	139205606	Aldh4a1	26798	+	NM_175438	139179053	139204185	15
chr4	139199956	139200026	Mir7020	70	+	NR_105987	139200026	139200026	1
chr4	139209452	139226194	Tas1r2	16742	+	NM_031873	139209483	139225711	6
chr4	139293995	139388883	Pax7	94888	-	NM_011039	139296701	139388826	9
chr4	139482025	139499434	4933427I22Rik	17409	-	NR_045159	139499434	139499434	3
chr4	139518087	139523941	Klhdc7a	5854	-	NM_173427	139521227	139523549	1
chr4	139523440	139523535	Mir2139	95	-	NR_035519	139523535	139523535	1
chr4	139582766	139802726	Igsf21	219960	-	NM_198610	139582919	139802286	10
chr4	140070399	140221820	Arhgef10l	151421	-	NM_001112722	140070904	140172864	28
chr4	140257387	140279135	Rcc2	21748	+	NM_173867	140258071	140277119	13
chr4	140283269	140298558	Padi6	15289	-	NM_153106	140283490	140298495	16
chr4	140301422	140330118	Padi4	28696	-	NM_011061	140302038	140330095	16
chr4	140341283	140366563	Padi3	25280	-	NM_011060	140342315	140366522	16
chr4	140366907	140373426	Gm13032	6519	+	NR_045944	140373426	140373426	3
chr4	140368895	140401693	Padi1	32798	-	NM_011059	140370535	140401566	16
chr4	140428607	140433972	4930515B02Rik	5365	+	NR_040654	140433972	140433972	3
chr4	140462274	140508501	Padi2	46227	+	NM_008812	140462348	140505839	16
chr4	140503580	140513817	Gm13031	10237	-	NR_045911	140513817	140513817	4
chr4	140517185	140535107	Sdhb	17922	+	NM_023374	140517319	140535017	8
chr4	140542787	140563616	Atp13a2	20829	+	NM_001164366	140542981	140562905	29
chr4	140566338	140571899	Mfap2	5561	+	NM_001161799	140568773	140571495	9
chr4	140572551	140616460	Crocc	43909	-	NM_001145958	140572960	140607090	36
chr4	140622426	140634260	Necap2	11834	-	NM_025383	140623478	140634219	8
chr4	140644259	140668674	Spata21	24415	+	NM_177867	140646377	140668567	15
chr4	140668892	140695711	Szrd1	26819	-	NM_001025608	140671676	140695657	4
chr4	140703836	140759977	Fbxo42	56141	+	NM_172518	140723642	140756479	10
chr4	140769870	140776029	Rsg1	6159	+	NM_001081174	140770275	140776001	6
chr4	140798798	140813477	Arhgef19	14679	+	NM_172520	140802118	140812794	17
chr4	140857135	140885299	Epha2	28164	+	NM_010139	140857267	140884433	17
chr4	140924106	140940089	Fam131c	15983	+	NM_001085513	140924217	140939562	7
chr4	140940525	140954621	Clcnka	14096	-	NM_024412	140940815	140953963	20
chr4	140960271	140971903	Clcnkb	11632	-	NM_019701	140960499	140971210	20
chr4	140976693	140981225	Hspb7	4532	+	NM_013868	140977699	140979973	3
chr4	140988586	140992020	Gm694	3434	-	NM_001033374	140988943	140991964	2
chr4	141000587	141023852	Zbtb17	23265	+	NM_009541	141017685	141023041	16
chr4	141023804	141094512	Spen	70708	-	NM_019763	141024820	141094161	16
chr4	141102076	141104228	B330016D10Rik	2152	+	NR_030695	141104228	141104228	1
chr4	141131976	141161967	Fblim1	29991	-	NM_133754	141133744	141151385	9
chr4	141170147	141174548	Tmem82	4401	-	NM_145987	141170495	141173901	6
chr4	141170284	141171519	AI507597	1235	+	NR_033566	141171519	141171519	3
chr4	141174739	141179749	Slc25a34	5010	-	NM_001013780	141176326	141179611	5
chr4	141181648	141220030	Plekhm2	38382	-	NM_001033150	141182484	141219835	20
chr4	141239477	141241631	Rsc1a1	2154	-	NM_023544	141239765	141241514	1
chr4	141239477	141279334	Ddi2	39857	-	NM_001017966	141245229	141279109	10
chr4	141302589	141315178	Agmat	12589	+	NM_001081408	141302724	141314986	7
chr4	141317912	141346559	Dnajc16	28647	-	NM_172338	141319433	141344970	15
chr4	141349526	141371893	Casp9	22367	+	NM_015733	141349769	141369602	9
chr4	141370877	141381918	Cela2a	11041	-	NM_007919	141370952	141381897	8
chr4	141394154	141402274	Ctrc	8120	-	NM_001033875	141394214	141402183	8
chr4	141400235	141402905	Ctrcos	2670	+	NR_040641	141402905	141402905	3
chr4	141414056	141430835	Efhd2	16779	-	NM_025994	141415661	141430782	4
chr4	141446537	141567566	Fhad1	121029	-	NM_177868	141446765	141567552	32
chr4	141538906	141542712	Fhad1os1	3806	+	NR_040672	141542712	141542712	4
chr4	141573812	141584910	4930455G09Rik	11098	+	NR_131014	141584910	141584910	2
chr4	141586907	141640219	Tmem51	53312	-	NM_145402	141587600	141593660	3
chr4	141640212	141644016	Tmem51os1	3804	+	NR_027137	141644016	141644016	5
chr4	141658304	141766123	Kazn	107819	-	NM_144531	141660704	141766123	14
chr4	142697293	142802612	Prdm2	105319	-	NM_001081355	142701559	142784572	10
chr4	142726002	142726065	Mir7021	63	-	NR_105988	142726065	142726065	1
chr4	142857311	142889467	Pdpn	32156	-	NM_010329	142858322	142889158	6
chr4	142939652	142960931	Lrrc38	21279	+	NM_001162983	142940071	142959920	2
chr4	142984343	142989722	Pramel1	5379	+	NM_031377	142986357	142988787	4
chr4	143002328	143010990	Pramef8	8662	+	NM_172877	143006568	143009308	5
chr4	143027066	143040205	Oog4	13139	-	NM_173773	143027353	143029919	5
chr4	143101245	143107734	Gm13043	6489	+	NM_001039595	143104949	143107151	4
chr4	143141602	143148139	Gm13040	6537	+	NM_001113736	143141630	143147554	4
chr4	143141602	143148139	Gm13057	6537	+	NM_001113735	143141630	143147554	4
chr4	143157369	143163701	BC080695	6332	+	NM_001007579	143160914	143163117	4
chr4	143204905	143208498	Gm13083	3593	+	NM_001126324	143204905	143207540	3
chr4	143243662	143247149	Gm13088	3487	-	NM_001126325	143243971	143246550	4
chr4	143309353	143319061	Gm13078	9708	+	NM_001085412	143315903	143318461	4
chr4	143379236	143385488	Gm13023	6252	+	NM_001007077	143379304	143385215	4
chr4	143399893	143405996	Gm13084	6103	-	NM_001005371	143400177	143405951	4
chr4	143436399	143443540	Gm13103	7141	+	NM_177571	143436441	143443225	4
chr4	143484139	143490283	Pramef6	6144	-	NM_001085414	143484139	143487828	6
chr4	143538085	143540919	Pramef25	2834	-	NM_001126315	143538672	143540910	3
chr4	143581029	143584272	Pramef17	3243	-	NM_001085540	143581346	143584272	3
chr4	143649028	143659221	Pramel4	10193	+	NM_001001319	143655657	143658450	4
chr4	143689782	143700004	Gm13102	10222	+	NM_001085419	143696433	143699226	4
chr4	143747458	143752554	Oog3	5096	-	NM_201258	143747764	143752509	4
chr4	143780619	143786837	Oog2	6218	+	NM_198661	143783901	143786500	5
chr4	143796664	143802920	C87977	6256	-	NM_001177542	143796941	143802868	4
chr4	143860535	143870369	Pramel5	9834	-	NM_001085418	143861071	143863907	4
chr4	143920151	143923368	Gm13128	3217	+	NM_001085541	143920151	143923051	3
chr4	143947866	143954322	Gm13119	6456	+	NM_001034101	143951538	143953740	4
chr4	143962662	143967836	Gm13125	5174	-	NM_001115077	143962662	143967836	3
chr4	143981576	143998367	Pramef12	16791	-	NM_029948	143982506	143985875	4
chr4	144008093	144028675	1700012P22Rik	20582	-	NM_027056	144008306	144028507	4
chr4	144043673	144053659	Aadacl3	9986	-	NM_001085503	144045572	144053632	4
chr4	144109724	144119256	9430007A20Rik	9532	+	NM_198662	144109788	144119138	4
chr4	144144902	144155037	Gm13124	10135	-	NM_001085542	144144902	144155037	4
chr4	144203609	144213301	Gm13177	9692	+	NM_001081248	144203609	144213301	4
chr4	144259839	144276271	Gm436	16432	-	NM_001085504	144259839	144276271	4
chr4	144293093	144311307	Gm13178	18214	-	NM_001085536	144293093	144311307	4
chr4	144367106	144376486	Gm438	9380	-	NM_001126316	144367300	144376430	4
chr4	144482729	144517548	Dhrs3	34819	+	NM_001172424	144483495	144517122	7
chr4	144562524	144784908	Vps13d	222384	-	NM_001276465	144565039	144780495	70
chr4	144802270	144836773	Tnfrsf1b	34503	-	NM_011610	144805689	144836704	10
chr4	144858878	144905050	Tnfrsf8	46172	-	NM_009401	144858893	144904987	13
chr4	145054112	145057864	Smarca5-ps	3752	+	NR_002888	145057864	145057864	1
chr4	145207048	145214297	Gm13212	7249	+	NM_001205101	145207048	145213862	4
chr4	145260599	145294340	Gm13242	33741	+	NM_001103158	145286063	145292543	5
chr4	145427121	145427895	Gm13238	774	+	NR_033612	145427895	145427895	1
chr4	145651165	145679000	1700095A21Rik	27835	+	NR_045468	145679000	145679000	3
chr4	145658643	145696039	Gm13247	37396	-	NM_001243138	145660081	145665915	5
chr4	145728598	145749009	Gm13251	20411	-	NM_001085522	145730493	145734506	4
chr4	145850602	145889553	Rex2	38951	+	NM_001177767	145881269	145887868	5
chr4	146034924	146036119	Gm13034	1195	+	NR_030771	146036119	146036119	1
chr4	146064712	146094024	Gm13051	29312	+	NM_001037926	146085280	146093302	4
chr4	146124227	146166157	Zfp600	41930	+	NM_001177546	146157622	146164378	5
chr4	146437474	146442545	4933438K21Rik	5071	-	NR_045446	146442545	146442545	3
chr4	146506201	146554688	Gm13139	48487	+	NM_001083918	146549983	146553998	7
chr4	146514185	146556724	Znf41-ps	42539	+	NR_040355	146556724	146556724	5
chr4	146549974	146887529	Gm13152	337555	+	NM_001039209	146549983	146887403	3
chr4	146927385	146959310	Gm13154	31925	+	NM_001014397	146951208	146958345	6
chr4	146986044	147016617	2610305D13Rik	30573	-	NM_145078	146987135	146992600	5
chr4	147048333	147076740	Zfp534	28407	-	NM_001127188	147048333	147056405	4
chr4	147128082	147183897	Gm13157	55815	-	NM_001127189	147128857	147135359	6
chr4	147195885	147196311	Rps19-ps3	426	-	NR_033639	147196311	147196311	1
chr4	147197094	147222484	Zfp933	25390	-	NM_198619	147199839	147222389	4
chr4	147234886	147242828	Miip	7942	-	NM_001025365	147235122	147240466	10
chr4	147243087	147244467	Fv1	1380	+	NM_010244	147243087	147244467	1
chr4	147247694	147279018	Mfn2	31324	-	NM_001285921	147249497	147272747	20
chr4	147283861	147310885	Plod1	27024	-	NM_011122	147284827	147310786	19
chr4	147315003	147321423	2510039O18Rik	6420	+	NM_029841	147315133	147320727	3
chr4	147359896	147361314	Nppb	1418	+	NM_008726	147360084	147361087	3
chr4	147374830	147376183	Nppa	1353	+	NM_008725	147374943	147375895	3
chr4	147378367	147412922	Clcn6	34555	-	NM_011929	147380889	147412876	23
chr4	147413185	147433671	Mthfr	20486	+	NM_010840	147415705	147429697	12
chr4	147451169	147462173	Agtrap	11004	-	NM_009642	147454591	147462052	5
chr4	147472545	147504807	Draxin	32262	-	NM_027426	147476578	147490100	7
chr4	147505028	147519813	Mad2l2	14785	+	NM_001305420	147514903	147519522	10
chr4	147519824	147526244	Fbxo6	6420	-	NM_001163707	147520024	147523746	6
chr4	147521044	147521105	Mir7022	61	-	NR_105989	147521105	147521105	1
chr4	147526907	147534203	Fbxo44	7296	-	NR_104374	147534203	147534203	7
chr4	147534776	147540526	Fbxo2	5750	+	NM_176848	147534798	147540208	6
chr4	147610965	147662074	Ptchd2	51109	-	NM_001083342	147615364	147646510	21
chr4	147808605	147818860	Ubiad1	10255	-	NM_027873	147810263	147818559	2
chr4	147822690	147931794	Mtor	109104	+	NM_020009	147826379	147930969	58
chr4	147869388	147874571	Angptl7	5183	-	NM_001039554	147870263	147874398	5
chr4	147932535	147956509	Exosc10	23974	+	NM_016699	147932576	147956423	25
chr4	147965621	147968728	Srm	3107	+	NM_009272	147965728	147968416	7
chr4	147976652	147989589	Masp2	12937	+	NM_001003893	147976694	147988630	11
chr4	147986490	148001105	Tardbp	14615	-	NR_027864	148001105	148001105	8
chr4	148017425	148045681	Gm572	28256	+	NM_001085505	148017466	148045537	11
chr4	148178500	148329001	Casz1	150501	+	NM_001159344	148275836	148326680	21
chr4	148334643	148473921	Pex14	139278	-	NM_019781	148335449	148473916	9
chr4	148478250	148494762	Dffa	16512	+	NM_001025296	148478359	148493400	6
chr4	148499142	148500872	Cort	1730	-	NM_007745	148499372	148500755	2
chr4	148502457	148511709	Apitd1	9252	-	NM_027263	148502881	148511632	5
chr4	148524093	148540816	Pgd	16723	-	NM_001081274	148524752	148540703	13
chr4	148550427	148681842	Kif1b	131415	-	NM_001290995	148554876	148665516	49
chr4	148702524	148800740	Ube4b	98216	-	NM_022022	148703784	148800014	27
chr4	148708747	148710021	Ube4bos3	1274	+	NR_131918	148710021	148710021	2
chr4	148823810	148829077	Rbp7	5267	-	NM_022020	148823981	148829059	4
chr4	148842895	148859251	Nmnat1	16356	-	NM_133435	148842904	148848651	5
chr4	148859441	148870776	Lzic	11335	+	NM_026963	148860868	148870247	7
chr4	148892349	148940546	Ctnnbip1	48197	+	NM_023465	148919844	148938372	5
chr4	148911971	148912031	Mir5616	60	+	NR_049189	148912031	148912031	1
chr4	148960576	149023008	Clstn1	62432	+	NM_023051	148960790	149021673	19
chr4	149023276	149075738	Pik3cd	52462	-	NM_001029837	149024748	149037393	24
chr4	149029612	149029676	Mir7023	64	-	NR_105990	149029676	149029676	1
chr4	149089483	149112177	Tmem201	22694	-	NM_001284270	149091088	149112056	11
chr4	149118144	149148376	Slc25a33	30232	-	NM_027460	149118846	149148164	7
chr4	149270392	149329115	Spsb1	58723	-	NM_029035	149272322	149281218	3
chr4	149353582	149383132	H6pd	29550	-	NM_173371	149355666	149382864	5
chr4	149442562	149442664	Mir34a	102	+	NR_029751	149442664	149442664	1
chr4	149461611	149480036	Gpr157	18425	+	NM_177366	149461862	149476518	4
chr4	149493452	149518277	Slc2a5	24825	+	NM_019741	149494844	149517340	14
chr4	149523080	149542591	Slc2a7	19511	+	NM_001085529	149523080	149542591	12
chr4	149561124	149575244	Car6	14120	-	NM_009802	149561513	149575218	8
chr4	149611305	149622982	Eno1	11677	+	NM_023119	149613590	149622664	12
chr4	149611432	149622982	Eno1b	11550	+	NM_001025388	149613590	149622664	12
chr4	149656024	149996075	Rere	340051	+	NM_001085492	149780448	149993598	23
chr4	150003504	150026283	Slc45a1	22779	-	NM_173774	150003639	150018453	9
chr4	150202333	150229058	1700045H11Rik	26725	-	NR_040649	150229058	150229058	4
chr4	150229199	150242989	Errfi1	13790	+	NM_133753	150239256	150241611	4
chr4	150271241	150284030	Park7	12789	-	NM_020569	150271419	150282516	7
chr4	150294263	150320211	Tnfrsf9	25948	+	NM_011612	150303954	150318979	8
chr4	150371205	150375919	Uts2	4714	+	NM_011910	150371241	150375789	4
chr4	150377763	150418774	Per3	41011	-	NM_001289878	150379984	150403266	22
chr4	150421413	150432062	Vamp3	10649	-	NM_009498	150423138	150431984	5
chr4	150433631	151235877	Camta1	802246	-	NM_001081557	150436931	151235778	24
chr4	150463678	150465558	Gm13090	1880	+	NM_001308446	150463779	150465249	4
chr4	151307828	151356068	Dnajc11	48240	+	NM_172704	151307861	151354837	16
chr4	151356746	151363095	Thap3	6349	-	NM_175152	151357173	151363065	4
chr4	151363739	151370288	Phf13	6549	-	NM_172705	151365661	151369973	4
chr4	151382999	151391786	Klhl21	8787	+	NM_001033352	151383051	151389737	4
chr4	151393884	151401780	Zbtb48	7896	-	NM_133879	151393932	151401165	11
chr4	151402022	151412599	Tas1r1	10577	-	NM_031867	151402174	151412495	6
chr4	151413429	151435603	Nol9	22174	+	NM_028727	151413463	151435367	12
chr4	151460971	151489513	Plekhg5	28542	+	NR_104381	151489513	151489513	22
chr4	151490042	151494228	Tnfrsf25	4186	+	NM_001291010	151490187	151493948	10
chr4	151494984	151526316	Espn	31332	-	NM_207687	151495229	151526316	16
chr4	151532975	151536578	Hes2	3603	+	NM_001301805	151533777	151534658	5
chr4	151552208	151645964	Acot7	93756	+	NM_133348	151552279	151645681	9
chr4	151648470	151659446	Gpr153	10976	+	NM_178406	151653233	151657698	6
chr4	151660080	151665771	Hes3	5691	-	NM_008237	151660996	151661974	5
chr4	151671322	151681235	Icmt	9913	+	NR_037908	151681235	151681235	6
chr4	151681131	151692734	Rnf207	11603	-	NM_001033489	151681535	151692567	17
chr4	151698544	151708191	Rpl22	9647	+	NM_001277113	151698583	151706533	4
chr4	151712759	151764303	Chd5	51544	+	NM_001081376	151713060	151760065	42
chr4	151764848	151851658	Kcnab2	86810	-	NM_010598	151767143	151809990	16
chr4	151852250	151937293	Nphp4	85043	+	NM_153424	151858514	151936887	30
chr4	152071648	152075031	Gm833	3383	+	NR_033138	152075031	152075031	3
chr4	152747329	152856939	Ajap1	109610	-	NM_001099299	152756373	152856266	6
chr4	153322563	153324585	BC039966	2022	-	NR_040670	153324585	153324585	3
chr4	153331345	153336033	A430005L14Rik	4688	+	NM_175287	153331416	153335700	4
chr4	153338557	153349190	Dffb	10633	-	NM_007859	153339478	153349098	7
chr4	153349669	153381334	Cep104	31665	+	NM_177673	153353091	153380914	22
chr4	153385911	153395621	Lrrc47	9710	+	NM_201226	153385924	153393985	7
chr4	153394578	153400153	Smim1	5575	-	NM_001163722	153397435	153397906	4
chr4	153400752	153416786	Ccdc27	16034	-	NM_001033455	153400842	153416712	12
chr4	153430357	153514317	Trp73	83960	-	NM_011642	153433099	153479004	14
chr4	153516480	153530927	Wdr8	14447	+	NM_021499	153516553	153530789	12
chr4	153531594	153534793	Tprgl	3199	-	NM_026388	153532479	153534738	4
chr4	153544821	153649830	Megf6	105009	+	NM_001162977	153545132	153647984	37
chr4	153652578	153674004	Arhgef16	21426	-	NM_001112744	153653064	153665644	15
chr4	153690233	154010982	Prdm16	320749	-	NM_001291026	153694896	154010868	17
chr4	154004799	154010476	5930403L14Rik	5677	-	NR_045643	154010476	154010476	1
chr4	154040536	154041976	Actrt2	1440	-	NM_028513	154040652	154041786	1
chr4	154230308	154241236	Ttc34	10928	+	NM_172878	154230499	154239892	7
chr4	154243693	154269639	Mmel1	25946	+	NM_013783	154245761	154269334	24
chr4	154270538	154273152	Fam213b	2614	-	NM_025582	154270679	154273114	7
chr4	154296318	154302186	Tnfrsf14	5868	-	NM_178931	154296352	154302155	8
chr4	154335031	154336480	Hes5	1449	+	NM_010419	154335104	154335784	3
chr4	154338231	154355047	Pank4	16816	+	NM_001305804	154338254	154354817	20
chr4	154357223	154385093	Plch2	27870	-	NM_175556	154359490	154385093	23
chr4	154441138	154446515	Pex10	5377	+	NM_001042407	154441177	154445882	6
chr4	154448220	154460406	Rer1	12186	-	NM_026395	154449047	154456856	7
chr4	154460685	154519616	Morn1	58931	+	NM_001081100	154460714	154519418	14
chr4	154528183	154596644	Ski	68461	-	NM_011385	154531449	154596629	7
chr4	154624074	154630796	Faap20	6722	+	NM_001190445	154624109	154630316	4
chr4	154634226	154735537	Prkcz	101311	-	NM_008860	154636552	154735331	18
chr4	154759087	154772178	Gabrd	13091	-	NM_008072	154759509	154772071	9
chr4	154775077	154795813	5830444B04Rik	20736	-	NR_102284	154795813	154795813	3
chr4	154783298	154817219	Cfap74	33921	+	NM_177674	154789807	154816955	21
chr4	154843222	154844967	Tmem52	1745	+	NM_027161	154843253	154844639	5
chr4	154865469	154933378	Gnb1	67909	+	NM_008142	154901561	154931386	12
chr4	154936500	154965110	Nadk	28610	+	NM_138671	154951127	154963584	12
chr4	154975524	154997450	Slc35e2	21926	+	NM_177186	154984106	154992858	9
chr4	154982405	154998864	Gm16023	16459	-	NR_040441	154998864	154998864	3
chr4	154998977	155024041	Cdk11b	25064	+	NM_007661	154999652	155023893	20
chr4	155024763	155027493	Mmp23	2730	-	NM_011985	155024817	155027289	8
chr4	155028580	155043363	Mib2	14783	-	NM_001256107	155028863	155035461	20
chr4	155068450	155070592	B930041F14Rik	2142	+	NM_178699	155068609	155069281	1
chr4	155078923	155107982	Ssu72	29059	+	NM_026899	155079490	155107683	5
chr4	155108912	155114673	Tmem240	5761	+	NM_001101506	155109198	155114103	4
chr4	155114748	155135207	Atad3a	20459	-	NM_179203	155115296	155135112	16
chr4	155135300	155137669	Atad3aos	2369	+	NR_027972	155137669	155137669	3
chr4	155142603	155148670	Vwa1	6067	-	NM_147776	155144436	155148611	4
chr4	155155699	155159983	Tmem88b	4284	-	NM_001033394	155158376	155159711	2
chr4	155177726	155182938	Mrpl20	5212	+	NM_025570	155177764	155182761	4
chr4	155186597	155198652	Ccnl2	12055	+	NM_207678	155186636	155197806	11
chr4	155205377	155207207	Aurkaip1	1830	+	NM_025338	155206124	155207101	4
chr4	155213788	155218211	Mxra8	4423	+	NM_024263	155213950	155217439	10
chr4	155221425	155233412	Dvl1	11987	+	NM_001302342	155221843	155232475	16
chr4	155233378	155237462	Tas1r3	4084	-	NM_031872	155234294	155237443	6
chr4	155238831	155243549	Cptp	4718	-	NM_024472	155240465	155241343	3
chr4	155243675	155263212	Cpsf3l	19537	+	NM_028020	155243801	155262794	17
chr4	155262968	155265871	Pusl1	2903	-	NM_001033490	155263263	155265816	8
chr4	155265983	155281360	Acap3	15377	+	NM_207223	155266503	155280069	24
chr4	155317921	155333713	Ube2j2	15792	+	NM_021402	155320490	155331474	8
chr4	155320361	155331710	Gm5801	11349	+	NR_002889	155331710	155331710	7
chr4	155336420	155340738	Fam132a	4318	+	NM_026125	155336687	155340611	8
chr4	155363574	155366787	B3galt6	3213	-	NM_080445	155365747	155366725	1
chr4	155366951	155387719	Sdf4	20768	+	NM_011341	155370304	155384059	7
chr4	155387803	155390698	Tnfrsf4	2895	+	NM_011659	155387982	155390541	7
chr4	155395753	155397933	Gm10560	2180	-	NR_040563	155397933	155397933	3
chr4	155400450	155403000	Tnfrsf18	2550	+	NM_009400	155400495	155402725	5
chr4	155408945	155424926	Ttll10	15981	-	NM_029264	155409021	155422734	15
chr4	155426824	155433911	Gm13648	7087	-	NR_132444	155433911	155433911	2
chr4	155428013	155428096	Mir429	83	-	NR_029958	155428096	155428096	1
chr4	155429004	155429094	Mir200a	90	-	NR_029723	155429094	155429094	1
chr4	155429789	155429859	Mir200b	70	-	NR_029587	155429859	155429859	1
chr4	155484106	155501372	9430015G10Rik	17266	+	NM_145557	155491140	155499623	10
chr4	155501596	155507531	Rnf223	5935	+	NM_001220499	155506278	155507046	2
chr4	155539398	155571597	Agrn	32199	-	NM_021604	155540604	155571529	36
chr4	155573532	155574927	Isg15	1395	-	NM_015783	155573692	155574817	2
chr4	155577392	155580137	AW011738	2745	+	NR_030671	155580137	155580137	1
chr4	155590035	155595416	Perm1	5381	+	NM_172417	155591109	155594331	4
chr4	155595564	155602651	Plekhn1	7087	-	NM_001008233	155595887	155602600	16
chr4	155603152	155608966	Klhl17	5814	-	NM_198305	155604142	155608865	12
chr4	155604167	155604224	Mir7658	57	-	NR_106118	155604224	155604224	1
chr4_random	109801	130134	Dhrsx	20333	+	NM_001033326	110219	129357	7
chr5	3343892	3531005	Cdk6	187113	+	NM_009873	3344366	3520791	8
chr5	3543832	3570546	Fam133b	26714	+	NM_001042501	3543923	3569073	11
chr5	3571715	3584341	1700109H08Rik	12626	+	NM_029843	3571752	3584296	6
chr5	3583977	3596547	Rbm48	12570	-	NM_172991	3584720	3596202	5
chr5	3596065	3637230	Pex1	41165	+	NM_001293806	3596388	3636855	24
chr5	3639960	3647936	Gatad1	7976	-	NM_026033	3641389	3647619	5
chr5	3657003	3679544	Tmbim7	22541	+	NM_029141	3657524	3679160	11
chr5	3689998	3803124	Ankib1	113126	-	NM_001003909	3692755	3772704	20
chr5	3803164	3844515	Krit1	41351	+	NM_030675	3806466	3840942	17
chr5	3845172	3866596	Lrrd1	21424	+	NM_172879	3849696	3866546	6
chr5	3890580	3893933	Mterf1a	3353	-	NM_172135	3890726	3891866	2
chr5	3928185	4080204	Akap9	152019	+	NM_194462	3928442	4079696	48
chr5	4080673	4104697	Cyp51	24024	-	NM_020010	4083124	4104307	10
chr5	4192366	4197651	Mterf1b	5285	+	NM_001042670	4196360	4197506	2
chr5	4753838	4758216	Fzd1	4378	-	NM_021457	4755651	4757580	1
chr5	4803383	5380251	Cdk14	576868	-	NM_011074	4888864	5380125	15
chr5	5437826	5479143	1700015F17Rik	41317	-	NM_001200025	5450643	5479013	7
chr5	5505014	5514976	Cldn12	9962	-	NM_022890	5507690	5508425	4
chr5	5537456	5559501	Gtpbp10	22045	-	NM_153116	5539251	5559465	10
chr5	5573798	5576203	Gm8773	2405	+	NR_033499	5576203	5576203	2
chr5	5580981	5664232	Cfap69	83251	-	NM_172447	5581195	5664030	23
chr5	5664828	5694568	Steap2	29740	-	NM_028734	5673408	5683022	6
chr5	5736321	5749317	Steap1	12996	-	NM_027399	5736415	5742909	5
chr5	6769029	7344378	Zfp804b	575349	-	NM_001163223	6769029	7344378	4
chr5	7304163	7311491	4921511H03Rik	7328	+	NM_027603	7304820	7305582	3
chr5	7960471	7982213	Steap4	21742	+	NM_054098	7975440	7980558	5
chr5	8046077	8069314	Sri	23237	+	NM_025618	8046209	8067559	8
chr5	8072346	8368160	Adam22	295814	-	NM_001310440	8078685	8367954	31
chr5	8396968	8422716	Dbf4	25748	-	NM_001190717	8397216	8422512	12
chr5	8422837	8454839	Slc25a40	32002	+	NM_178766	8427416	8453298	12
chr5	8490335	8622952	Rundc3b	132617	-	NM_198620	8492443	8622612	10
chr5	8660091	8748570	Abcb1a	88479	+	NM_011076	8660667	8747561	28
chr5	8798146	8866314	Abcb1b	68168	+	NM_011075	8798741	8865950	28
chr5	8893720	8959226	Abcb4	65506	+	NM_008830	8894093	8959175	28
chr5	8966047	8997146	Crot	31099	-	NM_023733	8966851	8993620	18
chr5	9100736	9118983	Tmem243	18247	+	NM_001081029	9101317	9118576	5
chr5	9118867	9161776	Dmtf1	42909	-	NM_011806	9120028	9150484	18
chr5	9266192	9480717	9330182L06Rik	214525	+	NM_172706	9266270	9479255	22
chr5	9375703	9375779	Mir879	76	+	NR_030537	9375779	9375779	1
chr5	9485235	9725352	Grm3	240117	-	NM_181850	9485767	9590043	6
chr5	10865028	10870808	Gm6455	5780	+	NR_003596	10870808	10870808	5
chr5	11183014	11187810	Gm5861	4796	+	NM_001310021	11183014	11186544	5
chr5	11340407	11346273	Speer1	5866	+	NR_001586	11346273	11346273	5
chr5	11594955	11599480	Gm6460	4525	+	NM_001037919	11595053	11598518	5
chr5	11664166	11680823	4930558F17Rik	16657	-	NR_126451	11680823	11680823	5
chr5	11749832	11769308	1700003C15Rik	19476	-	NR_045478	11769308	11769308	4
chr5	11918042	11922804	4933402N22Rik	4762	+	NM_001177510	11918140	11921556	5
chr5	12383165	12588943	Sema3d	205778	+	NM_028882	12448028	12585302	18
chr5	13396783	13603485	Sema3a	206702	+	NM_001243072	13399957	13599603	18
chr5	13791618	13796819	Speer3	5201	+	NM_027650	13791657	13796453	5
chr5	14025275	14256689	Sema3e	231414	+	NM_011348	14025909	14252790	17
chr5	14514917	14863459	Pclo	348542	+	NM_011995	14515221	14858886	25
chr5	14910123	14914889	Gm9758	4766	-	NM_198666	14910450	14914829	5
chr5	14933630	14938475	Speer4e	4845	-	NM_001122661	14934032	14938406	5
chr5	14933630	15220410	LOC105242399	286780	-	NM_001310450	14934032	15220020	6
chr5	14933648	15162836	Gm21190	229188	-	NM_001310449	14934010	15162832	6
chr5	14945293	14978541	Speer8-ps1	33248	+	NR_001584	14978541	14978541	4
chr5	14974496	14978899	Gm10354	4403	-	NM_001281514	14974496	14978875	5
chr5	15028949	15033007	Gm17019	4058	-	NM_182957	15029283	15032938	5
chr5	15124916	15129682	Speer4d	4766	+	NM_025759	15125082	15129328	5
chr5	15158105	15162877	4930572O03Rik	4772	-	NR_073011	15162877	15162877	5
chr5	15186527	15220414	Speer4cos	33887	+	NR_001585	15220414	15220414	5
chr5	15215322	15220089	Speer4c	4767	-	NM_001281511	15215672	15220020	5
chr5	15369745	15389584	4930519H02Rik	19839	-	NR_045974	15389584	15389584	6
chr5	15440508	15880329	Cacna2d1	439821	+	NM_001110843	15440831	15876492	39
chr5	16059312	16125257	Hgf	65945	+	NM_001289459	16059745	16124811	19
chr5	16981939	16986754	Speer4f1	4815	+	NM_027609	16981943	16986303	5
chr5	17080633	17236085	Sema3c	155452	+	NM_013657	17082685	17233574	18
chr5	17287507	17394777	Cd36	107270	-	NM_001159558	17291539	17334712	16
chr5	17468387	17525486	Gnat3	57099	+	NM_001081143	17468496	17525486	8
chr5	17770952	17866231	Gnai1	95279	-	NM_010305	17772836	17865987	8
chr5	18708185	18732373	4921504A21Rik	24188	-	NR_102341	18732373	18732373	4
chr5	18732863	20210609	Magi2	1477746	+	NM_001170746	18733106	20207944	23
chr5	20264481	20387942	Phtf2	123461	-	NM_172992	20266872	20360984	18
chr5	20388270	20392688	Tmem60	4418	+	NM_177601	20392056	20392458	2
chr5	20398841	20457640	Rsbn1l	58799	-	NM_001080977	20401892	20457603	8
chr5	20456806	20462216	A630072M18Rik	5410	+	NR_030699	20462216	20462216	1
chr5	20492462	20561615	Ptpn12	69153	-	NM_011203	20493250	20561565	18
chr5	20692084	20797519	Gsap	105435	+	NM_175437	20692180	20796447	31
chr5	20798778	20930495	Ccdc146	131717	-	NM_029195	20799109	20905656	19
chr5	20878490	20884204	Fgl2	5714	+	NM_008013	20878534	20881778	2
chr5	20930720	20987942	Fam185a	57222	+	NM_177869	20930985	20986262	8
chr5	20989664	21151423	Fbxl13	161759	-	NM_001199632	20989753	21151354	21
chr5	21049344	21081720	Lrrc17	32376	+	NM_028977	21066339	21081179	4
chr5	21151801	21168410	Armc10	16609	+	NM_026034	21151920	21167436	6
chr5	21168720	21207163	Napepld	38443	-	NM_178728	21171045	21189267	5
chr5	21242977	21262970	Pmpcb	19993	+	NM_028431	21242995	21262862	13
chr5	21263094	21290983	Dnajc2	27889	-	NM_009584	21263152	21290870	17
chr5	21291100	21309602	Psmc2	18502	+	NM_011188	21292506	21309522	13
chr5	21314818	21371422	Slc26a5	56604	-	NM_030727	21316965	21353147	20
chr5	21390271	21850523	Reln	460252	-	NM_011261	21391290	21850226	64
chr5	21992306	22056149	Orc5	63843	-	NM_011959	21992989	22056081	14
chr5	22034038	22034848	Gm15421	810	-	NR_004442	22034848	22034848	1
chr5	22056230	22063989	6030443J06Rik	7759	+	NR_102315	22063989	22063989	3
chr5	22244728	22252702	A930003O13Rik	7974	-	NR_027362	22252702	22252702	3
chr5	22252010	22781415	Lhfpl3	529405	+	NM_001081231	22252010	22727699	4
chr5	22937625	22940171	5031425E22Rik	2546	-	NR_040469	22940171	22940171	1
chr5	22940246	23010047	Kmt2e	69801	+	NM_026984	22956083	23008865	26
chr5	23009173	23122389	Srpk2	113216	-	NM_009274	23013353	23122182	15
chr5	23198078	23218485	AI506816	20407	-	NR_015554	23218485	23218485	5
chr5	23245982	23289529	Pus7	43547	-	NM_001289780	23247657	23284285	17
chr5	23293528	23326187	Rint1	32659	+	NM_177323	23293658	23325398	15
chr5	23344761	23349963	Tomm7	5202	-	NM_025394	23345630	23349891	3
chr5	23356414	23360851	2700038G22Rik	4437	+	NR_045042	23360851	23360851	4
chr5	23358050	23358095	Snord93	45	+	NR_028536	23358095	23358095	1
chr5	23421093	23536130	Fam126a	115037	-	NM_001310471	23421233	23505809	11
chr5	23606407	23667049	Klhl7	60642	+	NM_026448	23606572	23665548	11
chr5	23670780	23689826	Nupl2	19046	+	NM_153092	23670894	23688294	7
chr5	23825406	23857422	Kcnh2	32016	-	NM_013569	23825817	23857101	15
chr5	23870636	23890292	Nos3	19656	+	NM_008713	23870655	23889797	26
chr5	23889998	23897961	Atg9b	7963	-	NM_001002897	23891056	23897734	14
chr5	23899973	23915765	Abcb8	15792	+	NM_029020	23900306	23915312	16
chr5	23919268	23923652	Asic3	4384	+	NM_183000	23919529	23923564	11
chr5	23924059	23929348	Cdk5	5289	-	NM_007668	23925193	23929303	12
chr5	23931049	23946765	Slc4a2	15716	+	NM_009207	23933403	23946570	23
chr5	23946857	23951053	Fastk	4196	-	NM_023229	23946971	23950965	10
chr5	23951280	23953664	Tmub1	2384	-	NM_022418	23951739	23952737	3
chr5	23957994	24007865	Agap3	49871	+	NM_139153	23958024	24007421	18
chr5	24010243	24032666	Gbx1	22423	-	NM_015739	24010406	24032634	2
chr5	24038514	24046796	Asb10	8282	-	NM_001310476	24039471	24046744	6
chr5	24049251	24061287	4931409K22Rik	12036	-	NM_177676	24049356	24061200	19
chr5	24071158	24083285	Abcf2	12127	-	NM_013853	24071683	24082505	14
chr5	24092567	24098304	Chpf2	5737	+	NM_133913	24093855	24098182	4
chr5	24097931	24098029	Mir671	98	+	NR_030423	24098029	24098029	1
chr5	24098439	24107820	Smarcd3	9381	-	NM_025891	24098568	24107676	13
chr5	24151270	24154678	1700022A21Rik	3408	+	NR_003953	24154678	24154678	2
chr5	24191632	24216196	Nub1	24564	+	NM_001305264	24191769	24214985	15
chr5	24218086	24236498	Wdr86	18412	-	NM_001081441	24218392	24236161	6
chr5	24256819	24263661	Crygn	6842	-	NM_153076	24256871	24263661	4
chr5	24308640	24348179	Rheb	39539	-	NM_053075	24309481	24348054	8
chr5	24368552	24606460	Prkag2	237908	-	NM_145401	24369673	24605942	16
chr5	24408386	24412667	Prkag2os1	4281	+	NR_040684	24412667	24412667	7
chr5	24606792	24608825	2900005J15Rik	2033	+	NR_027851	24608825	24608825	1
chr5	24687297	24726107	Galntl5	38810	+	NM_026449	24691922	24726000	9
chr5	24728710	24771736	Galnt11	43026	+	NM_144908	24753309	24771199	12
chr5	24777611	25004601	Kmt2c	226990	-	NM_001081383	24779483	25004368	59
chr5	25005614	25010291	4831440E17Rik	4677	+	NR_030700	25010291	25010291	1
chr5	25021884	25023845	Cct8l1	1961	+	NM_198621	25022106	25023795	1
chr5	25035835	25037284	1700096K18Rik	1449	+	NR_027388	25037284	25037284	1
chr5	25195633	25211615	Xrcc2	15982	-	NM_020570	25197930	25211534	3
chr5	25265790	25356509	Actr3b	90719	+	NM_001004365	25265902	25355764	12
chr5	26326711	26331267	Gm1979	4556	-	NM_001281519	26326711	26331267	5
chr5	26344960	26349431	Gm5862	4471	-	NM_001281525	26344960	26349431	5
chr5	26344960	26431831	Gm21671	86871	-	NM_001281516	26344960	26431831	5
chr5	26360809	26366045	Speer4a	5236	-	NM_029376	26361486	26366023	5
chr5	26408711	26415804	Gm10471	7093	-	NM_001177579	26411208	26415718	5
chr5	26425207	26431854	5031410I06Rik	6647	-	NM_207657	26427327	26431831	5
chr5	26441303	26447965	Gm10220	6662	-	NM_001134299	26443408	26447890	5
chr5	26584301	26588728	Gm7361	4427	+	NM_001281527	26584301	26588728	5
chr5	26786609	26819854	4930584F24Rik	33245	-	NR_029445	26819854	26819854	5
chr5	27143896	28054040	Dpp6	910144	+	NM_010075	27144598	28052291	26
chr5	27822348	27827932	Speer4b	5584	-	NM_028561	27823496	27827907	5
chr5	28066620	28118090	Paxip1	51470	-	NM_018878	28069027	28117819	21
chr5	28168486	28181626	Htr5a	13140	+	NM_008314	28168988	28177626	2
chr5	28397951	28405202	Insig1	7251	+	NM_153526	28397977	28403360	5
chr5	28492235	28498706	En2	6471	+	NM_010134	28493066	28496975	2
chr5	28527358	28572328	Cnpy1	44970	-	NM_001310512	28529938	28535813	4
chr5	28643728	28745782	Rbm33	102054	+	NM_028234	28643907	28740156	19
chr5	28783379	28793641	Shh	10262	-	NM_009170	28784394	28793303	3
chr5	28793523	29045749	9530036O11Rik	252226	+	NR_015562	29045749	29045749	7
chr5	29522532	29552064	Rnf32	29532	+	NM_001289757	29524545	29551831	10
chr5	29556341	29704930	Lmbr1	148589	-	NM_020295	29559602	29704732	17
chr5	29761206	29778709	Nom1	17503	+	NM_001033457	29761217	29777743	11
chr5	29800362	29805010	Mnx1	4648	-	NM_019944	29800408	29804815	3
chr5	29864488	29865164	Gm6083	676	+	NR_102704	29865164	29865164	1
chr5	29895781	30002617	Ube3c	106836	+	NM_133907	29896054	30001109	23
chr5	30061873	30062476	Gm5129	603	-	NR_028426	30062476	30062476	1
chr5	30062437	30113018	Dnajb6	50581	+	NM_001037940	30074910	30111653	10
chr5	30115550	30297028	Mir6362	181478	+	NR_105781	30297028	30297028	3
chr5	30339653	30346515	Il6	6862	+	NM_031168	30339731	30346088	5
chr5	30384739	30400165	Tyms	15426	-	NR_033402	30400165	30400165	7
chr5	30419479	30424226	Gm4961	4747	+	NR_045694	30424226	30424226	2
chr5	30430123	30432626	3110082J24Rik	2503	-	NM_001256263	30430428	30431899	3
chr5	30431735	30444920	Gareml	13185	+	NM_001167879	30431831	30443827	6
chr5	30444843	30481520	Hadha	36677	-	NM_178878	30446354	30481488	20
chr5	30481792	30511133	Hadhb	29341	+	NM_145558	30490216	30510628	16
chr5	30497278	30497356	Mir1960	78	+	NR_035486	30497356	30497356	1
chr5	30519970	30532262	Adgrf3	12292	-	NM_001014394	30520076	30532245	14
chr5	30559157	30598976	Ept1	39819	+	NM_027652	30559298	30593545	10
chr5	30607913	30668993	Drc1	61080	+	NM_001033460	30607977	30668833	17
chr5	30669350	30764305	Otof	94955	-	NM_031875	30672470	30764171	47
chr5	30768449	30786460	1700001C02Rik	18011	+	NM_029285	30768483	30786385	4
chr5	30787956	30848209	Cib4	60253	-	NM_028483	30788109	30848152	7
chr5	30876359	30890992	Gm9899	14633	-	NR_040427	30890992	30890992	4
chr5	30890542	30927643	Kcnk3	37101	+	NM_010608	30890689	30925210	2
chr5	30950308	30950388	Mir5625	80	+	NR_049199	30950388	30950388	1
chr5	30950311	30962102	Slc35f6	11791	+	NM_175675	30950394	30960222	6
chr5	30969258	30977210	Cenpa	7952	+	NM_001302130	30972194	30975800	7
chr5	31014267	31101742	Dpysl5	87475	+	NM_023047	31047598	31098695	13
chr5	31117013	31168479	Mapre3	51466	+	NM_133350	31164186	31167569	7
chr5	31172019	31179840	Tmem214	7821	+	NM_144525	31172040	31179163	17
chr5	31191307	31209039	Agbl5	17732	+	NR_122117	31209039	31209039	16
chr5	31208888	31210161	Ost4	1273	-	NM_024460	31209794	31209908	3
chr5	31216158	31223646	Emilin1	7488	+	NM_133918	31216247	31223325	8
chr5	31223931	31233621	Khk	9690	+	NM_001310524	31224288	31233420	9
chr5	31235515	31247853	Cgref1	12338	-	NM_026770	31235863	31247848	6
chr5	31252438	31257468	Abhd1	5030	+	NR_003522	31257468	31257468	9
chr5	31254039	31262700	Preb	8661	-	NM_016703	31258015	31262478	9
chr5	31271049	31279391	Tcf23	8342	+	NM_053085	31271151	31276022	3
chr5	31338408	31351297	Slc5a6	12889	-	NM_001177622	31339179	31345712	18
chr5	31351012	31357006	Atraid	5994	+	NM_027855	31351045	31356740	7
chr5	31357152	31380852	Cad	23700	+	NM_001289523	31357327	31380568	44
chr5	31388478	31395900	Slc30a3	7422	-	NM_011773	31389142	31395730	8
chr5	31410691	31414897	Dnajc5g	4206	+	NM_177677	31411262	31413514	6
chr5	31418984	31439999	Trim54	21015	+	NM_021447	31419282	31439866	9
chr5	31440361	31441268	Ucn	907	-	NM_021290	31440524	31440893	2
chr5	31443035	31456624	Mpv17	13589	-	NM_008622	31444153	31456110	8
chr5	31458378	31482517	Gtf3c2	24139	-	NM_027901	31459921	31476845	19
chr5	31489930	31495512	Eif2b4	5582	-	NM_010122	31489973	31495396	13
chr5	31495676	31501273	Snx17	5597	+	NM_153680	31495775	31500844	15
chr5	31501353	31504676	Zfp513	3323	-	NM_175311	31501693	31504414	4
chr5	31505040	31522918	Ppm1g	17878	-	NM_008014	31505453	31522795	10
chr5	31543290	31553935	Nrbp1	10645	+	NM_147201	31546154	31553502	18
chr5	31554078	31555570	Krtcap3	1492	+	NM_027221	31554159	31555375	7
chr5	31555651	31593487	Ift172	37836	-	NM_026298	31555707	31593385	48
chr5	31594618	31598250	Fndc4	3632	-	NM_022424	31595823	31597706	7
chr5	31599953	31629675	Gckr	29722	+	NM_144909	31599992	31629464	19
chr5	31754808	31784126	Zfp512	29318	+	NM_172993	31754920	31782630	14
chr5	31788231	31790635	4930548H24Rik	2404	+	NM_026296	31788300	31790591	2
chr5	31797133	31814000	Gpn1	16867	+	NM_133756	31797145	31813284	14
chr5	31816941	31829135	Supt7l	12194	-	NM_028150	31818036	31825439	5
chr5	31829367	31856411	Slc4a1ap	27044	+	NM_009206	31829394	31856161	13
chr5	31871964	31873770	AI839979	1806	-	NR_102275	31873770	31873770	3
chr5	31916323	31925017	Mrpl33	8694	+	NM_025796	31916373	31924799	4
chr5	31926811	31999983	Rbks	73172	-	NM_153196	31926855	31999974	8
chr5	31969603	31969713	Mir3473e	110	-	NR_105859	31969713	31969713	1
chr5	32000422	32387112	Bre	386690	+	NM_181279	32004222	32387017	14
chr5	32438844	32460212	Fosl2	21368	+	NM_008037	32439076	32455562	4
chr5	32541456	32666729	Plb1	125273	+	NM_001081407	32549872	32666616	59
chr5	32761342	32796085	Ppp1cb	34743	+	NM_172707	32761728	32793431	8
chr5	32913543	32989439	Yes1	75896	+	NM_001205133	32942711	32987132	13
chr5	33078961	33128275	Pisd	49314	-	NM_177298	33079877	33128262	8
chr5	33131855	33196879	Prr14l	65024	-	NM_194340	33136180	33187163	11
chr5	33206369	33336882	Depdc5	130513	+	NM_001025426	33207290	33333731	43
chr5	33361464	33370615	Ywhah	9151	+	NM_011738	33361716	33369844	2
chr5	33446867	33505348	Slc5a1	58481	+	NM_019810	33447105	33503651	15
chr5	33556166	33560887	Spon2	4721	-	NM_133903	33557116	33560109	6
chr5	33590371	33617653	Ctbp1	27282	-	NM_001198861	33591148	33612097	10
chr5	33678220	33715943	Maea	37723	+	NM_021500	33678225	33715011	9
chr5	33721344	33762403	Uvssa	41059	+	NM_001081101	33721876	33757540	14
chr5	33773382	33776739	Nkx1-1	3357	-	NM_011320	33773382	33776739	2
chr5	33943001	33972284	Fam53a	29283	-	NM_178390	33943217	33957329	6
chr5	33982703	33995223	Slbp	12520	-	NM_009193	33983460	33994902	8
chr5	33995864	34000481	Tmem129	4617	-	NM_026698	33997014	34000476	4
chr5	34000776	34014851	Tacc3	14075	+	NM_001040435	34003871	34014696	15
chr5	34064372	34079717	Fgfr3	15345	+	NM_001163215	34065057	34078209	18
chr5	34084000	34125353	Letm1	41353	-	NM_019694	34085111	34125201	14
chr5	34185760	34240615	Whsc1	54855	+	NM_001081102	34185789	34237826	21
chr5	34240828	34278907	Nelfa	38079	-	NM_011914	34241373	34278884	11
chr5	34241558	34241620	Mir7024	62	-	NR_105991	34241620	34241620	1
chr5	34326081	34327658	Gm1673	1577	+	NM_001033458	34326094	34327612	4
chr5	34338632	34348565	Nat8l	9933	+	NM_001001985	34339492	34343796	3
chr5	34349827	34512175	Poln	162348	-	NM_001289804	34350077	34492504	25
chr5	34461388	34477988	4930557J02Rik	16600	+	NR_040703	34477988	34477988	4
chr5	34496547	34512073	Haus3	15526	-	NM_146159	34496620	34510962	5
chr5	34519228	34530359	Mxd4	11131	-	NM_010753	34519640	34530222	6
chr5	34537542	34630973	Zfyve28	93431	-	NM_001015039	34538617	34630786	13
chr5	34678898	34696094	Rnf4	17196	+	NM_011278	34685319	34694029	8
chr5	34712581	34829107	Fam193a	116526	+	NM_001243123	34712854	34828396	21
chr5	34838744	34856628	Tnip2	17884	-	NM_139064	34839335	34856546	6
chr5	34868432	34906288	Sh3bp2	37856	+	NM_011893	34894213	34905145	13
chr5	34916362	34974954	Add1	58592	+	NM_001102444	34943992	34973119	16
chr5	34916799	34916862	Mir7036b	63	+	NR_106111	34916862	34916862	1
chr5	34976295	34979763	Mfsd10	3468	-	NM_026660	34976547	34979416	13
chr5	34981184	35002797	Nop14	21613	-	NM_029278	34981200	35002694	18
chr5	35003027	35097952	Grk4	94925	+	NM_019497	35003601	35097843	16
chr5	35075501	35075621	Mir467g	120	-	NR_130328	35075621	35075621	1
chr5	35104388	35255183	Htt	150795	+	NM_010414	35104555	35251494	67
chr5	35258563	35266488	Msantd1	7925	+	NM_207277	35260244	35266213	3
chr5	35292096	35376242	Rgs12	84146	+	NM_173402	35307523	35375100	17
chr5	35363697	35363764	Mir3097	67	+	NR_037280	35363764	35363764	1
chr5	35384157	35391110	Hgfac	6953	+	NM_019447	35384245	35390988	14
chr5	35399732	35430480	Dok7	30748	+	NM_172708	35406993	35429775	9
chr5	35434154	35448346	Lrpap1	14192	-	NM_013587	35435972	35448340	8
chr5	35621214	35624412	Adra2c	3198	+	NM_007418	35622534	35623911	1
chr5	35704201	35710326	4930478P22Rik	6125	+	NR_046060	35710326	35710326	4
chr5	35731765	35735521	Hmx1	3756	+	NM_010445	35731765	35735012	2
chr5	35844866	35868275	Cpz	23409	-	NM_153107	35844983	35868184	11
chr5	35898857	35917719	Trmt44	18862	-	NM_030208	35900474	35917694	11
chr5	35923875	35931412	4931431C16Rik	7537	-	NR_045807	35931412	35931412	4
chr5	35925708	35956450	Acox3	30742	+	NM_030721	35930818	35954783	19
chr5	35994674	36022429	Htra3	27755	-	NM_030127	35995605	36021995	9
chr5	36039828	36071925	Sh3tc1	32097	-	NM_194344	36039959	36066746	18
chr5	36100528	36227628	Ablim2	127100	+	NM_001177696	36100699	36226068	22
chr5	36235967	36346571	Afap1	110604	+	NM_027373	36278202	36342374	17
chr5	36359829	36740788	Sorcs2	380959	-	NM_030889	36361976	36740694	27
chr5	36546669	36549216	Psapl1	2547	+	NM_175249	36546714	36548292	1
chr5	36644218	36644277	Mir7689	59	+	NR_106162	36644277	36644277	1
chr5	36790259	36807503	2210406O10Rik	17244	-	NR_126488	36807503	36807503	3
chr5	36807833	36816726	Grpel1	8893	+	NM_024478	36807842	36814051	4
chr5	36816318	36826934	Tada2b	10616	-	NM_001170454	36818618	36826706	2
chr5	36827236	36830820	Ccdc96	3584	+	NM_025725	36827300	36829055	1
chr5	36833252	36928875	Tbc1d14	95623	-	NM_001113362	36835697	36927473	15
chr5	36943137	37087260	D5Ertd579e	144123	-	NM_001081232	36945272	37064217	8
chr5	37138612	37139918	Bloc1s4	1306	-	NM_133724	37139236	37139884	1
chr5	37186105	37187993	Mrfap1	1888	-	NM_026242	37187454	37187832	2
chr5	37198051	37221888	Man2b2	23837	-	NM_008550	37198354	37221814	19
chr5	37259808	37346317	Ppp2r2c	86509	+	NM_172994	37260059	37343881	9
chr5	37264833	37268118	Ppp2r2cos	3285	-	NR_045505	37268118	37268118	3
chr5	37357342	37380221	Wfs1	22879	-	NM_011716	37358111	37373531	8
chr5	37442095	37516537	Jakmip1	74442	+	NM_178394	37476608	37516289	13
chr5	37633296	37683402	Crmp1	50106	+	NM_001136058	37633383	37682447	14
chr5	37690409	37728120	Evc	37711	-	NM_021292	37691615	37728032	21
chr5	37729716	37816293	Evc2	86577	+	NM_145920	37729786	37815915	20
chr5	37838063	38108392	Stk32b	270329	-	NM_022416	37839891	38108025	12
chr5	38126757	38131059	Cytl1	4302	+	NM_001081106	38126786	38130534	4
chr5	38211729	38215824	Msx1	4095	-	NM_010835	38212496	38215572	2
chr5	38211802	38213990	Msx1os	2188	+	NR_027920	38213990	38213990	1
chr5	38430468	38529008	Stx18	98540	+	NM_001289535	38430570	38527611	11
chr5	38528431	38550706	Nsg1	22275	-	NM_010942	38529910	38550244	5
chr5	38591282	38611667	Zbtb49	20385	-	NM_029162	38591875	38607837	8
chr5	38611720	38625545	Lyar	13825	+	NM_025281	38615914	38625364	9
chr5	38651613	38660857	Tmem128	9244	+	NM_025480	38651640	38658517	5
chr5	38668642	38695456	Otop1	26814	+	NM_172709	38668666	38694133	7
chr5	38710747	38713762	Drd5	3015	+	NM_013503	38710904	38712341	1
chr5	38735627	38740436	4930487D11Rik	4809	+	NR_046191	38740436	38740436	3
chr5	38740511	38893391	Slc2a9	152880	-	NM_145559	38742321	38874603	11
chr5	38918051	38952834	Wdr1	34783	-	NM_011715	38919044	38952770	15
chr5	39059722	39076065	Zfp518b	16343	-	NM_001081144	39062650	39065899	4
chr5	39097698	39267932	Clnk	170234	-	NM_013748	39097839	39253445	19
chr5	39852987	39994813	4930513D17Rik	141826	-	NR_045416	39994813	39994813	6
chr5	40005173	40035870	Hs3st1	30697	-	NM_010474	40005601	40006537	2
chr5	42016211	42099418	Rab28	83207	-	NM_027295	42017008	42099218	7
chr5	42152721	42155459	Nkx3-2	2738	-	NM_007524	42152880	42155183	2
chr5	42178778	42235554	Bod1l	56776	-	NM_001081422	42180070	42235407	27
chr5	42282580	42282662	Mir6414	82	+	NR_105842	42282662	42282662	1
chr5	42459198	42608023	Gm16223	148825	+	NR_131130	42608023	42608023	3
chr5	43542924	43626593	Gm7854	83669	-	NR_028417	43626593	43626593	8
chr5	43624701	43680963	Cpeb2	56262	+	NM_001177379	43624701	43677185	11
chr5	43906807	44007825	C1qtnf7	101018	+	NM_001135172	43907212	44007490	3
chr5	44053617	44132209	Cc2d2a	78592	+	NM_172274	44059906	44132093	40
chr5	44135856	44173388	Fbxl5	37532	-	NM_001159963	44136537	44173287	11
chr5	44210131	44234707	Bst1	24576	+	NM_009763	44210165	44233341	9
chr5	44260047	44303613	Cd38	43566	+	NM_007646	44260114	44301582	8
chr5	44370096	44373038	Fgfbp1	2942	-	NM_001271616	44370431	44371187	3
chr5	44384860	44492975	Prom1	108115	-	NM_001163577	44386337	44485853	28
chr5	44566400	44617845	Tapt1	51445	-	NM_173764	44568191	44617842	14
chr5	44863371	45190985	Ldb2	327614	-	NM_001286348	44867769	45190732	9
chr5	45357439	45370044	4930431F12Rik	12605	+	NR_073013	45370044	45370044	10
chr5	45400409	45815639	D5Ertd615e	415230	-	NR_131933	45815639	45815639	6
chr5	45825270	45841468	Qdpr	16198	-	NM_024236	45825811	45841341	7
chr5	45844989	45855388	Clrn2	10399	+	NM_001163317	45845049	45855203	3
chr5	45884612	45903930	Lap3	19318	+	NM_024434	45884698	45903309	13
chr5	45911467	45920523	Med28	9056	+	NM_025895	45911564	45916589	4
chr5	45920943	46030740	Fam184b	109797	-	NM_021416	45921975	46030478	16
chr5	46030513	46036708	9630001P10Rik	6195	+	NR_102378	46036708	46036708	4
chr5	46059939	46060947	1600023N17Rik	1008	-	NR_073433	46060947	46060947	1
chr5	46061163	46091786	Ncapg	30623	+	NM_019438	46061261	46091201	21
chr5	46088422	46248779	Lcorl	160357	-	NM_178142	46093061	46248736	7
chr5	46110905	46118817	Gm3414	7912	-	NR_027993	46118817	46118817	1
chr5	46318060	46323648	4930405L22Rik	5588	-	NR_110478	46323648	46323648	3
chr5	48374393	48698974	Slit2	324581	+	NM_001291227	48376278	48695480	39
chr5	48615180	48615290	Mir218-1	110	+	NR_029798	48615290	48615290	1
chr5	48763630	48779995	Pacrgl	16365	+	NM_025755	48765434	48779398	9
chr5	48780741	49676898	Kcnip4	896157	-	NM_001199244	48782147	49676579	8
chr5	48786811	48805533	5730480H06Rik	18722	+	NR_045500	48805533	48805533	4
chr5	50351189	50450235	Adgra3	99046	-	NM_133911	50351510	50450014	19
chr5	50542571	50547331	4930448I18Rik	4760	+	NR_040696	50547331	50547331	3
chr5	50644000	50644107	Mir8117	107	+	NR_106197	50644107	50644107	1
chr5	51845487	51958964	Ppargc1a	113477	-	NR_132764	51958964	51958964	13
chr5	52527140	52527256	Mir6417	116	-	NR_105845	52527256	52527256	1
chr5	52541441	52581785	Dhx15	40344	-	NM_007839	52541899	52581589	14
chr5	52581919	52589223	9230114K14Rik	7304	+	NR_015537	52589223	52589223	4
chr5	52591222	52607672	C130083M11Rik	16450	-	NR_040717	52607672	52607672	8
chr5	52755042	52760977	Sod3	5935	+	NM_011435	52759199	52759955	2
chr5	52765889	52862782	Ccdc149	96893	-	NM_001256059	52767486	52862637	12
chr5	52924755	52957545	Lgi2	32790	-	NM_001310604	52929201	52957344	8
chr5	52998788	53010250	8030423F21Rik	11462	-	NR_045738	53010250	53010250	3
chr5	53034645	53060940	Sepsecs	26295	-	NM_172490	53035042	53060927	11
chr5	53132812	53160583	Pi4k2b	27771	+	NM_028744	53132957	53158995	10
chr5	53166647	53215904	Zcchc4	49257	+	NM_001309445	53187866	53214926	12
chr5	53225373	53257973	Anapc4	32600	+	NM_024213	53225502	53257858	28
chr5	53364250	53383531	5033403H07Rik	19281	-	NR_040413	53383531	53383531	3
chr5	53440591	53462902	Slc34a2	22311	+	NM_011402	53449394	53460869	13
chr5	53498321	53604691	Sel1l3	106370	-	NM_172710	53499273	53604545	24
chr5	53658344	53669779	Smim20	11435	+	NM_001145433	53658482	53669173	3
chr5	53947017	54048684	Rbpj	101667	+	NM_001080928	53947128	54044859	11
chr5	54089723	54098943	Cckar	9220	-	NM_009827	54090994	54098596	5
chr5	54200865	54295619	Tbc1d19	94754	+	NM_144517	54200998	54294645	21
chr5	54389761	54512296	Stim2	122535	+	NM_001081103	54390122	54509988	12
chr5	54741230	54749781	Gm10440	8551	+	NR_038045	54749781	54749781	4
chr5	57961322	58109158	4932441J04Rik	147836	-	NR_015588	58109158	58109158	5
chr5	58109319	58524474	Pcdh7	415155	+	NM_001310608	58110343	58333494	4
chr5	58834478	58844237	4930459L07Rik	9759	-	NR_046190	58844237	58844237	3
chr5	60354357	60377241	4933402J10Rik	22884	-	NR_040682	60377241	60377241	5
chr5	62200081	62201716	G6pd2	1635	+	NM_019468	62200122	62201664	1
chr5	62993684	63157416	Arap2	163732	-	NM_178407	62995508	63140913	33
chr5	63205061	63279557	Dthd1	74496	+	NM_001170705	63205074	63279521	9
chr5	64040341	64201782	Nwd2	161441	+	NM_177006	64041408	64199542	7
chr5	64203733	64290858	0610040J01Rik	87125	+	NM_029554	64287690	64290103	4
chr5	64300136	64360136	Rell1	60000	-	NM_145923	64315976	64359972	7
chr5	64436211	64441465	5830416I19Rik	5254	+	NR_045384	64441465	64441465	3
chr5	64484188	64519397	Pgm1	35209	+	NM_025700	64484222	64519118	14
chr5	64551498	64742725	Tbc1d1	191227	+	NM_001310611	64564718	64741169	22
chr5	64846051	64859181	1700027F09Rik	13130	-	NR_040681	64859181	64859181	3
chr5	64868246	64875205	C030018K13Rik	6959	+	NR_045413	64875205	64875205	2
chr5	64985101	65001938	Gm3716	16837	-	NR_045078	65001938	65001938	4
chr5	65194761	65221368	Klf3	26607	+	NM_008453	65208012	65220397	6
chr5	65315918	65324797	Tlr1	8879	-	NM_001276445	65316083	65318471	4
chr5	65344333	65351273	Tlr6	6940	-	NM_011604	65344380	65346801	2
chr5	65361313	65433140	Fam114a1	71827	+	NM_026667	65370954	65431979	14
chr5	65361556	65361634	Mir574	78	+	NR_030577	65361634	65361634	1
chr5	65522469	65559381	Klhl5	36912	+	NM_175174	65522635	65558266	11
chr5	65590934	65651654	Wdr19	60720	+	NM_153391	65590993	65649451	37
chr5	65653090	65726878	Rfc1	73788	-	NM_011258	65654301	65726765	25
chr5	65739649	65775242	Klb	35593	+	NM_031180	65739650	65774936	5
chr5	65779602	65782670	Rpl9	3068	-	NM_011292	65779811	65782230	8
chr5	65782735	65801662	Lias	18927	+	NM_024471	65782867	65800032	11
chr5	65804460	65827081	Ugdh	22621	-	NM_009466	65805194	65818816	12
chr5	65839993	65884074	Smim14	44081	-	NM_133697	65841643	65859706	5
chr5	65928483	65990228	Ube2k	61745	+	NM_016786	65928722	65986188	7
chr5	66006498	66089095	Pds5a	82597	-	NM_001081321	66006498	66088136	32
chr5	66154759	66218023	N4bp2	63264	+	NM_001024917	66181267	66217889	20
chr5	66254807	66287939	Rhoh	33132	+	NM_001081105	66283627	66284203	3
chr5	66358362	66368725	Chrna9	10363	+	NM_001081104	66358686	66368486	5
chr5	66379166	66395524	9130230L23Rik	16358	-	NR_027961	66395524	66395524	7
chr5	66407787	66543193	Rbm47	135406	-	NM_001127382	66410444	66418497	8
chr5	66557845	66582574	1700126H18Rik	24729	-	NR_040695	66582574	66582574	3
chr5	66651136	66689267	Nsun7	38131	+	NM_001302833	66652167	66689125	13
chr5	66689963	67010056	Apbb2	320093	-	NM_009686	66693780	66853355	18
chr5	67017733	67067736	Uchl1os	50003	-	NR_102714	67067736	67067736	5
chr5	67067359	67078473	Uchl1	11114	+	NM_011670	67067528	67078167	9
chr5	67137078	67448398	Limch1	311320	+	NM_001001980	67137148	67445500	26
chr5	67485635	67490365	Phox2b	4730	-	NM_008888	67487345	67490180	3
chr5	67651803	67682700	Tmem33	30897	+	NM_030108	67652227	67678254	9
chr5	67698193	67747381	Slc30a9	49188	+	NM_178651	67698333	67745815	18
chr5	67783385	67819038	Bend4	35653	-	NM_001164806	67789474	67818818	5
chr5	67855136	67869138	C330024D21Rik	14002	+	NR_110363	67869138	67869138	8
chr5	67999121	68005226	Shisa3	6105	+	NM_001033415	67999646	68002714	2
chr5	68009377	68238670	Atp8a1	229293	-	NM_001038999	68013837	68238449	37
chr5	68324850	68334320	4930425K10Rik	9470	-	NR_038182	68334320	68334320	4
chr5	68332907	68368309	Gm5108	35402	+	NM_001256184	68333030	68368195	4
chr5	68423073	68557637	Grxcr1	134564	+	NM_001018019	68423126	68557510	4
chr5	69500523	69732948	Kctd8	232425	-	NM_175519	69501573	69732540	2
chr5	69907908	69933886	Yipf7	25978	-	NM_023784	69908274	69932401	6
chr5	69948162	69965891	Guf1	17729	+	NM_172711	69948293	69962960	17
chr5	69966240	69983524	Gnpda2	17284	-	NM_001038015	69967130	69981023	7
chr5	71142285	71233856	Gabrg1	91571	-	NM_010252	71145260	71233458	9
chr5	71352295	71487088	Gabra2	134793	-	NM_008066	71353040	71485841	10
chr5	71834061	71939444	Cox7b2	105383	-	NM_030052	71834203	71834452	3
chr5	71960972	72049547	Gabra4	88575	-	NM_010251	71962937	72049048	9
chr5	72091254	72528483	Gabrb1	437229	+	NM_008069	72091254	72528048	9
chr5	72548238	72559422	Commd8	11184	-	NM_178599	72551111	72559383	5
chr5	72594567	72690010	Atp10d	95443	+	NR_003966	72690010	72690010	23
chr5	72691263	72895779	Corin	204516	-	NM_001122756	72692724	72895678	22
chr5	72904542	72950884	Nfxl1	46342	-	NM_133921	72905396	72950505	23
chr5	72968352	72972323	Zar1	3971	-	NM_174877	72968498	72972296	4
chr5	72972877	72978789	Gm5868	5912	-	NM_001024147	72973688	72977612	3
chr5	72994935	73033991	Cnga1	39056	-	NM_007723	72995353	73010357	9
chr5	73039034	73062317	Nipal1	23283	+	NM_001081205	73039126	73059455	6
chr5	73087216	73144016	Txk	56800	-	NM_001122754	73087809	73143933	15
chr5	73146956	73259687	Tec	112731	-	NM_001113460	73147534	73214832	19
chr5	73305600	73370080	Slain2	64480	+	NM_153567	73305863	73367302	9
chr5	73398142	73404194	Slc10a4	6052	+	NM_173403	73398305	73403586	3
chr5	73411429	73647857	Fryl	236428	-	NM_028194	73413277	73539375	63
chr5	73659818	73675423	1700025M24Rik	15605	-	NR_040687	73675423	73675423	5
chr5	73684032	73705316	Ociad1	21284	+	NM_023429	73685528	73704719	9
chr5	73713436	73730186	Ociad2	16750	-	NM_026950	73715004	73727124	7
chr5	73797316	73844664	Cwh43	47348	+	NM_181323	73797600	73844335	16
chr5	73872293	73952033	Dcun1d4	79740	+	NM_001190734	73872327	73948926	12
chr5	73997880	74023660	Lrrc66	25780	-	NM_153568	73998318	74021244	5
chr5	74023987	74038970	Sgcb	14983	-	NM_011890	74026733	74038952	6
chr5	74042618	74070723	Spata18	28105	+	NM_178387	74042824	74070594	13
chr5	74396061	74464436	Usp46	68375	-	NM_177561	74398059	74464310	9
chr5	74489107	74490361	Dancr	1254	+	NR_015531	74490361	74490361	2
chr5	74489554	74489675	Snora26	121	+	NR_031758	74489675	74489675	1
chr5	74591350	74595502	Rasl11b	4152	+	NM_026878	74591476	74594604	4
chr5	74600840	74927767	Scfd2	326927	-	NM_001114660	74602327	74927644	9
chr5	74931506	74993149	Fip1l1	61643	+	NM_001159573	74931704	74992011	18
chr5	74993128	75098928	Lnx1	105800	-	NM_001159577	74993299	75081812	11
chr5	75345218	75362393	Gm6116	17175	+	NR_045866	75362393	75362393	5
chr5	75401028	75440666	Chic2	39638	-	NM_028850	75402737	75440323	6
chr5	75471625	75473918	Gsx2	2293	+	NM_133256	75471785	75473331	2
chr5	75506345	75543132	Gm19583	36787	+	NR_045792	75543132	75543132	4
chr5	75548315	75594229	Pdgfra	45914	+	NM_011058	75558267	75591125	23
chr5	75572855	75572929	Mir7025	74	+	NR_105992	75572929	75572929	1
chr5	75971011	76052746	Kit	81735	+	NM_001122733	75971076	76050570	21
chr5	76329298	76374453	Kdr	45155	-	NM_010612	76330447	76374193	30
chr5	76569297	76584528	Srd5a3	15231	+	NM_020611	76569352	76583807	6
chr5	76612904	76638269	Tmem165	25365	+	NM_011626	76613170	76637611	6
chr5	76638892	76733817	Clock	94925	-	NM_001289826	76645723	76695871	23
chr5	76741140	76760181	Pdcl2	19041	-	NM_023508	76741471	76760043	6
chr5	76762519	76792802	Nmu	30283	-	NM_019515	76764851	76792697	10
chr5	76913101	76945653	Gm7271	32552	+	NR_033501	76945653	76945653	3
chr5	76958335	76999323	Exoc1	40988	+	NM_027270	76961789	76998795	20
chr5	77020738	77075491	Cep135	54753	+	NM_199032	77020783	77070009	25
chr5	77269623	77302579	C530008M17Rik	32956	+	NM_001163793	77269828	77299702	9
chr5	77304959	77334539	Aasdh	29580	-	NM_173765	77305048	77331172	16
chr5	77342273	77380603	Ppat	38330	-	NM_172146	77344233	77380109	11
chr5	77380435	77396531	Paics	16096	+	NM_025939	77380844	77395839	9
chr5	77403725	77428960	Srp72	25235	+	NM_025691	77403748	77427394	19
chr5	77433079	77438502	Arl9	5423	+	NM_206935	77433079	77438502	4
chr5	77435466	77447888	1700112J05Rik	12422	-	NR_077218	77447888	77447888	4
chr5	77445047	77490547	Thegl	45500	+	NM_027970	77445176	77490337	9
chr5	77516010	77544148	Hopx	28138	-	NM_175606	77516763	77524034	3
chr5	77634131	77640496	Spink2	6365	-	NM_183284	77634404	77640399	4
chr5	77694518	77712722	Rest	18204	+	NM_011263	77696965	77712009	4
chr5	77723193	77739111	Noa1	15918	-	NM_019836	77723384	77739081	7
chr5	77739508	77778353	Polr2b	38845	+	NM_153798	77739636	77778194	25
chr5	77778264	77837070	Igfbp7	58806	-	NM_001159518	77778504	77837039	6
chr5	77894512	77897882	1700017L05Rik	3370	+	NR_131050	77897882	77897882	2
chr5	81450617	82224755	Adgrl3	774138	+	NM_198702	81739049	82224088	28
chr5	83227968	83228090	Mir1187	122	-	NR_035415	83228090	83228090	1
chr5	83707146	83784220	Tecrl	77074	-	NM_153801	83708238	83784025	12
chr5	84483787	84846407	Epha5	362620	-	NM_007937	84488066	84845530	16
chr5	86441049	86494608	Cenpc1	53559	-	NM_007683	86441281	86494370	19
chr5	86500770	86533025	Stap1	32255	+	NM_019992	86500862	86532786	9
chr5	86539753	86601768	Uba6	62015	-	NM_172712	86541674	86601763	33
chr5	86609778	86626926	Gnrhr	17148	-	NM_010323	86611200	86626850	3
chr5	86660505	86718333	Tmprss11c	57828	-	NM_001030297	86660776	86718285	10
chr5	86731878	86802412	Tmprss11d	70534	-	NM_145561	86732635	86802377	10
chr5	86839434	86898015	Tmprss11a	58581	-	NM_001033233	86840786	86897880	9
chr5	86914901	86947625	Tmprss11g	32724	-	NM_177162	86916423	86947529	10
chr5	86950250	87061449	Tmprss11f	111199	-	NM_178730	86953036	87020445	11
chr5	87088546	87105323	Tmprss11b	16777	-	NM_177024	87089489	87105301	10
chr5	87134210	87174832	Tmprss11e	40622	-	NM_172880	87136297	87174783	10
chr5	87233514	87265682	Ythdc1	32168	+	NM_177680	87233588	87264933	17
chr5	87318794	87335962	Ugt2b34	17168	-	NM_153598	87320226	87335945	6
chr5	87345663	87355528	Ugt2b1	9865	-	NM_152811	87346613	87355523	6
chr5	87429884	87442299	Ugt2b35	12415	+	NM_172881	87429916	87440563	6
chr5	87494951	87521580	Ugt2b36	26629	-	NM_001029867	87495215	87521549	6
chr5	87553971	87569365	Ugt2b5	15394	-	NM_009467	87554237	87569331	6
chr5	87669516	87683813	Ugt2b37	14297	-	NM_053215	87669784	87683795	6
chr5	87753996	87766220	Ugt2a3	12224	-	NM_028094	87754476	87766188	6
chr5	87838964	87853228	Ugt2b38	14264	-	NM_133894	87839232	87853196	6
chr5	87888514	87919896	Ugt2a1	31382	-	NM_053184	87889416	87915771	7
chr5	87888517	87911283	Ugt2a2	22766	-	NM_001024148	87889416	87904132	7
chr5	87942363	87967220	Sult1b1	24857	-	NM_019878	87943964	87964109	8
chr5	87983674	87998031	Sult1d1	14357	-	NM_016771	87984961	87995208	8
chr5	88004992	88020636	Sult1e1	15644	-	NM_023135	88005233	88019245	8
chr5	88024926	88025018	Mir3969	92	-	NR_039550	88025018	88025018	1
chr5	88095232	88111602	Csn1s1	16370	+	NM_001286016	88096271	88110521	34
chr5	88121643	88128450	Csn2	6807	-	NM_001286021	88122896	88127103	9
chr5	88203474	88217823	Csn1s2a	14349	+	NM_001304765	88204811	88216765	14
chr5	88237145	88253446	Csn1s2b	16301	+	NM_009973	88238933	88253169	12
chr5	88254721	88275411	Prr27	20690	+	NM_001163551	88264707	88275352	6
chr5	88279383	88282037	Gm7337	2654	+	NR_003652	88282037	88282037	1
chr5	88314719	88321767	Odam	7048	+	NM_027128	88314736	88321737	10
chr5	88337612	88408376	1700066N21Rik	70764	-	NR_045924	88408376	88408376	5
chr5	88337803	88343196	BC037156	5393	+	NM_001305431	88339661	88342093	5
chr5	88354657	88361289	Csn3	6632	+	NM_007786	88356601	88359207	5
chr5	88408475	88410566	Cabs1	2091	+	NM_027631	88408516	88409692	2
chr5	88431549	88437559	Smr3a	6010	+	NM_011422	88433753	88437443	3
chr5	88515580	88538078	Smr2	22498	+	NM_001252679	88534353	88537921	5
chr5	88697943	88711860	Gm7714	13917	+	NM_001110779	88706102	88711667	3
chr5	88720385	88730048	1700041A01Rik	9663	-	NR_126428	88730048	88730048	3
chr5	88746336	88757842	Prol1	11506	+	NM_008644	88747584	88757716	3
chr5	88805132	88814941	Amtn	9809	+	NM_027793	88805328	88814652	9
chr5	88885015	88897554	Ambn	12539	+	NM_009664	88885116	88897007	11
chr5	88916999	88935074	Enam	18075	+	NM_017468	88917740	88933708	10
chr5	88948833	88956922	Jchain	8089	-	NM_152839	88950337	88956804	4
chr5	88983507	88985108	Utp3	1601	+	NM_023054	88983638	88985048	1
chr5	88994064	89080442	Rufy3	86378	+	NM_001289774	88994173	89079000	18
chr5	89088257	89105196	Grsf1	16939	-	NM_178700	89091585	89105136	10
chr5	89149895	89187480	Mob1b	37585	+	NM_026735	89150132	89185197	6
chr5	89194037	89212302	Dck	18265	+	NM_007832	89194280	89210271	7
chr5	89316284	89668681	Slc4a4	352397	+	NM_001197147	89363774	89663865	26
chr5	89846535	89886923	Gc	40388	-	NM_008096	89851105	89886743	13
chr5	89956453	90012765	Npffr2	56312	+	NM_133192	89996840	90012491	4
chr5	90045460	90051636	Gm7056	6176	+	NR_037571	90051636	90051636	2
chr5	90102865	90312359	Adamts3	209494	-	NM_001081401	90106388	90311915	22
chr5	90643749	90653021	Cox18	9272	-	NM_001163456	90644023	90652964	6
chr5	90656190	90795211	Ankrd17	139021	-	NM_030886	90658306	90795073	35
chr5	90796022	90797514	Gm9958	1492	+	NR_045618	90797514	90797514	1
chr5	90889895	90905628	Alb	15733	+	NM_009654	90889960	90904336	15
chr5	90919739	90937933	Afp	18194	+	NM_007423	90919806	90937500	15
chr5	90947974	90982570	Afm	34596	+	NM_145146	90948017	90981618	15
chr5	90990234	91026932	5830473C10Rik	36698	+	NM_001252661	90990258	91026578	14
chr5	91032101	91069553	Rassf6	37452	-	NM_028478	91032898	91060598	11
chr5	91188323	91190651	Cxcl5	2328	+	NM_009141	91188468	91189539	4
chr5	91197543	91199086	Ppbp	1543	+	NM_023785	91197628	91198433	3
chr5	91201460	91202409	Pf4	949	+	NM_019932	91201607	91202286	3
chr5	91215126	91217119	Cxcl3	1993	+	NM_203320	91215196	91216474	4
chr5	91223559	91232093	Cxcl15	8534	+	NM_011339	91223596	91230507	4
chr5	91320270	91322141	Cxcl1	1871	+	NM_008176	91320336	91321549	4
chr5	91332924	91334964	Cxcl2	2040	+	NM_009140	91332970	91334230	4
chr5	91360221	91450395	Mthfd2l	90174	+	NM_026788	91360343	91449290	8
chr5	91456542	91464238	Epgn	7696	+	NM_053087	91456548	91462999	5
chr5	91503642	91522675	Ereg	19033	+	NM_007950	91503785	91519171	5
chr5	91568624	91577458	Areg	8834	+	NM_009704	91568839	91575757	6
chr5	91686596	91712102	Gm19619	25506	-	NR_040428	91712102	91712102	6
chr5	91786286	91832020	Btc	45734	-	NM_007568	91789773	91831747	6
chr5	91946725	92053022	Parm1	106297	+	NM_145562	91946940	92052043	4
chr5	92195267	92196326	1700063O14Rik	1059	-	NR_045383	92196326	92196326	3
chr5	92377867	92392094	Rchy1	14227	-	NM_026557	92378761	92391745	9
chr5	92391907	92401163	Thap6	9256	+	NR_028429	92401163	92401163	5
chr5	92416498	92424343	Gm1045	7845	+	NM_001177577	92416520	92423987	2
chr5	92435099	92472068	Cdkl2	36969	-	NM_016912	92438013	92468431	14
chr5	92481170	92512770	G3bp2	31600	-	NM_011816	92483806	92502280	12
chr5	92566963	92631821	Uso1	64858	+	NM_019490	92567123	92630963	24
chr5	92638920	92644434	U90926	5514	-	NR_033483	92644434	92644434	5
chr5	92655999	92682185	Ppef2	26186	-	NM_011148	92655999	92682185	16
chr5	92686685	92707207	Naaa	20522	-	NM_025972	92688581	92707158	11
chr5	92713035	92739050	Sdad1	26015	-	NM_172713	92715848	92738907	22
chr5	92750356	92757105	Cxcl9	6749	-	NM_008599	92752824	92757049	4
chr5	92760852	92843653	Art3	82801	+	NM_001310664	92817168	92843392	11
chr5	92775664	92777915	Cxcl10	2251	-	NM_021274	92776392	92777840	4
chr5	92788570	92792322	Cxcl11	3752	-	NR_038116	92792322	92792322	4
chr5	92844565	92864225	Nup54	19660	-	NM_183392	92845235	92864096	12
chr5	92870336	92934683	Scarb2	64347	-	NM_007644	92873271	92934334	12
chr5	92887582	92887682	Mir6415	100	+	NR_105843	92887682	92887682	1
chr5	93000562	93020310	Fam47e	19748	+	NM_001033478	93000614	93019640	7
chr5	93032076	93035605	Stbd1	3529	+	NM_175096	93032134	93034695	2
chr5	93037320	93104153	Ccdc158	66833	-	NM_177230	93037442	93097764	25
chr5	93112460	93394785	Shroom3	282325	+	NM_015756	93112692	93393750	11
chr5	93217476	93217588	Mir1961	112	-	NR_035487	93217588	93217588	1
chr5	93470148	93474048	Sowahb	3900	-	NM_175270	93471601	93473884	1
chr5	93522441	93610404	Sept11	87963	+	NM_001310669	93522596	93602520	11
chr5	93610958	93635521	Ccni	24563	-	NM_017367	93612002	93631444	7
chr5	93635543	93642500	2010109A12Rik	6957	+	NM_029363	93635705	93642474	3
chr5	93696598	93705257	Ccng2	8659	+	NM_007635	93697647	93704023	8
chr5	94064210	94100489	C87414	36279	-	NM_001164284	94065201	94067934	6
chr5	94495479	94499571	BC061212	4092	-	NM_198667	94495526	94498323	4
chr5	94495479	94499571	Gm7978	4092	-	NM_001270457	94495526	94498323	4
chr5	94806364	94813359	AA792892	6995	+	NM_178894	94810397	94813120	3
chr5	94955308	94967392	Gm3139	12084	+	NM_001243937	94963873	94966953	4
chr5	95294540	95307276	Gm16513	12736	+	NM_001200055	95302884	95305980	4
chr5	95294551	95306423	Gm16367	11872	+	NM_001031622	95302884	95305980	4
chr5	95380098	95384376	A430089I19Rik	4278	-	NM_177913	95380621	95383195	5
chr5	95734941	95772594	Gm3259	37653	+	NM_001270456	95769227	95771957	5
chr5	95885824	95914608	D5Ertd577e	28784	+	NM_177187	95910631	95913690	4
chr5	95939760	95951421	Gm3286	11661	+	NM_001167793	95947713	95950987	4
chr5	96204888	96233249	E330014E10Rik	28361	+	NM_001122668	96229750	96232820	4
chr5	96385957	96390087	Cxcl13	4130	+	NM_018866	96385989	96389287	4
chr5	96499351	96591009	Cnot6l	91658	-	NM_144910	96506198	96563141	12
chr5	96639133	96695746	Mrpl1	56613	+	NM_053158	96639181	96693356	9
chr5	96802973	97213747	Fras1	410774	+	NM_175473	96803831	97210790	74
chr5	97222403	97274987	Anxa3	52584	+	NM_013470	97226457	97274579	13
chr5	97350290	97363886	Gm8013	13596	+	NR_131152	97363886	97363886	3
chr5	97426707	97520067	Bmp2k	93360	+	NM_080708	97426946	97517155	16
chr5	97511347	97540615	Paqr3	29268	-	NM_198422	97524936	97540462	7
chr5	97811227	97821349	Naa11	10122	-	NM_001033191	97820659	97821316	2
chr5	97821435	98017145	4930467D21Rik	195710	+	NR_045981	98017145	98017145	8
chr5	97884179	97886027	Gk2	1848	-	NM_010294	97884331	97885996	1
chr5	98313706	98459981	Antxr2	146275	-	NM_133738	98315580	98459568	17
chr5	98609887	98616467	Prdm8	6580	+	NM_029947	98612309	98615661	4
chr5	98683202	98706052	Fgf5	22850	+	NM_010203	98683430	98704571	3
chr5	98758322	99231038	1700007G11Rik	472716	+	NM_001024614	98758372	99230929	6
chr5	98904574	98904683	Mir703	109	-	NR_030484	98904683	98904683	1
chr5	99283433	99313072	Bmp3	29639	+	NM_001310677	99284131	99308881	3
chr5	99358791	99466098	Prkg2	107307	-	NM_008926	99361028	99453873	19
chr5	99646438	99681946	Rasgef1b	35508	-	NM_145839	99647792	99672259	14
chr5	99726262	100158079	A930011G23Rik	431817	-	NR_030692	100158079	100158079	4
chr5	100159872	100182992	Gm38413	23120	-	NR_131054	100182992	100182992	12
chr5	100384953	100407957	Hnrnpd	23004	-	NM_001077265	100391563	100407643	9
chr5	100462597	100468241	Hnrnpdl	5644	-	NM_016690	100465143	100468181	8
chr5	100469012	100497784	Enoph1	28772	+	NM_001163035	100469237	100496954	7
chr5	100506891	100588827	Tmem150c	81936	-	NM_182841	100508871	100524705	8
chr5	100506980	100524292	Tmem150cos	17312	+	NR_045993	100524292	100524292	5
chr5	100639710	100647068	2310034O05Rik	7358	+	NR_040679	100647068	100647068	4
chr5	100790667	100845253	Sec31a	54586	-	NM_026969	100791069	100837131	28
chr5	100849860	100858554	5430416N02Rik	8694	-	NR_034038	100858554	100858554	5
chr5	100871057	100929658	Lin54	58601	-	NM_172714	100873094	100914842	13
chr5	100947327	100976821	Cops4	29494	+	NM_012001	100947495	100976456	10
chr5	100982751	101001224	Plac8	18473	-	NM_139198	100985509	100991752	5
chr5	101083744	101103275	Coq2	19531	-	NM_027978	101084316	101103260	7
chr5	101108504	101148702	Hpse	40198	-	NM_152803	101109889	101148613	12
chr5	101191166	101227619	Helq	36453	-	NM_001081107	101191517	101227492	18
chr5	101227777	101233486	Mrps18c	5709	+	NM_026826	101227788	101233427	6
chr5	101233820	101249954	Fam175a	16134	-	NM_172405	101235077	101249936	9
chr5	101275247	101328121	Agpat9	52874	+	NM_172715	101275826	101326847	13
chr5	102088215	102093730	Nkx6-1	5515	-	NM_144955	102088435	102093253	3
chr5	102194148	102252871	Cds1	58723	+	NM_173370	102194391	102250582	13
chr5	102261971	102498940	Wdfy3	236969	-	NM_172882	102265176	102410577	67
chr5	102910409	103326956	Arhgap24	416547	+	NM_029270	102981164	103326346	10
chr5	103337567	103640353	Mapk10	302786	-	NM_001081567	103342203	103487405	14
chr5	103659393	103728048	4930429D17Rik	68655	-	NR_040699	103728048	103728048	7
chr5	103854210	104027380	Ptpn13	173170	+	NM_011204	103891157	104026804	48
chr5	104034729	104058422	Slc10a6	23693	-	NM_029415	104035560	104058251	6
chr5	104077605	104084751	1700016H13Rik	7146	-	NM_001163550	104077839	104084005	4
chr5	104183180	104284341	Aff1	101161	+	NM_133919	104183347	104279842	20
chr5	104291068	104340248	Klhl8	49180	-	NM_178741	104292086	104315168	10
chr5	104384460	104406407	Hsd17b13	21947	-	NM_198030	104385202	104406334	7
chr5	104418783	104450815	Hsd17b11	32032	-	NM_053262	104419528	104450758	7
chr5	104475882	104494397	Nudt9	18515	+	NM_028794	104476058	104494134	8
chr5	104477021	104477082	Mir5619	61	+	NR_049192	104477082	104477082	1
chr5	104499079	104506627	Gm17660	7548	-	NM_001163772	104500267	104505592	10
chr5	104508127	104543107	Sparcl1	34980	-	NM_010097	104508567	104526781	11
chr5	104599730	104609146	Dspp	9416	+	NM_010080	104603045	104607629	5
chr5	104631635	104643121	Dmp1	11486	+	NM_016779	104636115	104641990	6
chr5	104728305	104740491	Ibsp	12186	+	NM_008318	104731155	104739592	7
chr5	104754347	104767630	Mepe	13283	+	NM_053172	104754413	104767340	3
chr5	104864129	104870072	Spp1	5943	+	NM_009263	104865407	104869637	7
chr5	104888475	104934838	Pkd2	46363	+	NM_008861	104888655	104932707	15
chr5	104937370	104951402	BC005561	14032	+	NM_001166581	104946632	104951402	2
chr5	104954753	104983230	D930016D06Rik	28477	+	NR_030673	104983230	104983230	4
chr5	105242186	105289087	Zfp951	46901	-	NM_001039231	105243361	105288715	5
chr5	105364075	105411736	Abcg3	47661	-	NM_030239	105364968	105406834	16
chr5	105443171	105482580	Gbp8	39409	-	NM_029509	105443967	105480066	10
chr5	105507412	105539311	Gbp9	31899	-	NM_172777	105509073	105534866	11
chr5	105544785	105568605	Gbp4	23820	-	NM_001256005	105547296	105566040	11
chr5	105644717	105668552	Gbp10	23835	-	NM_001039646	105646323	105665153	11
chr5	105699720	105722718	Gbp6	22998	-	NM_194336	105702120	105720039	11
chr5	105752044	105775495	Gbp11	23451	-	NR_132129	105775495	105775495	11
chr5	105844793	105915208	Lrrc8b	70415	+	NM_001033550	105908808	105915094	5
chr5	105948489	106037973	Lrrc8c	89484	+	NM_133897	106008490	106037791	4
chr5	106128987	106244234	Lrrc8d	115247	+	NM_001122768	106240744	106243324	3
chr5	106305586	106344837	Zfp326	39251	+	NM_018759	106305701	106344028	12
chr5	106881541	106887185	Barhl2	5644	-	NM_001005477	106882375	106886860	3
chr5	107045759	107125849	Zfp644	80090	-	NM_026856	107047254	107095847	7
chr5	107269215	107354909	Hfm1	85694	-	NM_177873	107269677	107351902	40
chr5	107393340	107413458	Cdc7	20118	+	NM_009863	107394036	107412374	12
chr5	107535588	107718614	Tgfbr3	183026	-	NM_011578	107538657	107695279	17
chr5	107760212	107816077	Brdt	55865	+	NM_054054	107771089	107814545	19
chr5	107832531	107859050	Ephx4	26519	+	NM_001001804	107832569	107858910	7
chr5	107860567	107864058	Lpcat2b	3491	+	NM_027599	107861825	107863376	2
chr5	107867015	107920615	Btbd8	53600	+	NM_001255991	107867015	107920615	9
chr5	107926763	107941575	A830010M20Rik	14812	+	NM_001007574	107926835	107938158	6
chr5	107963729	107980561	1700028K03Rik	16832	+	NM_175241	107968167	107978116	7
chr5	107977985	108026907	Glmn	48922	-	NM_001161738	107978077	108025845	19
chr5	108026714	108090872	Rpap2	64158	+	NM_001289569	108030875	108084317	13
chr5	108059268	108062869	A930041C12Rik	3601	-	NR_046195	108062869	108062869	3
chr5	108127230	108132499	4930428O21Rik	5269	-	NR_045871	108132499	108132499	3
chr5	108145673	108154825	Gfi1	9152	-	NM_001267621	108146758	108154730	8
chr5	108173813	108304126	Evi5	130313	-	NM_007964	108177164	108304058	18
chr5	108259180	108260796	Ube2d2b	1616	+	NM_001276397	108259503	108259947	1
chr5	108329546	108338024	Rpl5	8478	+	NM_016980	108329662	108337015	8
chr5	108337060	108416096	Fam69a	79036	-	NM_026062	108338422	108416021	5
chr5	108494692	108538238	Mtf2	43546	+	NR_045608	108538238	108538238	17
chr5	108550665	108561610	Tmed5	10945	-	NM_028876	108553559	108561443	4
chr5	108561932	108661968	Ccdc18	100036	+	NM_028481	108564443	108661767	29
chr5	108697915	108709540	Dr1	11625	+	NM_026106	108698608	108707684	3
chr5	108741943	108778374	Pigg	36431	+	NM_001081234	108741943	108777069	13
chr5	108817391	108860761	Pde6b	43370	+	NM_008806	108817458	108860583	22
chr5	108862271	108863397	Atp5k	1126	-	NM_007507	108862330	108863380	4
chr5	108870072	108877910	Mfsd7a	7838	-	NM_172883	108871002	108877883	10
chr5	108890350	108932118	Pcgf3	41768	+	NM_172716	108902816	108929423	11
chr5	108947572	108979046	Cplx1	31474	-	NM_007756	108949147	108977555	4
chr5	108998125	109058796	Gak	60671	-	NM_001282051	108998873	109045969	28
chr5	109058828	109076789	Tmem175	17961	+	NM_001163531	109067365	109075524	11
chr5	109076062	109089788	Dgkq	13726	-	NM_199011	109077728	109089714	23
chr5	109089349	109114465	Idua	25116	+	NM_008325	109098381	109112392	15
chr5	109098900	109104384	Slc26a1	5484	-	NM_174870	109100235	109103040	3
chr5	109123247	109135969	Fgfrl1	12722	+	NM_054071	109124070	109135364	7
chr5	109192860	109197936	1700047L14Rik	5076	+	NR_040691	109197936	109197936	3
chr5	109206253	109224382	Tmed11	18129	-	NM_026109	109206315	109224329	5
chr5	109226211	109237773	Vmn2r8	11562	-	NM_001104620	109226211	109237773	6
chr5	109271965	109281529	Vmn2r9	9564	-	NM_001104621	109271965	109281529	6
chr5	109424557	109435455	Vmn2r10	10898	-	NM_009491	109424557	109435455	6
chr5	109475891	109488471	Vmn2r11	12580	-	NM_001104622	109475891	109488471	6
chr5	109514867	109526883	Vmn2r12	12016	-	NM_001104623	109514867	109526883	6
chr5	109585086	109621126	Vmn2r13	36040	-	NM_001104624	109585086	109621126	6
chr5	109644520	109653641	Vmn2r14	9121	-	NM_001104625	109644520	109653641	6
chr5	109715287	109726575	Vmn2r15	11288	-	NM_001104626	109715287	109726575	6
chr5	109759399	109793500	Vmn2r16	34101	+	NM_001104627	109759399	109793500	6
chr5	109849031	109882406	Vmn2r17	33375	+	NM_001104628	109849031	109882406	6
chr5	109983727	109988012	Crlf2	4285	-	NM_016715	109983864	109987902	8
chr5	110262519	110263161	Gm10416	642	-	NR_027964	110263161	110263161	1
chr5	110362581	110370729	Gm15446	8148	+	NR_040366	110370729	110370729	3
chr5	110425545	110439430	Zfp932	13885	+	NM_145563	110425646	110439037	4
chr5	110528987	110534971	Plcxd1	5984	+	NM_207279	110529205	110532652	8
chr5	110532995	110537216	Gtpbp6	4221	-	NM_145147	110533039	110537190	10
chr5	110539110	110558813	Zfp605	19703	+	NM_001163996	110541070	110558121	5
chr5	110564848	110600992	Chfr	36144	+	NM_001289580	110573807	110599923	19
chr5	110596526	110605523	Gm15787	8997	-	NR_040431	110605523	110605523	3
chr5	110605719	110652174	Golga3	46455	+	NM_008146	110610796	110652098	24
chr5	110660022	110685670	Ankle2	25648	+	NM_001253814	110660255	110683539	13
chr5	110688153	110698918	Pgam5	10765	-	NM_028273	110689305	110698858	6
chr5	110703304	110715187	Pxmp2	11883	-	NM_008993	110703578	110715024	5
chr5	110715337	110766472	Pole	51135	+	NM_011132	110715406	110766264	49
chr5	110768830	110772168	P2rx2	3338	-	NM_001310701	110769211	110771569	11
chr5	110773748	110785113	Lrcol1	11365	+	NR_132326	110785113	110785113	7
chr5	110790770	110877522	Fbrsl1	86752	-	NM_001142642	110792060	110877186	19
chr5	110858893	110860974	Gm29766	2081	-	NR_105032	110860974	110860974	1
chr5	110943941	110954998	A630023P12Rik	11057	+	NR_102290	110954998	110954998	3
chr5	110973373	111050402	Galnt9	77029	+	NM_198306	110973720	111049673	11
chr5	111077437	111082401	Noc4l	4964	-	NM_153570	111077882	111082358	15
chr5	111082469	111089515	Ddx51	7046	+	NM_027156	111082506	111086626	15
chr5	111093391	111199736	Ep400	106345	-	NM_029337	111094820	111185750	52
chr5	111095093	111095160	Mir7026	67	-	NR_105993	111095160	111095160	1
chr5	111202685	111209634	Pus1	6949	-	NM_001025562	111202950	111208906	6
chr5	111213507	111239100	Ulk1	25593	-	NM_009469	111215190	111238743	28
chr5	111258088	111268796	Hscb	10708	-	NM_153571	111258138	111268747	6
chr5	111269035	111303152	Chek2	34117	+	NM_016681	111270231	111302585	15
chr5	111308821	111718799	Ttc28	409978	+	NM_001267622	111308923	111715567	24
chr5	111433162	111433271	Mir701	109	+	NR_030482	111433271	111433271	1
chr5	111759716	111817379	Pitpnb	57663	+	NM_019640	111759833	111814587	12
chr5	111847185	111886045	Mn1	38860	+	NM_001081235	111847185	111883811	2
chr5	112010580	112016173	C130026L21Rik	5593	+	NR_015546	112016173	112016173	4
chr5	112163303	112190748	E130006D01Rik	27445	-	NR_045833	112190748	112190748	5
chr5	112635782	112639022	1700028D13Rik	3240	+	NR_045377	112639022	112639022	4
chr5	112642247	112657968	Miat	15721	-	NR_033657	112657968	112657968	7
chr5	112675511	112681538	Cryba4	6027	-	NM_021351	112675690	112680805	6
chr5	112684839	112698605	Crybb1	13766	+	NM_023695	112686403	112698520	6
chr5	112705726	112744376	Tpst2	38650	+	NM_009419	112736616	112742303	7
chr5	112755388	112767093	Tfip11	11705	+	NM_018783	112756990	112766361	14
chr5	112766410	112772060	Srrd	5650	-	NM_027323	112766754	112772043	7
chr5	112772114	112807444	Hps4	35330	+	NM_138646	112774027	112807150	14
chr5	112782792	112785053	Gm6583	2261	-	NM_001039228	112783446	112784856	1
chr5	112814465	112821233	Asphd2	6768	-	NM_028386	112814771	112820985	3
chr5	112848170	113006218	Sez6l	158048	-	NM_019982	112851028	113005888	17
chr5	112878445	112880758	Gm6588	2313	+	NM_001177504	112878608	112879994	1
chr5	113011955	113019016	1700034G24Rik	7061	-	NR_045397	113019016	113019016	5
chr5	113117895	113325382	Myo18b	207487	-	NM_028901	113121127	113308477	44
chr5	113222311	113230721	1700095B10Rik	8410	+	NR_040676	113230721	113230721	4
chr5	113339497	113444558	Adrbk2	105061	-	NM_001285806	113343932	113398232	21
chr5	113487277	113499137	Crybb2	11860	-	NM_007773	113487369	113497765	7
chr5	113504858	113510604	Crybb3	5746	-	NM_021352	113504925	113509574	6
chr5	113515342	113592333	2900026A02Rik	76991	-	NM_172884	113521438	113592128	8
chr5	113655928	113668283	Tmem211	12355	+	NM_001033428	113663382	113667296	5
chr5	113672239	113739806	Sgsm1	67567	-	NM_172718	113674024	113739712	25
chr5	113753512	113753565	Mir7229	53	-	NR_106088	113753565	113753565	1
chr5	113766609	113766665	Mir7230	56	-	NR_106089	113766665	113766665	1
chr5	113786313	113786841	Aym1	528	+	NM_001012726	113786536	113786674	1
chr5	113919466	114039679	Wscd2	120213	+	NM_177292	114000752	114038099	9
chr5	114062363	114100399	Cmklr1	38036	-	NM_008153	114063831	114064947	3
chr5	114142432	114174781	1700069L16Rik	32349	-	NR_033216	114174781	114174781	3
chr5	114185790	114190616	Ficd	4826	+	NM_001010825	114186880	114189151	3
chr5	114192454	114221658	Sart3	29204	-	NM_016926	114193137	114221644	19
chr5	114222820	114228291	Iscu	5471	+	NM_025526	114222836	114227927	5
chr5	114243737	114250361	Tmem119	6624	-	NM_146162	114244904	114245747	2
chr5	114267806	114280510	Selplg	12704	-	NM_009151	114268998	114270252	2
chr5	114292447	114358715	Coro1c	66268	-	NM_011779	114294357	114332161	11
chr5	114392227	114443766	Ssh1	51539	-	NM_198109	114392247	114443741	15
chr5	114453743	114475684	Dao	21941	+	NM_010018	114459847	114474915	11
chr5	114476921	114541389	Svop	64468	-	NM_026805	114478266	114541195	16
chr5	114550341	114572933	Usp30	22592	+	NM_001033202	114550441	114571797	13
chr5	114573942	114578185	Alkbh2	4243	-	NM_175016	114573956	114577748	4
chr5	114580443	114589330	Ung	8887	+	NM_001040691	114580511	114588385	7
chr5	114615526	114700767	Acacb	85241	+	NM_133904	114615526	114699629	52
chr5	114704172	114723770	Foxn4	19598	-	NM_148935	114705499	114723067	10
chr5	114764949	114814585	Myo1h	49636	+	NM_001164573	114764949	114813023	31
chr5	114813580	114830514	Kctd10	16934	-	NM_026145	114815650	114830437	7
chr5	114830615	114871175	Ube3b	40560	+	NM_054093	114837126	114869678	28
chr5	114854476	114854548	Mir7027	72	+	NR_105994	114854548	114854548	1
chr5	114881042	114894036	Mmab	12994	-	NM_029956	114883279	114894000	9
chr5	114894277	114910599	Mvk	16322	+	NM_001306205	114895410	114910200	11
chr5	115018259	115063227	Fam222a	44968	+	NM_001004180	115044394	115062115	3
chr5	115072162	115108430	Trpv4	36268	-	NM_022017	115072661	115094908	16
chr5	115119510	115140944	Gltp	21434	-	NM_019821	115120415	115140870	5
chr5	115157787	115172336	Tchp	14549	+	NM_029992	115158662	115171149	13
chr5	115169523	115169587	Mir7028	64	+	NR_105995	115169587	115169587	1
chr5	115177416	115223501	Git2	46085	-	NM_001077359	115180190	115223374	19
chr5	115223741	115224992	4930515G01Rik	1251	-	NR_027872	115224992	115224992	1
chr5	115225148	115255829	Ankrd13a	30681	+	NM_026718	115225237	115254433	15
chr5	115258204	115263985	1500011B03Rik	5781	-	NR_027817	115263985	115263985	2
chr5	115271945	115273477	2610524H06Rik	1532	-	NM_181075	115272447	115273454	2
chr5	115303722	115333888	4930519G04Rik	30166	+	NM_026263	115311632	115332874	12
chr5	115346942	115362254	Oasl2	15312	+	NM_011854	115347673	115361376	6
chr5	115373248	115387920	Oasl1	14672	+	NM_145209	115373420	115387427	7
chr5	115392210	115398549	2210016L21Rik	6339	+	NM_028211	115392216	115398006	6
chr5	115398988	115421071	Hnf1a	22083	-	NM_009327	115400069	115420853	10
chr5	115461532	115548799	Sppl3	87267	+	NM_029012	115461601	115547206	11
chr5	115552930	115560277	Rpl37rt	7347	-	NM_001271590	115553236	115553530	2
chr5	115560307	115569355	Acads	9048	-	NM_007383	115560862	115569279	10
chr5	115572574	115584984	Unc119b	12410	-	NM_175352	115575396	115584919	5
chr5	115592989	115608185	Mlec	15196	-	NM_175403	115597923	115608043	5
chr5	115618699	115644390	Cabp1	25691	-	NM_001310712	115619131	115644256	6
chr5	115685859	115690979	Pop5	5120	+	NM_026398	115688058	115690760	6
chr5	115691778	115722904	Rnf10	31126	-	NM_016698	115691993	115722422	17
chr5	115729710	115746981	Coq5	17271	+	NM_026504	115729721	115745975	7
chr5	115747118	115750999	Dynll1	3881	-	NM_019682	115748704	115750653	3
chr5	115751128	115770091	Gm13830	18963	+	NR_131932	115770091	115770091	2
chr5	115777185	115783089	Srsf9	5904	+	NR_036616	115783089	115783089	5
chr5	115783250	115791170	Gatc	7920	-	NM_029645	115784547	115791158	3
chr5	115791255	115793561	Triap1	2306	+	NM_026933	115791279	115792767	2
chr5	115795662	115798964	Cox6a1	3302	-	NM_007748	115795851	115798959	3
chr5	115879693	115904211	Msi1	24518	+	NM_008629	115879756	115901507	15
chr5	115916274	115924726	Pla2g1b	8452	+	NM_011107	115916295	115924636	4
chr5	115928018	115934493	Sirt4	6475	-	NM_133760	115928409	115933120	5
chr5	115956684	116005996	Pxn	49312	+	NM_133915	115956864	116004144	12
chr5	116009475	116013738	Rplp0	4263	+	NM_007475	116009843	116013453	7
chr5	116015271	116072663	Gcn1l1	57392	+	NM_172719	116015297	116072159	58
chr5	116030957	116031018	Mir7029	61	+	NR_105996	116031018	116031018	1
chr5	116081057	116081825	1110006O24Rik	768	-	NR_027810	116081825	116081825	1
chr5	116081995	116097167	Rab35	15172	+	NM_198163	116082155	116095770	6
chr5	116095581	116095641	Mir7030	60	+	NR_105997	116095641	116095641	1
chr5	116099294	116181568	Ccdc64	82274	-	NM_001080808	116099413	116181568	9
chr5	116295664	116456350	Cit	160686	+	NM_007708	116296379	116456337	47
chr5	116463598	116474437	Prkab1	10839	-	NM_031869	116464657	116474258	7
chr5	116490542	116533255	Tmem233	42713	-	NM_001101546	116490773	116533194	3
chr5	116575589	116738994	Ccdc60	163405	-	NM_177759	116576084	116738545	14
chr5	116762368	116768283	B230112J18Rik	5915	+	NR_110475	116768283	116768283	3
chr5	116858499	116872873	Hspb8	14374	-	NM_030704	116859339	116872488	3
chr5	116888730	116915496	Srrm4os	26766	+	NR_015595	116915496	116915496	4
chr5	116889281	117041826	Srrm4	152545	-	NM_026886	116894576	117041473	13
chr5	117541686	117566002	Suds3	24316	-	NM_001122666	117542840	117565822	13
chr5	117570137	117725107	Taok3	154970	+	NM_001199685	117643728	117723843	21
chr5	117732659	117737573	Pebp1	4914	-	NM_018858	117733256	117737552	4
chr5	117769274	117805015	Vsig10	35741	+	NM_001033311	117769451	117802815	10
chr5	117807313	117828598	Wsb2	21285	+	NM_021539	117807469	117827561	9
chr5	117829153	117839032	Rfc5	9879	-	NM_028128	117829818	117838987	11
chr5	117864010	118217997	Ksr2	353987	+	NM_001312914	117864837	118215572	20
chr5	118316847	118408849	Nos1	92002	+	NM_008712	118317225	118403822	28
chr5	118426778	118460200	Fbxo21	33422	+	NM_145564	118426809	118458206	12
chr5	118477832	118511879	Tesc	34047	+	NM_021344	118477938	118511688	8
chr5	118514989	118605467	Fbxw8	90478	-	NM_172721	118518093	118605390	11
chr5	118619772	118639487	Hrk	19715	+	NM_007545	118619791	118620070	2
chr5	118640744	118695034	Rnft2	54290	-	NM_001109902	118643540	118692882	11
chr5	118695235	118713123	2410131K14Rik	17888	+	NM_001081236	118695356	118711192	5
chr5	119010727	119215446	Med13l	204719	+	NM_172424	119010794	119212842	31
chr5	119402347	119411270	4930413E15Rik	8923	+	NR_040694	119411270	119411270	5
chr5	119558244	119564552	1700081H04Rik	6308	+	NR_040693	119564552	119564552	4
chr5	119644321	119650027	Gm7538	5706	-	NR_046033	119650027	119650027	3
chr5	120020137	120030367	AW549542	10230	-	NR_045702	120030367	120030367	5
chr5	120075950	120084471	Gm16063	8521	+	NR_046178	120084471	120084471	4
chr5	120120870	120134733	Tbx3	13863	+	NM_198052	120122024	120133101	8
chr5	120135096	120141227	Tbx3os2	6131	-	NR_040416	120141227	120141227	3
chr5	120284671	120335227	Tbx5	50556	+	NM_011537	120286922	120333496	9
chr5	120566521	120648980	Rbm19	82459	+	NM_028762	120566622	120647988	24
chr5	120571104	120589272	Gm10390	18168	-	NR_045793	120589272	120589272	3
chr5	120881894	120891466	Lhx5	9572	+	NM_008499	120882289	120890334	5
chr5	120908210	120922772	Sdsl	14562	-	NM_133902	120908366	120913214	8
chr5	120926555	120933914	Sds	7359	+	NM_145565	120929089	120933787	8
chr5	120933901	120953632	Plbd2	19731	-	NM_023625	120935679	120953600	12
chr5	120961200	120984033	Slc8b1	22833	+	NM_133221	120963185	120983066	16
chr5	120984165	121038622	Tpcn1	54457	-	NM_145853	120986116	121035305	28
chr5	121039031	121057122	Iqcd	18091	+	NM_029408	121050127	121056994	5
chr5	121059068	121062598	Rita1	3530	-	NM_133908	121059478	121061655	4
chr5	121063138	121078601	Ddx54	15463	+	NM_028041	121063144	121077301	20
chr5	121078343	121084244	Cfap73	5901	-	NM_001195094	121078343	121084244	7
chr5	121098820	121129619	Rasal1	30799	+	NM_013832	121099478	121129037	22
chr5	121130272	121161678	Dtx1	31406	-	NM_008052	121131256	121160322	10
chr5	121180341	121199857	Oas2	19516	-	NM_145227	121181901	121199782	11
chr5	121203106	121227668	Oas3	24562	-	NM_145226	121204372	121227633	16
chr5	121236320	121245539	Oas1e	9219	-	NM_145210	121236932	121245507	6
chr5	121250207	121262523	Oas1c	12316	-	NM_033541	121251042	121258772	7
chr5	121262643	121274169	Oas1b	11526	+	NR_003507	121274169	121274169	6
chr5	121297375	121307995	Oas1f	10620	+	NM_145153	121297400	121307635	6
chr5	121311430	121323514	Oas1h	12084	+	NM_145228	121311462	121322955	6
chr5	121326150	121337622	Oas1g	11472	-	NM_011852	121327003	121337571	7
chr5	121346265	121357534	Oas1a	11269	-	NM_145211	121347000	121357485	7
chr5	121364826	121371656	Oas1d	6830	+	NM_133893	121364892	121371074	6
chr5	121390508	121460101	Rph3a	69593	-	NM_001302344	121392176	121436504	22
chr5	121580541	121641406	Ptpn11	60865	-	NM_001109992	121584765	121641224	16
chr5	121654509	121659250	Rpl6	4741	+	NM_011290	121655414	121658943	7
chr5	121670227	121818586	Gm15800	148359	+	NM_181421	121670480	121816614	76
chr5	121821733	121835624	Trafd1	13891	-	NM_172275	121822367	121834095	12
chr5	121847990	121890122	Naa25	42132	+	NM_172722	121848013	121889959	24
chr5	121894761	121902483	Erp29	7722	-	NM_026129	121895081	121902349	3
chr5	121902717	121945430	Tmem116	42713	+	NM_029912	121939275	121945203	10
chr5	121950105	121952989	Adam1b	2884	-	NM_172125	121950568	121952989	1
chr5	121968612	121971704	Adam1a	3092	-	NM_172126	121968861	121971237	1
chr5	121975059	121995901	Mapkapk5	20842	-	NM_010765	121975153	121995209	14
chr5	122016035	122043833	Aldh2	27798	-	NM_009656	122017999	122043490	13
chr5	122048289	122068947	Acad12	20658	-	NM_178799	122048815	122064255	11
chr5	122071037	122110519	Acad10	39482	-	NM_028037	122071217	122106209	21
chr5	122110571	122137258	Brap	26687	+	NM_028227	122110775	122135501	12
chr5	122161617	122264959	Atxn2	103342	+	NM_009125	122161644	122264375	25
chr5	122265489	122286868	Sh2b3	21379	-	NM_001306127	122267779	122279058	9
chr5	122269217	122269282	Mir7031	65	-	NR_105998	122269282	122269282	1
chr5	122299036	122304608	Fam109a	5572	+	NM_175474	122302585	122303386	4
chr5	122310224	122499860	Cux2	189636	-	NM_001312908	122310603	122371358	23
chr5	122550988	122556863	Myl2	5875	+	NM_010861	122551035	122556778	7
chr5	122558060	122588071	Ccdc63	30011	-	NM_183307	122558116	122580306	13
chr5	122608287	122625278	Ppp1cc	16991	+	NM_013636	122608569	122624153	7
chr5	122659737	122692306	Hvcn1	32569	+	NM_001042489	122666351	122690681	8
chr5	122689503	122714469	Tctn1	24966	-	NM_001039153	122691700	122714378	14
chr5	122734406	122774290	Pptc7	39884	+	NM_177242	122734677	122770883	6
chr5	122775516	122804204	Rad9b	28688	-	NM_144912	122775877	122804184	11
chr5	122804421	122813296	Vps29	8875	+	NM_019780	122804482	122812931	4
chr5	122814592	122821972	Fam216a	7380	-	NM_026883	122814803	122821956	7
chr5	122822516	122832778	Gpn3	10262	+	NM_024216	122822617	122832332	8
chr5	122841886	122856190	Arpc3	14304	+	NM_019824	122842000	122855940	7
chr5	122872452	122894920	Anapc7	22468	+	NM_019805	122872586	122894002	11
chr5	122903521	122952234	Atp2a2	48713	-	NM_009722	122904299	122951694	21
chr5	123000212	123064527	Ift81	64315	-	NM_009879	123001029	123061095	19
chr5	123093919	123141441	P2rx7	47522	+	NM_001038845	123094082	123141300	13
chr5	123157552	123179747	P2rx4	22195	+	NM_011026	123157662	123178322	12
chr5	123181179	123229419	Camkk2	48240	-	NM_001199676	123184083	123214253	17
chr5	123237469	123271351	Anapc5	33882	-	NM_001289519	123238330	123271159	17
chr5	123300196	123318954	Rnf34	18758	+	NM_030564	123300301	123318236	6
chr5	123320680	123439108	Kdm2b	118428	-	NM_001003953	123321724	123438909	23
chr5	123439362	123448350	A930024E05Rik	8988	+	NR_045820	123448350	123448350	3
chr5	123465082	123480461	Orai1	15379	+	NM_175423	123465266	123479689	2
chr5	123487135	123496829	Morn3	9694	-	NM_029112	123487291	123496784	5
chr5	123526283	123567454	Tmem120b	41171	+	NM_001039723	123526435	123566766	12
chr5	123568188	123582638	Rhof	14450	-	NM_175092	123569438	123582381	5
chr5	123592201	123618639	Setd1b	26438	+	NM_001040398	123592965	123616015	17
chr5	123621815	123632695	Hpd	10880	-	NM_008277	123621986	123632685	14
chr5	123678198	123700134	Psmd9	21936	+	NM_026000	123678315	123698329	6
chr5	123794456	123824092	Bcl7a	29636	+	NM_029850	123794638	123821098	6
chr5	123844806	123907940	Mlxip	63134	+	NM_133917	123844938	123903522	17
chr5	123930161	123932110	Il31	1949	-	NM_029594	123930427	123932058	3
chr5	123939333	123958214	Lrrc43	18881	+	NM_001289822	123939338	123958169	12
chr5	123960468	123961891	B3gnt4	1423	+	NM_198611	123960582	123961635	1
chr5	123961338	123974173	Diablo	12835	-	NM_023232	123962519	123974129	6
chr5	123972645	123972704	Mir7647	59	-	NR_106105	123972704	123972704	1
chr5	123978768	124023024	Vps33a	44256	-	NM_029929	123981048	124022990	13
chr5	124027802	124134370	Clip1	106568	-	NM_019765	124029285	124105987	24
chr5	124148310	124171053	Zcchc8	22743	-	NM_027494	124150352	124170939	14
chr5	124178434	124199423	Rsrc2	20989	-	NM_001005525	124179185	124199303	10
chr5	124199734	124271602	Kntc1	71868	+	NM_001042421	124203877	124271410	64
chr5	124313578	124315525	Hcar2	1947	-	NM_030701	124314364	124315447	1
chr5	124326744	124330029	Hcar1	3285	-	NM_175520	124328579	124329635	1
chr5	124357283	124378841	Denr	21558	+	NM_026603	124358117	124377303	8
chr5	124380697	124419904	Ccdc62	39207	+	NM_001134767	124380707	124416898	13
chr5	124423636	124453224	Hip1r	29588	+	NM_145070	124423771	124452174	32
chr5	124446860	124446939	Mir7032	79	+	NR_105999	124446939	124446939	1
chr5	124454649	124482269	Vps37b	27620	-	NM_177876	124456255	124482221	4
chr5	124511865	124545807	Abcb9	33942	-	NM_019875	124512671	124540185	12
chr5	124562346	124565485	Ogfod2	3139	+	NM_025671	124562346	124564987	7
chr5	124566116	124568204	Arl6ip4	2088	+	NM_144509	124566454	124568050	5
chr5	124568697	124699769	Pitpnm2	131072	-	NM_011256	124571271	124602630	25
chr5	124679733	124687146	Pitpnm2os1	7413	+	NR_045369	124687146	124687146	6
chr5	124700967	124777981	Mphosph9	77014	-	NM_001277867	124705025	124774989	23
chr5	124778097	124791861	2810006K23Rik	13764	+	NM_001134717	124788653	124790881	3
chr5	124795447	124804637	Cdk2ap1	9190	-	NM_013812	124796095	124804380	4
chr5	124818710	124875923	Sbno1	57213	-	NM_001081203	124824537	124864536	32
chr5	124889938	124912320	Setd8	22382	+	NM_030241	124890014	124910707	8
chr5	124913273	124928244	Rilpl2	14971	-	NM_030259	124913789	124928094	4
chr5	124933163	124941131	Snrnp35	7968	+	NM_029532	124940134	124940869	2
chr5	124943088	124981400	Rilpl1	38312	-	NM_021430	124943708	124980992	7
chr5	124990799	125000512	Tmed2	9713	+	NM_019770	124990870	124999214	4
chr5	125002872	125019669	Ddx55	16797	+	NM_001190795	125002940	125018741	14
chr5	125020222	125029140	Eif2b1	8918	-	NM_145371	125021198	125029022	9
chr5	125029156	125047689	Gtf2h3	18533	+	NM_181410	125029197	125045996	13
chr5	125048757	125077658	Tctn2	28901	+	NM_026486	125048883	125077243	18
chr5	125079632	125204825	Atp6v0a2	125193	+	NM_011596	125079754	125202174	20
chr5	125205454	125314678	Dnah10	109224	+	NM_019536	125205533	125314495	79
chr5	125314801	125342591	Ccdc92	27790	-	NM_144819	125315888	125320160	4
chr5	125343074	125369000	Zfp664	25926	+	NM_001081750	125365913	125366699	4
chr5	125483844	125492917	Fam101a	9073	+	NM_028443	125483937	125491975	3
chr5	125497522	125659584	Ncor2	162062	-	NM_001253904	125498536	125590328	48
chr5	125757456	125821464	Scarb1	64008	-	NM_016741	125761474	125821252	13
chr5	125866334	125870387	Ubc	4053	-	NM_019639	125866426	125868631	2
chr5	125894773	125914418	Dhx37	19645	-	NM_203319	125895450	125914407	27
chr5	125921937	125941255	Bri3bp	19318	+	NM_029752	125922031	125935123	3
chr5	125956242	125997773	Aacs	41531	+	NM_030210	125956346	125996723	18
chr5	126012787	126272953	Tmem132b	260166	+	NM_001190352	126012999	126268438	9
chr5	127511158	127568899	4933438B17Rik	57741	+	NR_040685	127568899	127568899	7
chr5	127650934	127664726	4930572K03Rik	13792	+	NR_045371	127664726	127664726	5
chr5	127722195	128046160	Tmem132c	323965	+	NM_175432	127722284	128044460	9
chr5	127737229	127761993	Tmem132cos	24764	-	NR_038128	127761993	127761993	4
chr5	128076035	128097762	Slc15a4	21727	-	NM_133895	128076993	128097739	8
chr5	128112631	128187890	Glt1d1	75259	+	NM_177005	128112653	128187394	12
chr5	128263860	128938937	Tmem132d	675077	-	NM_172885	128264131	128938224	9
chr5	129085004	129106562	5930412G12Rik	21558	-	NR_015517	129106562	129106562	6
chr5	129106980	129109968	Fzd10	2988	+	NM_175284	129107092	129108841	1
chr5	129242120	129261349	Piwil1	19229	+	NM_021311	129244921	129260184	22
chr5	129263662	129459361	Rimbp2	195699	-	NM_001081388	129266697	129325719	22
chr5	129490432	129514447	Stx2	24015	-	NM_007941	129493636	129514298	11
chr5	129526030	129530196	Ran	4166	+	NM_009391	129526413	129528693	7
chr5	129602624	129710474	Adgrd1	107850	+	NM_001081342	129603035	129708434	26
chr5	130007105	130077259	Sfswap	70154	+	NM_172276	130007253	130076942	18
chr5	130090088	130114086	Mmp17	23998	+	NM_011846	130090167	130112413	10
chr5	130160469	130175963	Zfp11	15494	-	NM_172462	130162326	130166654	3
chr5	130189265	130214386	Sept14	25121	-	NM_028826	130189364	130210134	11
chr5	130221402	130224566	Mrps17	3164	+	NM_025450	130222618	130224030	4
chr5	130230949	130264201	Gbas	33252	+	NM_008095	130231019	130263019	10
chr5	130271433	130293129	Psph	21696	-	NM_133900	130271666	130277491	8
chr5	130293231	130322319	Cct6a	29088	+	NM_009838	130293314	130321696	13
chr5	130300436	130300552	Snora15	116	+	NR_003681	130300552	130300552	1
chr5	130322865	130339827	Sumf2	16962	+	NM_026445	130322871	130338599	9
chr5	130339310	130354954	Phkg1	15644	-	NM_011079	130340316	130350175	10
chr5	130357031	130363340	Chchd2	6309	-	NM_024166	130357256	130363117	4
chr5	130371592	130379492	Zbed5	7900	+	NM_183088	130371672	130379352	4
chr5	130384409	130387151	Nupr1l	2742	+	NM_026916	130384461	130384770	3
chr5	130417978	130462562	Vkorc1l1	44584	+	NM_027121	130418041	130458237	3
chr5	130464890	130478698	Gusb	13808	-	NM_010368	130465387	130478686	12
chr5	130487372	130500201	Asl	12829	-	NM_133768	130487425	130499923	17
chr5	130505175	130536653	Crcp	31478	+	NM_007761	130505269	130535724	6
chr5	130549195	130611603	Tpst1	62408	+	NM_013837	130577560	130610346	6
chr5	130620757	130631678	Kctd7	10921	+	NM_172509	130620952	130628477	4
chr5	130647688	130690207	Rabgef1	42519	+	NM_001199059	130663277	130689102	9
chr5	130695613	130719635	Tmem248	24022	+	NM_001081394	130705337	130717168	7
chr5	130721601	130731400	Sbds	9799	-	NM_023248	130722202	130731207	5
chr5	130732906	130817437	Tyw1	84531	+	NM_001015876	130733059	130816710	16
chr5	130845327	131316515	Caln1	471188	+	NM_181045	130890697	131315280	7
chr5	130854720	130860501	A330070K13Rik	5781	-	NM_198665	130854890	130860386	3
chr5	131350820	131783392	Wbscr17	432572	-	NM_145218	131352297	131782470	11
chr5	131913551	133018213	Auts2	1104662	-	NM_177047	131915305	133017693	19
chr5	132356138	132359638	4930563F08Rik	3500	+	NR_040704	132359638	132359638	3
chr5	134575617	134617628	Gatsl2	42011	+	NM_030719	134575908	134614164	9
chr5	134623927	134652637	Wbscr16	28710	-	NM_033572	134624798	134652584	11
chr5	134659907	134694013	Gtf2ird2	34106	+	NM_053266	134667054	134693582	16
chr5	134695922	134705495	Ncf1	9573	-	NR_104383	134705495	134705495	12
chr5	134713701	134790630	Gtf2i	76929	-	NM_001080746	134715382	134771478	35
chr5	134802323	134802392	Mir3965	69	+	NR_039544	134802392	134802392	1
chr5	134833530	134932586	Gtf2ird1	99056	-	NM_020331	134833697	134893045	31
chr5	134965252	135028304	Clip2	63052	-	NM_009990	134966650	135011040	17
chr5	135033123	135036041	Syna	2918	-	NM_001013751	135034109	135035963	1
chr5	135047945	135047984	Mir7228	39	+	NR_106087	135047984	135047984	1
chr5	135058559	135074198	Rfc2	15639	+	NM_020022	135058658	135073829	11
chr5	135075972	135090895	Lat2	14923	-	NM_020044	135078456	135084774	13
chr5	135095741	135115279	Eif4h	19538	-	NM_033561	135097378	135115169	7
chr5	135131908	135164460	Limk1	32552	-	NM_010717	135133092	135164265	16
chr5	135178464	135223193	Eln	44729	-	NM_007925	135179650	135223111	37
chr5	135377462	135382603	Wbscr28	5141	-	NM_029681	135377731	135382569	3
chr5	135390119	135391400	Cldn13	1281	-	NM_020504	135390352	135391199	2
chr5	135408242	135418507	Wbscr27	10265	+	NM_024479	135408594	135416562	6
chr5	135420992	135422804	Cldn4	1812	-	NM_009903	135421982	135422615	1
chr5	135462083	135463346	Cldn3	1263	+	NM_009902	135462314	135462974	1
chr5	135463302	135477220	Wbscr25	13918	-	NR_026907	135477220	135477220	5
chr5	135485021	135488045	Abhd11	3024	+	NM_001190437	135485963	135487889	6
chr5	135487991	135489027	Abhd11os	1036	-	NR_026688	135489027	135489027	4
chr5	135499351	135526970	Stx1a	27619	+	NM_016801	135499450	135525774	10
chr5	135528826	135540536	Wbscr22	11710	-	NM_025375	135529239	135539931	13
chr5	135540075	135541235	Dnajc30	1160	+	NM_025362	135540120	135540780	1
chr5	135548769	135554136	Vps37d	5367	-	NM_001199677	135549460	135554069	4
chr5	135582760	135614252	Mlxipl	31492	+	NM_021455	135582792	135613230	17
chr5	135625580	135638532	Tbl2	12952	+	NM_013763	135625607	135635552	7
chr5	135644241	135657722	Bcl7b	13481	+	NM_009745	135644376	135656800	6
chr5	135663192	135721999	Baz1b	58807	+	NM_011714	135663519	135720333	19
chr5	135724807	135726917	Fzd9	2110	-	NM_010246	135725120	135726899	1
chr5	135767573	135825914	Fkbp6	58341	-	NM_033571	135813486	135825861	9
chr5	135829165	135843524	Trim50	14359	+	NM_178240	135829165	135843524	6
chr5	135845822	135852667	Nsun5	6845	+	NM_145414	135845853	135851854	10
chr5	135852009	135870416	Pom121	18407	-	NM_148932	135853946	135870375	13
chr5	135859599	135859680	Mir7033	81	-	NR_106000	135859680	135859680	1
chr5	135882387	136020992	Hip1	138605	-	NM_146001	135887086	136020926	31
chr5	136036317	136039439	Ccl26	3122	-	NM_001013412	136036317	136039439	3
chr5	136045806	136048913	Ccl24	3107	-	NM_019577	136046664	136048842	3
chr5	136108523	136122246	Rhbdd2	13723	+	NM_146002	136108610	136119248	4
chr5	136165014	136211196	Por	46182	+	NM_008898	136191754	136210827	16
chr5	136211359	136220042	Tmem120a	8683	-	NM_172541	136211561	136219998	12
chr5	136211675	136211759	Mir7034	84	-	NR_106001	136211759	136211759	1
chr5	136223089	136254255	Styxl1	31166	-	NM_029659	136223636	136246228	9
chr5	136254518	136266256	Mdh2	11738	+	NM_008617	136254605	136266078	9
chr5	136293975	136350642	Srrm3	56667	+	NM_021403	136310919	136349178	15
chr5	136363788	136365433	Hspb1	1645	+	NM_013560	136363928	136365300	3
chr5	136384248	136410511	Ywhag	26263	-	NM_018871	136386864	136410279	2
chr5	136436092	136450346	Ssc4d	14254	-	NM_001160366	136436761	136446217	11
chr5	136455974	136464494	Zp3	8520	+	NM_011776	136456003	136464481	8
chr5	136470669	136508751	Dtx2	38082	+	NM_023742	136485958	136508357	11
chr5	136514365	136520863	Upk3b	6498	+	NM_175309	136514671	136519964	6
chr5	136533136	136540194	Upk3bl	7058	+	NM_027158	136533273	136540041	6
chr5	136559785	136587731	Rasa4	27946	+	NM_133914	136559982	136587422	21
chr5	136581391	136581473	Mir7035	82	+	NR_106002	136581473	136581473	1
chr5	136592560	136598817	Polr2j	6257	+	NM_011293	136592622	136598647	4
chr5	136598935	136611944	Lrwd1	13009	-	NM_027891	136599044	136611821	15
chr5	136614650	136617484	Alkbh4	2834	+	NM_028070	136615345	136616636	3
chr5	136623331	136646526	Orai2	23195	-	NM_178751	136626294	136637581	3
chr5	136656226	136674824	Prkrip1	18598	-	NM_025774	136657265	136674770	6
chr5	136694018	136720810	Sh2b2	26792	-	NM_018825	136694699	136708230	9
chr5	136724004	137043360	Cux1	319356	-	NM_198602	136724780	137043110	23
chr5	136851585	136851673	Mir721	88	-	NR_030500	136851673	136851673	1
chr5	137169015	137176964	Myl10	7949	+	NM_001303019	137169252	137176591	7
chr5	137217633	137358977	Col26a1	141344	-	NM_024474	137218915	137358877	13
chr5	137384019	137389114	Ift22	5095	+	NM_026073	137384101	137388843	5
chr5	137395015	137412979	4933404O12Rik	17964	+	NR_015555	137412979	137412979	4
chr5	137429144	137442104	Fis1	12960	+	NM_001163243	137429436	137441884	5
chr5	137443738	137451715	Cldn15	7977	+	NM_021719	137443976	137450786	5
chr5	137458063	137463829	Znhit1	5766	-	NM_027318	137458265	137463377	5
chr5	137462888	137472516	Plod3	9628	+	NM_011962	137463555	137472131	19
chr5	137467302	137467411	Mir702	109	+	NR_030483	137467411	137467411	1
chr5	137506164	137509221	Vgf	3057	+	NM_001039385	137506855	137508709	2
chr5	137510863	137521930	Ap1s1	11067	-	NM_007457	137511613	137521880	5
chr5	137537375	137548142	Serpine1	10767	-	NM_008871	137539043	137547173	9
chr5	137587155	137592077	Trim56	4922	-	NM_201373	137588325	137590530	3
chr5	137729481	137735694	Ache	6213	+	NM_009599	137731261	137735466	5
chr5	137735007	137735104	Mir8116	97	+	NR_106196	137735104	137735104	1
chr5	137735896	137736892	Ufsp1	996	+	NM_027356	137736017	137736671	1
chr5	137736931	137748902	Srrt	11971	-	NM_031405	137737058	137748395	20
chr5	137737851	137737916	Mir7036	65	-	NR_106003	137737916	137737916	1
chr5	137751126	137755469	Trip6	4343	-	NM_011639	137751270	137755296	9
chr5	137755785	137774810	Slc12a9	19025	-	NM_031406	137756178	137773864	14
chr5	137791336	137815750	Ephb4	24414	+	NM_001159571	137791825	137814869	17
chr5	137819864	137918292	Zan	98428	-	NM_011741	137819909	137917680	88
chr5	137924247	137927044	Epo	2797	-	NM_001312875	137924312	137926973	5
chr5	137942666	137943657	Pop7	991	-	NM_028753	137942874	137943297	2
chr5	137960107	137969163	Gigyf1	9056	+	NM_031408	137960179	137966932	24
chr5	137969356	137974457	Gnb2	5101	-	NM_010312	137969730	137971979	10
chr5	137970707	137970822	Mir6418	115	-	NR_105846	137970822	137970822	1
chr5	137994782	138010801	Actl6b	16019	+	NM_031404	137994862	138010614	14
chr5	138011067	138029309	Tfr2	18242	+	NM_015799	138012236	138028332	20
chr5	138037874	138042287	Mospd3	4413	-	NM_030037	138038249	138041703	6
chr5	138046334	138052632	Pcolce	6298	-	NM_008788	138046390	138052556	9
chr5	138053732	138066306	Fbxo24	12574	-	NM_027708	138053984	138066169	10
chr5	138070350	138082327	Lrch4	11977	+	NM_146164	138070434	138081373	18
chr5	138070350	138084124	Gm20605	13774	+	NR_033148	138084124	138084124	22
chr5	138082700	138084130	Sap25	1430	+	NM_001081962	138082863	138084014	5
chr5	138084259	138086942	Irs3	2683	-	NM_010571	138084914	138086748	2
chr5	138091705	138125981	Agfg2	34276	-	NM_001303266	138092996	138125807	13
chr5	138172190	138181226	Nyap1	9036	-	NM_175521	138172909	138180946	6
chr5	138187196	138209681	Tsc22d4	22485	+	NM_029805	138188343	138209431	6
chr5	138220145	138221335	Ppp1r35	1190	+	NM_027242	138220221	138221255	4
chr5	138223133	138227929	Mepce	4796	-	NM_144913	138223659	138227290	4
chr5	138229029	138263849	Zcwpw1	34820	+	NM_001005426	138236745	138263695	17
chr5	138263179	138277506	Pilra	14327	-	NM_153510	138264699	138277347	7
chr5	138293374	138299277	Pilrb1	5903	-	NM_133209	138294270	138299172	5
chr5	138307056	138312986	Pilrb2	5930	-	NM_001024932	138308080	138312881	4
chr5	138334160	138362847	Cyp3a13	28687	-	NM_007819	138335496	138362740	13
chr5	138395036	138404187	Gjc3	9151	-	NM_080450	138398439	138404125	3
chr5	138422748	138431460	Azgp1	8712	+	NM_013478	138422787	138431109	4
chr5	138462503	138475887	Smok3a	13384	+	NM_001168602	138473603	138475118	2
chr5	138478451	138491861	Smok3b	13410	+	NM_001039889	138489574	138491089	3
chr5	138494422	138507767	Smok3c	13345	+	NM_001310703	138505480	138506995	3
chr5	138526311	138549050	Zkscan1	22739	+	NM_133906	138534234	138542710	6
chr5	138558132	138575493	Zscan21	17361	+	NM_001044704	138566288	138575111	5
chr5	138580929	138596972	Zfp113	16043	-	NM_019747	138585894	138594127	5
chr5	138602329	138605212	Cops6	2883	+	NM_012002	138602340	138605104	10
chr5	138605816	138613090	Mcm7	7274	-	NM_008568	138605946	138612984	15
chr5	138606548	138606632	Mir25	84	-	NR_029787	138606632	138606632	1
chr5	138606750	138606838	Mir93	88	-	NR_029749	138606838	138606838	1
chr5	138606964	138607046	Mir106b	82	-	NR_029658	138607046	138607046	1
chr5	138613248	138619913	Ap4m1	6665	+	NM_021392	138613418	138619717	15
chr5	138619844	138628414	Taf6	8570	-	NM_009315	138619994	138625715	15
chr5	138628762	138635122	Cnpy4	6360	+	NM_178612	138628812	138634129	6
chr5	138635541	138636849	Mblac1	1308	+	NM_177878	138635625	138636408	1
chr5	138667131	138693103	Nxpe5	25972	+	NM_001013773	138671113	138692872	6
chr5	138696709	138700623	Lamtor4	3914	+	NM_001081108	138697028	138700365	4
chr5	138700885	138705280	BC037034	4395	-	NM_153161	138701468	138705060	11
chr5	138705272	138707889	6330418K02Rik	2617	+	NR_045821	138707889	138707889	3
chr5	138706152	138713982	Gal3st4	7830	-	NM_001033416	138706520	138712631	3
chr5	138714887	138721165	Gpc2	6278	-	NM_172412	138715537	138721042	10
chr5	138721736	138753621	Stag3	31885	+	NM_016964	138723102	138753272	34
chr5	138882703	138901922	Zfp157	19219	+	NM_028130	138882854	138898473	5
chr5	139003067	139005922	1700123K08Rik	2855	-	NM_029693	139003192	139005888	6
chr5	139044879	139060971	Zfp68	16092	-	NM_001163797	139047466	139057718	6
chr5	139064086	139090054	A430033K04Rik	25968	+	NM_183025	139064177	139089046	4
chr5	139231034	139286017	Fam20c	54983	+	NM_030565	139231589	139285311	10
chr5	139296033	139297573	Gm5294	1540	+	NM_001195128	139296033	139297573	3
chr5	139452928	139470907	Pdgfa	17979	-	NM_008808	139453170	139470725	6
chr5	139493257	139606340	Prkar1b	113083	-	NM_001253890	139494612	139603717	11
chr5	139626176	139662459	Dnaaf5	36283	+	NM_001081265	139626200	139661600	13
chr5	139676590	139725793	Sun1	49203	+	NM_024451	139691131	139724485	23
chr5	139728277	139746004	Get4	17727	+	NM_026269	139728418	139745023	9
chr5	139747829	139801418	Adap1	53589	-	NM_172723	139749001	139801316	11
chr5	139813775	139821120	Cox19	7345	-	NM_197980	139814244	139821107	3
chr5	139828570	139832987	Cyp2w1	4417	+	NM_001160265	139828600	139832987	9
chr5	139835692	139936488	3110082I17Rik	100796	-	NM_028469	139836498	139931499	5
chr5	139845603	139845699	Mir339	96	-	NR_029768	139845699	139845699	1
chr5	139853650	139856007	D830046C22Rik	2357	+	NR_033147	139856007	139856007	1
chr5	139856620	139872363	Gpr146	15743	+	NM_030258	139868398	139869400	2
chr5	139882340	139892046	C130050O18Rik	9706	+	NM_177000	139882447	139891218	2
chr5	139899132	139903754	Gper1	4622	+	NM_029771	139901855	139902983	3
chr5	139947169	139960445	Zfand2a	13276	-	NM_001159908	139949492	139958710	7
chr5	139999704	140017293	4930500L23Rik	17589	+	NR_040701	140017293	140017293	4
chr5	140019851	140024132	Uncx	4281	+	NM_013702	140019947	140023728	3
chr5	140182646	140212287	Micall2	29641	-	NM_174850	140182789	140212114	17
chr5	140227235	140251632	Ints1	24397	-	NM_026748	140227471	140251424	47
chr5	140243832	140243897	Mir7037	65	-	NR_106004	140243897	140243897	1
chr5	140267489	140278606	Mafk	11117	+	NM_010757	140275136	140276473	3
chr5	140280905	140290237	Tmem184a	9332	-	NM_001161548	140281435	140290078	9
chr5	140299547	140302797	Psmg3	3250	-	NM_025604	140299874	140302297	3
chr5	140383896	140450678	Elfn1	66782	+	NM_175522	140447196	140449683	2
chr5	140484642	140797506	Mad1l1	312864	-	NM_010752	140485069	140791093	18
chr5	140803627	140807852	Ftsj2	4225	-	NM_026510	140804291	140807814	3
chr5	140807875	140814089	Nudt1	6214	+	NM_008637	140810421	140813719	5
chr5	140816256	140865201	Snx8	48945	-	NM_172277	140817482	140865195	11
chr5	140895258	140919312	Eif3b	24054	+	NM_133916	140895314	140918377	19
chr5	140903292	140903363	Mir7038	71	+	NR_106005	140903363	140903363	1
chr5	140981562	141001192	Chst12	19630	+	NM_021528	140999573	141000833	2
chr5	141039142	141041021	Grifin	1879	-	NM_030022	141039232	141041007	5
chr5	141083294	141091499	Lfng	8205	+	NM_008494	141083369	141090427	8
chr5	141096530	141124985	Ttyh3	28455	-	NM_175274	141099410	141124781	14
chr5	141139458	141178332	Iqce	38874	-	NM_028833	141141319	141178171	23
chr5	141180964	141195332	Brat1	14368	+	NM_181066	141181923	141194551	14
chr5	141200080	141229266	Amz1	29186	+	NM_173405	141217237	141228449	8
chr5	141235897	141306385	Gna12	70488	-	NM_010302	141236502	141306250	4
chr5	141348952	141476550	Card11	127598	-	NM_175362	141349278	141403681	25
chr5	141717487	142689745	Sdk1	972258	+	NM_177879	141717802	142688129	45
chr5	142877450	142937969	Foxk1	60519	+	NM_199068	142877477	142932710	9
chr5	142939884	142954669	Ap5z1	14785	+	NM_172725	142940048	142953440	17
chr5	142960792	143027052	Radil	66260	-	NM_001289588	142961096	143019893	15
chr5	143003693	143006030	Papolb	2337	-	NM_019943	143003911	143005840	1
chr5	143039434	143084706	Mmd2	45272	-	NM_175217	143040691	143084561	7
chr5	143105537	143145324	Wipi2	39787	+	NM_178398	143105712	143142926	12
chr5	143178054	143198443	Slc29a4	20389	+	NM_146257	143181320	143197443	11
chr5	143200557	143579066	Tnrc18	378509	-	NM_001122730	143201933	143576880	19
chr5	143276932	143287233	LOC102631757	10301	+	NR_110502	143287233	143287233	6
chr5	143285576	143289234	Tff1	3658	-	NM_009362	143285757	143289201	3
chr5	143633467	143656917	Fbxl18	23450	-	NM_001033312	143634042	143650551	5
chr5	143664793	143668433	Actb	3640	-	NM_007393	143665476	143667365	6
chr5	143722033	143734868	Fscn1	12835	+	NM_007984	143722127	143733777	5
chr5	143752571	143874699	Rnf216	122128	-	NM_207110	143754327	143860124	17
chr5	143926457	143927430	Rbakdn	973	-	NR_040426	143927430	143927430	3
chr5	143933864	143942454	Rbak	8590	-	NM_001045482	143934839	143941179	5
chr5	143942695	143966747	Spdye4b	24052	+	NM_177880	143953976	143965845	8
chr5	143977994	143988569	Spdye4a	10575	-	NM_001310757	143980397	143988406	6
chr5	143988670	143996427	4930448H16Rik	7757	+	NR_040700	143996427	143996427	5
chr5	143996841	144010513	Zfp12	13672	+	NM_001289589	143997980	144007563	5
chr5	144011373	144031701	Zfp316	20328	-	NM_017467	144014887	144026335	7
chr5	144062750	144077039	E130309D02Rik	14289	-	NM_172726	144063480	144076773	6
chr5	144078167	144090917	Zdhhc4	12750	-	NM_028379	144078220	144087894	8
chr5	144090986	144094383	0610040B10Rik	3397	+	NR_027874	144094383	144094383	2
chr5	144119016	144153147	Grid2ip	34131	+	NM_001159321	144119229	144153147	22
chr5	144165498	144182955	Kdelr2	17457	+	NM_025841	144165640	144181886	5
chr5	144225360	144265310	Daglb	39950	+	NM_144915	144225549	144264267	15
chr5	144266348	144288861	Rac1	22513	-	NM_009007	144267842	144288665	6
chr5	144309573	144325393	Fam220a	15820	+	NM_026050	144323702	144324485	3
chr5	144383315	144471117	Cyth3	87802	+	NM_011182	144383508	144468774	13
chr5	144471194	144493149	Usp42	21955	-	NM_029749	144472849	144488886	18
chr5	144519222	144525811	D130017N08Rik	6589	+	NR_015486	144525811	144525811	2
chr5	144578660	144663586	Eif2ak1	84926	+	NM_013557	144578759	144662758	15
chr5	144651609	144655936	Ankrd61	4327	-	NM_025732	144651758	144655853	3
chr5	144663572	144670708	Aimp2	7136	-	NM_146165	144663670	144670584	4
chr5	144670869	144692625	Pms2	21756	+	NM_008886	144670925	144692028	15
chr5	144748777	144775722	Ccz1	26945	-	NM_177682	144749062	144775681	15
chr5	144780675	144811478	Ocm	30803	-	NM_033039	144780944	144786575	5
chr5	144861304	144949073	Lmtk2	87769	+	NM_001081109	144861542	144945613	14
chr5	144951154	144955310	Bhlha15	4156	+	NM_010800	144951940	144952534	2
chr5	144956217	144984447	Tecpr1	28230	-	NM_027410	144956784	144979607	25
chr5	145005305	145025442	Bri3	20137	+	NM_001163709	145005354	145025010	3
chr5	145025393	145118981	Baiap2l1	93588	-	NM_025833	145026825	145118710	14
chr5	145037929	145041383	Gm15708	3454	+	NR_040432	145041383	145041383	3
chr5	145118791	145121874	Dmr	3083	+	NR_102374	145121874	145121874	2
chr5	145306755	145318347	Nptx2	11592	+	NM_016789	145306932	145317263	5
chr5	145496783	145522447	Tmem130	25664	-	NM_177735	145498211	145522401	8
chr5	145529660	145620642	Trrap	90982	+	NM_001081362	145532018	145619827	71
chr5	145637363	145726699	Smurf1	89336	-	NM_029438	145640225	145726424	18
chr5	145657600	145657685	Mir7039	85	-	NR_106006	145657685	145657685	1
chr5	145744612	145770505	Kpna7	25893	-	NM_001013774	145746558	145768897	13
chr5	145790468	145793633	Gm4871	3165	-	NM_001101463	145790595	145793576	5
chr5	145803858	145806547	1700018F24Rik	2689	+	NM_027069	145803905	145806420	5
chr5	145844737	145869625	Arpc1a	24888	+	NM_019767	145852051	145869284	10
chr5	145875124	145889055	Arpc1b	13931	+	NM_023142	145882544	145888728	10
chr5	145889638	145900958	Pdap1	11320	-	NM_001033313	145891185	145900848	6
chr5	145901244	145908947	Bud31	7703	+	NM_001310771	145903342	145908754	6
chr5	145908246	145927973	Ptcd1	19727	-	NM_133735	145909200	145926376	9
chr5	145928081	145942910	Cpsf4	14829	+	NM_001291249	145928225	145942073	8
chr5	145944574	145952461	Atp5j2	7887	-	NM_020582	145944707	145952384	4
chr5	145955814	145962751	Zkscan14	6937	-	NM_023322	145956022	145962544	3
chr5	145965427	145982619	Zkscan5	17192	+	NM_016683	145966163	145982018	6
chr5	145992627	146008175	Zfp655	15548	+	NM_028298	145994335	146005828	4
chr5	146044211	146052338	Zscan25	8127	+	NM_001081431	146044265	146052028	5
chr5	146106138	146151381	Cyp3a57	45243	+	NM_001100180	146106215	146151381	13
chr5	146197177	146230592	Cyp3a16	33415	-	NM_007820	146197309	146230509	13
chr5	146319532	146345599	Cyp3a41b	26067	-	NM_001105159	146319990	146345508	13
chr5	146505623	146531712	Cyp3a41a	26089	-	NM_017396	146506081	146531625	13
chr5	146585558	146617450	Cyp3a44	31892	-	NM_177380	146585920	146617365	13
chr5	146666182	146691430	Cyp3a11	25248	-	NM_007818	146666642	146691352	13
chr5	146788769	146821194	Cyp3a25	32425	-	NR_030782	146821194	146821194	12
chr5	146890833	146924859	Cyp3a59	34026	+	NM_001105160	146890910	146924451	13
chr5	146994025	146996880	1700001J03Rik	2855	-	NM_001008547	146994109	146996846	5
chr5	147020769	147033033	Rnf6	12264	-	NM_028774	147021778	147029654	5
chr5	147043250	147114450	Cdk8	71200	+	NM_153599	147043268	147113277	13
chr5	147196581	147282701	Wasf3	86120	+	NM_145155	147246910	147281953	10
chr5	147293518	147296278	Gm6408	2760	+	NM_001243104	147293569	147296101	5
chr5	147302938	147305708	Gm6370	2770	+	NM_001243110	147302966	147305530	5
chr5	147313952	147328478	Gm3415	14526	+	NM_001243114	147314003	147328300	5
chr5	147313974	147316759	4930449I24Rik	2785	+	NM_026136	147314003	147316580	5
chr5	147325698	147328478	Gm3402	2780	+	NM_001243111	147325726	147328300	5
chr5	147337376	147340129	Gm3404	2753	+	NM_001243109	147337404	147339951	5
chr5	147349223	147352003	Gm3409	2780	+	NM_001243113	147349251	147351825	5
chr5	147393725	147396815	Gpr12	3090	-	NM_001010941	147394681	147395686	2
chr5	147546387	147606532	Usp12	60145	-	NM_011669	147549254	147606238	9
chr5	147644465	147648608	Rpl21	4143	+	NM_019647	147645771	147647529	6
chr5	147656646	147659302	Rasl11a	2656	+	NM_026864	147656792	147659051	4
chr5	147760232	147767190	Gtf3a	6958	+	NM_025652	147760356	147767111	9
chr5	147763148	147775373	Mtif3	12225	-	NM_001256100	147767169	147770851	5
chr5	147828230	147888148	Lnx2	59918	-	NM_080795	147830496	147854016	10
chr5	147888921	147922937	Polr1d	34016	+	NM_181730	147889243	147922503	3
chr5	148000271	148002522	Gsx1	2251	+	NM_008178	148000465	148001730	2
chr5	148040173	148083097	2210019I11Rik	42924	-	NR_038157	148083097	148083097	6
chr5	148081706	148086725	Pdx1	5019	+	NM_008814	148081814	148086401	2
chr5	148094764	148094874	Mir7k	110	-	NR_105854	148094874	148094874	1
chr5	148112475	148118825	Cdx2	6350	-	NM_007673	148113417	148118558	3
chr5	148126559	148134016	Urad	7457	-	NM_001039678	148126679	148133907	2
chr5	148142316	148212065	Flt3	69749	-	NM_010229	148142746	148211841	24
chr5	148230195	148234620	D5Ertd605e	4425	+	NR_033625	148234620	148234620	3
chr5	148242155	148360077	Pan3	117922	+	NM_028291	148242155	148357963	19
chr5	148373771	148537564	Flt1	163793	-	NM_010228	148375795	148537310	30
chr5	148672203	148687354	Pomp	15151	+	NM_025624	148672264	148687107	6
chr5	148690016	148706378	Slc46a3	16362	-	NM_027872	148690708	148705597	6
chr5	148768895	149127641	Mtus2	358746	+	NM_029920	148887974	149125095	15
chr5	149138985	149211480	Slc7a1	72495	-	NM_007513	149144015	149164011	13
chr5	149316206	149364364	Ubl3	48158	-	NM_011908	149317710	149363555	5
chr5	149553415	149554715	2210417A02Rik	1300	+	NR_028285	149554715	149554715	2
chr5	149589538	149594656	4930505K14Rik	5118	+	NR_131106	149594656	149594656	3
chr5	149683159	149740223	Katnal1	57064	-	NM_153572	149687713	149732974	11
chr5	149761825	149763234	8430423G03Rik	1409	+	NR_040686	149763234	149763234	3
chr5	149801631	149806791	5930430L01Rik	5160	-	NR_102384	149806791	149806791	2
chr5	149818537	149824352	Gm15408	5815	+	NR_040429	149824352	149824352	4
chr5	149858277	149864633	Hmgb1	6356	-	NM_010439	149860312	149862313	5
chr5	149931140	149993612	5730422E09Rik	62472	-	NR_015478	149993612	149993612	3
chr5	149965703	149967768	Gm8615	2065	-	NR_028061	149967768	149967768	1
chr5	149996135	150027010	Uspl1	30875	+	NM_001013378	149999350	150025621	10
chr5	150076579	150099729	Alox5ap	23150	+	NM_009663	150076688	150099310	5
chr5	150214380	150234278	Medag	19898	+	NM_027519	150214552	150232486	5
chr5	150242234	150273554	Tex26	31320	+	NM_029464	150242301	150273013	7
chr5	150291630	150340605	Gm15997	48975	-	NR_045423	150340605	150340605	5
chr5	150331253	150414469	Wdr95	83216	+	NM_029440	150365854	150414308	23
chr5	150419419	150438890	Hsph1	19471	-	NM_013559	150420081	150438651	18
chr5	150480831	150565174	B3glct	84343	+	NM_001081204	150480911	150562181	15
chr5	150604564	150614326	Gm21221	9762	-	NR_077242	150614326	150614326	5
chr5	150650321	150666855	4930500F04Rik	16534	+	NR_045758	150666855	150666855	4
chr5	150821249	150884761	Rxfp2	63512	+	NM_080468	150821442	150883779	18
chr5	151062504	151300328	Fry	237824	+	NM_172887	151062843	151299000	61
chr5	151302321	151304794	Gm5	2473	-	NR_024513	151304794	151304794	2
chr5	151309643	151320734	Zar1l	11091	-	NM_001159693	151309643	151320734	4
chr5	151325195	151372721	Brca2	47526	+	NM_001081001	151325787	151372086	27
chr5	151374217	151397100	N4bp2l1	22883	-	NM_133898	151375317	151397011	5
chr5	151438547	151468187	N4bp2l2	29640	-	NM_201369	151445688	151465088	6
chr5	151476401	151613245	Pds5b	136844	+	NM_175310	151518996	151610423	35
chr5	151755181	151796392	Kl	41211	+	NM_013823	151755291	151794429	5
chr5	151840089	151992768	Stard13	152679	-	NM_001163493	151842229	151992669	14
chr5	152171249	152216658	1700028E10Rik	45409	+	NR_045700	152216658	152216658	4
chr5	152209078	152234693	Gm3704	25615	+	NR_131166	152234693	152234693	4
chr5	152364235	152389499	Vmn2r18	25264	-	NM_001102582	152364235	152389481	5
chr5	152445398	152453783	Rfc3	8385	-	NM_027009	152445486	152453727	9
chr6	3238518	3267019	Gm8579	28501	+	NR_036696	3267019	3267019	3
chr6	3322256	3349571	Samd9l	27315	-	NM_010156	3322519	3327259	2
chr6	3407088	3444498	Hepacam2	37410	-	NM_178899	3407912	3444478	10
chr6	3448392	3553531	Vps50	105139	+	NM_024260	3448522	3552779	28
chr6	3635719	3714713	Calcr	78994	-	NM_007588	3637394	3702974	16
chr6	3671300	3671385	Mir653	85	-	NR_030612	3671385	3671385	1
chr6	3671896	3672003	Mir489	107	-	NR_030250	3672003	3672003	1
chr6	3912594	3918354	Tfpi2	5760	-	NM_009364	3913379	3918324	5
chr6	3944011	3947436	Gngt1	3425	+	NM_010314	3944223	3946780	3
chr6	3953986	3958445	Gng11	4459	+	NM_025331	3954315	3958160	2
chr6	3981840	3997584	4930528H21Rik	15744	-	NR_131108	3997584	3997584	3
chr6	4026903	4036927	Bet1	10024	-	NM_009748	4027880	4036795	4
chr6	4455617	4491543	Col1a2	35926	+	NM_007743	4455839	4490662	52
chr6	4551065	4593381	Casd1	42316	+	NM_145398	4551168	4592118	18
chr6	4624349	4697204	Sgce	72855	-	NM_001130190	4627198	4697088	12
chr6	4697305	4710516	Peg10	13211	+	NM_130877	4704220	4707240	2
chr6	4853319	5115661	Ppp1r9a	262342	+	NM_181595	4855446	5109752	16
chr6	5118089	5143946	Pon1	25857	-	NM_011134	5118337	5143749	9
chr6	5170851	5206233	Pon3	35382	-	NM_173006	5171563	5206226	9
chr6	5214623	5248373	Pon2	33750	-	NM_183308	5215320	5248285	9
chr6	5333385	5383021	Asb4	49636	+	NM_023048	5340608	5381047	6
chr6	5433350	5446278	Pdk4	12928	-	NM_013743	5435448	5446162	11
chr6	5675638	5978039	Dync1i1	302401	+	NM_010063	5707386	5977482	17
chr6	5913896	5927393	1700019G24Rik	13497	-	NR_040255	5927393	5927393	3
chr6	5991217	6167173	Slc25a13	175956	-	NM_001177572	5992145	6167010	18
chr6	6508274	6528658	Shfm1	20384	-	NM_009169	6508448	6528554	3
chr6	6770545	6819533	Dlx6os1	48988	-	NR_015388	6819533	6819533	2
chr6	6813333	6817970	Dlx6	4637	+	NM_010057	6813379	6817292	4
chr6	6813796	6815150	Dlx6os2	1354	-	NR_002839	6815150	6815150	1
chr6	6827800	6832068	Dlx5	4268	-	NM_010056	6828158	6831886	3
chr6	6906017	6989220	Sdhaf3	83203	+	NM_001077713	6906026	6989057	2
chr6	7504884	7512978	Tac1	8094	+	NM_001311060	7505613	7512432	6
chr6	7625170	7643182	Asns	18012	-	NM_012055	7625314	7639500	12
chr6	7795223	7822042	C1galt1	26819	+	NM_052993	7813921	7821257	4
chr6	7947807	8142617	Col28a1	194810	-	NM_001037865	7948481	8126355	35
chr6	8159226	8186273	Mios	27047	+	NM_145374	8164805	8185481	12
chr6	8205935	8209141	Rpa3	3206	-	NM_026632	8206164	8209098	4
chr6	8209287	8378765	Umad1	169478	+	NM_001302353	8220499	8377228	5
chr6	8457058	8459161	A430035B10Rik	2103	-	NR_040452	8459161	8459161	2
chr6	8459599	8547549	Glcci1	87950	+	NM_133236	8459886	8543252	8
chr6	8580526	8728484	Ica1	147958	-	NM_010492	8580675	8708382	14
chr6	8900018	9198578	Nxph1	298560	+	NM_008751	8900253	9197846	2
chr6	10921467	10924378	AA545190	2911	-	NR_033776	10924378	10924378	3
chr6	11850372	11857446	Ndufa4	7074	-	NM_010886	11850534	11857365	4
chr6	11875880	12031198	Phf14	155318	+	NM_001168382	11876291	12031071	18
chr6	12049522	12059580	Gm6578	10058	-	NR_003631	12059580	12059580	4
chr6	12261607	12699253	Thsd7a	437646	-	NM_001164805	12267366	12698953	27
chr6	13019758	13039269	Tmem106b	19511	+	NM_027992	13021743	13034326	9
chr6	13135609	13174965	Vwde	39356	-	NM_001013757	13136705	13174863	12
chr6	13363336	13365996	1700016P04Rik	2660	+	NR_038149	13365996	13365996	2
chr6	13530688	13558063	Tmem168	27375	-	NM_028990	13532786	13553365	5
chr6	13575674	13627966	B630005N14Rik	52292	-	NM_175312	13578470	13627833	5
chr6	13785073	13789848	Gpr85	4775	-	NM_145066	13785790	13786903	4
chr6	13819073	13821483	2610001J05Rik	2410	-	NR_024619	13821483	13821483	3
chr6	13821568	13846421	1110019D14Rik	24853	+	NR_045995	13846421	13846421	3
chr6	14663821	14705274	Ppp1r3a	41453	-	NM_080464	14667643	14705246	4
chr6	14851348	15391977	Foxp2	540629	+	NM_053242	15146960	15388021	19
chr6	15670660	15752169	Mdfic	81509	+	NM_175088	15671270	15749865	5
chr6	16783380	16848441	Tfec	65061	-	NM_031198	16783952	16817639	7
chr6	17015148	17055825	Tes	40677	+	NM_207176	17015286	17054781	7
chr6	17147750	17155695	D830026I12Rik	7945	+	NR_102305	17155695	17155695	3
chr6	17231184	17239130	Cav2	7946	+	NM_016900	17231360	17237047	3
chr6	17256334	17291328	Cav1	34994	+	NM_007616	17256449	17289454	3
chr6	17413956	17523980	Met	110024	+	NM_008591	17441240	17521823	22
chr6	17587097	17616536	Capza2	29439	+	NM_007604	17587121	17615435	10
chr6	17643993	17893023	St7	249030	+	NM_001289625	17644211	17892765	16
chr6	17938939	17980445	Wnt2	41506	-	NM_023653	17939813	17980287	5
chr6	18000963	18059061	Asz1	58098	-	NM_023729	18001250	18059036	13
chr6	18120686	18272769	Cftr	152083	+	NM_021050	18120823	18271033	27
chr6	18316476	18464825	Cttnbp2	148349	-	NM_080285	18317370	18464735	23
chr6	18798634	18804052	Lsm8	5418	+	NM_133939	18798732	18803691	4
chr6	18816317	18829584	Ankrd7	13267	+	NM_001167757	18816482	18829401	6
chr6	19197898	19228843	4930524B17Rik	30945	-	NR_126084	19228843	19228843	5
chr6	19505341	19505461	Mir6370	120	+	NR_105789	19505461	19505461	1
chr6	21166108	21679805	Kcnd2	513697	+	NM_019697	21166298	21677342	6
chr6	21721394	21802515	Tspan12	81121	-	NM_173007	21722630	21801075	9
chr6	21899570	21926038	Ing3	26468	+	NM_001311061	21899765	21923699	12
chr6	21935909	22205606	Cped1	269697	+	NM_001081351	21936810	22204690	22
chr6	22238226	22248522	Wnt16	10296	+	NM_053116	22238506	22248231	4
chr6	22256521	22306081	Fam3c	49560	-	NM_138587	22258448	22293278	10
chr6	22825501	23002916	Ptprz1	177415	+	NM_001081306	22825826	23002112	30
chr6	23022172	23082986	Aass	60814	-	NM_013930	23022971	23072722	24
chr6	23195046	23198264	Fezf1	3218	-	NM_028462	23195736	23198074	4
chr6	23212773	23789421	Cadps2	576648	-	NM_153163	23213542	23789137	30
chr6	23598868	23600305	Rnf133	1437	-	NM_198251	23598908	23600057	2
chr6	23603894	23605136	Rnf148	1242	-	NM_027754	23604044	23604995	1
chr6	23919160	23920060	Tas2r118	900	-	NM_207022	23919160	23920060	1
chr6	24038282	24118092	Slc13a1	79810	-	NM_019481	24038964	24118064	15
chr6	24394864	24465067	Iqub	70203	-	NM_172535	24396056	24455907	13
chr6	24468665	24477687	Ndufa5	9022	-	NM_026614	24468722	24477546	5
chr6	24478143	24523164	Asb15	45021	+	NM_080847	24506507	24520776	10
chr6	24547770	24555414	Lmod2	7644	+	NM_053098	24547882	24555212	3
chr6	24563809	24614995	Wasl	51186	-	NM_028459	24566284	24614643	11
chr6	24683244	24695452	Hyal6	12208	+	NM_028920	24684069	24693791	4
chr6	24698366	24716519	Hyal4	18153	+	NM_029848	24705784	24716094	5
chr6	24741187	24751048	Spam1	9861	+	NM_001079875	24746051	24750802	5
chr6	24807996	24841958	Hyal5	33962	+	NM_028957	24826129	24841769	4
chr6	24901140	24906125	Tmem229a	4985	-	NM_177013	24904637	24905753	1
chr6	25618522	25639980	Gpr37	21458	-	NM_010338	25619040	25639096	2
chr6	25693734	25759226	Pot1a	65492	-	NM_133931	25694580	25748017	18
chr6	25881425	25927227	Gm20756	45802	+	NR_040771	25927227	25927227	9
chr6	27225120	28084369	Grm8	859249	-	NM_008174	27235684	28076125	11
chr6	27886654	27886750	Mir592	96	-	NR_030420	27886750	27886750	1
chr6	28189930	28211601	Zfp800	21671	-	NM_001081678	28191656	28210778	6
chr6	28366602	28371724	Gcc1	5122	-	NM_028900	28367995	28371316	2
chr6	28373639	28376499	Arf5	2860	+	NM_007480	28373688	28376158	6
chr6	28377900	28388622	Fscn3	10722	+	NM_019569	28378015	28386203	7
chr6	28392333	28399340	Pax4	7007	-	NM_001159926	28392377	28397133	11
chr6	28430347	28838832	Snd1	408485	+	NM_019776	28430564	28838300	24
chr6	28778125	28781747	Lrrc4	3622	-	NM_138682	28779655	28781614	1
chr6	28972618	28972691	Mir129-1	73	+	NR_029567	28972691	28972691	1
chr6	29010220	29023876	Lep	13656	+	NM_008493	29018951	29021182	3
chr6	29073572	29114724	Rbm28	41152	-	NM_133925	29075389	29114608	19
chr6	29119229	29129584	Prrt4	10355	-	NM_001101443	29119742	29127768	5
chr6	29150436	29166364	Impdh1	15928	-	NM_001302934	29151197	29166241	15
chr6	29222487	29225449	Hilpda	2962	+	NM_001190461	29222571	29224900	2
chr6	29231140	29240676	Fam71f2	9536	+	NM_001101486	29231264	29240518	5
chr6	29269139	29286022	Fam71f1	16883	+	NM_001289663	29269198	29285520	7
chr6	29298105	29326675	Calu	28570	+	NM_001285412	29316077	29324503	7
chr6	29326670	29330513	Opn1sw	3843	-	NM_007538	29327941	29330415	5
chr6	29348925	29376995	Ccdc136	28070	+	NM_145574	29349310	29376732	16
chr6	29383152	29411888	Flnc	28736	+	NM_001081185	29383458	29411209	48
chr6	29417782	29420509	Atp6v1f	2727	+	NM_025381	29417816	29420268	2
chr6	29421436	29423429	Gm9047	1993	+	NM_001145360	29421526	29423407	2
chr6	29432035	29457952	Kcp	25917	-	NM_001029985	29432244	29457926	38
chr6	29476624	29491869	Irf5	15245	+	NM_001311083	29481136	29491741	10
chr6	29490826	29559607	Tnpo3	68781	-	NM_177296	29493299	29559485	23
chr6	29644213	29668558	Tspan33	24345	+	NM_001301407	29644442	29667638	8
chr6	29685496	29711366	Smo	25870	+	NM_176996	29686010	29710285	12
chr6	29718442	29862310	Ahcyl2	143868	+	NM_001171000	29718537	29859046	17
chr6	29867012	29909680	Strip2	42668	+	NM_001037740	29867074	29906908	21
chr6	29935328	29943531	Smkr-ps	8203	+	NR_040264	29943531	29943531	2
chr6	29997987	30103458	Nrf1	105471	+	NM_010938	30039923	30101677	12
chr6	30108640	30124125	Mirc35hg	15485	-	NR_126540	30124125	30124125	2
chr6	30115917	30115992	Mir182	75	-	NR_029569	30115992	30115992	1
chr6	30119445	30119551	Mir96	106	-	NR_029750	30119551	30119551	1
chr6	30119667	30119737	Mir183	70	-	NR_030713	30119737	30119737	1
chr6	30126622	30128040	BB283400	1418	+	NR_038124	30128040	30128040	1
chr6	30161288	30254539	Ube2h	93251	-	NM_009459	30164958	30254104	7
chr6	30316383	30341020	Zc3hc1	24637	-	NM_001311086	30316676	30341002	10
chr6	30351854	30405174	Klhdc10	53320	+	NM_029742	30351993	30400696	10
chr6	30410984	30413313	1700012C14Rik	2329	+	NR_131049	30413313	30413313	2
chr6	30431232	30459783	Tmem209	28551	-	NM_001311093	30432930	30458802	15
chr6	30459848	30470253	Ssmem1	10405	+	NM_027073	30460252	30469908	3
chr6	30491641	30514473	Cpa2	22832	+	NM_001024698	30491664	30514425	11
chr6	30518375	30541747	Cpa4	23372	+	NM_027926	30518393	30540967	11
chr6	30561009	30581521	Cpa5	20512	+	NM_144537	30562602	30581399	12
chr6	30589220	30595361	Cpa1	6141	+	NM_025350	30589463	30595286	10
chr6	30603456	30643749	Cep41	40293	-	NR_130781	30643749	30643749	12
chr6	30683505	30698466	Mest	14961	+	NM_001252293	30690670	30697169	12
chr6	30691298	30691396	Mir335	98	+	NR_029900	30691396	30691396	1
chr6	30697553	30846794	Copg2	149241	-	NM_017478	30698856	30846697	24
chr6	30846980	30865573	Tsga13	18593	-	NM_054073	30847073	30863587	8
chr6	30906020	30908990	Klf14	2970	-	NM_001135093	30907719	30908697	1
chr6	31012659	31012747	Mir29a	88	-	NR_029744	31012747	31012747	1
chr6	31013022	31013093	Mir29b-1	71	-	NR_029532	31013093	31013093	1
chr6	31043562	31168474	Lncpint	124912	-	NR_110471	31168474	31168474	4
chr6	31170350	31287394	2210408F21Rik	117044	+	NR_040257	31287394	31287394	8
chr6	31316884	31348773	Mkln1os	31889	-	NR_040300	31348773	31348773	3
chr6	31348827	31459477	Mkln1	110650	+	NM_013791	31348856	31457746	18
chr6	31469492	31513937	Podxl	44445	-	NM_013723	31473021	31513648	8
chr6	32000287	32008915	1700012A03Rik	8628	+	NM_029587	32001634	32008779	3
chr6	32094558	32538192	Plxna4	443634	-	NM_175750	32100488	32467679	32
chr6	32461140	32465576	Plxna4os1	4436	+	NR_040277	32465576	32465576	2
chr6	32742226	33010152	Chchd3	267926	-	NM_025336	32742902	33010080	8
chr6	33199149	33922930	Exoc4	723781	+	NM_009148	33199152	33922151	18
chr6	33979447	34084034	Lrguk	104587	+	NM_028886	33979456	34083448	20
chr6	34105878	34127054	Slc35b4	21176	-	NM_021435	34108379	34126854	10
chr6	34253929	34267489	Akr1b3	13560	-	NM_009658	34254296	34267405	10
chr6	34253933	34267443	Gm6644	13510	-	NR_037965	34267443	34267443	10
chr6	34304163	34318454	Akr1b8	14291	+	NM_008012	34304230	34318168	10
chr6	34334246	34346949	Akr1b10	12703	+	NM_172398	34334341	34346654	10
chr6	34362361	34373137	Akr1b7	10776	+	NM_009731	34362409	34372888	10
chr6	34426355	34455610	Bpgm	29255	+	NM_007563	34437349	34454449	3
chr6	34659443	34725469	Cald1	66026	+	NM_145575	34659644	34723228	12
chr6	34730431	34809459	Agbl3	79028	+	NM_001289656	34732155	34807903	20
chr6	34813145	34824946	Tmem140	11801	+	NM_197986	34822550	34823108	2
chr6	34821770	34828065	3110062M04Rik	6295	-	NM_001135611	34824443	34826684	4
chr6	34830425	34860831	Wdr91	30406	-	NM_001013366	34830803	34860819	15
chr6	34870959	34889342	Stra8	18383	+	NM_009292	34877724	34889170	9
chr6	34895294	34927999	2010107G12Rik	32705	-	NM_001025573	34896079	34909562	8
chr6	34972064	35083737	Cnot4	111673	-	NM_001164413	34973130	35030134	12
chr6	35127615	35197598	Nup205	69983	+	NM_027513	35127631	35197413	43
chr6	35202698	35212059	1810058I24Rik	9361	+	NR_015608	35212059	35212059	3
chr6	35217952	35258126	Slc13a4	40174	-	NM_172892	35218830	35257456	16
chr6	35262745	35276141	Fam180a	13396	-	NM_173375	35263524	35275914	3
chr6	35280845	35286829	1700065J11Rik	5984	+	NR_040526	35286829	35286829	3
chr6	35458823	35489888	Mtpn	31065	-	NM_008098	35462230	35489610	4
chr6	36283137	36338234	9330158H04Rik	55097	-	NR_015589	36338234	36338234	6
chr6	36338083	36474774	Chrm2	136691	+	NM_203491	36473209	36474610	3
chr6	36371741	36371825	Mir490	84	+	NR_030524	36371825	36371825	1
chr6	36665662	36761361	Ptn	95699	-	NM_008973	36665706	36694503	5
chr6	36796021	37249976	Dgki	453955	-	NM_001081206	36797375	37249948	34
chr6	37281020	37392148	Creb3l2	111128	-	NM_178661	37282424	37391800	12
chr6	37480172	37518815	Akr1d1	38643	+	NM_145364	37480244	37517166	9
chr6	37820810	37918445	Trim24	97635	+	NM_001272064	37821110	37915710	19
chr6	37933738	37996996	Svopl	63258	-	NM_177200	37934511	37991615	16
chr6	37998482	38074586	Atp6v0a4	76104	-	NM_080467	37998989	38044054	21
chr6	38059352	38065806	Tmem213	6454	+	NM_029921	38059410	38065718	3
chr6	38073173	38204009	D630045J12Rik	130836	-	NM_194061	38078320	38204009	20
chr6	38237393	38249259	Zc3hav1l	11866	-	NM_172467	38243021	38249240	4
chr6	38260496	38304603	Zc3hav1	44107	-	NM_028421	38261058	38304222	12
chr6	38331523	38377647	Ttc26	46124	+	NM_153600	38331590	38375239	18
chr6	38383924	38462763	Ubn2	78839	+	NM_177185	38384172	38452287	17
chr6	38457324	38457393	Mir7670	69	+	NR_106130	38457393	38457393	1
chr6	38484860	38489449	1110001J03Rik	4589	+	NM_025363	38484872	38489362	2
chr6	38501333	38559470	Luc7l2	58137	+	NM_001311099	38535043	38558330	11
chr6	38576659	38587239	Klrg2	10580	-	NM_001033171	38577604	38587066	5
chr6	38613068	38630864	Clec2l	17796	+	NM_001101507	38613235	38630238	5
chr6	38647838	38826189	Hipk2	178351	-	NM_010433	38648133	38825816	15
chr6	38868984	39034578	Tbxas1	165594	+	NM_011539	38869151	39034369	13
chr6	39013877	39017585	1700025N23Rik	3708	-	NR_040523	39017585	39017585	4
chr6	39036410	39068348	Parp12	31938	-	NM_172893	39037313	39068158	12
chr6	39068471	39098311	4930599N23Rik	29840	+	NR_045813	39098311	39098311	4
chr6	39086618	39156772	Kdm7a	70154	-	NM_001033430	39093209	39156633	20
chr6	39284769	39327706	Slc37a3	42937	-	NM_028123	39287190	39316976	15
chr6	39331426	39340378	Rab19	8952	+	NM_011226	39333918	39339805	4
chr6	39347819	39370368	Mkrn1	22549	-	NM_018810	39349223	39370282	8
chr6	39412376	39507833	Dennd2a	95457	-	NM_172477	39413418	39473628	19
chr6	39523874	39538768	Adck2	14894	+	NM_178873	39524299	39537508	8
chr6	39542581	39549470	Ndufb2	6889	+	NM_026612	39542613	39548339	4
chr6	39553236	39675462	Braf	122226	-	NM_139294	39560380	39675294	22
chr6	39751806	39760935	Mrps33	9129	-	NM_010270	39752437	39755584	3
chr6	40060251	40198352	Tmem178b	138101	+	NM_001004182	40060342	40195771	3
chr6	40275476	40346761	Agk	71285	+	NM_023538	40279497	40345861	16
chr6	40357496	40386132	E330009J07Rik	28636	-	NM_175528	40358263	40386124	8
chr6	40392861	40416814	Wee2	23953	+	NM_201370	40393976	40415962	12
chr6	40421413	40431822	Ssbp1	10409	+	NM_212468	40422108	40430895	7
chr6	40441236	40442238	Tas2r137	1002	+	NM_001025385	40441236	40442238	1
chr6	40443590	40444484	Tas2r108	894	+	NM_020502	40443590	40444484	1
chr6	40464822	40469507	Prss37	4685	-	NM_026317	40464929	40469065	6
chr6	40494034	40494976	Olfr461	942	-	NM_146382	40494034	40494976	1
chr6	40521386	40522331	Olfr460	945	+	NM_146383	40521386	40522331	1
chr6	40524896	40535804	Clec5a	10908	-	NM_001038604	40527964	40535227	7
chr6	40562313	40563309	Tas2r138	996	-	NM_001001451	40562313	40563309	1
chr6	40578829	40719122	Mgam	140293	+	NM_001171003	40592977	40718283	48
chr6	40828792	40837493	Moxd2	8701	-	NM_139296	40828792	40837493	13
chr6	40845260	40850386	Prss58	5126	-	NM_175020	40845360	40850092	6
chr6	40870458	40890556	1700074P13Rik	20098	-	NM_028550	40870990	40879479	7
chr6	40914770	40918426	1810009J06Rik	3656	+	NM_023707	40914787	40918331	5
chr6	40945820	40949478	Gm2663	3658	-	NM_001102660	40945926	40949458	5
chr6	40980266	40985508	2210010C04Rik	5242	-	NM_023333	40981633	40985477	5
chr6	41252270	41255532	Try4	3262	+	NM_011646	41252283	41255487	5
chr6	41261230	41264709	Try5	3479	-	NM_001003405	41261275	41264694	5
chr6	41304103	41307943	Try10	3840	+	NM_001038996	41304190	41307881	5
chr6	41323757	41327612	Prss3	3855	-	NM_011645	41323812	41327596	5
chr6	41342354	41347255	Gm5771	4901	+	NM_001038997	41342387	41347202	5
chr6	41365305	41369592	Gm5409	4287	+	NM_001003664	41365308	41369591	5
chr6	41392212	41396096	Gm10334	3884	-	NM_001103153	41392269	41396064	5
chr6	41408928	41413785	Prss1	4857	+	NM_053243	41408941	41413732	5
chr6	41471774	41475078	Prss2	3304	+	NM_009430	41471802	41475021	5
chr6	41555480	41570506	Ephb6	15026	+	NM_001146351	41563314	41570303	18
chr6	41570617	41586404	Trpv6	15787	-	NM_022413	41571066	41586229	15
chr6	41602768	41630722	Trpv5	27954	-	NM_001007572	41603128	41630654	15
chr6	41634429	41635716	1700034O15Rik	1287	+	NM_029671	41634516	41635389	2
chr6	41636328	41654324	Kel	17996	-	NM_032540	41636445	41653784	19
chr6	41680061	41735061	Mir5124b	55000	+	NR_105811	41735061	41735061	3
chr6	41721351	41722296	Olfr459	945	-	NM_146576	41721351	41722296	1
chr6	41797547	41802061	Pip	4514	+	NM_008843	41797578	41801962	4
chr6	41810337	41814321	Sval2	3984	+	NM_032542	41810337	41814321	4
chr6	41901626	41906097	Sval1	4471	+	NM_027832	41901654	41905964	4
chr6	41918138	41923089	Sval3	4951	+	NM_001003952	41918138	41922974	4
chr6	41988392	41992850	Sva	4458	+	NM_009299	41988420	41992704	4
chr6	42090934	42091894	Tas2r139	960	+	NM_181275	42090934	42091894	1
chr6	42165326	42166286	Tas2r144	960	+	NM_001001453	42165326	42166286	1
chr6	42195933	42200440	Gstk1	4507	+	NM_029555	42196020	42200278	8
chr6	42211968	42214554	Tmem139	2586	+	NM_175408	42213259	42214126	3
chr6	42214983	42232507	Casp2	17524	+	NM_007610	42215122	42230476	11
chr6	42236683	42264655	Clcn1	27972	+	NM_013491	42236765	42264177	23
chr6	42265303	42274639	Fam131b	9336	-	NM_029528	42268157	42274468	7
chr6	42299826	42310212	Zyx	10386	+	NM_001289617	42300267	42307955	11
chr6	42308485	42323267	Epha1	14782	-	NM_023580	42308766	42323209	18
chr6	42320669	42330557	2010310C07Rik	9888	+	NR_045169	42330557	42330557	4
chr6	42350236	42351118	Tas2r143	882	+	NM_001001452	42350236	42351118	1
chr6	42355527	42356493	Tas2r135	966	+	NM_199159	42355527	42356493	1
chr6	42384533	42385460	Tas2r126	927	+	NM_207028	42384533	42385460	1
chr6	42410074	42411016	Olfr458	942	-	NM_146444	42410074	42411016	1
chr6	42421233	42422175	Olfr457	942	-	NM_146987	42421233	42422175	1
chr6	42436161	42437213	Olfr456	1052	-	NM_001011528	42436251	42437190	1
chr6	42488065	42489019	Olfr455	954	-	NM_001081301	42488065	42489019	1
chr6	42537211	42547371	Tcaf3	10160	-	NM_203396	42537480	42547275	7
chr6	42573041	42595040	Tcaf2	21999	-	NM_146174	42574362	42593090	8
chr6	42622545	42643058	Tcaf1	20513	-	NM_029930	42623373	42636943	8
chr6	42694037	42694991	Olfr453	954	+	NM_001011799	42694037	42694991	1
chr6	42712052	42713006	Olfr38	954	+	NM_146986	42712052	42713006	1
chr6	42740039	42740993	Olfr452	954	+	NM_001011869	42740039	42740993	1
chr6	42767471	42768404	Olfr450	933	+	NM_146445	42767471	42768404	1
chr6	42787881	42788817	Olfr449	936	+	NM_147064	42787881	42788817	1
chr6	42846451	42847384	Olfr448	933	+	NM_146273	42846451	42847384	1
chr6	42861523	42862456	Olfr447	933	+	NM_146988	42861523	42862456	1
chr6	42877231	42878158	Olfr446	927	+	NM_146295	42877231	42878158	1
chr6	42905498	42906431	Olfr444	933	+	NM_146656	42905498	42906431	1
chr6	43065742	43066675	Olfr441	933	+	NM_146655	43065742	43066675	1
chr6	43103305	43104238	Olfr237-ps1	933	+	NM_146654	43103305	43104238	1
chr6	43112452	43124857	1700024N05Rik	12405	-	NR_126471	43124857	43124857	4
chr6	43117058	43117991	Olfr437	933	+	NM_146296	43117058	43117991	1
chr6	43123986	43124919	Olfr13	933	+	NM_146652	43123986	43124919	1
chr6	43151644	43152586	Olfr435	942	+	NM_146653	43151644	43152586	1
chr6	43166913	43167879	Olfr434	966	+	NM_146369	43166913	43167879	1
chr6	43185608	43186574	Olfr47	966	+	NM_146370	43185608	43186574	1
chr6	43215642	43239319	Arhgef5	23677	+	NM_133674	43222315	43238770	15
chr6	43253672	43259553	Nobox	5881	-	NM_130869	43253953	43259525	9
chr6	43294999	43616277	Tpk1	321278	-	NM_013861	43296780	43615801	9
chr6	43392427	43424317	9430018G01Rik	31890	+	NR_045988	43424317	43424317	3
chr6	45010059	47251370	Cntnap2	2241311	+	NM_001004357	45010288	47248613	24
chr6	47404322	47476138	Cul1	71816	+	NM_012042	47434903	47475633	22
chr6	47480272	47545029	Ezh2	64757	-	NM_007971	47480539	47527659	20
chr6	47702750	47702924	Rn4.5s	174	-	NR_002841	47702924	47702924	1
chr6	47746139	47763511	Pdia4	17372	-	NM_009787	47746486	47763303	10
chr6	47753574	47753651	Mir704	77	-	NR_030485	47753651	47753651	1
chr6	47769264	47780504	Zfp786	11240	-	NM_177882	47769667	47780412	4
chr6	47785659	47818256	Zfp398	32597	+	NM_027477	47785895	47816946	6
chr6	47827553	47858483	Zfp282	30930	+	NM_146175	47827670	47855380	8
chr6	47870566	47882636	Zfp212	12070	+	NM_001145881	47870724	47881566	5
chr6	47893173	47904548	Zfp783	11375	+	NR_027963	47904548	47904548	6
chr6	47903388	47915298	Zfp956	11910	+	NM_178898	47903557	47914426	5
chr6	47974186	47998113	Zfp777	23927	-	NM_001081382	47974627	47998101	6
chr6	48012393	48036592	Zfp746	24199	-	NM_001163475	48013830	48036337	7
chr6	48345584	48369854	Krba1	24270	+	NM_133922	48352975	48366389	18
chr6	48377690	48395824	Zfp467	18134	-	NM_001085417	48377798	48393444	5
chr6	48398227	48451249	Sspo	53022	+	NM_173428	48398227	48451098	103
chr6	48454337	48484831	Zfp862-ps	30494	+	NR_027808	48484831	48484831	7
chr6	48486580	48487473	1700026J14Rik	893	-	NR_130985	48487473	48487473	2
chr6	48487567	48491799	Atp6v0e2	4232	+	NM_133764	48487749	48490132	4
chr6	48504797	48520721	Lrrc61	15924	+	NM_177736	48518243	48519023	3
chr6	48519696	48522669	Rarres2	2973	-	NM_027852	48519950	48522266	6
chr6	48539443	48540583	Gm5111	1140	+	NM_183309	48539675	48540424	2
chr6	48543881	48549081	Repin1	5200	+	NM_001079901	48544830	48547943	3
chr6	48563178	48573226	Zfp775	10048	+	NM_173429	48563227	48570809	2
chr6	48578165	48583687	AI854703	5522	+	NR_027236	48583687	48583687	4
chr6	48597232	48610874	Gimap8	13642	+	NM_001077410	48597434	48609368	6
chr6	48626133	48628703	Gimap9	2570	+	NM_174960	48627479	48628355	2
chr6	48634576	48642061	Gimap4	7485	+	NM_175048	48636850	48641428	5
chr6	48651581	48658243	Gimap6	6662	-	NM_153175	48652181	48658149	3
chr6	48668619	48674635	Gimap7	6016	+	NM_146167	48673480	48674362	2
chr6	48689045	48693794	Gimap1	4749	+	NM_008376	48691373	48693357	3
chr6	48696195	48704199	Gimap5	8004	+	NM_175035	48700458	48703423	3
chr6	48714462	48720850	Gimap3	6388	-	NM_031247	48715087	48716518	5
chr6	48783810	48791373	Tmem176b	7563	-	NM_001164208	48784051	48788356	7
chr6	48791481	48795363	Tmem176a	3882	+	NM_025326	48792205	48795144	7
chr6	48845253	48859186	Aoc1	13933	+	NM_029638	48855190	48858832	5
chr6	48879894	48883686	1600015I10Rik	3792	+	NM_001081273	48880066	48883510	4
chr6	48925141	48928744	Doxl2	3603	+	NM_001029987	48925141	48928628	4
chr6	48936614	48949615	4930563H07Rik	13001	-	NR_126454	48949615	48949615	3
chr6	48936859	48941723	Svs1	4864	+	NM_172888	48937058	48941608	5
chr6	48986516	49008181	Gpnmb	21665	+	NM_053110	48986721	49006313	11
chr6	49023793	49034716	Malsu1	10923	+	NM_029353	49023864	49034689	4
chr6	49035216	49164953	Igf2bp3	129737	-	NM_023670	49037340	49164470	15
chr6	49193919	49214051	Tra2a	20132	-	NM_198102	49194719	49213872	8
chr6	49269272	49291584	Ccdc126	22312	+	NM_001311112	49284058	49289828	4
chr6	49317737	49339903	Fam221a	22166	+	NM_172727	49317907	49338884	7
chr6	49345602	49419501	Stk31	73899	+	NM_029916	49345633	49419351	24
chr6	49772708	49779504	Npy	6796	+	NM_023456	49773596	49779326	4
chr6	50060239	50148597	Mpp6	88358	+	NM_001164734	50095774	50148329	14
chr6	50157401	50211768	Dfna5	54367	-	NM_018769	50157932	50201485	10
chr6	50243325	50406169	Osbpl3	162844	-	NM_001163645	50247063	50320214	22
chr6	50512561	50516473	Cycs	3912	-	NM_007808	50515235	50515659	3
chr6	50516641	50544864	5430402O13Rik	28223	+	NR_015581	50544864	50544864	4
chr6	50522396	50522507	Mir6371	111	+	NR_105790	50522507	50522507	1
chr6	50523302	50546589	4921507P07Rik	23287	-	NM_027564	50523699	50545930	10
chr6	50600869	50604392	Npvf	3523	-	NM_021892	50600869	50604392	3
chr6	50726113	50764893	C530044C16Rik	38780	+	NR_045984	50764893	50764893	5
chr6	51219810	51219909	Mir148a	99	-	NR_029719	51219909	51219909	1
chr6	51329708	51342790	Gm6559	13082	+	NR_110455	51342790	51342790	3
chr6	51382668	51408767	Nfe2l3	26099	+	NM_010903	51382905	51408443	4
chr6	51410433	51419893	Hnrnpa2b1	9460	-	NM_016806	51413430	51419675	11
chr6	51420614	51433703	Cbx3	13089	+	NM_007624	51421843	51432605	6
chr6	51473901	51540669	Snx10	66768	+	NM_001127349	51512039	51538961	7
chr6	51809163	51962548	Skap2	153385	-	NM_018773	51810005	51962400	13
chr6	52052947	52063683	Halr1	10736	+	NR_110440	52063683	52063683	3
chr6	52105365	52108316	Hoxa1	2951	-	NM_001311118	52107600	52108220	3
chr6	52108522	52112019	Hotairm1	3497	+	NR_131181	52112019	52112019	2
chr6	52112415	52114830	Hoxa2	2415	-	NM_010451	52112884	52114643	2
chr6	52115672	52119450	Hoxaas2	3778	+	NR_131182	52119450	52119450	3
chr6	52119060	52163066	Hoxa3	44006	-	NM_010452	52119938	52122648	5
chr6	52139685	52141702	Hoxa4	2017	-	NM_008265	52140340	52141687	2
chr6	52151122	52163596	Hoxaas3	12474	+	NR_015611	52163596	52163596	3
chr6	52151752	52154586	Hoxa5	2834	-	NM_010453	52152579	52154349	2
chr6	52156363	52158623	Hoxa6	2260	-	NM_010454	52156363	52158623	2
chr6	52164489	52165287	Mira	798	-	NR_045199	52165287	52165287	1
chr6	52165622	52168572	Hoxa7	2950	-	NM_010455	52165715	52167404	2
chr6	52173095	52177369	Hoxa9	4274	-	NM_001277238	52174242	52176348	3
chr6	52180079	52180164	Mir196b	85	-	NR_029912	52180164	52180164	1
chr6	52181195	52190853	Hoxa10	9658	-	NM_001122950	52182504	52190286	2
chr6	52192103	52195809	Hoxa11	3706	-	NM_010450	52193358	52195718	2
chr6	52195241	52199768	Hoxa11os	4527	+	NR_015348	52199768	52199768	5
chr6	52208851	52210874	Hoxa13	2023	-	NM_008264	52208902	52210768	3
chr6	52212768	52217597	Hottip	4829	+	NR_110442	52217597	52217597	2
chr6	52258382	52264826	5730457N03Rik	6444	-	NR_038163	52264826	52264826	4
chr6	52263491	52268372	Evx1	4881	+	NM_007966	52263838	52267093	3
chr6	52442444	52450079	1700094M24Rik	7635	+	NR_046049	52450079	52450079	3
chr6	52496223	52590294	Hibadh	94071	-	NM_145567	52496897	52590242	8
chr6	52663722	52716773	Tax1bp1	53051	+	NM_025816	52671298	52716068	18
chr6	52718061	53018618	Jazf1	300557	-	NM_173406	52720197	53018561	5
chr6	53171795	53176593	Gm4872	4798	+	NR_073372	53176593	53176593	3
chr6	53237288	53347210	9430076C15Rik	109922	+	NR_015553	53347210	53347210	5
chr6	53523367	53645826	Creb5	122459	+	NM_172728	53523421	53644081	7
chr6	53765461	53770819	Tril	5358	-	NM_025817	53767799	53770229	1
chr6	53823272	53928667	Cpvl	105395	-	NM_027749	53823407	53924790	13
chr6	53928684	53967377	4921529L05Rik	38693	+	NR_110484	53967377	53967377	4
chr6	53989925	54251806	Chn2	261881	+	NM_001163640	53990100	54250238	13
chr6	54219674	54380215	9130019P16Rik	160541	-	NR_033635	54380215	54380215	14
chr6	54277005	54280194	Prr15	3189	+	NM_030024	54279252	54279621	2
chr6	54402876	54453762	Wipf3	50886	+	NM_001167860	54402876	54451010	8
chr6	54458809	54516376	Scrn1	57567	-	NM_027268	54459197	54498376	8
chr6	54527598	54543122	Fkbp14	15524	-	NM_153573	54529521	54543037	4
chr6	54545104	54595816	Plekha8	50712	+	NM_001164361	54545425	54590975	14
chr6	54631617	54653849	Mturn	22232	+	NM_001289741	54631763	54649542	5
chr6	54766909	54840218	Znrf2	73309	+	NM_199143	54767009	54834816	5
chr6	54873935	54922606	Nod1	48671	-	NM_172729	54874930	54899626	12
chr6	54935088	54942861	Ggct	7773	-	NM_026637	54935851	54942829	4
chr6	54987994	55029498	Gars	41504	+	NM_180678	54988035	55029339	17
chr6	55040042	55083010	Crhr2	42968	-	NM_001288618	55041271	55082835	13
chr6	55120620	55124984	Inmt	4364	-	NM_009349	55120841	55124977	3
chr6	55153376	55270216	Fam188b	116840	+	NM_001142781	55153500	55268305	18
chr6	55286292	55298549	Aqp1	12257	+	NM_007472	55286484	55296791	4
chr6	55326288	55338524	Ghrhr	12236	+	NM_001003685	55326378	55338288	13
chr6	55346880	55362279	6430584L05Rik	15399	+	NR_046179	55362279	55362279	4
chr6	55401971	55451449	Adcyap1r1	49478	+	NM_007407	55410229	55447165	17
chr6	55627812	55631257	Neurod6	3445	-	NM_009717	55628630	55629644	2
chr6	55634564	55644568	Gm3279	10004	+	NR_046071	55644568	55644568	3
chr6	55787011	55928592	Ccdc129	141581	+	NM_001081665	55822478	55928507	14
chr6	55967508	55982682	Ppp1r17	15174	+	NM_011153	55972377	55981550	5
chr6	56019797	56312386	Pde1c	292589	-	NM_001159953	56022199	56311839	19
chr6	56651056	56654693	Lsm5	3637	-	NM_025520	56651250	56654662	5
chr6	56664898	56711905	Avl9	47007	+	NM_030235	56665115	56707381	16
chr6	56727518	56747807	Kbtbd2	20289	-	NM_145958	56728871	56739382	4
chr6	56782052	56829354	Fkbp9	47302	+	NM_012056	56782200	56828204	10
chr6	56832394	56873926	Nt5c3	41532	-	NM_026004	56832950	56873803	9
chr6	56906506	56907400	Vmn1r4	894	+	NM_134176	56906506	56907400	1
chr6	56935335	56936283	Vmn1r5	948	+	NM_134174	56935335	56936283	1
chr6	56952348	56953260	Vmn1r6	912	+	NM_134175	56952348	56953260	1
chr6	56974331	56975267	Vmn1r7	936	-	NM_001166710	56974331	56975267	1
chr6	56985906	56987119	Vmn1r8	1213	+	NM_134187	56985959	56986871	1
chr6	57020888	57021939	Vmn1r9	1051	+	NM_134185	57020935	57021835	1
chr6	57063418	57064354	Vmn1r10	936	+	NM_053231	57063418	57064354	1
chr6	57087346	57088246	Vmn1r11	900	+	NM_053233	57087346	57088246	1
chr6	57108913	57109837	Vmn1r12	924	+	NM_001101579	57108913	57109837	1
chr6	57159851	57160754	Vmn1r13	903	+	NM_053235	57159851	57160754	1
chr6	57183432	57184344	Vmn1r14	912	+	NM_053237	57183432	57184344	1
chr6	57208142	57209042	Vmn1r15	900	+	NM_053236	57208142	57209042	1
chr6	57272717	57273629	Vmn1r16	912	-	NM_134184	57272717	57273629	1
chr6	57310460	57311372	Vmn1r17	912	-	NM_134171	57310460	57311372	1
chr6	57339661	57340561	Vmn1r18	900	-	NM_134181	57339661	57340561	1
chr6	57354457	57355384	Vmn1r19	927	+	NM_134182	57354457	57355384	1
chr6	57381684	57382596	Vmn1r20	912	+	NM_001101533	57381684	57382596	1
chr6	57456495	57485420	Ppm1k	28925	-	NM_175523	57460711	57475170	7
chr6	57530985	57615130	Herc6	84145	+	NM_025992	57531030	57612908	23
chr6	57634732	57642072	Pyurf	7340	-	NM_025574	57639730	57641999	2
chr6	57652448	57689443	Lancl2	36995	+	NM_133737	57653053	57687744	9
chr6	57702257	57775119	Vopp1	72862	-	NM_146168	57704479	57774974	5
chr6	57793557	57794451	Vmn1r21	894	-	NM_134183	57793557	57794451	1
chr6	57850075	57850984	Vmn1r22	909	-	NM_134178	57850075	57850984	1
chr6	57875876	57876785	Vmn1r23	909	-	NM_134179	57875876	57876785	1
chr6	57905634	57906525	Vmn1r24	891	-	NM_134173	57905634	57906525	1
chr6	57928387	57929296	Vmn1r25	909	-	NM_053238	57928387	57929296	1
chr6	57958176	57959196	Vmn1r26	1020	-	NM_134172	57958176	57959196	1
chr6	58165099	58166011	Vmn1r27	912	-	NM_134436	58165099	58166011	1
chr6	58215167	58216076	Vmn1r28	909	+	NM_134180	58215167	58216076	1
chr6	58257290	58258202	Vmn1r29	912	+	NM_053232	58257290	58258202	1
chr6	58384930	58385839	Vmn1r30	909	-	NM_134177	58384930	58385839	1
chr6	58421960	58422872	Vmn1r31	912	-	NM_001166729	58421960	58422872	1
chr6	58546665	58642445	Abcg2	95780	+	NM_011920	58605650	58642384	16
chr6	58783693	58870390	Herc3	86697	+	NM_028705	58793626	58868915	25
chr6	58855226	58857120	Nap1l5	1894	-	NM_021432	58856490	58856961	1
chr6	58883529	58974496	Fam13a	90967	-	NM_153574	58885578	58974334	18
chr6	59158863	59162027	Tigd2	3164	+	NM_001081145	59160143	59161721	2
chr6	59302454	59376284	Gprin3	73830	-	NM_183183	59303022	59305314	2
chr6	60229036	60353701	A530053G22Rik	124665	-	NR_015565	60353701	60353701	2
chr6	60681566	60779849	Snca	98283	-	NM_009221	60682122	60777595	6
chr6	60894310	60939372	Mmrn1	45062	+	NM_001163507	60894554	60938613	8
chr6	61125597	61130804	A730020E08Rik	5207	-	NR_040287	61130804	61130804	3
chr6	61130318	62332857	Ccser1	1202539	+	NM_001164316	61260848	62330261	11
chr6	63206850	64616273	Grid2	1409423	+	NM_008167	63206850	64616273	16
chr6	64679139	64681229	Atoh1	2090	+	NM_007500	64679316	64680372	1
chr6	64992660	65066043	Smarcad1	73383	+	NM_007958	64993249	65064356	24
chr6	65067286	65094724	Hpgds	27438	-	NM_019455	65069917	65088291	6
chr6	65331287	65408144	C130060K24Rik	76857	+	NM_175524	65331287	65406442	6
chr6	65540391	65584034	Tnip3	43643	+	NM_001001495	65540601	65581102	8
chr6	65621604	65656924	Ndnf	35320	+	NM_172399	65646033	65654439	4
chr6	65728955	65886371	Prdm5	157416	+	NM_027547	65729094	65886128	15
chr6	65902564	65904008	4930544G11Rik	1444	+	NM_001161773	65902776	65903358	1
chr6	66485461	66490985	Mad2l1	5524	+	NM_019499	66485520	66489937	5
chr6	66502176	66509702	Vmn1r32	7526	-	NM_134170	66502875	66503784	3
chr6	66561644	66562562	Vmn1r33	918	-	NM_134169	66561644	66562562	1
chr6	66586816	66587746	Vmn1r34	930	-	NM_001166719	66586816	66587746	1
chr6	66628787	66629678	Vmn1r35	891	-	NM_134167	66628787	66629678	1
chr6	66665965	66666883	Vmn1r36	918	-	NM_134166	66665965	66666883	1
chr6	66681385	66682294	Vmn1r37	909	+	NM_134165	66681385	66682294	1
chr6	66726215	66727124	Vmn1r38	909	-	NM_134168	66726215	66727124	1
chr6	66754408	66755326	Vmn1r39	918	-	NM_001166720	66754408	66755326	1
chr6	66846390	66971355	Gng12	124965	+	NM_001177560	66965744	66967583	5
chr6	66985089	66987401	Gadd45a	2312	-	NM_007836	66985652	66987238	4
chr6	66986592	67030646	E230016M11Rik	44054	+	NR_040278	67030646	67030646	7
chr6	67216972	67239296	Serbp1	22324	+	NM_001113566	67217090	67233953	8
chr6	67242011	67326131	Il12rb2	84120	-	NM_008354	67242196	67311944	16
chr6	67372925	67441849	Il23r	68924	-	NM_144548	67373358	67441774	11
chr6	67484052	67485816	Tacstd2	1764	-	NM_020047	67484746	67485700	1
chr6	67515227	67515693	4930515G16Rik	466	-	NR_003100	67515693	67515693	1
chr6	69276930	69277168	Rprl1	238	-	NR_004434	69277168	69277168	1
chr6	70715713	70742169	Rpia	26456	-	NM_009075	70716547	70742143	9
chr6	70794508	70855235	Eif2ak3	60727	+	NM_010121	70794719	70854282	17
chr6	70863082	70868916	Tex37	5834	-	NM_028825	70863257	70867686	4
chr6	70906599	70911060	Foxi3	4461	+	NM_001101464	70906602	70911057	2
chr6	71078159	71094374	Thnsl2	16215	-	NM_178413	71078623	71091436	10
chr6	71149881	71155017	Fabp1	5136	+	NM_017399	71149920	71154948	4
chr6	71163933	71212275	Smyd1	48342	-	NM_001160127	71165744	71212198	10
chr6	71221664	71221795	Mir8112	131	+	NR_106192	71221795	71221795	1
chr6	71222012	71235313	Krcc1	13301	+	NM_145568	71233979	71234750	4
chr6	71272805	71287445	Cd8b1	14640	+	NM_009858	71272850	71286716	6
chr6	71323420	71329165	Cd8a	5745	+	NM_001081110	71323546	71326905	5
chr6	71338627	71390631	Rmnd5a	52004	-	NM_024288	71343118	71390133	9
chr6	71443870	71460874	Rnf103	17004	+	NM_009543	71444656	71460432	4
chr6	71493847	71531568	Chmp3	37721	+	NM_025783	71493982	71529786	6
chr6	71538963	71582911	Kdm3a	43948	-	NM_001038695	71539628	71582235	27
chr6	71657674	71760699	Reep1	103025	+	NM_178608	71657963	71757795	7
chr6	71762990	71773778	Mrpl35	10788	-	NM_025430	71766092	71773752	4
chr6	71781313	71825260	Immt	43947	+	NM_029673	71781464	71824924	15
chr6	71830631	71858756	Ptcd3	28125	-	NM_027275	71831146	71858734	24
chr6	71859046	71929355	Polr1a	70309	+	NM_009088	71859156	71928509	34
chr6	71963889	71992522	9130221F21Rik	28633	-	NR_046180	71992522	71992522	3
chr6	72047601	72104564	St3gal5	56963	+	NM_011375	72078259	72103664	7
chr6	72070206	72073191	4933431G14Rik	2985	-	NR_045165	72073191	72073191	3
chr6	72156171	72185571	Atoh8	29400	-	NM_153778	72157143	72185158	3
chr6	72254603	72264367	Sftpb	9764	+	NM_147779	72254618	72262926	12
chr6	72268669	72295169	Usp39	26500	-	NM_138592	72269185	72295143	13
chr6	72297310	72303154	0610030E20Rik	5844	+	NM_026696	72297402	72299113	4
chr6	72305476	72309756	Tmem150a	4280	+	NM_144916	72306241	72309241	8
chr6	72309707	72312375	Rnf181	2668	-	NM_025607	72310576	72312359	5
chr6	72318042	72330462	Vamp5	12420	-	NM_001080742	72319296	72330377	4
chr6	72335214	72340661	Vamp8	5447	-	NM_016794	72335503	72340470	3
chr6	72364301	72381100	Ggcx	16799	+	NM_019802	72364400	72380150	15
chr6	72382792	72389552	Mat2a	6760	-	NM_145569	72384286	72389430	9
chr6	72388676	72390609	Particl	1933	+	NR_046011	72390609	72390609	1
chr6	72494384	72512977	Capg	18593	+	NM_007599	72505279	72512869	10
chr6	72515915	72548407	Elmod3	32492	-	NM_144917	72516654	72544787	13
chr6	72548621	72557482	Retsat	8861	+	NM_026159	72548621	72557375	11
chr6	72558414	72566994	Tgoln1	8580	-	NM_009443	72562098	72566716	4
chr6	72560950	72566742	Tgoln2	5792	-	NM_009444	72562098	72566716	4
chr6	72576364	72739039	Tcf7l1	162675	-	NM_001079822	72577353	72738946	13
chr6	72579281	72587711	Gm15401	8430	+	NR_040422	72587711	72587711	5
chr6	72791107	72849973	Kcmf1	58866	-	NM_019715	72792862	72849623	7
chr6	72907340	72908742	Tmsb10	1402	-	NM_001190327	72907611	72908006	4
chr6	72967600	73171625	Dnah6	204025	-	NM_001164669	72967735	73162657	77
chr6	73198498	73226901	Suclg1	28403	+	NM_019879	73198650	73226702	9
chr6	73386958	73421015	1700065L07Rik	34057	-	NR_108032	73421015	73421015	5
chr6	73418566	73419661	4931417E11Rik	1095	-	NM_025737	73418640	73419558	1
chr6	76831630	77929661	Ctnna2	1098031	-	NM_001109764	76832543	77795573	20
chr6	77192710	77195511	Lrrtm1	2801	+	NM_028880	77193555	77195124	2
chr6	77330250	77332469	6330415B21Rik	2219	-	NR_045141	77332469	77332469	1
chr6	78320878	78323460	Reg3b	2582	+	NM_011036	78321198	78323260	6
chr6	78325867	78328859	Reg3d	2992	-	NM_013893	78326064	78328500	6
chr6	78330702	78333833	Reg3a	3131	+	NM_011259	78331081	78333602	6
chr6	78355148	78358091	Reg2	2943	+	NM_009043	78355506	78357992	6
chr6	78375976	78378660	Reg1	2684	+	NM_009042	78376324	78378460	6
chr6	78416261	78418868	Reg3g	2607	-	NM_011260	78416478	78418556	6
chr6	78982035	78985863	Gm20362	3828	+	NR_040302	78985863	78985863	3
chr6	79768024	79768358	Gm20594	334	+	NM_001190732	79768244	79768358	1
chr6	79968870	80760137	Lrrtm4	791267	+	NM_001134743	79969173	80759183	3
chr6	81845583	81845657	Mir7232	74	-	NR_106091	81845657	81845657	1
chr6	81846592	81846670	Mir468	78	-	NR_030151	81846670	81846670	1
chr6	81850458	81860794	1700009C05Rik	10336	-	NR_046040	81860794	81860794	6
chr6	81873662	81909092	Gcfc2	35430	+	NM_177884	81873700	81908065	17
chr6	81907839	81915943	Mrpl19	8104	-	NM_026490	81911934	81915921	5
chr6	81991621	82043093	Eva1a	51472	+	NM_145570	82021136	82042158	3
chr6	82352468	82510098	Tacr1	157630	+	NM_009313	82353603	82507212	6
chr6	82596705	82602859	Pole4	6154	-	NM_025882	82598016	82602833	4
chr6	82675020	82724448	Hk2	49428	-	NM_013820	82677303	82723974	18
chr6	82827859	82831847	2310069B03Rik	3988	-	NR_040520	82831847	82831847	4
chr6	82861878	82889763	Sema4f	27885	-	NM_011350	82863484	82889617	14
chr6	82896915	82980303	M1ap	83388	+	NM_033079	82906460	82979931	10
chr6	82980929	82983465	Dok1	2536	-	NM_010070	82981244	82983424	5
chr6	82984217	83002558	Loxl3	18341	+	NM_013586	82985475	83000867	14
chr6	82999704	82999767	Mir7040	63	+	NR_106007	82999767	82999767	1
chr6	83001261	83004565	Htra2	3304	-	NM_019752	83001462	83004420	8
chr6	83004514	83007676	Aup1	3162	+	NM_007517	83004689	83007528	12
chr6	83007837	83017213	Dqx1	9376	+	NM_033606	83008501	83016586	12
chr6	83018318	83020219	Tlx2	1901	-	NM_009392	83018751	83020073	3
chr6	83028383	83030849	Pcgf1	2466	+	NM_197992	83028415	83030751	9
chr6	83036358	83038235	Lbx2	1877	+	NM_010692	83036417	83038065	2
chr6	83051509	83059115	Ccdc142	7606	+	NM_001081266	83051677	83058371	9
chr6	83059101	83059926	Mrpl53	825	+	NM_026744	83059105	83059667	3
chr6	83065499	83068892	Mogs	3393	+	NM_020619	83065574	83068702	4
chr6	83069037	83071455	Wbp1	2418	-	NM_001083922	83069253	83071265	5
chr6	83071821	83075023	Ino80b	3202	-	NM_023547	83071821	83075023	5
chr6	83085801	83102573	Rtkn	16772	+	NM_001136227	83085942	83102214	12
chr6	83102703	83106373	Wdr54	3670	-	NM_023790	83102759	83105864	10
chr6	83106397	83112969	1700003E16Rik	6572	+	NM_027948	83106566	83112885	4
chr6	83115917	83150111	Dctn1	34194	+	NM_001198866	83132535	83149805	32
chr6	83187368	83254939	Slc4a5	67571	+	NM_001166067	83190680	83250499	25
chr6	83255697	83267598	Mthfd2	11901	-	NM_008638	83256639	83267523	8
chr6	83276032	83290943	Mob1a	14911	+	NM_145571	83276247	83290247	6
chr6	83299477	83308386	Bola3	8909	+	NM_175277	83299494	83308206	4
chr6	83312367	83391672	Tet3	79305	-	NM_183138	83318035	83354773	11
chr6	83350989	83351096	Mir6374	107	-	NR_105793	83351096	83351096	1
chr6	83391748	83398316	B230319C09Rik	6568	+	NR_028382	83398316	83398316	3
chr6	83430207	83456963	Dguok	26756	-	NM_013764	83430403	83456883	7
chr6	83462902	83486245	Actg2	23343	-	NM_009610	83462978	83477435	9
chr6	83493199	83522498	Stambp	29299	-	NM_024239	83493973	83520499	10
chr6	83518032	83538120	Gm21284	20088	+	NR_078345	83538120	83538120	8
chr6	83594535	83606110	Clec4f	11575	-	NM_016751	83595204	83606026	7
chr6	83621200	83627851	Cd207	6651	-	NM_144943	83621676	83627793	6
chr6	83642799	83662195	Vax2os	19396	-	NR_002871	83662195	83662195	6
chr6	83661257	83688298	Vax2	27041	+	NM_011912	83661290	83687977	3
chr6	83693010	83708804	Atp6v1b1	15794	+	NM_134157	83693078	83708487	14
chr6	83711752	83712502	1700124L16Rik	750	-	NR_105027	83712502	83712502	2
chr6	83712639	83718320	Ankrd53	5681	+	NM_029245	83712859	83718297	6
chr6	83720407	83725806	Tex261	5399	-	NM_009357	83721181	83725717	6
chr6	83745050	83752550	Nagk	7500	+	NM_019542	83745247	83752449	10
chr6	83756052	83781735	Paip2b	25683	-	NM_146169	83758829	83781293	5
chr6	83864346	83936865	Zfp638	72519	+	NM_008717	83878848	83936617	27
chr6	83958591	84161053	Dysf	202462	+	NM_001077694	83958908	84160825	55
chr6	84362935	84373832	Gm10445	10897	-	NR_046063	84373832	84373832	4
chr6	84521407	84543902	Cyp26b1	22495	-	NM_001177713	84524260	84537999	7
chr6	84568479	85019507	Exoc6b	451028	-	NM_177077	84571378	85019399	22
chr6	85026134	85027120	Npm3-ps1	986	+	NR_002702	85027120	85027120	1
chr6	85061409	85076088	Gm5878	14679	-	NM_001034902	85065399	85075735	3
chr6	85083673	85087758	Spr	4085	-	NM_011467	85084091	85087739	3
chr6	85137924	85154457	Emx1	16533	+	NM_010131	85137936	85154070	3
chr6	85163044	85283416	Sfxn5	120372	-	NM_178639	85165662	85283409	14
chr6	85284955	85324628	Rab11fip5	39673	-	NM_001003955	85287016	85324522	6
chr6	85286285	85286367	Mir705	82	-	NR_030486	85286367	85286367	1
chr6	85373879	85378871	Noto	4992	+	NM_001007472	85373984	85378097	3
chr6	85381969	85396423	Smyd5	14454	+	NM_144918	85381998	85395210	13
chr6	85396778	85401964	Pradc1	5186	-	NR_028081	85401964	85401964	5
chr6	85401498	85418471	Cct7	16973	+	NM_007638	85402115	85418271	12
chr6	85419569	85452988	Fbxo41	33419	-	NM_001001160	85423019	85434718	14
chr6	85461115	85463536	Egr4	2421	-	NM_020596	85461633	85463391	2
chr6	85537524	85652745	Alms1	115221	+	NM_145223	85537639	85652632	23
chr6	85656700	85658555	Gm4477	1855	-	NM_001253910	85657166	85657850	2
chr6	85710624	85715738	Cml3	5114	-	NM_001037842	85711088	85711772	3
chr6	85740133	85740228	Mir6375	95	-	NR_105794	85740228	85740228	1
chr6	85742110	85754051	Alms1-ps2	11941	+	NR_040440	85754051	85754051	8
chr6	85758044	85759871	Gm11128	1827	-	NM_001201389	85758478	85759159	3
chr6	85767211	85770966	Cml5	3755	-	NM_023493	85767286	85767970	3
chr6	85780380	85781884	Nat8	1504	-	NM_023455	85780459	85781143	2
chr6	85815415	85819131	Cml2	3716	-	NM_053096	85817655	85818372	3
chr6	85849043	85854932	1700019G17Rik	5889	-	NM_029331	85850852	85851533	4
chr6	85860147	85865671	Cml1	5524	-	NM_023160	85860271	85860970	2
chr6	85865712	85880278	Tprkb	14566	+	NM_001170488	85874375	85878856	7
chr6	85892262	85911661	Dusp11	19399	-	NM_028099	85897598	85911529	9
chr6	85967184	85970990	Figla	3806	+	NM_012013	85967238	85970870	3
chr6	85978674	86074403	Add2	95729	+	NM_001271858	86035855	86068775	16
chr6	86145220	86225737	Tgfa	80517	+	NM_031199	86145499	86221949	6
chr6	86315676	86320052	Fam136a	4376	+	NM_025591	86315726	86318913	3
chr6	86321533	86328896	Snrpg	7363	+	NM_026506	86321576	86328777	4
chr6	86335999	86347144	Pcyox1	11145	-	NM_025823	86338706	86347078	6
chr6	86354212	86383399	Tia1	29187	+	NM_011585	86354490	86380361	13
chr6	86388391	86420381	C87436	31990	+	NM_146170	86395439	86419948	10
chr6	86420270	86430824	A430078I02Rik	10554	-	NR_131125	86430824	86430824	5
chr6	86433369	86438221	2310040G24Rik	4852	-	NR_040293	86438221	86438221	2
chr6	86474490	86476159	Pcbp1	1669	-	NM_011865	86474838	86475909	1
chr6	86477323	86514443	1600020E01Rik	37120	+	NR_037960	86514443	86514443	5
chr6	86578167	86579698	Asprv1	1531	+	NM_026414	86578167	86579187	1
chr6	86597038	86619153	Mxd1	22115	-	NM_010751	86600864	86619002	6
chr6	86625162	86634485	Snrnp27	9323	-	NM_025665	86625519	86634474	6
chr6	86641761	86683372	Gmcl1	41611	-	NM_011818	86642916	86683158	14
chr6	86686833	86743578	Anxa4	56745	-	NM_013471	86687757	86715758	13
chr6	86798400	86799434	2610306M01Rik	1034	-	NR_028298	86799434	86799434	1
chr6	86799510	86953221	Aak1	153711	+	NM_001040106	86800046	86937292	21
chr6	86959829	86978455	Nfu1	18626	+	NM_001170591	86959894	86978336	8
chr6	86992839	87042201	Gfpt1	49362	+	NM_013528	86992992	87038152	19
chr6	87054739	87062997	D6Ertd527e	8258	+	NM_001167938	87054819	87062245	2
chr6	87083846	87285769	Antxr1	201923	-	NM_054041	87087088	87285436	18
chr6	87295646	87300909	Gkn1	5263	-	NM_025466	87296268	87300866	6
chr6	87323358	87329488	Gkn2	6130	+	NM_025467	87323389	87329297	6
chr6	87333312	87338929	Gkn3	5617	-	NM_026860	87333429	87338829	6
chr6	87378987	87384506	Bmp10	5519	+	NM_009756	87379026	87384486	2
chr6	87408538	87483253	Arhgap25	74715	-	NM_001037727	87409913	87482880	11
chr6	87528585	87540695	Prokr1	12110	-	NM_021381	87531213	87538855	3
chr6	87578422	87622162	Aplf	43740	-	NM_001170489	87579893	87621949	11
chr6	87625586	87640841	1810020O05Rik	15255	-	NR_045482	87640841	87640841	5
chr6	87680862	87705905	Efcc1	25043	+	NM_001159697	87680886	87704853	8
chr6	87728129	87729756	Gp9	1627	+	NM_018762	87728998	87729532	2
chr6	87738846	87762158	Rab43	23312	-	NR_104478	87762158	87762158	3
chr6	87768441	87788753	Isy1	20312	-	NM_133934	87769089	87788640	11
chr6	87792608	87801100	Cnbp	8492	-	NM_001109746	87794032	87795773	5
chr6	87837933	87863588	Copg1	25655	+	NM_017477	87838029	87862296	24
chr6	87863969	87886607	Hmces	22638	+	NM_173737	87864506	87886320	7
chr6	87930414	87931476	H1fx	1062	-	NM_198622	87930783	87931350	1
chr6	87931676	87934174	Gm5577	2498	+	NR_026990	87934174	87934174	2
chr6	87949099	87995264	Rab7	46165	-	NM_001293652	87950428	87963684	8
chr6	88034466	88055298	Rpn1	20832	+	NM_133933	88034524	88053541	10
chr6	88054121	88054252	Mir6376	131	-	NR_105795	88054252	88054252	1
chr6	88148657	88157026	Gata2	8369	+	NM_008090	88149554	88155488	6
chr6	88172261	88173250	Dnajb8	989	+	NM_019964	88172477	88173161	1
chr6	88207327	88396533	Eefsec	189206	-	NM_023060	88208194	88396473	7
chr6	88415416	88447560	Ruvbl1	32144	+	NM_019685	88415521	88447381	11
chr6	88453600	88468794	Sec61a1	15194	-	NM_016906	88455100	88468686	12
chr6	88497715	88577442	Kbtbd12	79727	-	NM_001278671	88497715	88568840	6
chr6	88674405	88778354	Mgll	103949	+	NM_001166249	88675714	88775770	8
chr6	88785907	88791929	Abtb1	6022	-	NM_030251	88786239	88791818	12
chr6	88792551	88824038	Podxl2	31487	-	NM_176973	88792760	88815152	8
chr6	88792847	88797268	Gm15612	4421	+	NR_045880	88797268	88797268	3
chr6	88833467	88848774	Mcm2	15307	-	NM_008564	88833993	88848644	16
chr6	88852244	88862234	Tpra1	9990	+	NM_011906	88857950	88861941	12
chr6	89046108	89060031	4933427D06Rik	13923	+	NM_175017	89051524	89058221	4
chr6	89090987	89097364	Gm1965	6377	+	NR_121595	89097364	89097364	3
chr6	89162190	89166173	Gm839	3983	-	NR_033190	89166173	89166173	3
chr6	89219504	89235719	4930512J16Rik	16215	-	NR_131021	89235719	89235719	4
chr6	89266307	89312607	Plxna1	46300	-	NM_008881	89269369	89307639	32
chr6	89333139	89545646	Chchd6	212507	-	NM_025351	89333336	89545539	8
chr6	89593981	89625523	Txnrd3	31542	+	NM_001178058	89594126	89624791	16
chr6	89664196	89665129	Vmn1r40	933	+	NM_053228	89664196	89665129	1
chr6	89690881	89697408	Vmn1r41	6527	+	NM_053230	89696472	89697408	2
chr6	89794511	89795609	Vmn1r42	1098	-	NM_053221	89794589	89795579	1
chr6	89819454	89820523	Vmn1r43	1069	-	NM_053220	89819506	89820496	1
chr6	89843267	89844200	Vmn1r44	933	+	NM_053227	89843267	89844200	1
chr6	89881643	89890501	Vmn1r45	8858	-	NM_011684	89883023	89883980	2
chr6	89926164	89927094	Vmn1r46	930	+	NM_053229	89926164	89927094	1
chr6	89971881	89972814	Vmn1r47	933	+	NM_053219	89971881	89972814	1
chr6	89985926	89986835	Vmn1r48	909	-	NM_053218	89985926	89986835	1
chr6	90022079	90023012	Vmn1r49	933	-	NM_011911	90022079	90023012	1
chr6	90057268	90058201	Vmn1r50	933	+	NM_053225	90057268	90058201	1
chr6	90072636	90080639	Vmn1r51	8003	+	NM_011683	90079097	90080087	3
chr6	90128709	90129639	Vmn1r52	930	+	NM_053222	90128709	90129639	1
chr6	90152810	90153650	V1ra8	840	+	NM_053223	90152810	90153650	1
chr6	90173310	90174432	Vmn1r53	1122	-	NM_053226	90173401	90174334	1
chr6	90219099	90220047	Vmn1r54	948	+	NM_053224	90219099	90220047	1
chr6	90251263	90255442	BC048671	4179	+	NM_177738	90252790	90255270	5
chr6	90258344	90275179	Chst13	16835	-	NM_027928	90258961	90275156	3
chr6	90283282	90314542	Uroc1	31260	+	NM_144940	90283312	90313241	20
chr6	90319487	90353480	Zxdc	33993	+	NM_173002	90319652	90352100	10
chr6	90353729	90378474	Cfap100	24745	-	NM_173775	90353872	90377483	17
chr6	90412619	90425203	Klf15	12584	+	NM_023184	90416438	90424282	3
chr6	90500841	90549165	Aldh1l1	48324	+	NM_027406	90507218	90548936	23
chr6	90554873	90596406	Slc41a3	41533	+	NM_027868	90561902	90595775	11
chr6	90609591	90760117	Iqsec1	150526	-	NM_001134384	90612448	90759784	14
chr6	90963060	91066820	Nup210	103760	-	NM_018815	90964392	91066778	40
chr6	91106808	91124677	Hdac11	17869	+	NM_144919	91106839	91123258	10
chr6	91162757	91222534	Fbln2	59777	+	NM_007992	91183069	91221873	18
chr6	91313976	91361363	Wnt7a	47387	-	NM_009527	91315842	91361103	4
chr6	91380453	91390848	4930471M09Rik	10395	-	NR_045980	91390848	91390848	3
chr6	91390980	91391749	1810044D09Rik	769	+	NR_038153	91391749	91391749	2
chr6	91414269	91423417	Chchd4	9148	-	NM_133928	91415008	91423331	3
chr6	91423744	91438452	Tmem43	14708	+	NM_028766	91423880	91436941	12
chr6	91439301	91465882	Xpc	26581	-	NM_009531	91440050	91465793	16
chr6	91466028	91472614	Lsm3	6586	+	NM_026309	91466051	91472315	4
chr6	91634060	91709057	Slc6a6	74997	+	NM_009320	91673286	91705051	15
chr6	91711502	91757387	Grip2	45885	-	NM_001159507	91713441	91757312	24
chr6	91828046	91849842	Ccdc174	21796	+	NM_172730	91828138	91849581	11
chr6	91854226	91900719	4930590J08Rik	46493	+	NM_198668	91864752	91900634	20
chr6	91937103	92025999	Fgd5	88896	+	NM_172731	91937255	92024600	20
chr6	92041411	92123052	Nr2c2	81641	+	NM_011630	92089812	92117627	15
chr6	92119516	92134017	Mrps25	14501	-	NM_025578	92125015	92133967	4
chr6	92136705	92164805	Rbsn	28100	-	NM_030081	92139303	92161726	12
chr6	92192054	92194644	Trh	2590	-	NM_009426	92192556	92193873	3
chr6	92320885	92656178	Prickle2	335293	-	NM_001081146	92325939	92656139	9
chr6	92722692	92851435	Adamts9	128743	-	NM_175314	92727391	92844347	30
chr6	92890575	93061743	9530026P05Rik	171168	+	NR_015530	93061743	93061743	3
chr6	93625446	94233911	Magi1	608465	-	NM_001286785	93628939	94233316	25
chr6	94082916	94187436	4930511A08Rik	104520	-	NR_130996	94187436	94187436	2
chr6	94450307	94554646	Slc25a26	104339	+	NM_026255	94450418	94553663	10
chr6	94554522	94650139	Lrig1	95617	-	NM_008377	94555752	94649679	19
chr6	94556357	94556409	Mir7041	52	-	NR_106008	94556409	94556409	1
chr6	94893827	94901539	4930511E03Rik	7712	+	NR_040761	94901539	94901539	8
chr6	95067873	95079787	Kbtbd8	11914	+	NM_001008785	95067952	95076934	4
chr6	95240567	95283987	AY512915	43420	-	NR_033559	95283987	95283987	4
chr6	95423002	95668840	Suclg2	245838	-	NM_011507	95425042	95668769	11
chr6	96063147	96607192	Fam19a1	544045	+	NM_182808	96065630	96604778	5
chr6	96114496	96116199	1700123L14Rik	1703	-	NR_003643	96116199	96116199	1
chr6	96781202	97010405	Fam19a4	229203	-	NM_177233	96782554	96964480	6
chr6	97060937	97098877	Eogt	37940	-	NM_175313	97062053	97095464	18
chr6	97101943	97129118	Tmf1	27175	-	NM_001081111	97105347	97129017	17
chr6	97133625	97155641	Uba3	22016	-	NM_001301857	97134773	97153587	18
chr6	97160785	97183309	Arl6ip5	22524	+	NM_022992	97160814	97182566	3
chr6	97188521	97202774	Lmod3	14253	-	NM_001081157	97188838	97202565	3
chr6	97236860	97567651	Frmd4b	330791	-	NM_145148	97238353	97373518	24
chr6	97757051	97971352	Mitf	214301	+	NM_001113198	97757177	97968169	10
chr6	98188007	98292748	Gm765	104741	-	NM_001128092	98188084	98291996	4
chr6	98875335	99385339	Foxp1	510004	-	NM_053202	98880083	99113012	19
chr6	99575130	99616765	Eif4e3	41635	-	NM_025829	99577000	99616746	7
chr6	99642672	99643812	Gpr27	1140	+	NM_008158	99642672	99643812	1
chr6	99661292	99676386	Prok2	15094	-	NM_015768	99662346	99676314	4
chr6	100178558	100237352	Rybp	58794	-	NM_019743	100182166	100237271	5
chr6	100477393	100483420	1700049E22Rik	6027	+	NR_040525	100483420	100483420	4
chr6	100521804	100621151	Shq1	99347	-	NM_181590	100523259	100621055	11
chr6	100654727	100755075	Gxylt2	100348	+	NM_198612	100654837	100754694	7
chr6	100783631	100818711	Ppp4r2	35080	+	NM_182939	100783877	100816570	9
chr6	101099600	101327891	Pdzrn3	228291	-	NM_018884	101100505	101327882	10
chr6	101724242	101751976	Gm9871	27734	+	NR_027989	101751976	101751976	6
chr6	102113299	102414661	Cntn3	301362	-	NM_008779	102115311	102414577	22
chr6	102216093	102286670	4930587E11Rik	70577	+	NR_131017	102286670	102286670	5
chr6	102744377	102744479	Mir6373	102	+	NR_105792	102744479	102744479	1
chr6	103460869	103683029	Chl1	222160	+	NM_007697	103591964	103679329	27
chr6	104443037	104813399	Cntn6	370362	+	NM_017383	104519032	104813221	23
chr6	105431259	105442662	Gm19757	11403	-	NR_040297	105442662	105442662	3
chr6	105622331	105627575	Gm15631	5244	-	NR_132434	105627575	105627575	3
chr6	105627738	106649299	Cntn4	1021561	+	NM_001109749	106131769	106647615	26
chr6	106660372	106699031	Il5ra	38659	-	NM_008370	106662375	106694330	13
chr6	106719131	106732468	Trnt1	13337	+	NM_001242358	106719849	106729428	9
chr6	106728238	106750081	Crbn	21843	-	NM_175357	106730923	106750051	11
chr6	107479719	107520222	Lrrn1	40503	+	NM_008516	107517236	107519387	2
chr6	108015038	108027121	Setmar	12083	+	NM_001276356	108023059	108026470	3
chr6	108057014	108135577	Sumf1	78563	-	NM_145937	108058469	108135550	9
chr6	108163089	108501110	Itpr1	338021	+	NM_010585	108186987	108499833	62
chr6	108439736	108439797	Mir7661	61	+	NR_106121	108439797	108439797	1
chr6	108527029	108610928	0610040F04Rik	83899	-	NR_104577	108610928	108610928	7
chr6	108610622	108616919	Bhlhe40	6297	+	NM_011498	108610906	108615326	5
chr6	108733052	108773717	Arl8b	40665	+	NM_026011	108733248	108771546	7
chr6	108778634	108809350	Edem1	30716	+	NM_138677	108778733	108805550	12
chr6	110595591	111517224	Grm7	921633	+	NM_177328	110595861	111516061	10
chr6	112160701	112162512	1700054K19Rik	1811	+	NR_027865	112162512	112162512	3
chr6	112223751	112280417	Lmcd1	56666	+	NM_144799	112223924	112279960	6
chr6	112236787	112240313	5031434C07Rik	3526	-	NR_045987	112240313	112240313	3
chr6	112309317	112338017	Ssu2	28700	-	NM_175525	112309591	112337993	12
chr6	112409498	112422866	Cav3	13368	+	NM_007617	112409805	112422472	2
chr6	112423677	112439802	Oxtr	16125	-	NM_001081147	112427067	112439791	2
chr6	112569844	112646664	Rad18	76820	-	NM_001167730	112570798	112646588	14
chr6	112667965	112897260	Srgap3	229295	-	NM_080448	112672781	112896490	22
chr6	112996320	113018267	Thumpd3	21947	+	NM_008188	112997440	113017820	10
chr6	113017422	113027238	Gt(ROSA)26Sor	9816	-	NR_027010	113027238	113027238	3
chr6	113027632	113103418	Setd5	75786	+	NM_028385	113055044	113101464	22
chr6	113118080	113145378	Lhfpl4	27298	-	NM_177763	113121851	113144217	4
chr6	113187836	113231386	Mtmr14	43550	+	NM_026849	113187959	113230780	19
chr6	113232300	113255565	Cpne9	23265	+	NM_170673	113232467	113254615	20
chr6	113257130	113274856	Brpf1	17726	+	NM_001282128	113259806	113274160	14
chr6	113276969	113284180	Ogg1	7211	+	NM_010957	113277219	113283925	7
chr6	113284117	113293916	Camk1	9799	-	NM_133926	113284307	113291944	12
chr6	113316654	113327514	Tada3	10860	-	NM_133932	113316981	113326040	9
chr6	113328106	113340441	Arpc4	12335	+	NM_026552	113328199	113338770	6
chr6	113342490	113364565	Ttll3	22075	+	NM_133923	113342490	113364236	13
chr6	113365312	113369334	Rpusd3	4022	-	NM_001033204	113365524	113369312	9
chr6	113374627	113385754	Cidec	11127	-	NM_001301295	113375555	113384481	6
chr6	113392510	113398223	Jagn1	5713	+	NM_001205025	113397324	113397714	2
chr6	113408477	113420745	Il17re	12268	+	NM_145826	113408888	113420137	15
chr6	113421448	113433157	Il17rc	11709	+	NM_178942	113421676	113433113	18
chr6	113433562	113443332	Creld1	9770	+	NM_133930	113433896	113442895	10
chr6	113443632	113451925	Prrt3	8293	-	NM_001289699	113444284	113448253	4
chr6	113464880	113481632	Emc3	16752	-	NM_175101	113465896	113481476	8
chr6	113481675	113546279	Fancd2	64604	+	NM_001033244	113483801	113545953	44
chr6	113546755	113550709	Fancd2os	3954	-	NM_027633	113547500	113548037	4
chr6	113554765	113566945	Brk1	12180	+	NM_133937	113554772	113566085	3
chr6	113574014	113581627	Vhl	7613	+	NM_009507	113574134	113579563	3
chr6	113588460	113645020	Irak2	56560	+	NM_172161	113588541	113643774	13
chr6	113647492	113661062	Tatdn2	13570	+	NM_001033463	113647706	113660175	8
chr6	113657201	113657259	Mir7042	58	+	NR_106009	113657259	113657259	1
chr6	113666112	113669905	Ghrl	3793	-	NM_021488	113666243	113669423	5
chr6	113678045	113690675	Sec13	12630	-	NM_024206	113678343	113690641	9
chr6	113695661	113992074	Atp2b2	296413	-	NM_009723	113698530	113792324	22
chr6	114081234	114199880	Slc6a11	118646	+	NM_172890	114081270	114197734	14
chr6	114232628	114267519	Slc6a1	34891	+	NM_178703	114251943	114265403	16
chr6	114347929	114433292	Hrh1	85363	+	NM_008285	114429753	114431220	3
chr6	114593118	114810632	Atg7	217514	+	NM_001253717	114621164	114809041	20
chr6	114812107	114871770	Vgll4	59663	-	NM_177683	114812182	114871416	5
chr6	114954398	114987892	Tamm41	33494	-	NM_026894	114954460	114987802	8
chr6	115077617	115084853	Gm17733	7236	-	NR_132436	115084853	115084853	2
chr6	115084919	115232644	Syn2	147725	+	NM_001111015	115085098	115231241	13
chr6	115195633	115201867	Timp4	6234	-	NM_080639	115196303	115201796	5
chr6	115310968	115440419	Pparg	129451	+	NM_001127330	115389865	115440213	8
chr6	115494721	115528354	Tsen2	33633	+	NM_199033	115497859	115528008	12
chr6	115533564	115542594	Mkrn2os	9030	-	NM_001101431	115535364	115542509	4
chr6	115551955	115568688	Mkrn2	16733	+	NM_023290	115552005	115567749	8
chr6	115568590	115626653	Raf1	58063	-	NM_029780	115569283	115594634	17
chr6	115679156	115712484	Tmem40	33328	-	NM_001168256	115679682	115692397	12
chr6	115724574	115755573	Cand2	30999	+	NM_025958	115724628	115753882	15
chr6	115725674	115725737	Mir7660	63	+	NR_106120	115725737	115725737	1
chr6	115755531	115758761	Rpl32	3230	-	NM_172086	115755576	115757915	4
chr6	115757992	115758121	Snora7a	129	-	NR_028546	115758121	115758121	1
chr6	115760746	115788430	Efcab12	27684	-	NM_001110506	115760995	115788150	9
chr6	115790714	115803359	Mbd4	12645	-	NM_010774	115792502	115803228	8
chr6	115803545	115876717	Ift122	73172	+	NM_031177	115803686	115876343	29
chr6	115881944	115888848	Rho	6904	+	NM_145383	115882022	115886737	5
chr6	115894948	115900260	H1foo	5312	+	NM_138311	115895000	115900096	5
chr6	115904828	115945023	Plxnd1	40195	-	NM_026376	115905757	115944823	36
chr6	115968635	116143392	Tmcc1	174757	-	NM_177412	115972104	116084348	6
chr6	116149427	116158011	9530062K07Rik	8584	-	NR_131013	116158011	116158011	4
chr6	116158050	116212689	Fam21	54639	+	NM_026585	116158224	116212492	31
chr6	116214236	116280322	Zfand4	66086	+	NM_001309446	116223628	116279502	10
chr6	116288039	116359561	March8	71522	+	NM_001302383	116326788	116356344	8
chr6	116360088	116411196	Alox5	51108	-	NM_009662	116360736	116411042	14
chr6	116443628	116444558	Olfr211	930	+	NM_146912	116443628	116444558	1
chr6	116456533	116467983	Olfr212	11450	+	NM_001011800	116465796	116466780	2
chr6	116490472	116491456	Olfr213	984	+	NM_001011801	116490472	116491456	1
chr6	116506444	116507407	Olfr214	963	+	NM_146759	116506444	116507407	1
chr6	116532029	116532962	Olfr215	933	-	NM_146446	116532029	116532962	1
chr6	116574033	116579017	Zfp422	4984	-	NM_026057	116576340	116577054	2
chr6	116583025	116623854	Rassf4	40829	-	NM_178045	116588255	116611922	11
chr6	116595995	116596065	Mir7043	70	-	NR_106010	116596065	116596065	1
chr6	116600701	116602865	8430408G22Rik	2164	+	NM_001166580	116601715	116602333	2
chr6	116642742	116666776	Tmem72	24034	-	NM_178768	116645068	116666595	5
chr6	117118552	117131386	Cxcl12	12834	+	NM_001012477	117118673	117126197	4
chr6	117629224	117701787	1700030F04Rik	72563	-	NR_045731	117701787	117701787	4
chr6	117791259	117795974	Zfp637	4715	+	NM_177684	117793340	117795791	3
chr6	117813094	117822784	Zfp239	9690	+	NM_001001792	117821320	117821926	4
chr6	117850357	117875640	Hnrnpf	25283	+	NM_001166432	117873774	117875022	4
chr6	117883576	117887353	Fxyd4	3777	-	NM_033648	117883746	117885911	9
chr6	117961554	118041564	Rasgef1a	80010	+	NM_001316749	118030381	118039858	13
chr6	118035209	118035281	Mir7044	72	+	NR_106011	118035281	118035281	1
chr6	118057470	118089158	Csgalnact2	31688	-	NM_030165	118059119	118079373	8
chr6	118101765	118147762	Ret	45997	-	NM_009050	118103870	118147151	20
chr6	118196712	118198472	1700069P05Rik	1760	-	NR_040527	118198472	118198472	3
chr6	118250184	118258737	Gm30498	8553	-	NR_110507	118258737	118258737	6
chr6	118333398	118369435	Bms1	36037	-	NM_194339	118333668	118368602	23
chr6	118377336	118405524	Zfp248	28188	-	NM_028335	118378913	118403878	6
chr6	118411967	118429291	Zfp9	17324	-	NM_011763	118414352	118427339	6
chr6	118452581	118512274	Ankrd26	59693	-	NM_001081112	118453040	118512075	34
chr6	118537257	119146427	Cacna1c	609170	-	NM_001255998	118543909	119146249	48
chr6	118830175	118835561	4931430N09Rik	5386	+	NR_046053	118835561	118835561	4
chr6	119125270	119171632	Dcp1b	46362	+	NM_001033379	119125310	119170098	9
chr6	119186543	119302425	Cacna2d4	115882	+	NM_001033382	119186639	119300153	38
chr6	119265150	119280784	Lrtm2	15634	-	NM_172492	119267073	119273733	5
chr6	119303167	119367501	Adipor2	64334	-	NM_197985	119305817	119320338	8
chr6	119382548	119494365	Wnt5b	111817	-	NM_009525	119383415	119398233	5
chr6	119429685	119433904	Fbxl14	4219	+	NM_133940	119429877	119431080	1
chr6	119520813	119798168	Erc1	277355	-	NR_104484	119798168	119798168	21
chr6	119798210	119799034	3110021A11Rik	824	+	NR_030776	119799034	119799034	1
chr6	119852715	119872841	Rad52	20126	+	NM_001166382	119861072	119872551	12
chr6	119873986	119988673	Wnk1	114687	-	NM_001199083	119876387	119987650	28
chr6	119984245	119984329	Mir706	84	-	NR_030487	119984329	119984329	1
chr6	120043397	120150356	Ninj2	106959	+	NM_016718	120043443	120148827	4
chr6	120153827	120244577	B4galnt3	90750	-	NM_198884	120153827	120244577	20
chr6	120274339	120314387	Ccdc77	40048	-	NR_045558	120314387	120314387	10
chr6	120314116	120394592	Kdm5a	80476	+	NM_145997	120314631	120389211	28
chr6	120413214	120433745	Il17ra	20531	+	NM_008359	120413346	120432502	13
chr6	120438956	120443825	Cecr6	4869	-	NM_033567	120442053	120443772	1
chr6	120459511	120481317	Cecr5	21806	-	NM_144815	120460152	120481310	8
chr6	120504813	120524222	1700072O05Rik	19409	+	NR_045733	120524222	120524222	4
chr6	120616438	120721209	Cecr2	104771	+	NM_001128151	120616599	120716435	19
chr6	120723785	120744000	Slc25a18	20215	+	NM_001081048	120734520	120743661	10
chr6	120745261	120772703	Atp6v1e1	27442	-	NM_007510	120745719	120772638	9
chr6	120786247	120842860	Bcl2l13	56613	+	NM_153516	120798522	120837409	7
chr6	120843136	120866838	Bid	23702	-	NM_007544	120844298	120851752	6
chr6	120881563	121081040	Mical3	199477	-	NM_001270475	120884685	120992277	32
chr6	121133684	121148855	Pex26	15171	+	NR_130903	121148855	121148855	7
chr6	121160751	121176116	Tuba8	15365	+	NM_017379	121160851	121176097	5
chr6	121195923	121220935	Usp18	25012	+	NM_011909	121202441	121220535	11
chr6	121250313	121287736	Slc6a13	37423	+	NM_144512	121252719	121287434	15
chr6	121296714	121315791	Slc6a12	19077	+	NM_133661	121296989	121315390	15
chr6	121322945	121423696	Iqsec3	100751	-	NM_001033354	121326087	121423581	14
chr6	121586190	121629256	A2m	43066	+	NM_175628	121586306	121629126	36
chr6	121788558	121839075	Mug1	50517	+	NM_008645	121788656	121838947	36
chr6	121956815	122035985	Mug2	79170	+	NM_008646	121956876	122035858	35
chr6	122086645	122100976	Gm10319	14331	+	NR_003624	122100976	122100976	6
chr6	122126070	122198584	Mug-ps1	72514	+	NR_027619	122198584	122198584	36
chr6	122220618	122232851	Klrg1	12233	-	NM_016970	122221389	122232829	5
chr6	122259027	122267695	M6pr	8668	+	NM_010749	122262252	122266468	7
chr6	122267748	122290245	Phc1	22497	-	NM_001271579	122268510	122286989	15
chr6	122403626	122436323	Rimklb	32697	-	NM_027664	122406214	122422731	6
chr6	122463693	122479305	Mfap5	15612	+	NM_015776	122464360	122478449	10
chr6	122503826	122514198	Aicda	10372	+	NM_009645	122503919	122512491	5
chr6	122527809	122552462	Apobec1	24653	-	NM_001134391	122528824	122541120	8
chr6	122555420	122560089	Gdf3	4669	-	NM_008108	122556323	122559984	2
chr6	122576441	122580289	Dppa3	3848	+	NM_139218	122576540	122580023	4
chr6	122657506	122664651	Nanog	7145	+	NM_001289831	122657875	122663573	5
chr6	122677826	122692763	Slc2a3	14937	-	NM_011401	122679948	122692408	10
chr6	122770201	122795384	Foxj2	25183	+	NM_021899	122778188	122792870	11
chr6	122781394	122781455	Mir7231	61	+	NR_106090	122781455	122781455	1
chr6	122797157	122806175	C3ar1	9018	-	NM_009779	122799840	122801274	2
chr6	122824574	122838959	Necap1	14385	+	NM_026267	122824586	122837406	8
chr6	122871865	122884637	Clec4a1	12772	+	NM_199311	122871991	122883943	6
chr6	122902532	122919896	Clec4a3	17364	+	NM_001204241	122902885	122919530	7
chr6	122940384	122974439	Clec4a4	34055	+	NM_001005860	122940384	122974058	6
chr6	122999979	123021573	Clec4b1	21594	+	NM_001190310	123000115	123021555	6
chr6	123072707	123094017	Clec4a2	21310	+	NM_001170332	123073605	123092525	7
chr6	123123040	123154689	Clec4b2	31649	+	NM_001004159	123123070	123154302	6
chr6	123179860	123197042	Clec4n	17182	+	NM_020001	123180036	123196603	6
chr6	123212124	123225286	Clec4d	13162	+	NM_001163161	123212352	123224838	6
chr6	123231806	123239889	Clec4e	8083	-	NM_019948	123233557	123239766	6
chr6	123258350	123286555	Vmn2r19	28205	+	NM_001104632	123258350	123286555	6
chr6	123335279	123368079	Vmn2r20	32800	-	NM_001104634	123335279	123368079	6
chr6	123442525	123483424	Vmn2r21	40899	-	NM_001104635	123442525	123483424	6
chr6	123559775	123600653	Vmn2r22	40878	-	NM_001104637	123559775	123600653	6
chr6	123652838	123692257	Vmn2r23	39419	+	NM_001104638	123652838	123692257	6
chr6	123728988	123766298	Vmn2r24	37310	+	NM_001104639	123728988	123766298	6
chr6	123772831	123803208	Vmn2r25	30377	-	NM_001104641	123772831	123803208	6
chr6	123974775	124012053	Vmn2r26	37278	+	NM_019917	123974775	124012053	6
chr6	124141613	124181802	Vmn2r27	40189	-	NM_001104642	124141613	124181802	6
chr6	124254668	124280545	Cd163	25877	+	NM_053094	124254757	124279106	17
chr6	124297611	124307104	1700013D24Rik	9493	-	NM_001177502	124297715	124307037	3
chr6	124313299	124314504	1700027F06Rik	1205	-	NR_131162	124314504	124314504	2
chr6	124346833	124365085	Pex5	18252	-	NM_001277805	124347986	124364451	16
chr6	124380773	124414802	Clstn3	34029	-	NM_153508	124381609	124414502	18
chr6	124443130	124460661	C1rl	17531	+	NM_181344	124443168	124459138	6
chr6	124462638	124473458	C1ra	10820	+	NM_023143	124462816	124472998	11
chr6	124480361	124492377	C1s1	12016	-	NM_001097617	124480961	124491373	12
chr6	124520447	124531062	C1rb	10615	+	NM_001113356	124520474	124531044	11
chr6	124574642	124586103	C1s2	11461	-	NM_173864	124575183	124586067	11
chr6	124613121	124654734	Lpcat3	41613	+	NM_145130	124613226	124653629	13
chr6	124654387	124662196	Emg1	7809	-	NM_013536	124654562	124662061	6
chr6	124662306	124666963	Phb2	4657	+	NM_007531	124662454	124666651	9
chr6	124667931	124668003	Mir141	72	-	NR_029554	124668003	124668003	1
chr6	124668339	124668408	Mir200c	69	-	NR_029792	124668408	124668408	1
chr6	124670724	124688727	Ptpn6	18003	-	NM_001077705	124671125	124688530	16
chr6	124689201	124691097	Grcc10	1896	-	NM_013535	124689279	124690989	3
chr6	124692561	124706505	Atn1	13944	-	NM_007881	124693089	124699791	10
chr6	124710070	124719691	Eno2	9621	-	NM_013509	124711310	124718340	12
chr6	124719886	124729745	Lrrc23	9859	-	NM_001302555	124720619	124729146	8
chr6	124758678	124760634	Spsb2	1956	+	NM_001306051	124759323	124760417	3
chr6	124760609	124764314	Tpi1	3705	-	NM_009415	124761286	124764290	7
chr6	124765036	124779465	Usp5	14429	-	NM_013700	124765583	124779413	20
chr6	124780193	124783719	Cdca3	3526	+	NM_013538	124780548	124783158	6
chr6	124784257	124790293	Gnb3	6036	-	NM_013530	124784694	124789738	10
chr6	124791112	124807705	P3h3	16593	-	NM_013534	124791692	124807705	15
chr6	124808462	124813935	Gpr162	5473	-	NM_013533	124808686	124811703	5
chr6	124814710	124838227	Cd4	23517	-	NM_013488	124816262	124829672	10
chr6	124854376	124861723	Lag3	7347	-	NM_008479	124854459	124861369	8
chr6	124863692	124867964	Ptms	4272	-	NM_026988	124864199	124867622	5
chr6	124881405	124886167	Mlf2	4762	+	NM_145385	124882144	124885438	9
chr6	124908428	124915547	Cops7a	7119	-	NM_001164089	124908744	124914903	8
chr6	124946737	124953117	Pianp	6380	+	NM_175696	124948990	124952002	6
chr6	124959255	124987888	Zfp384	28633	+	NM_001252083	124973701	124986743	11
chr6	124960193	124999871	4930557K07Rik	39678	-	NR_130997	124999871	124999871	4
chr6	124989865	124999282	Ing4	9417	+	NM_133345	124989878	124998425	8
chr6	124999944	125013283	Acrbp	13339	+	NM_016845	125000027	125013076	10
chr6	125017937	125032490	Lpar5	14553	+	NM_001163269	125031335	125032490	2
chr6	125046180	125080519	Chd4	34339	+	NM_145979	125047183	125080019	39
chr6	125047041	125047104	Mir7045	63	+	NR_106012	125047104	125047104	1
chr6	125081900	125094771	Nop2	12871	+	NM_138747	125082230	125094659	16
chr6	125095241	125111800	Iffo1	16559	+	NM_001302778	125095274	125110656	10
chr6	125111869	125116485	Gapdh	4616	-	NM_001289726	125112049	125116471	7
chr6	125118024	125141604	Ncapd2	23580	-	NM_146171	125118251	125139907	32
chr6	125136378	125136449	Scarna10	71	-	NR_028517	125136449	125136449	1
chr6	125142217	125144410	Mrpl51	2193	+	NM_025595	125142372	125143437	3
chr6	125145809	125145896	Mir3098	87	+	NR_037281	125145896	125145896	1
chr6	125165598	125172324	Vamp1	6726	+	NM_009496	125165743	125170084	5
chr6	125174229	125181878	Tapbpl	7649	-	NM_145391	125174683	125181615	7
chr6	125181293	125189952	E130112N10Rik	8659	+	NR_015604	125189952	125189952	2
chr6	125182639	125187045	Cd27	4406	-	NM_001033126	125183327	125186910	6
chr6	125184701	125184830	Mir8113	129	-	NR_106193	125184830	125184830	1
chr6	125215542	125223795	4930417O13Rik	8253	+	NR_015527	125223795	125223795	4
chr6	125228291	125236060	Tuba3a	7769	-	NM_009446	125228375	125235988	5
chr6	125256588	125263888	Ltbr	7300	-	NM_010736	125257247	125263703	10
chr6	125271357	125294960	Scnn1a	23603	+	NM_011324	125271898	125294106	12
chr6	125299740	125312501	Tnfrsf1a	12761	+	NM_011609	125300041	125312012	10
chr6	125312668	125330522	Plekhg6	17854	-	NM_198604	125312875	125328857	17
chr6	125410283	125444773	Cd9	34490	-	NM_007657	125410678	125444657	8
chr6	125502965	125636697	Vwf	133732	+	NM_011708	125504470	125636557	52
chr6	125640436	125990146	Ano2	349710	+	NM_153589	125640740	125989532	26
chr6	126051429	126116762	Ntf3	65333	-	NM_001164034	126051743	126114765	3
chr6	126236666	126278704	Gm10415	42038	-	NR_045480	126278704	126278704	4
chr6	126482568	126485573	Kcna5	3005	-	NM_145983	126483372	126485181	1
chr6	126586480	126595819	Kcna1	9339	-	NM_010595	126591885	126593373	2
chr6	126658346	126690692	Kcna6	32346	-	NM_013568	126688352	126689942	2
chr6	126771880	126799162	Ndufa9	27282	-	NM_025358	126772036	126799130	11
chr6	126803115	126824326	Akap3	21211	+	NM_009650	126810272	126824133	6
chr6	126826216	126871857	Dyrk4	45641	-	NM_207210	126826338	126871805	15
chr6	126873436	126889573	Rad51ap1	16137	-	NM_009013	126874212	126889528	9
chr6	126889983	126925722	D6Wsu163e	35739	+	NM_138594	126892346	126925221	14
chr6	126965559	126974736	Fgf6	9177	+	NM_010204	126965603	126974175	3
chr6	127022919	127032314	Fgf23	9395	+	NM_022657	127023047	127030496	3
chr6	127035133	127059570	Tigar	24437	-	NM_177003	127037891	127059485	6
chr6	127075726	127101066	Ccnd2	25340	-	NM_009829	127080352	127100791	5
chr6	127099406	127162437	9330179D12Rik	63031	+	NR_040274	127162437	127162437	3
chr6	127246203	127257985	Gm38404	11782	-	NR_073373	127257985	127257985	4
chr6	127403740	127444257	Parp11	40517	+	NM_181402	127420722	127441753	9
chr6	127527992	127579956	Cracr2a	51964	+	NM_001033464	127553880	127579945	7
chr6	127639026	127719177	Prmt8	80151	-	NM_201371	127639842	127718765	10
chr6	127738101	127738161	Mir7233	60	-	NR_106092	127738161	127738161	1
chr6	127837639	127903049	Tspan11	65410	+	NM_026743	127862978	127899870	8
chr6	127911417	128093596	Tspan9	182179	-	NM_175414	127914445	127984246	9
chr6	128119717	128133821	9330102E08Rik	14104	-	NR_077223	128133821	128133821	3
chr6	128177160	128250831	Tead4	73671	-	NM_011567	128178383	128221090	12
chr6	128271178	128305869	Tulp3	34691	-	NM_011657	128273096	128305796	11
chr6	128307017	128312915	Rhno1	5898	-	NR_027359	128312915	128312915	3
chr6	128313011	128325904	Foxm1	12893	+	NM_008021	128315722	128323984	8
chr6	128325527	128335162	4933413G19Rik	9635	+	NM_027697	128325536	128335006	3
chr6	128349783	128358953	Nrip2	9170	+	NM_001162858	128350130	128358438	6
chr6	128359461	128374928	Itfg2	15467	-	NM_133927	128360331	128374831	12
chr6	128380124	128388649	Fkbp4	8525	-	NM_010219	128380793	128388528	10
chr6	128388774	128453299	Gm10069	64525	+	NR_028593	128453299	128453299	5
chr6	128433584	128476738	Pzp	43154	-	NM_007376	128433721	128476682	36
chr6	128489839	128531624	BC048546	41785	-	NM_001001179	128490314	128531530	36
chr6	128559244	128572952	Klrb1a	13708	-	NM_010737	128559715	128572851	6
chr6	128612402	128627392	Clec2h	14990	+	NM_053165	128612459	128625946	5
chr6	128656525	128673064	Klrb1	16539	-	NM_001099918	128656525	128673064	6
chr6	128728502	128738659	Klrb1c	10157	-	NM_008527	128730302	128738643	6
chr6	128763723	128776333	Klrb1b	12610	-	NM_030599	128765194	128776264	6
chr6	128798061	128841142	BC035044	43081	-	NM_001254946	128800099	128840985	3
chr6	128837604	128848185	Clec2i	10581	+	NM_001289706	128837652	128846568	7
chr6	128884398	128934725	Clec2g	50327	+	NM_027562	128884434	128933105	7
chr6	128902370	128925047	Gm15987	22677	-	NR_045009	128925047	128925047	2
chr6	128924857	128924913	Mir7649	56	-	NR_106107	128924913	128924913	1
chr6	128943037	128956667	BC064078	13630	+	NR_015455	128956667	128956667	3
chr6	128964129	128970545	Clec2f	6416	+	NM_001277202	128964151	128970537	5
chr6	128995918	129007489	Klrb1f	11571	+	NM_153094	128995965	129006482	6
chr6	129041833	129050921	Clec2e	9088	-	NM_153506	129043423	129050891	5
chr6	129066535	129079464	Klrb1-ps1	12929	+	NR_073569	129079464	129079464	5
chr6	129130632	129136553	Clec2d	5921	+	NM_053109	129130698	129136029	5
chr6	129182640	129188500	2310001H17Rik	5860	-	NR_040268	129188500	129188500	4
chr6	129217342	129225387	Cd69	8045	-	NM_001033122	129218278	129225303	5
chr6	129272182	129281799	4922502D21Rik	9617	-	NM_199034	129272961	129281582	5
chr6	129300261	129315321	Clec12a	15060	+	NM_177686	129300438	129314080	6
chr6	129325530	129335892	Clec12b	10362	-	NM_001204223	129326212	129335508	7
chr6	129347314	129355431	Clec1b	8117	+	NM_019985	129347632	129355269	6
chr6	129358879	129374782	Clec9a	15903	+	NM_001205363	129358972	129372376	7
chr6	129376701	129402018	Clec1a	25317	-	NM_175526	129378874	129401733	6
chr6	129411608	129422797	Clec7a	11189	-	NM_020008	129413058	129422703	6
chr6	129435265	129457183	Olr1	21918	-	NM_138648	129437683	129457125	8
chr6	129462574	129469245	Tmem52b	6671	+	NM_001081186	129463056	129467413	5
chr6	129482201	129483302	1700101I11Rik	1101	-	NR_045270	129483302	129483302	2
chr6	129483209	129492349	Gabarapl1	9140	+	NM_020590	129483464	129491185	4
chr6	129528303	129535845	Klre1	7542	+	NM_153590	129529954	129535712	7
chr6	129541828	129548793	Klrd1	6965	+	NM_010654	129541848	129548487	6
chr6	129560340	129573882	Klrk1	13542	-	NM_001286018	129562803	129571258	8
chr6	129589102	129593306	Klrc3	4204	-	NM_021378	129589102	129593306	5
chr6	129606363	129610614	Klrc2	4251	-	NM_001098669	129606388	129610574	5
chr6	129616034	129628991	Klrc1	12957	-	NM_001136068	129624876	129628928	7
chr6	129641552	129641661	Mir680-1	109	+	NR_030447	129641661	129641661	1
chr6	129647235	129667150	Klri1	19915	-	NM_001012520	129647316	129667140	6
chr6	129679058	129690502	Klri2	11444	-	NM_177155	129682158	129690436	6
chr6	129716664	129725867	Gm156	9203	-	NM_001014997	129716665	129725858	6
chr6	129781171	129826690	Klra17	45519	-	NM_133203	129781464	129824925	8
chr6	129849008	129863242	Klra5	14234	-	NM_008463	129849329	129861479	8
chr6	129922099	130330826	Klra22	408727	-	NM_053152	129922397	130330680	6
chr6	129922110	130330680	Klra15	408570	-	NM_013793	129994056	130330680	7
chr6	129963050	129976972	Klra6	13922	-	NM_008464	129963363	129975237	8
chr6	129963051	129976978	Klra19	13927	-	NM_053154	129963363	129975237	8
chr6	129993749	130017276	Klra18	23527	-	NM_053153	129994056	130015320	7
chr6	129994034	130017289	Klra4	23255	-	NM_001252577	129994056	130015320	7
chr6	129994041	130256499	Klra12	262458	-	NM_010646	129994056	130256445	7
chr6	130032615	130079897	Klra21	47282	-	NM_053151	130032934	130078178	8
chr6	130065243	130079916	Klra8	14673	-	NM_001101620	130065553	130078178	8
chr6	130099123	130110766	Klra14-ps	11643	-	NR_104106	130110766	130110766	6
chr6	130128699	130143130	Klra9	14431	-	NM_010651	130129007	130141319	8
chr6	130168848	130183340	Klra7	14492	-	NM_001110323	130168917	130181635	8
chr6	130219211	130231946	Klra10	12735	-	NM_008459	130219227	130231940	6
chr6	130241178	130256450	Klra13-ps	15272	-	NR_033451	130256450	130256450	6
chr6	130241178	130258379	Klra23	17201	-	NM_024470	130241190	130256445	8
chr6	130273306	130287644	Klra3	14338	-	NM_001289605	130273621	130285817	8
chr6	130313935	130336892	Klra1	22957	-	NM_016659	130314237	130330680	9
chr6	131169252	131197380	Klra2	28128	-	NM_001170851	131170006	131195344	9
chr6	131234406	131243262	Magohb	8856	-	NM_025564	131234646	131243183	5
chr6	131249161	131263845	Styk1	14684	-	NM_172891	131250404	131263000	9
chr6	131314875	131338468	Ybx3	23593	-	NM_139117	131317815	131338273	10
chr6	131493779	131503775	5430401F13Rik	9996	+	NM_001244628	131493801	131503723	5
chr6	131579909	131580848	Tas2r130	939	-	NM_199156	131579909	131580848	1
chr6	131609135	131610167	Tas2r107	1032	-	NM_199154	131609175	131610102	1
chr6	131627977	131628904	Tas2r106	927	-	NM_207016	131627977	131628904	1
chr6	131634853	131635762	Tas2r104	909	-	NM_207011	131634853	131635762	1
chr6	131636578	131637481	Tas2r105	903	-	NM_020501	131636578	131637481	1
chr6	131639151	131640081	Tas2r114	930	-	NM_207019	131639151	131640081	1
chr6	132064238	132314153	Gm4736	249915	-	NM_053251	132064593	132314125	6
chr6	132156812	132160539	Prb1	3727	-	NM_198669	132157171	132160534	4
chr6	132261607	132264761	Prpmp5	3154	-	NM_001024705	132261986	132264747	3
chr6	132311122	132314152	Gm8882	3030	-	NM_001177588	132311419	132314125	4
chr6	132519859	132522419	Prh1	2560	+	NM_011174	132519859	132522419	2
chr6	132545963	132550720	Prp2	4757	+	NM_031499	132545963	132550720	2
chr6	132575128	132577529	A630073D07Rik	2401	-	NM_001142969	132576506	132577498	3
chr6	132606974	132607862	Tas2r120	888	+	NM_207023	132606974	132607862	1
chr6	132650107	132651025	Tas2r121	918	-	NM_207024	132650107	132651025	1
chr6	132661016	132661946	Tas2r122	930	-	NM_001039128	132661016	132661946	1
chr6	132687071	132688004	Tas2r115	933	-	NM_207020	132687071	132688004	1
chr6	132704747	132705677	Tas2r124	930	+	NM_207026	132704747	132705677	1
chr6	132712148	132713192	Tas2r102	1044	+	NM_199153	132712148	132713192	1
chr6	132727196	132728180	Tas2r136	984	-	NM_181276	132727196	132728180	1
chr6	132752918	132753911	Tas2r117	993	+	NM_207021	132752918	132753911	1
chr6	132797159	132798161	Tas2r123	1002	+	NM_207025	132797159	132798161	1
chr6	132805455	132806373	Tas2r116	918	+	NM_053212	132805455	132806373	1
chr6	132818025	132819027	Tas2r110	1002	+	NM_199155	132818025	132819027	1
chr6	132843028	132843958	Tas2r113	930	+	NM_207018	132843028	132843958	1
chr6	132859668	132860604	Tas2r125	936	+	NM_207027	132859668	132860604	1
chr6	132901119	132902082	Tas2r129	963	+	NM_207029	132901119	132902082	1
chr6	132906929	132907862	Tas2r131	933	-	NM_207030	132906929	132907862	1
chr6	132930032	132930983	Tas2r109	951	-	NM_207017	132930032	132930983	1
chr6	132986180	132987119	Tas2r103	939	-	NM_053211	132986180	132987119	1
chr6	133004872	133005811	Tas2r140	939	-	NM_021562	133004872	133005811	1
chr6	133055256	133060917	Smim10l1	5661	+	NR_073368	133060917	133060917	4
chr6	133242233	133245808	5530400C23Rik	3575	+	NM_027784	133242268	133244534	4
chr6	133479206	133482780	Gm5885	3574	+	NM_001185040	133479241	133481507	4
chr6	133714015	133717426	Gm5886	3411	-	NM_001177652	133715313	133717397	4
chr6	133799872	133803685	Kap	3813	-	NM_010594	133800070	133803641	4
chr6	133985717	134220165	Etv6	234448	+	NM_001303102	134087398	134216492	9
chr6	134346346	134388742	Bcl2l14	42396	+	NM_025778	134373635	134387757	7
chr6	134396495	134516931	Lrp6	120436	-	NM_008514	134400803	134516715	23
chr6	134559224	134582506	Mansc1	23282	-	NM_026345	134559985	134571970	4
chr6	134589529	134661202	Borcs5	71673	+	NM_001170479	134589644	134660289	4
chr6	134665485	134742646	Dusp16	77161	-	NM_130447	134667901	134711091	7
chr6	134780216	134807901	Crebl2	27685	+	NM_177687	134780447	134802309	5
chr6	134819109	134847943	Gpr19	28834	-	NM_001167700	134819230	134820460	5
chr6	134847978	134850803	2810454H06Rik	2825	+	NR_029441	134850803	134850803	1
chr6	134870418	134875543	Cdkn1b	5125	+	NM_009875	134870937	134872092	3
chr6	134879109	134901736	Droc	22627	+	NR_037956	134901736	134901736	2
chr6	134932018	134936854	Apold1	4836	+	NM_001109914	134933602	134934343	2
chr6	134961629	134973794	Ddx47	12165	+	NM_026360	134961659	134973428	12
chr6	135015679	135034726	Gprc5a	19047	+	NM_181444	135028574	135033851	4
chr6	135056008	135068301	Gprc5d	12293	-	NM_001205396	135056211	135066925	4
chr6	135087536	135118233	Hebp1	30697	-	NM_013546	135087906	135118115	4
chr6	135138497	135144977	Gm19434	6480	+	NR_040296	135144977	135144977	5
chr6	135148004	135186258	Fam234b	38254	+	NM_028982	135148082	135184002	13
chr6	135187347	135204354	Gsg1	17007	-	NM_010352	135187420	135194417	7
chr6	135259146	135260402	Pbp2	1256	-	NM_029595	135259801	135260365	1
chr6	135312948	135333191	Emp1	20243	+	NM_001288628	135329924	135331158	6
chr6	135608930	135633409	4930425L21Rik	24479	+	NR_126088	135633409	135633409	5
chr6	135679822	136123529	Grin2b	443707	-	NM_008171	135682115	135994319	15
chr6	136277556	136280001	Gm8994	2445	+	NM_001142734	136278560	136279796	2
chr6	136350340	136364090	E330021D16Rik	13750	-	NM_001201390	136350736	136351852	2
chr6	136467371	136555900	Atf7ip	88529	+	NM_019426	136508291	136555414	15
chr6	136560591	136610414	Plbd1	49823	-	NM_025806	136560698	136610200	11
chr6	136645804	136730263	Gucy2c	84459	-	NM_001127318	136646385	136730127	27
chr6	136752513	136752952	Hist4h4	439	-	NM_175652	136752588	136752900	1
chr6	136756768	136758595	H2afj	1827	+	NM_177688	136756860	136757250	1
chr6	136762174	136776737	Wbp11	14563	-	NM_021714	136762728	136774585	12
chr6	136777363	136789075	BC049715	11712	+	NM_178776	136788284	136789028	3
chr6	136778451	136783971	Smco3	5520	-	NM_001039558	136779717	136780395	2
chr6	136796971	136806121	Art4	9150	-	NM_026639	136798095	136805764	3
chr6	136820955	136824326	Mgp	3371	-	NM_008597	136821164	136824251	4
chr6	136855907	136870701	Erp27	14794	-	NM_026983	136855983	136870643	7
chr6	136872180	136890420	Arhgdib	18240	-	NM_001301301	136872647	136882282	6
chr6	136903043	136912004	Pde6h	8961	+	NM_023898	136907781	136911790	4
chr6	137003345	137119017	Rerg	115672	-	NM_181988	137004653	137113516	5
chr6	137200819	137413154	Ptpro	212335	+	NM_011216	137201206	137410278	27
chr6	137425765	137597806	Eps8	172041	-	NM_007945	137427536	137487901	22
chr6	137683602	137700451	Strap	16849	+	NM_011499	137683875	137699133	10
chr6	137703097	137786393	Dera	83296	+	NM_172733	137703128	137785693	9
chr6	137932110	138028437	Slc15a5	96327	-	NM_177787	137932870	138028437	9
chr6	138089057	138105273	Mgst1	16216	+	NM_019946	138096210	138104899	4
chr6	138313001	138530489	Lmo3	217488	-	NM_207222	138314462	138365141	5
chr6	138371625	138378113	A830011K09Rik	6488	+	NR_126073	138378113	138378113	4
chr6	138392493	138410136	Gm30332	17643	+	NR_126082	138410136	138410136	5
chr6	138529144	138547835	B230110G15Rik	18691	+	NR_131103	138547835	138547835	4
chr6	138605613	138606965	Igbp1b	1352	-	NM_015777	138605933	138606965	1
chr6	139264117	139271097	4922502N22Rik	6980	-	NR_045149	139271097	139271097	4
chr6	139441702	139450430	Rergl	8728	-	NM_001128090	139441734	139450395	5
chr6	139535771	139917804	Pik3c2g	382033	+	NM_207683	139570408	139916464	33
chr6	139938242	139989938	Plcz1	51696	-	NM_054066	139938291	139989126	14
chr6	139990045	139991307	Capza3	1262	+	NM_007605	139990197	139991097	1
chr6	140372619	140543427	Plekha5	170808	+	NM_144920	140372685	140542170	31
chr6	140572022	140626993	Aebp2	54971	+	NM_009637	140572215	140625939	9
chr6	141197789	141447872	Pde3a	250083	+	NM_018779	141198110	141447414	16
chr6	141289073	141292908	Gm10400	3835	+	NR_033555	141292908	141292908	1
chr6	141472906	141518698	Slco1c1	45792	+	NM_001177772	141479998	141518049	15
chr6	141578038	141635156	Slco1b2	57118	+	NM_020495	141582978	141634127	16
chr6	141753960	141804692	Slco1a4	50732	-	NM_030687	141755481	141793989	17
chr6	141855801	141895483	Slco1a1	39682	-	NM_013797	141857431	141895159	14
chr6	141920716	141957266	Gm6614	36550	-	NM_001081318	141920716	141957266	14
chr6	142034288	142134670	Slco1a6	100382	-	NM_023718	142034905	142109580	15
chr6	142182747	142271501	Slco1a5	88754	-	NM_130861	142183182	142224038	15
chr6	142246944	142252339	Iapp	5395	+	NM_010491	142247368	142252024	3
chr6	142294216	142311144	Pyroxd1	16928	+	NM_183165	142294252	142310522	12
chr6	142298861	142335607	Recql	36746	-	NM_001204907	142299030	142333064	16
chr6	142335762	142352378	Golt1b	16616	+	NM_025872	142335864	142350101	5
chr6	142361950	142368260	Spx	6310	+	NM_001242345	142361960	142367091	6
chr6	142371132	142421629	Gys2	50497	-	NM_145572	142371928	142421321	17
chr6	142438768	142456477	Ldhb	17709	-	NM_008492	142438956	142454060	8
chr6	142513458	142519876	Kcnj8	6418	-	NM_008428	142514124	142518899	3
chr6	142536381	142650794	Abcc9	114413	-	NM_021041	142542524	142646340	41
chr6	142563114	142574982	5330439B14Rik	11868	+	NR_037679	142574982	142574982	2
chr6	142705205	142724234	Cmas	19029	+	NM_009908	142705292	142723860	8
chr6	142734300	142752986	Gm766	18686	-	NM_001145390	142734826	142752910	6
chr6	142762750	142782014	Gm7457	19264	+	NR_045707	142782014	142782014	7
chr6	142770060	142912972	St8sia1	142912	-	NM_011374	142777303	142912288	5
chr6	142959439	143048672	C2cd5	89233	-	NM_029081	142960527	143048287	26
chr6	143115749	143157066	Etnk1	41317	+	NM_029250	143116000	143151976	8
chr6	143194407	143246399	D6Ertd474e	51992	+	NR_027803	143246399	143246399	4
chr6	143541872	143599808	1700060C16Rik	57936	-	NR_045732	143599808	143599808	5
chr6	143776944	144158088	Sox5	381144	-	NM_011444	143781783	144157888	15
chr6	144621387	144642352	Sox5os3	20965	+	NR_040519	144642352	144642352	3
chr6	144942354	145024677	Bcat1	82323	-	NM_007532	144948782	145024414	11
chr6	145064155	145123448	Lrmp	59293	+	NM_001281981	145086759	145123200	20
chr6	145123391	145159490	Casc1	36099	-	NM_177222	145123571	145159329	16
chr6	145159653	145165062	Lyrm5	5409	+	NM_001163628	145163746	145164086	3
chr6	145165218	145198751	Kras	33533	-	NM_021284	145169127	145195325	5
chr6	145199071	145200376	Gm15706	1305	+	NR_045598	145200376	145200376	2
chr6	145336144	145340743	1700073E17Rik	4599	+	NR_003625	145340743	145340743	1
chr6	145345754	145383445	Ifltd1	37691	-	NM_028742	145345867	145382285	10
chr6	145564482	145569997	Tuba3b	5515	+	NM_009449	145564606	145569907	5
chr6	145756902	145766104	Rassf8	9202	+	NM_027760	145756979	145765708	4
chr6	145806762	145813940	Bhlhe41	7178	-	NM_024469	145811371	145813787	5
chr6	145880392	145913745	Sspn	33353	+	NM_001310837	145904144	145910015	3
chr6	146056820	146450745	Itpr2	393925	-	NM_019923	146060192	146450400	57
chr6	146498153	146526357	Asun	28204	-	NM_138757	146498467	146524971	18
chr6	146526432	146547720	Fgfr1op2	21288	+	NM_026218	146534205	146545954	7
chr6	146550797	146583114	Tm7sf3	32317	-	NM_026281	146552280	146582983	12
chr6	146591100	146599122	Med21	8022	+	NM_025315	146591132	146598809	4
chr6	146595698	146596324	Gm6654	626	-	NR_038089	146596324	146596324	1
chr6	146605739	146613925	4930479D17Rik	8186	+	NR_046277	146613925	146613925	3
chr6	146673451	146727336	Stk38l	53885	+	NM_172734	146706993	146724243	14
chr6	146754051	146782051	Arntl2	28000	+	NM_001289680	146754051	146781168	15
chr6	146798631	146819926	Smco2	21295	+	NM_027059	146801120	146819867	10
chr6	146837015	146980545	Ppfibp1	143530	+	NM_001170433	146925160	146978922	28
chr6	146899822	146902943	1700034J05Rik	3121	-	NM_028509	146900773	146902064	3
chr6	146981058	146982040	Rep15	982	+	NM_025620	146981186	146981879	1
chr6	146991291	147019424	Mrps35	28133	+	NM_145573	146991316	147019345	8
chr6	147023583	147035554	Mansc4	11971	-	NM_001034903	147023624	147035486	3
chr6	147039596	147061300	Klhl42	21704	+	NM_001081237	147040053	147056668	3
chr6	147128762	147156816	E330012B07Rik	28054	+	NR_033640	147156816	147156816	3
chr6	147200630	147212535	Pthlh	11905	-	NM_008970	147201089	147211892	4
chr6	147424392	147581134	Ccdc91	156742	+	NM_025911	147456319	147580207	13
chr6	147638762	147650896	1700049E15Rik	12134	+	NR_033636	147650896	147650896	4
chr6	147995937	148131282	Far2	135345	+	NM_178797	148087094	148129528	13
chr6	148127839	148160896	Ergic2	33057	-	NM_026168	148130198	148155160	14
chr6	148160809	148184185	4732416N19Rik	23376	+	NR_015615	148184185	148184185	2
chr6	148180951	148392874	Tmtc1	211923	-	NM_198967	148186315	148392721	20
chr6	148303177	148304118	Rps4l	941	+	NR_003634	148304118	148304118	1
chr6	148555307	148562831	Gm6313	7524	-	NR_045867	148562831	148562831	3
chr6	148608499	148626522	4930528G23Rik	18023	-	NR_131024	148626522	148626522	4
chr6	148719205	148779989	Ipo8	60784	-	NM_001081113	148721311	148779769	25
chr6	148791013	148844759	Caprin2	53746	-	NM_181541	148791351	148843635	19
chr6	148869580	148894954	Fam60a	25374	-	NM_019643	148871392	148881651	6
chr6	148936590	149050202	Dennd5b	113612	-	NM_177192	148942227	149049831	21
chr6	149090034	149099692	Mettl20	9658	+	NM_001252095	149092671	149099207	5
chr6	149106098	149137234	Amn1	31136	-	NM_001113424	149106279	149137165	7
chr6	149257935	149284185	2810474O19Rik	26250	+	NM_001289661	149273979	149283271	6
chr6	149357505	149511848	Bicd1	154343	+	NM_009753	149357950	149498919	9
chr7	3128145	3144993	Speer9-ps1	16848	+	NR_001583	3144993	3144993	4
chr7	3154659	3169204	AU018091	14545	-	NM_001004153	3155978	3169130	12
chr7	3218626	3218709	Mir290a	83	+	NR_029640	3218709	3218709	1
chr7	3218638	3218696	Mir290b	58	-	NR_106158	3218696	3218696	1
chr7	3218784	3221016	D7Ertd143e	2232	+	NR_028425	3221016	3221016	1
chr7	3218919	3219001	Mir291a	82	+	NR_029641	3219001	3219001	1
chr7	3219189	3219271	Mir292	82	+	NR_029642	3219271	3219271	1
chr7	3219198	3219260	Mir292b	62	-	NR_106140	3219260	3219260	1
chr7	3219482	3219561	Mir291b	79	+	NR_030276	3219561	3219561	1
chr7	3220343	3220423	Mir293	80	+	NR_029643	3220423	3220423	1
chr7	3220641	3220725	Mir294	84	+	NR_029644	3220725	3220725	1
chr7	3220773	3220842	Mir295	69	+	NR_029645	3220842	3220842	1
chr7	3221510	3249741	Nlrp12	28231	-	NM_001033431	3222473	3249540	10
chr7	3289038	3299350	Myadm	10312	+	NM_001093764	3296724	3297687	3
chr7	3303657	3331154	Prkcg	27497	+	NM_011102	3303915	3330643	18
chr7	3336684	3366537	Cacng7	29853	+	NM_133189	3336684	3366537	5
chr7	3394383	3415366	Cacng8	20983	+	NM_133190	3394566	3415366	5
chr7	3422327	3424206	3300002P13Rik	1879	-	NR_126426	3424206	3424206	2
chr7	3425422	3436385	Cacng6	10963	+	NM_133183	3425422	3435658	4
chr7	3489956	3503433	Tarm1	13477	-	NM_177363	3489959	3503346	6
chr7	3561415	3567759	Oscar	6344	-	NM_175632	3562365	3567679	5
chr7	3568974	3571763	Ndufa3	2789	+	NM_025348	3568999	3571694	4
chr7	3571925	3581531	Tfpt	9606	-	NM_023524	3571956	3581176	6
chr7	3581586	3594086	Prpf31	12500	+	NM_027328	3582167	3592524	14
chr7	3596870	3612711	Cnot3	15841	+	NM_146176	3602452	3612428	18
chr7	3607563	3607649	Mir3572	86	+	NR_039587	3607649	3607649	1
chr7	3611708	3617442	Leng1	5734	-	NM_027203	3612742	3617049	4
chr7	3617355	3629155	Tmc4	11800	-	NM_181820	3617541	3629080	15
chr7	3629390	3645127	Mboat7	15737	-	NM_029934	3630060	3643717	8
chr7	3645211	3652637	Tsen34	7426	+	NM_001164205	3646203	3652317	5
chr7	3655642	3658499	Rps9	2857	+	NM_029767	3655953	3658430	5
chr7	3664106	3671984	Pirb	7878	-	NM_011095	3664252	3671928	15
chr7	3683234	3849752	Pira6	166518	-	NM_001289428	3835892	3849686	13
chr7	3788411	3796653	Pira2	8242	-	NM_011089	3789804	3796625	10
chr7	3788416	3867086	Pira1	78670	-	NM_011087	3789804	3867077	10
chr7	3789723	3849722	Pira7	59999	-	NM_011094	3789804	3849686	10
chr7	3789728	3849694	Pira4	59966	-	NM_011091	3789804	3849686	10
chr7	3789755	3849695	Pira11	59940	-	NM_011088	3789804	3849686	10
chr7	3835813	3849694	Gm14548	13881	-	NM_001166672	3835892	3849686	10
chr7	3859881	3867103	Lilra6	7222	-	NM_011090	3860287	3867077	9
chr7	3958674	4014806	Lair1	56132	-	NM_001113474	3961292	4014704	8
chr7	4025726	4072330	9430041J12Rik	46604	-	NR_033568	4072330	4072330	9
chr7	4071131	4087009	Ttyh1	15878	+	NM_001109765	4071256	4085303	14
chr7	4077941	4088528	D030047H15Rik	10587	-	NR_033548	4088528	4088528	3
chr7	4088657	4099775	Leng8	11118	+	NM_172736	4090352	4097190	15
chr7	4099784	4101474	Leng9	1690	-	NM_175529	4099819	4101277	1
chr7	4102861	4116301	Cdc42ep5	13440	-	NM_021454	4102936	4103389	3
chr7	4189355	4195065	Lilra5	5710	+	NM_001081239	4189359	4193848	6
chr7	4289325	4296766	Ncr1	7441	+	NM_010746	4289350	4296306	7
chr7	4320314	4349346	Gp6	29032	-	NM_001163014	4320464	4349286	8
chr7	4377266	4397259	Rdh13	19993	-	NM_175372	4379159	4397113	7
chr7	4416336	4432089	Eps8l1	15753	+	NM_026146	4416997	4430529	20
chr7	4418846	4422486	D630041G03Rik	3640	-	NR_028416	4422486	4422486	1
chr7	4433122	4453282	Ppp1r12c	20160	-	NM_029834	4433673	4453200	22
chr7	4456171	4467577	Tnnt1	11406	-	NM_001277903	4456356	4465970	14
chr7	4469909	4474045	Tnni3	4136	-	NM_009406	4469969	4473917	8
chr7	4474558	4484044	Dnaaf3	9486	-	NM_001033548	4474917	4483873	12
chr7	4491366	4498169	Syt5	6803	-	NM_016908	4491699	4497913	8
chr7	4500215	4555643	Ptprh	55428	-	NM_207270	4500949	4554700	20
chr7	4579641	4582084	Tmem86b	2443	-	NM_023440	4579972	4581874	3
chr7	4583096	4610552	Ppp6r1	27456	-	NM_172894	4583842	4598536	24
chr7	4612122	4636565	Hspbp1	24443	-	NM_024172	4612372	4636077	8
chr7	4642529	4667599	Brsk1	25070	+	NM_001003920	4642681	4667092	19
chr7	4658433	4676853	Tmem150b	18420	-	NM_177887	4660609	4676577	5
chr7	4691728	4699116	Suv420h2	7388	+	NM_001115018	4693473	4698493	9
chr7	4703393	4704696	Cox6b2	1303	-	NM_001289850	4703560	4704437	4
chr7	4704828	4722872	Fam71e2	18044	-	NM_172895	4705176	4722713	11
chr7	4723979	4734459	Il11	10480	-	NM_001290423	4725168	4727929	5
chr7	4734541	4735942	Tmem190	1401	+	NM_030028	4734584	4735901	5
chr7	4736386	4741162	Tmem238	4776	-	NM_029384	4740613	4741144	2
chr7	4744566	4746149	Rpl28	1583	+	NM_009081	4744930	4746109	5
chr7	4759615	4763942	Ube2s	4327	-	NM_133777	4759756	4763767	4
chr7	4777153	4796298	Shisa7	19145	-	NM_172737	4781236	4788325	6
chr7	4796561	4817781	Isoc2b	21220	-	NM_026158	4796871	4803132	6
chr7	4828654	4847318	Isoc2a	18664	+	NM_001101598	4842794	4847002	6
chr7	4866818	4873605	Zfp628	6787	+	NM_170759	4870382	4873499	3
chr7	4873852	4876608	Nat14	2756	+	NM_201355	4874859	4876053	3
chr7	4877445	4896399	Ssc5d	18954	+	NM_173008	4877556	4896366	14
chr7	4908682	4915950	Sbk2	7268	-	NM_001146329	4908682	4914785	4
chr7	4916861	4922563	Sbk3	5702	-	NM_001200041	4918941	4922225	4
chr7	4944453	4947703	Zfp579	3250	-	NM_026741	4944823	4946512	2
chr7	4958657	4966330	Fiz1	7673	-	NM_001110329	4959616	4964591	3
chr7	4967109	4970090	Zfp524	2981	+	NM_025324	4969076	4970042	2
chr7	4971977	4984825	Zfp865	12848	+	NM_001033383	4980619	4983796	3
chr7	4986047	4990048	Zfp784	4001	-	NM_001039532	4987265	4990014	2
chr7	5003133	5005325	Zfp580	2192	+	NM_026900	5004418	5004937	2
chr7	5007753	5012386	Ccdc106	4633	+	NM_001290429	5007786	5012125	6
chr7	5013744	5031547	U2af2	17803	+	NM_133671	5013889	5030918	12
chr7	5031836	5049780	Epn1	17944	+	NM_010147	5035356	5049382	12
chr7	5061388	5068513	Rfpl4	7125	-	NM_001145013	5061918	5067171	3
chr7	5076543	5077552	Rasl2-9	1009	-	NM_009028	5076880	5077531	1
chr7	5098091	5099024	Vmn1r55	933	-	NM_001166706	5098091	5099024	1
chr7	5146517	5148349	Vmn1r56	1832	-	NM_030740	5147285	5148218	1
chr7	5172079	5173012	Vmn1r57	933	+	NM_001166734	5172079	5173012	1
chr7	5250148	5302637	Nlrp2	52489	-	NM_177690	5250337	5289415	12
chr7	5302143	5312284	Gm5065	10141	+	NR_003622	5312284	5312284	2
chr7	5360491	5364747	Vmn1r58	4256	-	NM_030739	5361898	5362831	2
chr7	5405428	5406361	Vmn1r59	933	-	NM_207543	5405428	5406361	1
chr7	5432057	5445453	Vmn2r28	13396	-	NM_001081405	5432242	5445453	6
chr7	5495798	5496701	Vmn1r60	903	-	NM_001166732	5495798	5496701	1
chr7	5562012	5562915	Vmn1r61	903	-	NM_001166733	5562012	5562915	1
chr7	5626205	5628199	Vmn1r62	1994	+	NM_030741	5626923	5627826	1
chr7	5626923	5627826	Vmn1r186	903	+	NM_001167567	5626923	5627826	1
chr7	5753949	5757047	Vmn1r63	3098	-	NM_030742	5754330	5755233	2
chr7	5754330	5755233	Vmn1r187	903	-	NM_001167568	5754330	5755233	1
chr7	5835181	5836144	Vmn1r64	963	-	NM_207544	5835181	5836144	1
chr7	5959351	5962612	Vmn1r65	3261	-	NM_030738	5959836	5960835	3
chr7	5996762	6056751	Nlrp4c	59989	+	NM_031389	6012196	6056213	10
chr7	6083090	6107573	Zfp787	24483	-	NM_001013012	6083706	6094742	3
chr7	6124114	6144706	Zfp444	20592	+	NM_001146024	6135492	6141582	5
chr7	6148691	6167739	Galp	19048	+	NM_178028	6154402	6167707	6
chr7	6173879	6191014	Zscan5b	17135	+	NM_133204	6181780	6190792	6
chr7	6204311	6233463	Gm6792	29152	+	NM_001177416	6204409	6233097	11
chr7	6238181	6259485	Zfp667	21304	+	NM_001024928	6241006	6257766	5
chr7	6267266	6282036	Zfp583	14770	-	NM_001033249	6267906	6280865	5
chr7	6316014	6335315	Zfp78	19301	+	NM_177888	6324070	6332201	5
chr7	6336027	6349347	Zfp28	13320	+	NM_175247	6336103	6347755	7
chr7	6367885	6383797	Gm16532	15912	+	NM_001134752	6377427	6382101	4
chr7	6392612	6393578	Olfr1344	966	+	NM_177061	6392612	6393578	1
chr7	6413221	6414166	Olfr1336	945	+	NM_146915	6413221	6414166	1
chr7	6426822	6427764	Olfr1346	942	+	NM_146916	6426822	6427764	1
chr7	6432926	6439524	Olfr5	6598	-	NM_146914	6432926	6433865	2
chr7	6440623	6441583	Olfr1347	960	-	NM_146385	6440623	6441583	1
chr7	6453996	6454935	Olfr1348	939	-	NM_146913	6453996	6454935	1
chr7	6467184	6468138	Olfr1349	954	-	NM_207136	6467184	6468138	1
chr7	6522703	6523630	Olfr1350	927	+	NM_146389	6522703	6523630	1
chr7	6604458	6615079	Zim2	10621	-	NR_131759	6615079	6615079	5
chr7	6628153	6649143	Zim1	20990	-	NM_011769	6629633	6641383	8
chr7	6658670	6683130	Peg3	24460	-	NM_008817	6660216	6671152	9
chr7	6659470	6660335	Peg3os	865	+	NR_023846	6660335	6660335	1
chr7	6683293	6919930	Usp29	236637	+	NM_001290994	6913870	6916480	9
chr7	6756297	6756381	Mir3099	84	+	NR_037213	6756381	6756381	1
chr7	6908396	6929373	Zim3	20977	-	NR_036631	6929373	6929373	7
chr7	6948095	6955802	Aurkc	7707	+	NM_020572	6948989	6955656	7
chr7	7067393	7074187	Zfp954	6794	-	NM_172738	7068003	7074011	5
chr7	7083388	7089466	Zfp773	6078	-	NM_029584	7084890	7089359	4
chr7	7124063	7136271	Zfp418	12208	+	NM_146179	7124242	7135709	4
chr7	7154832	7162709	Zfp772	7877	-	NM_145577	7156150	7162506	5
chr7	7165706	7231000	Vmn2r29	65294	-	NR_003555	7231000	7231000	7
chr7	7235019	7252268	Clcn4	17249	-	NM_011334	7236894	7249539	13
chr7	7251601	7251657	Mir5620	56	+	NR_049193	7251657	7251657	1
chr7	7264984	7290204	Vmn2r30	25220	-	NM_009490	7264984	7290204	6
chr7	7336695	7352338	Vmn2r31	15643	-	NM_001105062	7336695	7352338	6
chr7	7416679	7432684	Vmn2r32	16005	-	NM_001105063	7416679	7432684	6
chr7	7503677	7519497	Vmn2r33	15820	-	NM_001105065	7503677	7519497	6
chr7	7624539	7642109	Vmn2r34	17570	-	NM_001105066	7624539	7642109	6
chr7	7829363	7855173	Vmn2r36	25810	-	NM_001105068	7829363	7855173	6
chr7	8639867	8851885	Vmn2r35	212018	+	NM_001105067	8639867	8851885	6
chr7	8954256	8972357	Vmn2r37	18101	+	NM_009489	8954371	8971803	6
chr7	9080031	9103001	Vmn2r38	22970	+	NM_001105070	9080031	9103001	6
chr7	9147158	9163091	Vmn2r39	15933	+	NM_001105071	9147158	9163091	6
chr7	9246438	9270107	Vmn2r40	23669	+	NM_001105072	9246438	9270107	6
chr7	9638310	9655801	Vmn2r45	17491	+	NM_001105075	9638310	9655801	6
chr7	9744079	9759858	Vmn2r44	15779	+	NM_001105074	9744079	9759858	6
chr7	9866726	9882971	Vmn2r43	16245	+	NM_198961	9866760	9882702	6
chr7	9927006	9944061	Vmn2r42	17055	+	NM_009493	9927122	9943117	6
chr7	9965778	9989425	Vmn2r41	23647	+	NM_001105073	9965778	9989425	6
chr7	10034292	10041283	2810047C21Rik1	6991	+	NR_015598	10041283	10041283	6
chr7	10092186	10116991	Vmn2r47	24805	+	NM_001105151	10092186	10116991	6
chr7	10339984	10355920	Vmn2r46	15936	-	NM_001105076	10339984	10355920	6
chr7	10512972	10538934	Vmn2r48	25962	-	NM_001105152	10512972	10538934	6
chr7	10561593	10577488	Vmn2r49	15895	-	NM_001105156	10561593	10577488	6
chr7	10622583	10638527	Vmn2r50	15944	-	NM_001105178	10622583	10638527	6
chr7	10672546	10691008	Vmn2r51	18462	-	NM_001105179	10672546	10691008	6
chr7	10744000	10761635	Vmn2r52	17635	-	NM_001105191	10744000	10761635	6
chr7	10859176	10860700	Vmn1r66	1524	-	NM_134230	10859520	10860453	1
chr7	11032137	11033136	Vmn1r67	999	+	NM_134229	11032159	11033077	1
chr7	11072572	11080730	Zik1	8158	-	NM_009577	11075125	11079871	4
chr7	11112558	11113518	Vmn1r68	960	-	NM_001172072	11112558	11113518	1
chr7	11165104	11166836	Vmn1r69	1732	-	NM_145842	11165191	11166151	1
chr7	11218935	11219832	Vmn1r70	897	+	NM_134228	11218935	11219832	1
chr7	11273141	11315507	Nlrp4b	42366	+	NM_172481	11295474	11314992	9
chr7	11332850	11334887	Vmn1r71	2037	-	NM_145848	11333184	11334108	1
chr7	11379589	11384414	Zscan4a	4825	-	NR_033707	11384414	11384414	4
chr7	11486088	11490399	Zscan4b	4311	-	NM_001185173	11486145	11489564	4
chr7	11591093	11595896	Zscan4c	4803	+	NM_001013765	11591904	11595345	4
chr7	11746991	11751497	Zscan4d	4506	-	NM_001100186	11747269	11750697	4
chr7	11983263	11987667	Zscan4f	4404	+	NM_001110316	11984097	11987538	4
chr7	12254947	12255868	Vmn1r72	921	-	NM_145843	12254947	12255868	1
chr7	12341605	12342517	Vmn1r73	912	+	NM_134203	12341605	12342517	1
chr7	12432123	12433038	Vmn1r74	915	+	NM_134206	12432123	12433038	1
chr7	12465691	12466609	Vmn1r75	918	+	NM_134207	12465691	12466609	1
chr7	12515659	12516634	Vmn1r76	975	-	NM_134205	12515659	12516634	1
chr7	12626647	12627568	Vmn1r77	921	+	NM_001166731	12626647	12627568	1
chr7	12737812	12738754	Vmn1r78	942	+	NM_134208	12737812	12738754	1
chr7	12761541	12762462	Vmn1r79	921	+	NM_001166835	12761541	12762462	1
chr7	12778313	12779240	Vmn1r80	927	+	NM_134204	12778313	12779240	1
chr7	12806664	12811156	Gm4224	4492	+	NR_046074	12811156	12811156	3
chr7	12845107	12846028	Vmn1r81	921	-	NM_134210	12845107	12846028	1
chr7	12890153	12891068	Vmn1r82	915	+	NM_134234	12890153	12891068	1
chr7	12906556	12907477	Vmn1r83	921	-	NM_134209	12906556	12907477	1
chr7	12947156	12948113	Vmn1r84	957	-	NM_134233	12947156	12948113	1
chr7	13000496	13007840	Zfp551	7344	-	NM_001033820	13000738	13007837	4
chr7	13063653	13081584	Zfp606	17931	+	NM_001310620	13066524	13079687	8
chr7	13097899	13141670	2900092C05Rik	43771	+	NM_028434	13097927	13141402	6
chr7	13166818	13191893	Vmn2r53	25075	-	NM_001104644	13166818	13191893	5
chr7	13200581	13221483	Vmn2r54	20902	-	NM_001081449	13200581	13221483	5
chr7	13237054	13270340	Vmn2r55	33286	-	NM_001104645	13237054	13270340	5
chr7	13279346	13318454	Vmn2r56	39108	-	NM_001104648	13279346	13318454	6
chr7	13353440	13361007	Zscan18	7567	-	NM_001017955	13354549	13360920	6
chr7	13389126	13404209	Zfp329	15083	-	NM_026046	13395375	13396944	2
chr7	13420158	13435933	Zfp110	15775	+	NM_022981	13420831	13435274	8
chr7	13466526	13478771	Zfp128	12245	+	NM_153802	13466643	13476774	4
chr7	13483157	13494432	Zscan22	11275	+	NM_001290436	13489031	13492670	3
chr7	13507659	13512035	Rps5	4376	+	NM_009095	13508322	13511989	6
chr7	13512764	13516421	Rnf225	3657	+	NM_029809	13513244	13514243	2
chr7	13551212	13559171	Zfp324	7959	+	NM_178732	13551564	13556986	4
chr7	13563196	13571065	Zfp446	7869	+	NM_175558	13563200	13568024	6
chr7	13573695	13583541	Slc27a5	9846	-	NM_009512	13573824	13583411	10
chr7	13591014	13595149	Zbtb45	4135	-	NM_001024699	13591472	13593678	3
chr7	13609500	13616381	Trim28	6881	+	NM_011588	13610067	13616211	17
chr7	13617354	13620126	Chmp2a	2772	-	NM_026885	13617423	13619345	6
chr7	13620468	13623624	Ube2m	3156	-	NM_001168469	13620962	13621616	7
chr7	13627651	13640113	Mzf1	12462	-	NM_001290453	13628616	13630035	7
chr7	13669637	13670564	Vmn1r85	927	-	NM_145847	13669637	13670564	1
chr7	13687345	13688296	Vmn1r86	951	-	NM_001167536	13687345	13688296	1
chr7	13716819	13717707	Vmn1r87	888	-	NM_134227	13716819	13717707	1
chr7	13763067	13764018	Vmn1r88	951	+	NM_001167537	13763067	13764018	1
chr7	13804687	13805638	Vmn1r89	951	+	NM_134226	13804687	13805638	1
chr7	13844315	13864070	6330408A02Rik	19755	-	NM_177312	13845026	13862769	5
chr7	13862661	13896776	Lig1	34115	+	NM_001199310	13865505	13896625	29
chr7	13911015	13946017	Pla2g4c	35002	+	NM_001168504	13911088	13942492	16
chr7	13983503	13994227	Cabp5	10724	+	NM_013877	13983656	13993157	6
chr7	14036189	14058799	Bsph1	22610	+	NM_001033418	14036262	14058451	5
chr7	14140214	14156416	Bsph2	16202	-	NM_001080942	14140329	14156397	5
chr7	14209315	14256156	Sult2a5	46841	+	NM_001184980	14209393	14256046	6
chr7	14318854	14364986	Sult2a2	46132	+	NM_009286	14318907	14364883	4
chr7	14381594	14422759	Sult2a1	41165	-	NM_001111296	14381703	14422705	6
chr7	14495025	14574937	Sult2a4	79912	-	NM_001101534	14495134	14574937	6
chr7	14652903	14708342	Sult2a3	55439	-	NM_001101586	14652903	14708342	6
chr7	14807751	14840219	Sult2a6	32468	-	NM_001081325	14807825	14840182	6
chr7	14996034	15031936	Sult2a8	35902	-	NM_175250	14997055	15013268	7
chr7	15050507	15078275	Sult2a7	27768	-	NM_001184981	15050507	15078275	7
chr7	15116002	15207827	Nlrp5-ps	91825	-	NR_045120	15207827	15207827	13
chr7	15146590	15147520	Vmn1r90	930	-	NM_001244031	15146590	15147520	1
chr7	15245056	15251345	Obox7	6289	+	NM_001038676	15249385	15250856	4
chr7	15974199	15983892	Obox2	9693	+	NM_145708	15982193	15983222	4
chr7	16132605	16142195	Obox1	9590	+	NM_027802	16140510	16141697	4
chr7	16210654	16225126	Obox3	14472	-	NM_145707	16211083	16212687	5
chr7	16335718	16344623	Obox5	8905	+	NM_145709	16342885	16344346	4
chr7	16418598	16425028	Obox6	6430	-	NM_145710	16418825	16420298	3
chr7	16451295	16465304	Crx	14009	-	NM_007770	16453128	16456592	4
chr7	16467965	16485648	Crxos	17683	+	NR_038092	16485648	16485648	5
chr7	16502556	16507720	Sepw1	5164	-	NM_009156	16505211	16507629	6
chr7	16523184	16531457	Gltscr2	8273	-	NM_133831	16523231	16531402	13
chr7	16524110	16524209	Snord23	99	-	NR_028539	16524209	16524209	1
chr7	16534335	16552884	Ehd2	18549	-	NM_153068	16535589	16549659	6
chr7	16556610	16584844	Gltscr1	28234	-	NM_001081418	16557126	16581940	14
chr7	16657290	16681677	Zfp541	24387	+	NM_001099277	16657290	16681208	16
chr7	16683991	16703324	Napa	19333	+	NM_025898	16684025	16701914	11
chr7	16705224	16712865	Kptn	7641	+	NM_133727	16705307	16712592	12
chr7	16715648	16745860	Slc8a2	30212	+	NM_148946	16719193	16744529	10
chr7	16760743	16771857	Meis3	11114	+	NM_008627	16760904	16770846	13
chr7	16782569	16807381	Dhx34	24812	-	NM_027883	16782645	16804047	17
chr7	16819933	16829503	C5ar2	9570	-	NM_176912	16822272	16829397	2
chr7	16832091	16844889	C5ar1	12798	-	NM_007577	16833386	16844496	3
chr7	16857361	16859041	Inafm1	1680	-	NM_001136270	16858246	16858639	1
chr7	16859390	16872144	Ccdc9	12754	-	NM_001136471	16859661	16869849	14
chr7	16894931	16903683	Bbc3	8752	+	NM_133234	16897489	16902583	4
chr7	16905584	16973245	Sae1	67661	-	NM_001285891	16913185	16973099	10
chr7	16986544	17023045	Zc3h4	36501	+	NM_198631	16986641	17020859	14
chr7	17038127	17040839	Tmem160	2712	+	NM_026938	17038311	17040775	3
chr7	17041069	17062129	Npas1	21060	-	NM_008718	17041183	17060977	12
chr7	17079821	17200342	Arhgap35	120521	-	NM_172739	17083001	17150487	7
chr7	17234378	17242827	Ceacam-ps1	8449	-	NR_003247	17242827	17242827	3
chr7	17256679	17261054	Ceacam15	4375	-	NM_175315	17257268	17260957	3
chr7	17307277	17311459	Ceacam9	4182	+	NM_011927	17307318	17310831	3
chr7	17323792	17334639	Ap2s1	10847	+	NM_198613	17323884	17334362	5
chr7	17366694	17383623	Slc1a5	16929	+	NM_009201	17367249	17383088	9
chr7	17394615	17402081	Fkrp	7466	-	NM_173430	17395799	17397284	3
chr7	17401237	17426280	Strn4	25043	+	NM_133789	17401701	17425259	18
chr7	17428250	17455810	Prkd2	27560	+	NM_001252458	17428972	17455372	19
chr7	17460665	17472650	Dact3	11985	+	NM_001081655	17460773	17471763	4
chr7	17477134	17480784	Gng8	3650	+	NM_010320	17480292	17480712	4
chr7	17491838	17496254	Ptgir	4416	+	NM_008967	17492133	17494463	2
chr7	17500727	17509381	Calm3	8654	-	NM_007590	17502296	17509192	6
chr7	17530030	17534177	Pnmal2	4147	+	NM_001099636	17530441	17532427	1
chr7	17545143	17547669	Pnmal1	2526	+	NM_001007569	17545570	17547385	3
chr7	17579936	17581994	Ccdc8	2058	+	NM_001101535	17579936	17581994	1
chr7	17589989	17613263	Ppp5c	23274	-	NM_011155	17590457	17613162	13
chr7	17616341	17647776	Hif3a	31435	-	NM_001162950	17621216	17647730	15
chr7	17659388	17718799	Psg16	59411	+	NM_001310628	17675914	17716018	6
chr7	17735748	17748580	Ceacam3	12832	+	NM_054059	17735748	17748580	7
chr7	17788825	17801105	Psg29	12280	+	NM_054064	17789016	17797262	5
chr7	18257661	18267409	Psg-ps1	9748	+	NR_002857	18267409	18267409	5
chr7	18298600	18346470	Ceacam5	47870	+	NM_028480	18298795	18346261	9
chr7	18398030	18400976	Ceacam14	2946	+	NM_025957	18398112	18400826	3
chr7	18557515	18563905	Ceacam11	6390	+	NM_023289	18557597	18563888	4
chr7	18595237	18604569	Ceacam13	9332	+	NM_027210	18595318	18604438	4
chr7	18651277	18663335	Ceacam12	12058	+	NM_001162523	18651409	18662814	4
chr7	18761842	18767211	Igfl3	5369	+	NM_001003393	18761875	18767092	4
chr7	18830695	18851441	Mill1	20746	+	NM_153749	18830958	18850403	5
chr7	18931156	18940356	Psg18	9200	-	NM_011963	18931192	18940166	5
chr7	19007884	19017404	Psg28	9520	-	NM_054063	19008238	19017214	5
chr7	19059930	19069498	Psg26	9568	-	NM_001029893	19060402	19069340	5
chr7	19105050	19117576	Psg25	12526	-	NM_054060	19106510	19117397	5
chr7	19141862	19152654	Psg27	10792	-	NM_001037168	19142200	19152475	5
chr7	19191691	19201850	Psg23	10159	-	NM_020261	19192260	19201656	5
chr7	19232002	19242074	Psg21	10072	-	NM_027403	19232549	19241878	5
chr7	19259714	19271341	Psg20	11627	-	NM_054058	19259714	19271341	6
chr7	19303438	19312597	Psg22	9159	+	NM_001004152	19303625	19312341	5
chr7	19371650	19374763	Sycp1-ps1	3113	+	NR_024208	19374763	19374763	1
chr7	19374473	19383859	Psg19	9386	-	NM_011964	19375399	19383666	5
chr7	19399285	19406940	Psg17	7655	-	NM_007677	19399765	19406764	5
chr7	19425314	19444002	Mill2	18688	+	NM_153761	19425340	19443976	6
chr7	19470038	19475787	Pglyrp1	5749	+	NM_009402	19470074	19475691	3
chr7	19476232	19495753	Ccdc61	19521	-	NM_001033314	19476424	19489278	14
chr7	19511236	19550668	Nova2	39432	+	NM_001029877	19511428	19543967	4
chr7	19572872	19574311	Nanos2	1439	+	NM_194064	19572953	19573364	1
chr7	19576593	19587115	Mypop	10522	+	NM_145579	19577458	19586510	3
chr7	19589413	19592112	Irf2bp1	2699	+	NM_178757	19589785	19591540	1
chr7	19598631	19608888	Foxa3	10257	-	NM_008260	19599486	19608766	2
chr7	19609725	19639971	Sympk	30246	+	NM_026605	19614231	19639866	27
chr7	19640035	19659796	Rsph6a	19761	+	NM_031255	19640093	19659624	6
chr7	19661548	19668124	Dmwd	6576	+	NM_010058	19661618	19667672	5
chr7	19669197	19679169	Dmpk	9972	+	NM_001190490	19669343	19678451	16
chr7	19672176	19672241	Mir3100	65	+	NR_037282	19672241	19672241	1
chr7	19679892	19683694	Six5	3802	+	NM_011383	19679985	19683094	3
chr7	19705207	19723610	Fbxo46	18403	+	NM_175530	19720806	19722618	2
chr7	19725565	19734545	Qpctl	8980	-	NM_026111	19726502	19734534	7
chr7	19735186	19738075	Snrpd2	2889	+	NM_026943	19735241	19737999	3
chr7	19742473	19751476	Gipr	9003	-	NM_001080815	19742716	19750373	14
chr7	19766518	19791831	Eml2	25313	+	NM_028153	19766552	19791560	19
chr7	19766813	19766911	Mir330	98	+	NR_029763	19766911	19766911	1
chr7	19797886	19809525	Gpr4	11639	+	NM_175668	19807503	19808601	2
chr7	19813737	19832166	Opa3	18429	+	NM_207525	19813791	19830500	2
chr7	19842278	19857203	Vasp	14925	-	NM_009499	19843065	19856867	13
chr7	19862155	19865398	Ppm1n	3243	-	NM_177691	19862546	19865373	5
chr7	19867972	19881513	Rtn2	13541	+	NM_013648	19868180	19881143	10
chr7	19888044	19895394	Fosb	7350	-	NM_008036	19890189	19894780	4
chr7	19930419	19941873	Ercc1	11454	+	NM_007948	19930961	19941821	10
chr7	19941357	19944832	Cd3eap	3475	-	NM_145822	19942329	19944758	3
chr7	19946564	19963882	Ppp1r13l	17318	+	NM_001010836	19953916	19963354	13
chr7	19967387	19981041	Ercc2	13654	+	NM_007949	19967403	19979793	23
chr7	19971991	19972066	Mir343	75	+	NR_030759	19972066	19972066	1
chr7	19979788	19989453	Klc3	9665	-	NM_001286039	19979989	19984890	13
chr7	19996442	20006932	Ckm	10490	+	NM_007710	19999486	20006735	8
chr7	20002814	20006766	A930016O22Rik	3952	-	NR_073014	20006766	20006766	4
chr7	20011423	20043843	Mark4	32420	-	NM_172279	20011423	20043843	17
chr7	20091152	20093680	Bloc1s3	2528	-	NM_177692	20092362	20092950	2
chr7	20094077	20101494	Trappc6a	7417	+	NM_025960	20094097	20101226	6
chr7	20104079	20110399	Nkpd1	6320	+	NM_027116	20104079	20110124	4
chr7	20116315	20147747	Ppp1r37	31432	-	NM_199149	20116859	20147379	13
chr7	20150297	20158692	Gemin7	8395	-	NM_027189	20150627	20151017	2
chr7	20162635	20166005	Zfp296	3370	+	NM_022409	20162730	20165908	3
chr7	20166386	20189835	Clasrp	23449	-	NR_125832	20189835	20189835	21
chr7	20191570	20214787	Relb	23217	-	NM_009046	20191901	20214591	11
chr7	20216928	20250379	Clptm1	33451	-	NM_019649	20219039	20250354	14
chr7	20256927	20263290	Apoc2	6363	-	NM_001277944	20257109	20258950	5
chr7	20256927	20266809	Apoc4-apoc2	9882	-	NM_001309799	20257109	20258950	4
chr7	20263432	20266809	Apoc4	3377	-	NM_007385	20263495	20266729	3
chr7	20274828	20278008	Apoc1	3180	-	NM_001110009	20274924	20277817	4
chr7	20281592	20284537	Apoe	2945	-	NM_001305843	20281728	20283579	5
chr7	20286661	20300778	Tomm40	14117	-	NM_016871	20287066	20300603	10
chr7	20301992	20334922	Pvrl2	32930	-	NM_008990	20302863	20334651	9
chr7	20341486	20355881	Bcam	14395	-	NM_020486	20341962	20355819	15
chr7	20365066	20382158	Cblc	17092	-	NM_023224	20366186	20382131	12
chr7	20393810	20408104	Bcl3	14294	-	NM_033601	20394220	20408026	9
chr7	20437351	20443704	Gm19345	6353	+	NM_001270489	20437505	20443235	4
chr7	20437445	20446648	Ceacam16	9203	-	NM_001033419	20437651	20446500	6
chr7	20461090	20473314	Ceacam19	12224	-	NM_177036	20463475	20473154	7
chr7	20488926	20506492	Pvr	17566	-	NM_027514	20490475	20506380	8
chr7	20522653	20536092	Igsf23	13439	-	NM_027308	20523593	20535857	5
chr7	20550760	20576460	Ceacam20	25700	+	NM_027839	20550836	20575375	12
chr7	20593371	20648287	Nlrp9b	54916	+	NM_194058	20604520	20648088	10
chr7	20686506	20687430	Vmn1r91	924	+	NM_001166736	20686506	20687430	1
chr7	20707004	20707928	Gm16442	924	-	NM_001167148	20707004	20707928	1
chr7	20707004	20707928	Gm16451	924	-	NM_001167149	20707004	20707928	1
chr7	20723471	20724437	Gm10666	966	-	NM_001167573	20723471	20724437	1
chr7	20723471	20724437	Vmn1r93	966	-	NM_207547	20723471	20724437	1
chr7	20752808	20753726	Vmn1r94	918	-	NM_001166723	20752808	20753726	1
chr7	20752808	20753726	Vmn1r142	918	-	NM_001166749	20752808	20753726	1
chr7	20779058	20779982	Vmn1r95	924	+	NM_001167538	20779058	20779982	1
chr7	20779058	20779982	Vmn1r143	924	+	NM_001166750	20779058	20779982	1
chr7	20790032	20790956	Gm6164	924	-	NM_001167153	20790032	20790956	1
chr7	20790032	20790956	Gm8653	924	-	NM_001167152	20790032	20790956	1
chr7	20818256	20819177	Gm4498	921	-	NM_001167151	20818256	20819177	1
chr7	20818256	20819177	Gm8453	921	-	NM_001167150	20818256	20819177	1
chr7	20818256	20819177	Vmn1r118	921	-	NM_001166742	20818256	20819177	1
chr7	20918490	20919414	Gm4133	924	-	NM_001167158	20918490	20919414	1
chr7	20918490	20919414	Gm4187	924	-	NM_001167159	20918490	20919414	1
chr7	20941974	20944267	Vmn1r-ps79	2293	-	NR_030707	20944267	20944267	1
chr7	20959841	20960759	Gm5728	918	-	NM_001166713	20959841	20960759	1
chr7	20959841	20960759	Gm8660	918	-	NM_001166751	20959841	20960759	1
chr7	21003290	21004214	Vmn1r100	924	+	NM_001166844	21003290	21004214	1
chr7	21027018	21027942	Vmn1r101	924	-	NM_001166836	21027018	21027942	1
chr7	21027018	21027942	Vmn1r149	924	-	NM_001166840	21027018	21027942	1
chr7	21059308	21060274	Gm10665	966	-	NM_001167160	21059308	21060274	1
chr7	21059308	21060274	Gm10670	966	-	NM_001167161	21059308	21060274	1
chr7	21094965	21095883	Vmn1r103	918	-	NM_001166737	21094965	21095883	1
chr7	21119185	21120109	Vmn1r104	924	+	NM_001166738	21119185	21120109	1
chr7	21119185	21120109	Vmn1r152	924	+	NM_001166752	21119185	21120109	1
chr7	21130182	21131106	Gm5726	924	-	NM_001167146	21130182	21131106	1
chr7	21130182	21131106	Gm8677	924	-	NM_001167147	21130182	21131106	1
chr7	21160669	21161590	Gm4141	921	-	NM_001167163	21160669	21161590	1
chr7	21160669	21161590	Gm4201	921	-	NM_001167162	21160669	21161590	1
chr7	21254266	21255190	Vmn1r107	924	+	NM_001166759	21254266	21255190	1
chr7	21254266	21255190	Vmn1r130	924	+	NM_001166848	21254266	21255190	1
chr7	21254266	21255190	Vmn1r137	924	+	NM_001166849	21254266	21255190	1
chr7	21254266	21255190	Vmn1r155	924	+	NM_001166753	21254266	21255190	1
chr7	21254266	21255190	Vmn1r165	924	+	NM_001166850	21254266	21255190	1
chr7	21287647	21288568	Gm8693	921	-	NM_001167154	21287647	21288568	1
chr7	21309847	21315960	Gm4567	6113	-	NM_001037248	21310254	21311160	3
chr7	21357946	21358840	Vmn1r157	894	+	NM_001166754	21357946	21358840	1
chr7	21487314	21488235	Vmn1r111	921	-	NM_001166746	21487314	21488235	1
chr7	21487314	21488235	Vmn1r131	921	-	NM_001166839	21487314	21488235	1
chr7	21487314	21488235	Vmn1r138	921	-	NM_001167169	21487314	21488235	1
chr7	21487314	21488235	Vmn1r166	921	-	NM_001167168	21487314	21488235	1
chr7	21556203	21557097	Vmn1r112	894	+	NM_001166847	21556203	21557097	1
chr7	21572303	21573227	Vmn1r113	924	+	NM_001166716	21572303	21573227	1
chr7	21596239	21597205	Vmn1r114	966	-	NM_001166837	21596239	21597205	1
chr7	21629116	21630004	Vmn1r115	888	-	NM_001166745	21629116	21630004	1
chr7	21657274	21658198	Vmn1r116	924	+	NM_001166744	21657274	21658198	1
chr7	21668216	21669140	Vmn1r117	924	-	NM_001166743	21668216	21669140	1
chr7	21796550	21797474	Vmn1r119	924	-	NM_001166708	21796550	21797474	1
chr7	21837885	21838803	Vmn1r120	918	-	NM_001166715	21837885	21838803	1
chr7	21882587	21883532	Vmn1r121	945	-	NM_001166741	21882587	21883532	1
chr7	21918229	21919147	Vmn1r122	918	-	NM_001166714	21918229	21919147	1
chr7	21947203	21948127	Vmn1r123	924	+	NM_001166707	21947203	21948127	1
chr7	22044712	22045636	Vmn1r124	924	-	NM_001166757	22044712	22045636	1
chr7	22057197	22058121	Vmn1r125	924	+	NM_001166740	22057197	22058121	1
chr7	22085520	22086486	Vmn1r126	966	-	NM_001166838	22085520	22086486	1
chr7	22103962	22104880	Vmn1r127	918	-	NM_001166726	22103962	22104880	1
chr7	22134391	22135315	Vmn1r128	924	+	NM_001166739	22134391	22135315	1
chr7	22145386	22146310	Vmn1r129	924	-	NM_001166725	22145386	22146310	1
chr7	22397763	22400165	Vmn1r132	2402	+	NM_001122682	22399110	22400004	1
chr7	22399110	22400004	Vmn1r139	894	+	NM_001166748	22399110	22400004	1
chr7	22545549	22546494	Gm4175	945	-	NM_001167165	22545549	22546494	1
chr7	22545549	22546494	Gm4214	945	-	NM_001167164	22545549	22546494	1
chr7	22580829	22581747	Gm4177	918	-	NM_001167167	22580829	22581747	1
chr7	22580829	22581747	Gm4216	918	-	NM_001167166	22580829	22581747	1
chr7	22617369	22618293	Vmn1r135	924	+	NM_001166747	22617369	22618293	1
chr7	22617369	22618293	Vmn1r163	924	+	NM_001166755	22617369	22618293	1
chr7	22628362	22629286	Gm5725	924	-	NM_001166711	22628362	22629286	1
chr7	22628362	22629286	Gm8720	924	-	NM_001166756	22628362	22629286	1
chr7	22694452	22706308	Gm10662	11856	-	NM_001201364	22694825	22695767	4
chr7	22694452	22706310	Gm5891	11858	-	NM_001034904	22694825	22695767	4
chr7	23197249	23199687	Vmn1r148	2438	+	NM_030736	23198601	23199525	1
chr7	23283779	23284697	Vmn1r151	918	-	NM_001166712	23283779	23284697	1
chr7	23498616	23685774	Gm6902	187158	-	NM_001270494	23499023	23499929	2
chr7	23574877	23575801	Vmn1r158	924	-	NM_001166841	23574877	23575801	1
chr7	23627706	23628624	Vmn1r159	918	-	NM_001166758	23627706	23628624	1
chr7	23656242	23657166	Vmn1r160	924	+	NM_001166724	23656242	23657166	1
chr7	23936779	23963780	Gm4541	27001	+	NR_033693	23963780	23963780	3
chr7	24086210	24147296	Nlrp4e	61086	+	NM_001004194	24086300	24146941	9
chr7	24170907	24226942	Nlrp5	56035	+	NM_011860	24189128	24226832	16
chr7	24289660	24290608	Vmn1r167	948	-	NM_001101562	24289660	24290608	1
chr7	24325738	24326668	Vmn1r168	930	+	NM_001166842	24325738	24326668	1
chr7	24362203	24363118	Vmn1r169	915	+	NM_001166843	24362203	24363118	1
chr7	24391193	24392108	Vmn1r170	915	+	NM_001166722	24391193	24392108	1
chr7	24417006	24418587	Vmn1r171	1581	+	NM_030737	24417370	24418321	1
chr7	24443334	24445682	Vmn1r172	2348	+	NM_030735	24444710	24445652	2
chr7	24487360	24488302	Vmn1r173	942	+	NM_001166718	24487360	24488302	1
chr7	24538929	24539871	Vmn1r174	942	+	NM_207548	24538929	24539871	1
chr7	24593304	24594219	Vmn1r175	915	-	NM_001166727	24593304	24594219	1
chr7	24619830	24620745	Vmn1r176	915	-	NM_001166721	24619830	24620745	1
chr7	24650538	24651468	Vmn1r177	930	-	NM_206872	24650538	24651468	1
chr7	24678547	24679462	Vmn1r178	915	+	NM_206868	24678547	24679462	1
chr7	24713404	24714376	Vmn1r179	972	+	NM_207545	24713404	24714376	1
chr7	24737405	24738375	Vmn1r180	970	+	NM_206869	24737432	24738350	1
chr7	24768979	24770067	Vmn1r181	1088	+	NM_207546	24769130	24770045	1
chr7	24788109	24789266	V1rd18	1157	+	NM_207618	24788129	24789047	1
chr7	24788129	24789047	V1rd19	918	+	NM_207619	24788129	24789047	1
chr7	24839792	24840710	Vmn1r183	918	+	NM_203489	24839792	24840710	1
chr7	24866915	24892727	Zfp180	25812	+	NM_001289634	24882860	24891144	6
chr7	24897338	24912971	Zfp112	15633	+	NM_021307	24903387	24912255	5
chr7	24919181	24928260	Zfp235	9079	+	NM_019941	24920319	24927285	4
chr7	24960063	24967337	Zfp114	7274	+	NM_001029933	24961170	24967007	4
chr7	24978233	24993168	Zfp111	14935	-	NM_019940	24983100	24992091	4
chr7	25012813	25022617	Zfp109	9804	-	NM_020262	25013066	25021651	4
chr7	25039812	25047463	Zfp108	7651	+	NM_018791	25040894	25046933	4
chr7	25055436	25062813	Zfp93	7377	+	NM_009567	25056674	25061548	4
chr7	25076064	25084568	Zfp61	8504	-	NM_009561	25076075	25081000	7
chr7	25086722	25101685	Zfp94	14963	-	NM_001199321	25087573	25096498	6
chr7	25118098	25118984	Tescl	886	-	NM_001163810	25118221	25118917	1
chr7	25134242	25138852	Lypd5	4610	+	NM_029806	25134263	25138709	5
chr7	25155281	25170231	Kcnn4	14950	+	NM_001163510	25155455	25169192	9
chr7	25184646	25207796	Smg9	23150	+	NM_028047	25188416	25207397	14
chr7	25216944	25230701	Irgc1	13757	-	NM_199013	25217017	25218409	3
chr7	25247501	25260987	Plaur	13486	+	NM_011113	25247528	25260490	7
chr7	25267041	25289552	Cadm4	22511	+	NM_153112	25267117	25288640	9
chr7	25292105	25300701	Zfp428	8596	+	NM_001290461	25295696	25300549	3
chr7	25315666	25323619	Irgq	7953	+	NM_153134	25316404	25319506	3
chr7	25326676	25331024	Pinlyp	4348	-	NM_001037143	25326755	25331012	5
chr7	25332168	25358457	Xrcc1	26289	+	NM_009532	25332327	25358357	17
chr7	25368856	25372660	Zfp575	3804	-	NM_001033205	25370513	25371748	4
chr7	25372561	25393944	Ethe1	21383	+	NM_023154	25378949	25393794	8
chr7	25396346	25414316	Phldb3	17970	+	NM_001102613	25396363	25413998	15
chr7	25421588	25426137	Lypd3	4549	+	NM_133743	25421608	25425620	5
chr7	25446312	25448128	Gm4598	1816	+	NR_030681	25448128	25448128	2
chr7	25453030	25457069	Tex101	4039	-	NM_019981	25453191	25455661	6
chr7	25494277	25499554	BC049730	5277	+	NM_199150	25495176	25499320	7
chr7	25507512	25509309	Gm4763	1797	-	NM_177593	25507750	25509256	4
chr7	25529001	25545330	Cd177	16329	-	NM_026862	25529236	25545305	17
chr7	25562222	25569674	Ceacam10	7452	+	NM_007675	25562294	25569495	4
chr7	25603813	25625294	Gm5893	21481	+	NR_045096	25625294	25625294	12
chr7	25649638	25654710	Lypd4	5072	-	NM_182785	25649709	25652313	5
chr7	25655075	25662670	Dmrtc2	7595	+	NM_027732	25657500	25662284	9
chr7	25669732	25674821	Rps19	5089	+	NM_023133	25670154	25674786	6
chr7	25682529	25687216	Cd79a	4687	+	NM_007655	25682540	25686563	5
chr7	25688004	25711610	Arhgef1	23606	+	NM_001130150	25692752	25711269	31
chr7	25754768	25757747	Rabac1	2979	-	NM_010261	25754939	25757601	5
chr7	25755028	25755094	Mir7046	66	-	NR_106013	25755094	25755094	1
chr7	25763185	25790956	Atp1a3	27771	-	NM_001290469	25763566	25790779	23
chr7	25772622	25772686	Mir7047	64	-	NR_106014	25772686	25772686	1
chr7	25794869	25857388	Grik5	62519	-	NM_008168	25795387	25853541	20
chr7	25862223	25868511	Zfp574	6288	+	NM_001168506	25864573	25867276	2
chr7	25876133	25917479	Pou2f2	41346	-	NM_001163554	25877695	25917471	15
chr7	25882084	25882194	Mir6537	110	-	NR_105855	25882194	25882194	1
chr7	25937475	25941649	D930028M14Rik	4174	+	NR_045847	25941649	25941649	3
chr7	25987858	26004878	Dedd2	17020	-	NM_207677	25988558	26004147	5
chr7	26002686	26002744	Mir7048	58	-	NR_106015	26002744	26002744	1
chr7	26006443	26012514	Zfp526	6071	+	NM_175436	26009336	26011364	3
chr7	26013277	26022870	Gsk3a	9593	-	NM_001031667	26013872	26022679	11
chr7	26013741	26015283	9130221H12Rik	1542	+	NR_046001	26015283	26015283	1
chr7	26027578	26035777	Erf	8199	-	NM_010155	26029267	26035619	4
chr7	26052717	26079178	Cic	26461	+	NM_001302811	26055864	26078554	21
chr7	26080067	26082974	Pafah1b3	2907	-	NM_008776	26080107	26082471	6
chr7	26086377	26089152	Prr19	2775	+	NM_001081294	26087897	26089082	3
chr7	26091126	26101214	Tmem145	10088	+	NM_183311	26091182	26100664	15
chr7	26102182	26150936	Megf8	48754	+	NM_001160400	26102525	26149609	41
chr7	26152634	26154743	Cnfn	2109	-	NM_028219	26152766	26153970	5
chr7	26164545	26181006	Lipe	16461	-	NM_010719	26164979	26180628	10
chr7	26179731	26351436	4732471J01Rik	171705	+	NR_015569	26351436	26351436	7
chr7	26185071	26197905	Cxcl17	12834	-	NM_153576	26185365	26197799	4
chr7	26246720	26262644	Ceacam1	15924	-	NM_001039185	26248799	26262553	9
chr7	26301060	26325023	Ceacam2	23963	-	NM_001113368	26303084	26324783	9
chr7	26399639	26400911	Erich4	1272	-	NM_001039243	26400082	26400867	2
chr7	26404432	26410569	Atp5sl	6137	+	NM_001290487	26404461	26409911	6
chr7	26412642	26414509	B3gnt8	1867	+	NM_001036740	26413165	26414335	2
chr7	26414870	26443780	Bckdha	28910	-	NM_007533	26415281	26443759	9
chr7	26444171	26453051	Exosc5	8880	+	NR_104358	26453051	26453051	6
chr7	26454158	26460185	Tmem91	6027	-	NM_001290497	26454303	26458653	4
chr7	26466176	26471577	B9d2	5401	+	NM_172148	26466405	26471313	3
chr7	26472020	26490096	Tgfb1	18076	+	NM_011577	26472887	26489961	7
chr7	26496135	26504072	Ccdc97	7937	-	NM_028771	26498011	26503985	5
chr7	26507057	26539739	Hnrnpul1	32682	-	NM_144922	26507265	26539654	15
chr7	26541518	26573752	Axl	32234	-	NM_009465	26543680	26573497	20
chr7	26587494	26601549	Cyp2s1	14055	-	NM_028775	26588581	26601521	9
chr7	26682676	26711643	Cyp2b10	28967	+	NM_009999	26682703	26711268	9
chr7	26846513	26881215	Cyp2b13	34702	+	NM_007813	26846538	26880840	9
chr7	26958427	26995679	Cyp2b9	37252	+	NM_010000	26958452	26995303	9
chr7	27051849	27052794	Vmn1r184	945	+	NM_001167540	27051849	27052794	1
chr7	27092210	27100107	Cyp2a4	7897	+	NM_009997	27092236	27099903	9
chr7	27149905	27179262	Nlrp9c	29357	-	NM_001042612	27149905	27179257	9
chr7	27220131	27260477	Nlrp4a	40346	+	NM_172896	27229230	27260158	11
chr7	27320041	27359165	Nlrp9a	39124	+	NM_001048219	27335830	27358972	10
chr7	27396137	27397097	Vmn1r185	960	-	NM_134231	27396137	27397097	1
chr7	27450245	27471449	Cyp2b23	21204	-	NM_001081148	27450951	27471449	9
chr7	27542160	27557649	Cyp2b19	15489	+	NM_007814	27542205	27556433	9
chr7	27593945	27606216	Cyp2g1	12271	+	NM_013809	27593945	27605848	9
chr7	27620357	27628283	Cyp2a5	7926	+	NM_007812	27620382	27628078	9
chr7	27716649	27724405	Cyp2a22	7756	-	NM_001101467	27717369	27724378	9
chr7	27814108	27821834	Cyp2a12	7726	+	NM_133657	27814124	27821665	9
chr7	27904973	27918679	Cyp2f2	13706	+	NM_007817	27906589	27918416	10
chr7	27938732	27943583	Cyp2t4	4851	+	NM_001100184	27938732	27943583	10
chr7	27943676	27951821	Egln2	8145	-	NM_053208	27944174	27950517	6
chr7	27953451	27963902	Rab4b	10451	-	NM_029391	27957670	27963761	8
chr7	27961024	27961112	Mir3101	88	-	NR_037283	27961112	27961112	1
chr7	27964759	27966168	Mia	1409	-	NM_019394	27964829	27966064	4
chr7	27972024	27981290	Snrpa	9266	-	NM_015782	27972223	27980553	7
chr7	27980799	27990405	BC024978	9606	+	NM_001290513	27982032	27989404	8
chr7	27990554	27990674	Mir1191	120	+	NR_035422	27990674	27990674	1
chr7	27992188	28013616	Itpkc	21428	-	NM_181593	27993259	28013506	7
chr7	28018031	28042968	Adck4	24937	+	NM_133770	28018486	28042544	15
chr7	28043779	28067169	Numbl	23390	+	NM_010950	28043956	28066428	10
chr7	28090159	28122631	Ltbp4	32472	-	NM_175641	28090414	28122586	33
chr7	28127151	28141027	Shkbp1	13876	-	NM_138676	28127331	28140975	18
chr7	28141401	28231608	Sptbn4	90207	-	NM_032610	28142310	28227585	36
chr7	28232996	28251000	Blvrb	18004	+	NM_144923	28233136	28250896	5
chr7	28258858	28262383	Sertad3	3525	+	NM_133210	28261161	28261755	2
chr7	28271971	28275333	Sertad1	3362	+	NM_018820	28274274	28274985	2
chr7	28284342	28305060	Prx	20718	+	NM_198048	28289998	28304853	7
chr7	28308279	28316193	Hipk4	7914	+	NM_001033315	28308535	28315886	4
chr7	28317018	28338237	Pld3	21219	-	NM_001317355	28317316	28327134	14
chr7	28338308	28367117	2310022A10Rik	28809	+	NM_175107	28341508	28365856	10
chr7	28376578	28424472	Akt2	47894	+	NM_001110208	28393726	28423160	14
chr7	28438942	28441226	Ttc9b	2284	+	NM_028417	28438945	28441045	3
chr7	28441393	28459600	Map3k10	18207	-	NM_001290528	28441682	28459043	10
chr7	28459679	28491501	C030039L03Rik	31822	+	NM_198417	28477520	28489086	6
chr7	28516427	28536708	Zfp60	20281	+	NM_029531	28521974	28535042	5
chr7	28550691	28555991	Gm10046	5300	+	NR_033484	28555991	28555991	3
chr7	28592214	28607935	Zfp626	15721	+	NM_027703	28592222	28604645	4
chr7	28623602	28641793	Zfp59	18191	+	NM_011762	28627873	28640105	5
chr7	28645603	28665844	Zfp607	20241	+	NM_001024726	28647575	28664586	5
chr7	28692410	28714449	1700049G17Rik	22039	-	NM_028538	28695058	28705752	4
chr7	28744818	28764176	Zfp780b	19358	-	NM_001081021	28747726	28759804	6
chr7	28769489	28799134	Zfp850	29645	-	NM_001254951	28773730	28793435	6
chr7	28826720	28835111	Psmc4	8391	-	NM_011874	28826825	28835037	11
chr7	28856254	28905883	Fcgbp	49629	+	NM_001122603	28856601	28905724	20
chr7	28914484	28949830	9530053A07Rik	35346	+	NM_001164655	28914842	28949673	20
chr7	28954766	28964288	Fbl	9522	+	NM_007991	28954827	28964174	9
chr7	28964501	28972317	Dyrk1b	7816	+	NM_001037957	28966628	28971942	11
chr7	29052899	29054187	Eid2	1288	+	NM_198425	29052973	29053684	1
chr7	29062724	29065148	Eid2b	2424	+	NM_001177427	29062799	29063255	1
chr7	29069670	29076153	BC089491	6483	-	NM_175033	29072983	29076096	6
chr7	29078573	29086804	Dll3	8231	-	NM_007866	29078939	29086765	9
chr7	29090844	29097065	Timm50	6221	-	NM_025616	29090947	29097051	11
chr7	29099914	29123738	Supt5	23824	-	NM_013676	29100142	29123445	30
chr7	29135707	29137717	Rps16	2010	+	NM_013647	29135822	29137658	5
chr7	29136558	29136652	AF357399	94	+	NR_028129	29136652	29136652	1
chr7	29144622	29157681	Plekhg2	13059	-	NM_138752	29144823	29156242	19
chr7	29161802	29164247	Zfp36	2445	-	NM_011756	29162576	29164216	2
chr7	29170265	29177709	Med29	7444	-	NM_026042	29171800	29177682	4
chr7	29178014	29184402	Paf1	6388	+	NM_019458	29178226	29184269	14
chr7	29184540	29221210	Samd4b	36670	-	NM_175021	29186607	29208650	13
chr7	29222465	29231914	Gmfg	9449	+	NM_022024	29222590	29231462	7
chr7	29237256	29252567	Lrfn1	15311	+	NM_001141921	29243676	29252502	5
chr7	29281959	29282511	1700028B04Rik	552	+	NR_033605	29282511	29282511	1
chr7	29293879	29295379	Ifnl2	1500	-	NM_001024673	29293879	29295379	5
chr7	29307854	29309341	Ifnl3	1487	+	NM_177396	29307854	29309341	5
chr7	29325903	29327229	Sycn	1326	+	NM_026716	29325928	29327102	2
chr7	29328615	29332273	Nccrp1	3658	-	NM_001081115	29329150	29332154	6
chr7	29343837	29383203	Pak4	39366	-	NM_027470	29344668	29353256	10
chr7	29345943	29346003	Mir7049	60	-	NR_106016	29346003	29346003	1
chr7	29392655	29416034	Papl	23379	-	NM_175319	29392958	29415905	13
chr7	29477867	29484356	Fbxo27	6489	+	NM_207238	29478314	29483401	6
chr7	29501800	29523159	Fbxo17	21359	+	NM_001310687	29517518	29522695	7
chr7	29524659	29526800	Mrps12	2141	-	NM_011885	29524887	29526554	3
chr7	29526986	29538898	Sars2	11912	+	NM_023637	29527034	29538593	16
chr7	29541192	29543983	Ccer2	2791	+	NM_001195091	29541197	29543763	5
chr7	29543269	29551663	Nfkbib	8394	-	NM_010908	29544121	29551441	7
chr7	29551770	29573684	Sirt2	21914	+	NM_022432	29551870	29573091	16
chr7	29559917	29566533	Gm19897	6616	-	NR_040339	29566533	29566533	4
chr7	29573987	29583984	Rinl	9997	+	NM_177158	29575377	29582873	12
chr7	29595908	29607285	Hnrnpl	11377	+	NM_177301	29595929	29606925	13
chr7	29610356	29617258	Ech1	6902	+	NM_016772	29610379	29617127	10
chr7	29618812	29626722	Lgals4	7910	+	NM_010706	29619200	29626652	10
chr7	29619200	29626652	Lgals6	7452	+	NM_010707	29619200	29626652	9
chr7	29649404	29651303	Lgals7	1899	+	NM_008496	29649499	29651212	4
chr7	29666674	29678604	Capn12	11930	+	NM_001110807	29666742	29678007	21
chr7	29678272	29747299	Actn4	69027	-	NM_021895	29679247	29747202	21
chr7	29756390	29766907	Eif3k	10517	-	NM_028659	29756425	29766751	8
chr7	29767872	29788297	Map4k1	20425	+	NM_008279	29767974	29788185	32
chr7	29788358	29910170	Ryr1	121812	-	NM_009109	29788476	29910034	106
chr7	29868654	29868713	Mir1963	59	-	NR_035489	29868713	29868713	1
chr7	29919951	29938974	Rasgrp4	19023	+	NM_001174155	29920091	29936521	17
chr7	29937528	29941229	Fam98c	3701	-	NM_001146023	29937722	29941189	8
chr7	29943847	29953666	Spred3	9819	-	NM_182927	29946544	29952988	6
chr7	29955228	29958952	Ggn	3724	+	NM_182694	29956107	29958892	3
chr7	29959205	29965692	Psmd8	6487	-	NM_026545	29959628	29965664	7
chr7	29966550	29999052	Catsperg1	32502	-	NM_001164658	29966690	29995933	28
chr7	30006946	30017541	Kcnk6	10595	-	NM_001033525	30010054	30017502	3
chr7	30023341	30032551	Yif1b	9210	+	NM_029887	30023409	30032411	8
chr7	30032539	30033486	2200002D01Rik	947	-	NM_028179	30032612	30033397	4
chr7	30041348	30066996	Spint2	25648	-	NM_011464	30041689	30066636	7
chr7	30074338	30078409	Ppp1r14a	4071	+	NM_026731	30074353	30078337	4
chr7	30089023	30102605	Dpf1	13582	+	NM_013874	30089099	30101570	12
chr7	30105396	30290479	Sipa1l3	185083	-	NM_001081028	30107162	30185861	23
chr7	30482237	30512034	Catsperg2	29797	-	NM_029714	30482657	30510488	29
chr7	30553570	30566438	Zfp84	12868	+	NM_023750	30556389	30562583	5
chr7	30558312	30558395	Mir1964	83	+	NR_035490	30558395	30558395	1
chr7	30569808	30579559	Zfp30	9751	+	NM_013705	30571268	30578745	5
chr7	30601090	30617061	Zfp790	15971	+	NM_146185	30608154	30615250	5
chr7	30628954	30638667	Zfp940	9713	-	NM_173738	30629798	30635969	5
chr7	30644997	30662321	Zfp420	17324	+	NM_172740	30659375	30661112	4
chr7	30678355	30691551	Zfp27	13196	-	NM_001285798	30679097	30683882	5
chr7	30691527	30691586	Mir7668	59	+	NR_106128	30691586	30691586	1
chr7	30693535	30701832	Zfp383	8297	+	NM_001243908	30693663	30700813	5
chr7	30717809	30736912	Zfp74	19103	-	NM_178384	30719260	30728524	5
chr7	30768973	30813301	Zfp568	44328	+	NM_001033355	30772791	30808666	10
chr7	30821377	30836415	Zfp14	15038	-	NM_011748	30823071	30829753	6
chr7	30841052	30857842	Zfp82	16790	-	NM_177889	30841171	30853092	7
chr7	30862355	30875529	Zfp566	13174	-	NM_152814	30862612	30872127	4
chr7	30880094	30892633	Zfp260	12539	+	NM_011981	30889695	30890919	3
chr7	30906966	30920051	Zfp382	13085	+	NM_001081007	30907052	30919684	5
chr7	30946286	30954746	Zfp146	8460	-	NM_011980	30946755	30947634	2
chr7	30954940	30965228	Gm5113	10288	+	NM_001033540	30963507	30963933	3
chr7	30969189	30971049	Cox7a1	1860	+	NM_009944	30969249	30970986	4
chr7	30971960	30980067	Capns1	8107	-	NM_009795	30972525	30979105	11
chr7	31009149	31017048	Tbcb	7899	-	NM_025548	31009251	31016712	6
chr7	31017092	31018406	Polr2i	1314	+	NM_027259	31017364	31018366	6
chr7	31018315	31021784	Ovol3	3469	-	NM_001289817	31018457	31020478	4
chr7	31025156	31065440	Wdr62	40284	-	NM_146186	31025239	31065354	33
chr7	31076771	31093386	Clip3	16615	+	NM_001081114	31077219	31091879	14
chr7	31093771	31099322	Alkbh6	5551	+	NM_198027	31094524	31099201	7
chr7	31099834	31104064	Syne4	4230	+	NM_153577	31099977	31104020	8
chr7	31106427	31107394	Sdhaf1	967	-	NM_001033140	31106991	31107348	1
chr7	31140532	31147791	Lrfn3	7259	-	NM_175478	31140656	31145817	3
chr7	31198806	31202598	Tyrobp	3792	+	NM_011662	31198857	31202428	5
chr7	31202730	31204873	Hcst	2143	-	NM_011827	31202824	31204765	4
chr7	31208322	31213765	Nfkbid	5443	+	NM_172142	31209464	31213206	11
chr7	31219998	31230601	Aplp1	10603	-	NM_007467	31220311	31230487	17
chr7	31232784	31242534	Kirrel2	9750	-	NM_172898	31233137	31241868	15
chr7	31245076	31273628	Nphs1	28552	+	NM_019459	31245162	31271735	30
chr7	31247182	31250610	Nphs1os	3428	-	NR_004443	31250610	31250610	3
chr7	31278676	31298421	Prodh2	19745	+	NM_019546	31278702	31298001	10
chr7	31300140	31307212	Arhgap33os	7072	+	NR_036630	31307212	31307212	12
chr7	31307244	31320079	Arhgap33	12835	-	NM_178252	31307606	31319199	22
chr7	31324152	31337291	Proser3	13139	-	NM_183321	31324533	31334684	12
chr7	31337846	31337923	Gm38670	77	+	NR_128568	31337923	31337923	1
chr7	31338320	31340458	Hspb6	2138	+	NM_001012401	31338353	31339655	3
chr7	31340459	31344665	Lin37	4206	-	NM_001290569	31340545	31342975	9
chr7	31346884	31348203	Psenen	1319	-	NM_025498	31347013	31347875	4
chr7	31348358	31350383	U2af1l4	2025	+	NM_170760	31348374	31350198	8
chr7	31350445	31352981	Igflr1	2536	+	NM_145580	31351234	31352925	5
chr7	31353873	31373745	Kmt2b	19872	-	NM_029274	31354179	31373736	37
chr7	31374398	31374456	Mir3569	58	+	NR_106134	31374456	31374456	1
chr7	31374699	31377961	Zbtb32	3262	-	NM_021397	31374948	31376887	6
chr7	31388110	31397493	Upk1a	9383	-	NM_026815	31388616	31397486	7
chr7	31401992	31411170	Cox6b1	9178	-	NM_025628	31402127	31409624	4
chr7	31418634	31420871	Etv2	2237	-	NM_007959	31418652	31420849	6
chr7	31426013	31435247	Rbm42	9234	-	NM_133693	31426126	31435096	10
chr7	31438726	31450013	Haus5	11287	-	NM_027999	31438995	31449947	19
chr7	31455740	31456624	Pmis2	884	-	NR_027848	31456624	31456624	2
chr7	31483944	31485553	2200002J24Rik	1609	+	NM_026961	31484801	31485399	4
chr7	31497227	31510553	Atp4a	13326	+	NM_001290627	31497269	31510203	22
chr7	31512719	31514553	Tmem147	1834	-	NM_027215	31512798	31514439	7
chr7	31514797	31528700	Gapdhs	13903	-	NM_001290631	31514905	31528673	11
chr7	31536489	31541153	Sbsn	4664	+	NM_001083903	31536580	31541007	4
chr7	31548774	31566085	Dmkn	17311	+	NM_001166173	31548942	31564899	20
chr7	31572923	31576102	Krtdap	3179	+	NM_001033131	31572945	31575977	6
chr7	31603375	31608794	Ffar2	5419	-	NM_146187	31604139	31605132	3
chr7	31639348	31641197	Ffar3	1849	-	NM_001033316	31639952	31640912	2
chr7	31645586	31646489	Ffar1	903	-	NM_194057	31645586	31646489	1
chr7	31650422	31665361	Cd22	14939	-	NM_001043317	31651549	31663105	16
chr7	31684201	31699851	Mag	15650	-	NM_010758	31685382	31696955	13
chr7	31707390	31709200	Hamp2	1810	-	NM_183257	31707526	31709154	3
chr7	31727387	31729036	Hamp	1649	-	NM_032541	31727495	31729002	3
chr7	31730266	31741822	Usf2	11556	-	NM_011680	31731598	31741776	10
chr7	31742788	31758488	Lsr	15700	-	NM_017405	31742884	31758192	10
chr7	31758822	31774744	Fam187b	15922	+	NR_038860	31774744	31774744	2
chr7	31817741	31827350	Fxyd5	9609	-	NM_001287217	31817987	31826476	9
chr7	31825276	31825336	Mir7050	60	-	NR_106017	31825336	31825336	1
chr7	31827533	31836473	Fxyd7	8940	-	NM_022007	31827900	31836405	6
chr7	31836696	31840675	Fxyd1	3979	-	NM_019503	31836983	31840574	8
chr7	31844953	31855954	Lgi4	11001	+	NM_144556	31845039	31854210	9
chr7	31855553	31861716	Fxyd3	6163	-	NM_008557	31855719	31858640	8
chr7	31883743	31900345	Hpn	16602	-	NM_001110252	31884053	31899709	14
chr7	31901542	31911964	Scn1b	10422	-	NM_011322	31902247	31911724	6
chr7	31915145	31936069	Gramd1a	20924	-	NM_027898	31915510	31935922	19
chr7	31947376	31955660	Gm10640	8284	+	NR_046062	31955660	31955660	4
chr7	32048754	32050954	Scgb2b1	2200	+	NM_001310660	32048775	32050779	3
chr7	32075537	32076835	Scgb1b2	1298	-	NM_020563	32075658	32076819	3
chr7	32087787	32089996	Scgb2b2	2209	+	NM_207262	32087800	32089842	3
chr7	32144056	32147091	Scgb2b3	3035	-	NM_001270541	32144056	32147091	3
chr7	32160610	32161935	Scgb1b3	1325	+	NM_001256073	32160626	32161814	3
chr7	32488797	32490773	Scgb2b7	1976	-	NM_001198871	32488959	32490757	3
chr7	32497683	32498999	Scgb1b7	1316	+	NM_001270542	32497700	32498877	3
chr7	32994191	32996161	Scgb2b11	1970	-	NM_001310657	32994353	32996142	3
chr7	33110304	33112264	Scgb2b12	1960	-	NM_001281508	33110460	33112248	3
chr7	33119200	33120520	Scgb1b12	1320	+	NM_001310633	33119216	33120401	3
chr7	33226559	33227863	Scgb1b29	1304	+	NM_001256066	33226559	33227741	3
chr7	33612701	33614672	Scgb2b15	1971	-	NM_001281523	33612864	33614659	3
chr7	33612701	33614672	Scgb2b17	1971	-	NM_001281524	33612864	33614659	3
chr7	33956910	33958880	Scgb2b18	1970	-	NM_001310621	33957072	33958861	3
chr7	34063384	34065360	Scgb2b19	1976	-	NM_001199336	34063550	34065338	3
chr7	34072325	34073510	Scgb1b19	1185	+	NM_001281526	34072325	34073510	3
chr7	34149361	34151338	Scgb2b20	1977	-	NM_001009952	34149523	34151319	3
chr7	34158252	34159577	Scgb1b20	1325	+	NM_001270543	34158268	34159455	3
chr7	34303506	34305474	Scgb2b21	1968	-	NM_001310615	34303662	34305459	3
chr7	34410163	34438300	Scgb2b23-ps	28137	-	NR_045685	34438300	34438300	3
chr7	34522211	34524314	Scgb2b24	2103	-	NM_177446	34522365	34524304	3
chr7	34528817	34530122	Scgb1b24	1305	+	NM_001099329	34528817	34530001	3
chr7	34728015	34730004	Scgb2b26	1989	-	NM_178308	34728184	34729983	3
chr7	34796937	34798961	Scgb2b27	2024	-	NM_001100464	34797102	34798885	3
chr7	34806585	34807900	Scgb1b27	1315	+	NM_009596	34806586	34807771	3
chr7	34880449	34885856	Scgb1b30	5407	+	NM_001099330	34880532	34885727	3
chr7	34894566	34918287	Wtip	23721	-	NM_207212	34895117	34918078	8
chr7	34925715	34953548	Uba2	27833	-	NM_016682	34926303	34953529	17
chr7	34969515	34981666	Pdcd2l	12151	-	NM_026549	34969699	34981662	7
chr7	34986345	35015355	Gpi1	29010	-	NM_008155	34987432	35015232	18
chr7	35021732	35070628	4931406P16Rik	48896	-	NM_172741	35023947	35070215	13
chr7	35129738	35174559	Lsm14a	44821	-	NM_025948	35132977	35174497	11
chr7	35424035	35437860	Kctd15	13825	-	NM_146188	35425309	35435831	6
chr7	35459486	35597730	Chst8	138244	-	NM_175140	35460177	35533210	4
chr7	35697425	35829727	Pepd	132302	+	NM_008820	35697456	35829387	15
chr7	35831440	35841585	Cebpg	10145	-	NM_009884	35835402	35835855	2
chr7	35904311	35906951	Cebpa	2640	+	NM_007678	35904437	35905517	1
chr7	35971403	35986130	Slc7a10	14727	+	NM_017394	35971500	35985870	11
chr7	35985896	36000364	Lrp3	14468	-	NM_001024707	35987100	35999947	8
chr7	36061562	36103459	Gpatch1	41897	-	NM_026181	36061799	36103432	20
chr7	36119255	36177306	Rhpn2	58051	+	NM_027897	36119361	36176034	15
chr7	36177170	36181786	Faap24	4616	-	NM_178643	36177843	36181337	4
chr7	36182111	36223703	Cep89	41592	+	NM_028120	36182186	36223587	19
chr7	36234110	36251053	Slc7a9	16943	+	NM_001199015	36234818	36250914	14
chr7	36278628	36322763	Tdrd12	44135	-	NM_028034	36278818	36322556	12
chr7	36332203	36340947	Nudt19	8744	-	NM_033080	36332927	36340823	3
chr7	36364012	36370601	Rgs9bp	6589	-	NM_145840	36369525	36370239	1
chr7	36371265	36424256	Ankrd27	52991	+	NM_145633	36376799	36423263	29
chr7	36427003	36432501	Pdcd5	5498	-	NM_019746	36427153	36432390	6
chr7	36470518	36539473	Dpy19l3	68955	-	NM_178704	36475799	36537736	19
chr7	36557368	36588008	Zfp507	30640	-	NM_177739	36560979	36580635	7
chr7	36587610	36623093	E130304I02Rik	35483	+	NR_033567	36623093	36623093	3
chr7	37483136	37558476	Tshz3	75340	+	NM_172298	37483268	37556852	2
chr7	38264127	38554771	Zfp536	290644	-	NM_172385	38264288	38355008	6
chr7	38745010	38804571	Uri1	59561	-	NM_011274	38746533	38804239	11
chr7	38883002	38892509	Ccne1	9507	-	NM_007633	38883533	38891819	12
chr7	38968235	38982584	1600014C10Rik	14349	+	NM_001085385	38973635	38979989	4
chr7	39005672	39013013	Plekhf1	7341	-	NM_024413	39006321	39007161	2
chr7	39047838	39056367	Pop4	8529	-	NM_025390	39048191	39056172	7
chr7	39303157	39313212	Gm5591	10055	-	NM_001013810	39303898	39313080	3
chr7	46511993	46519904	Gm21276	7911	-	NR_073038	46519904	46519904	3
chr7	46662663	46668530	Gm5114	5867	-	NM_177890	46662986	46668383	3
chr7	46704887	46732786	Zfp939	27899	+	NM_001243021	46705020	46732703	6
chr7	46773135	46795785	Zfp619	22650	+	NM_001004139	46773231	46793403	4
chr7	47930106	47946630	4933402C06Rik	16524	+	NR_045504	47946630	47946630	4
chr7	48104522	48153694	A230077H06Rik	49172	-	NR_040329	48153694	48153694	5
chr7	48154647	48185338	Vstm2b	30691	+	NM_021387	48154737	48184831	5
chr7	48242978	48250203	4930433I11Rik	7225	+	NM_207248	48243075	48250177	2
chr7	48288088	48300672	Gm4884	12584	+	NM_183166	48288246	48300063	3
chr7	48315986	48345213	1700110I07Rik	29227	-	NR_131068	48345213	48345213	4
chr7	48539696	48545553	Gm5592	5857	+	NM_001033782	48539841	48545239	3
chr7	48628299	48648749	AI987944	20450	-	NM_001199330	48629711	48632236	5
chr7	48655101	48704011	Vmn2r57	48910	-	NM_177764	48655101	48704011	6
chr7	48734243	48755260	AW146154	21017	-	NM_001033530	48735653	48754666	4
chr7	48888900	48906902	Zfp788	18002	+	NM_023363	48902953	48905966	6
chr7	48923383	48982563	Vmn2r-ps54	59180	+	NR_004441	48982563	48982563	7
chr7	49092250	49128040	Vmn2r58	35790	-	NM_001105055	49092250	49128040	6
chr7	49267161	49314351	Vmn2r59	47190	-	NM_001105056	49267161	49314351	6
chr7	49371840	49451146	Vmn2r60	79306	+	NM_001105057	49371840	49451146	6
chr7	49515422	49556125	Vmn2r61	40703	+	NM_001105058	49515422	49556125	6
chr7	49685474	49685739	Vmn2r-ps60	265	-	NR_028441	49685739	49685739	1
chr7	49700831	49703450	4933421I07Rik	2619	-	NM_027702	49701547	49703438	4
chr7	49728755	49761123	Zfp141	32368	-	NM_001309388	49730358	49745423	7
chr7	49864895	49897974	9830147E19Rik	33079	-	NM_001242388	49867873	49897852	4
chr7	49915477	49948088	Gm5595	32611	-	NM_001008427	49916979	49948023	4
chr7	50019807	50048866	Vmn2r62	29059	-	NM_001105059	50019807	50048866	6
chr7	50072196	50122604	Gm2381	50408	-	NR_046214	50122604	50122604	4
chr7	50158620	50189159	Vmn2r63	30539	-	NM_001105060	50158620	50189159	6
chr7	50274167	50303476	Gm9268	29309	+	NM_001105061	50274167	50303476	7
chr7	50432957	50447479	Zfp936	14522	+	NM_001034893	50442538	50445851	4
chr7	50469408	50482212	EU599041	12804	+	NM_001177525	50469514	50481703	4
chr7	50551892	50568631	Zfp715	16739	-	NM_027264	50553243	50566535	5
chr7	50606710	50614840	Siglecf	8130	+	NM_145581	50606917	50614144	10
chr7	50663649	50673719	Siglecg	10070	+	NM_172900	50663929	50673447	12
chr7	50685470	50691361	Lim2	5891	+	NM_177693	50685960	50691079	5
chr7	50692507	50693616	Nkg7	1109	+	NM_024253	50692673	50693467	4
chr7	50696185	50698690	Cldnd2	2505	+	NM_028849	50697015	50698660	5
chr7	50699441	50713170	Etfb	13729	+	NM_026695	50699517	50713110	6
chr7	50712866	50712939	Mir7051	73	+	NR_106018	50712939	50712939	1
chr7	50718602	50727384	Vsig10l	8782	+	NM_001290316	50718602	50726242	10
chr7	50728276	50745393	Iglon5	17117	-	NM_001164518	50729832	50745393	8
chr7	50747413	50761308	4931406B18Rik	13895	-	NM_028737	50750998	50759592	8
chr7	50782825	50788541	Cd33	5716	-	NM_001111058	50784107	50788464	7
chr7	50817739	50830831	Zfp658	13092	+	NM_001008549	50820153	50830336	5
chr7	50834955	50849080	Zfp719	14125	+	NM_172482	50839528	50846567	4
chr7	50862538	50873649	Zfp819	11111	+	NM_028913	50865276	50873288	5
chr7	50890108	50904664	Ceacam18	14556	+	NM_028236	50890133	50903883	6
chr7	50906439	50915531	Siglece	9092	-	NM_031181	50906855	50915502	7
chr7	50927400	50933667	Ctu1	6267	+	NM_145582	50930508	50932551	3
chr7	50945787	50950906	Klk14	5119	+	NM_174866	50945788	50950389	5
chr7	50967936	50982128	Klk13	14192	+	NM_001039042	50969200	50982103	6
chr7	51000835	51011306	2310002F09Rik	10471	-	NR_077063	51011306	51011306	3
chr7	51024469	51028851	Klk12	4382	+	NM_027097	51024568	51028764	5
chr7	51029986	51034632	Klk11	4646	+	NM_001177373	51030128	51034307	6
chr7	51036423	51040780	Klk10	4357	+	NM_133712	51036904	51040392	6
chr7	51047260	51052126	Klk9	4866	+	NM_028660	51047366	51051513	5
chr7	51052946	51059192	Klk8	6246	+	NM_008940	51053432	51059139	5
chr7	51066813	51071729	Klk7	4916	+	NM_011872	51067330	51070822	6
chr7	51079913	51087397	Klk6	7484	+	NM_001164698	51081426	51087017	7
chr7	51097638	51106551	Klk5	8913	+	NM_026806	51097685	51106241	5
chr7	51136541	51141174	Klk4	4633	+	NM_019928	51137018	51140756	6
chr7	51189140	51194960	Klk15	5820	+	NM_174865	51189140	51194960	5
chr7	51200381	51201297	Klk1b7-ps	916	+	NR_033120	51201297	51201297	3
chr7	51206041	51210308	Klk1b8	4267	+	NM_008457	51206060	51210265	5
chr7	51222137	51226685	Klk1b1	4548	+	NM_010645	51222156	51226643	5
chr7	51231430	51235746	Klk1b9	4316	+	NM_010116	51231466	51235698	5
chr7	51251248	51255245	Klk1b11	3997	+	NM_010640	51251274	51255196	5
chr7	51268047	51272339	Klk1b26	4292	+	NM_010644	51268089	51272290	5
chr7	51268080	51272338	Egfbp2	4258	+	NM_010115	51268089	51272290	5
chr7	51307659	51312081	Klk1b27	4422	+	NM_020268	51307710	51312036	5
chr7	51357661	51361949	Klk1b21	4288	+	NM_010642	51357733	51361904	5
chr7	51368052	51372246	Klk1b22	4194	+	NM_010114	51368071	51372246	5
chr7	51392136	51396974	Klk1b16	4838	+	NM_008454	51392688	51396931	5
chr7	51443632	51447821	Klk1b24	4189	+	NM_010643	51443642	51447776	5
chr7	51453560	51457721	Klk1b3	4161	+	NM_008693	51453616	51457675	5
chr7	51462804	51467124	Klk1b4	4320	+	NM_010915	51462823	51467075	5
chr7	51471844	51476073	Klk1b5	4229	+	NM_008456	51471870	51476024	5
chr7	51480806	51484987	Klk1	4181	+	NM_010639	51480848	51484939	5
chr7	51485299	51491492	1700028J19Rik	6193	-	NR_029436	51491492	51491492	5
chr7	51502091	51507689	2410002F23Rik	5598	+	NM_025880	51506042	51506897	6
chr7	51505224	51505308	Snord88c	84	+	NR_028534	51505308	51505308	1
chr7	51505519	51505591	Snord88a	72	+	NR_028533	51505591	51505591	1
chr7	51508456	51512574	Acpt	4118	-	NM_001195034	51508456	51512574	11
chr7	51559135	51562329	Clec11a	3194	-	NM_009131	51559910	51562135	4
chr7	51565633	51613723	Shank1	48090	+	NM_001034115	51568076	51612707	25
chr7	51615414	51630400	1700008O03Rik	14986	-	NM_027049	51615555	51629759	6
chr7	51639495	51655400	Syt3	15905	+	NM_001114116	51641340	51654521	11
chr7	51697856	51718714	Lrrc4b	20858	+	NM_198250	51700279	51718205	3
chr7	51720804	51723121	Aspdh	2317	+	NM_026690	51720841	51723056	7
chr7	51723349	51727028	Josd2	3679	+	NM_001205070	51724193	51726884	6
chr7	51725716	51725781	Mir7052	65	+	NR_106019	51725781	51725781	1
chr7	51739886	51740783	5430431A17Rik	897	+	NR_131001	51740783	51740783	2
chr7	51745307	51751883	Emc10	6576	-	NM_197991	51746241	51751769	7
chr7	51751957	51756504	Fam71e1	4547	+	NM_028169	51752057	51756394	5
chr7	51757068	51780039	Mybpc2	22971	-	NM_146189	51757201	51779959	28
chr7	51781364	51787441	Spib	6077	-	NM_019866	51783328	51787423	6
chr7	51788113	51804185	Pold1	16072	-	NM_011131	51788158	51798806	27
chr7	51793475	51793548	Mir7053	73	-	NR_106020	51793548	51793548	1
chr7	51804985	51809335	Nr1h2	4350	-	NM_009473	51805354	51808106	10
chr7	51827814	51842216	Napsa	14402	+	NM_008437	51827985	51842168	9
chr7	51846255	51860121	Kcnc3	13866	+	NM_001290682	51846255	51854279	5
chr7	51861172	51926213	Myh14	65041	-	NM_001271540	51861579	51920867	42
chr7	51964112	51975212	Izumo2	11100	+	NM_029317	51964112	51975155	6
chr7	51986851	52003987	Zfp473	17136	-	NM_178734	51987598	51997118	5
chr7	52003998	52032884	Vrk3	28886	+	NM_133945	52009186	52030894	15
chr7	52067625	52072028	Atf5	4403	-	NR_033136	52072028	52072028	3
chr7	52071457	52087206	Nup62	15749	+	NM_053074	52083932	52085513	2
chr7	52071739	52096173	Gm21948	24434	+	NM_001171024	52089425	52096075	9
chr7	52091657	52096179	Il4i1	4522	+	NM_010215	52091894	52096075	8
chr7	52096145	52104449	Tbc1d17	8304	-	NM_001042655	52096598	52104239	17
chr7	52104593	52110791	Akt1s1	6198	+	NM_026270	52107947	52110105	5
chr7	52105068	52105141	Mir707	73	+	NR_030488	52105141	52105141	1
chr7	52112515	52118299	Pnkp	5784	+	NM_001290764	52112773	52117992	17
chr7	52118437	52125158	Ptov1	6721	-	NM_133949	52118802	52124891	12
chr7	52134755	52147736	Med25	12981	-	NM_029365	52134786	52147734	18
chr7	52151448	52155994	Fuz	4546	+	NM_027376	52151621	52155717	11
chr7	52155742	52184860	Ap2a1	29118	-	NM_007458	52156107	52184716	24
chr7	52198609	52213405	Tsks	14796	+	NM_011651	52198653	52213382	11
chr7	52214741	52230221	Cpt1c	15480	-	NM_153679	52214868	52229237	19
chr7	52232124	52241790	Prmt1	9666	-	NR_045521	52241790	52241790	12
chr7	52242269	52249971	Gm15545	7702	+	NR_045266	52249971	52249971	2
chr7	52246591	52252949	Bcl2l12	6358	-	NM_029410	52246773	52252354	7
chr7	52253017	52258218	Irf3	5201	+	NM_016849	52254082	52257716	8
chr7	52258319	52271619	Scaf1	13300	-	NM_001008422	52258549	52268957	11
chr7	52267795	52267857	Mir7054	62	-	NR_106021	52267857	52267857	1
chr7	52273376	52277014	Rras	3638	+	NM_009101	52273385	52276734	6
chr7	52283076	52308251	Prr12	25175	-	NM_175022	52283847	52308251	14
chr7	52308976	52317022	Prrg2	8046	-	NM_022999	52309548	52316195	7
chr7	52317798	52333873	Nosip	16075	+	NM_025533	52328864	52332753	9
chr7	52338283	52347583	Rcn3	9300	-	NM_026555	52338625	52347052	7
chr7	52348362	52359192	Fcgrt	10830	-	NM_010189	52348615	52358439	7
chr7	52377126	52377191	Mir150	65	+	NR_029560	52377191	52377191	1
chr7	52377757	52379759	Rps11	2002	-	NM_013725	52377804	52379681	5
chr7	52378395	52378481	Snord35b	86	-	NR_000004	52378481	52378481	1
chr7	52380932	52384115	Rpl13a	3183	-	NM_009438	52381315	52384084	8
chr7	52381716	52381805	Snord35a	89	-	NR_000003	52381805	52381805	1
chr7	52381972	52382038	Snord34	66	-	NR_002455	52382038	52382038	1
chr7	52382233	52382315	Snord33	82	-	NR_001277	52382315	52382315	1
chr7	52382287	52382361	Mir5121	74	-	NR_039581	52382361	52382361	1
chr7	52382752	52382833	Snord32a	81	-	NR_000002	52382833	52382833	1
chr7	52386558	52391802	Flt3l	5244	-	NM_013520	52387483	52391420	9
chr7	52397209	52409908	Aldh16a1	12699	-	NM_145954	52397310	52409851	17
chr7	52409672	52415434	Pih1d1	5762	+	NM_029406	52411679	52415353	10
chr7	52419290	52431509	Slc17a7	12219	+	NM_182993	52419452	52430414	12
chr7	52428672	52428731	Mir7055	59	+	NR_106022	52428731	52428731	1
chr7	52431718	52434967	Gfy	3249	-	NM_001195255	52431807	52434040	5
chr7	52436364	52437208	Pth2	844	+	NM_053256	52436663	52437142	3
chr7	52439045	52460262	Ccdc155	21217	-	NM_201374	52439119	52460073	20
chr7	52462894	52467253	Dkkl1	4359	-	NM_015789	52462959	52466923	5
chr7	52471122	52488989	Tead2	17867	+	NM_011565	52472588	52488298	12
chr7	52489001	52494485	Cd37	5484	-	NM_001290802	52489270	52494389	9
chr7	52538242	52544363	1700039E15Rik	6121	+	NM_001033176	52538242	52543903	6
chr7	52558524	52589150	Trpm4	30626	-	NM_175130	52559057	52589080	25
chr7	52580327	52581021	Rpl14-ps1	694	+	NR_110499	52581021	52581021	1
chr7	52590638	52594342	Hrc	3704	+	NM_010473	52590796	52594287	6
chr7	52594495	52622389	Ppfia3	27894	-	NM_029741	52595571	52617174	30
chr7	52621532	52623318	Mtag2	1786	+	NR_015480	52623318	52623318	2
chr7	52623260	52625934	Lin7b	2674	-	NM_011698	52623346	52625928	6
chr7	52631823	52651112	Snrnp70	19289	-	NR_126538	52651112	52651112	11
chr7	52661329	52666752	Kcna7	5423	+	NM_010596	52661731	52665130	2
chr7	52669064	52672549	Ntf5	3485	+	NM_198190	52670815	52671445	3
chr7	52676315	52677224	Lhb	909	+	NM_008497	52676322	52677148	3
chr7	52677267	52689834	Ruvbl2	12567	-	NM_011304	52677349	52689633	15
chr7	52690208	52711987	Gys1	21779	+	NM_030678	52690422	52710737	16
chr7	52713313	52715256	Ftl1	1943	-	NM_010240	52713476	52715001	4
chr7	52717064	52722268	Bax	5204	-	NM_007527	52717231	52722145	6
chr7	52728932	52744166	Dhdh	15234	-	NM_027903	52730635	52744133	7
chr7	52741631	52778297	Tulp2	36666	+	NM_001290996	52771685	52777817	11
chr7	52748043	52765778	Nucb1	17735	-	NM_008749	52749206	52765207	13
chr7	52778287	52781638	Ppp1r15a	3351	-	NM_008654	52778362	52780752	3
chr7	52781699	52809599	Plekha4	27900	+	NM_148927	52785944	52809397	20
chr7	52810297	52822691	Hsd17b14	12394	+	NM_025330	52810348	52822199	9
chr7	52823164	52830546	0610005C13Rik	7382	-	NR_038166	52830546	52830546	5
chr7	52825522	52845080	Bcat2	19558	+	NM_009737	52825745	52844714	11
chr7	52869259	52870860	Fgf21	1601	-	NM_020013	52869389	52870676	3
chr7	52872975	52876429	Fut1	3454	+	NM_008051	52873993	52875127	2
chr7	52877180	52882612	Izumo1	5432	+	NM_001018013	52878166	52882578	10
chr7	52882906	52894462	Rasip1	11556	+	NM_028544	52883139	52894254	12
chr7	52895346	52901138	Mamstr	5792	+	NM_172418	52896151	52900359	10
chr7	52903960	52921764	Fut2	17804	-	NM_001271993	52905672	52906716	3
chr7	52933056	52949772	Sec1	16716	-	NM_001271578	52933821	52939646	4
chr7	52939391	52949926	Ntn5	10535	+	NM_001289692	52939834	52949524	7
chr7	52955336	52960031	Car11	4695	+	NM_009800	52955642	52959884	9
chr7	52960616	52965573	Dbp	4957	+	NM_016974	52960993	52965250	4
chr7	52964832	52973372	Sphk2	8540	-	NM_203280	52966094	52969035	7
chr7	52973440	52976205	Rpl18	2765	+	NM_009077	52973506	52976159	6
chr7	52976589	52984862	Fam83e	8273	+	NM_001033170	52977550	52984369	5
chr7	52980476	52981186	Spaca4	710	-	NM_027055	52980562	52980946	1
chr7	52985352	53014925	Sult2b1	29573	-	NM_017465	52985369	53014823	7
chr7	53039316	53059512	Lmtk3	20196	+	NM_001005511	53040975	53059018	16
chr7	53062006	53069686	Cyth2	7680	-	NM_001112701	53063130	53069486	12
chr7	53071836	53080117	Kcnj14	8281	-	NM_145963	53072985	53075449	3
chr7	53080592	53086159	Grwd1	5567	-	NM_153419	53081145	53086151	7
chr7	53087852	53122051	Grin2d	34199	-	NM_008172	53088149	53121937	12
chr7	53128209	53139096	Kdelr1	10887	+	NM_133950	53128380	53138381	5
chr7	53142214	53152081	Syngr4	9867	-	NM_021482	53142264	53151153	5
chr7	53152438	53172783	Tmem143	20345	+	NM_144801	53152448	53172001	8
chr7	53173392	53176796	Emp3	3404	-	NM_010129	53173435	53175736	5
chr7	53183767	53204326	Ccdc114	20559	+	NM_001033243	53183931	53204014	13
chr7	53231749	53285656	Abcc6	53907	-	NM_018795	53232205	53285651	31
chr7	53289065	53339582	Nomo1	50517	+	NM_153057	53289201	53339104	31
chr7	53352492	53356134	Kcnj11	3642	-	NM_001204411	53354094	53355006	2
chr7	53359892	53435403	Abcc8	75511	-	NM_011510	53359993	53435319	39
chr7	53450720	53493860	Ush1c	43140	-	NM_001291182	53452133	53493834	27
chr7	53496356	53566804	Otog	70448	+	NM_013624	53496398	53565539	56
chr7	53626772	53627862	Munc	1090	+	NR_131190	53627862	53627862	2
chr7	53631843	53634462	Myod1	2619	+	NM_010866	53632042	53633764	3
chr7	53651837	53694074	Kcnc1	42237	+	NM_001112739	53653047	53692706	4
chr7	53698528	53895177	Sergef	196649	-	NM_013789	53698558	53895142	11
chr7	53900010	53927907	Tph1	27897	-	NM_009414	53902795	53920671	11
chr7	53941477	53966021	Saal1	24544	-	NM_030233	53944732	53966002	12
chr7	53967367	53971046	Saa3	3679	-	NM_011315	53967495	53970470	4
chr7	53983368	53987913	Saa4	4545	-	NM_011316	53984891	53987066	4
chr7	53995868	53998350	Saa1	2482	-	NM_009117	53996073	53997892	4
chr7	54007202	54009684	Saa2	2482	+	NM_011314	54007660	54009479	4
chr7	54015835	54051251	Hps5	35416	-	NM_001167864	54016759	54046394	23
chr7	54051463	54079170	Gtf2h1	27707	+	NM_008186	54057056	54078279	15
chr7	54101173	54110997	Ldha	9824	+	NM_010699	54102989	54110511	8
chr7	54116632	54133512	Ldhc	16880	+	NM_013580	54117139	54133247	8
chr7	54144396	54175300	Tsg101	30904	-	NM_021884	54144984	54175232	10
chr7	54178585	54213888	Uevld	35303	-	NM_001040695	54181690	54213802	12
chr7	54223116	54231281	C86187	8165	-	NR_015609	54231281	54231281	2
chr7	54232001	54243173	Gm9999	11172	+	NR_033461	54243173	54243173	5
chr7	54245765	54263784	Spty2d1	18019	-	NM_175318	54248662	54263504	6
chr7	54306009	54310146	Tmem86a	4137	+	NM_026436	54306150	54309222	3
chr7	54333169	54389054	Ptpn5	55885	-	NM_013643	54334194	54368115	14
chr7	54338535	54338594	Mir7056	59	-	NR_106023	54338594	54338594	1
chr7	54441086	54444786	Mrgpra6	3700	-	NM_001308537	54441135	54444725	2
chr7	54490288	54508218	Mrgpra9	17930	-	NM_001288801	54490288	54508165	2
chr7	54590244	54609610	Mrgpra1	19366	-	NM_153095	54590303	54609577	2
chr7	54681698	54707509	Mrgpra2a	25811	-	NM_001172588	54681882	54707450	2
chr7	54719176	54744952	Mrgpra2b	25776	-	NM_153101	54719356	54744868	2
chr7	54844319	54856742	Mrgpra3	12423	-	NM_153067	54844556	54856674	2
chr7	55236163	55237666	Mrgpra4	1503	-	NM_153524	55236279	55237221	1
chr7	55276340	55282967	Mrgprx1	6627	-	NM_207540	55276398	55277367	2
chr7	55423386	55424355	Mrgprb5	969	-	NM_207538	55423386	55424355	1
chr7	55453582	55454548	Mrgprb4	966	-	NM_205795	55453582	55454548	1
chr7	55643895	55645018	Mrgprb8	1123	+	NM_207539	55643952	55644945	1
chr7	55699482	55711712	Mrgprb1	12230	-	NM_205810	55702479	55711577	2
chr7	55733988	55754640	Mrgprx2	20652	-	NM_001034868	55737379	55754531	2
chr7	55806335	55813456	Mrgprb2	7121	-	NM_175531	55807328	55808345	2
chr7	55898232	55899171	Mrgprb3	939	-	NM_207537	55898232	55899171	1
chr7	56044372	56082807	Zdhhc13	38435	+	NM_028031	56044480	56082377	17
chr7	56085767	56103421	Csrp3	17654	-	NM_001198841	56085999	56094902	6
chr7	56121798	56136411	E2f8	14613	-	NM_001013368	56122416	56135662	13
chr7	56214442	56865458	Nav2	651016	+	NM_001111016	56219735	56862191	39
chr7	56886868	56892205	Dbx1	5337	-	NM_001005232	56887817	56892085	4
chr7	57014475	57029369	Htatip2	14894	+	NM_001146053	57014968	57028896	6
chr7	57033727	57113635	Prmt3	79908	+	NM_133740	57033846	57112846	16
chr7	57165668	57214863	Slc6a5	49195	+	NM_001146013	57165748	57214794	16
chr7	57230719	58118659	Nell1	887940	+	NM_001037906	57230758	58118319	20
chr7	57772678	57831254	Nell1os	58576	-	NR_045928	57831254	57831254	4
chr7	57854559	57855898	4933405O20Rik	1339	+	NM_172901	57854589	57855780	1
chr7	58766398	58854077	Ano5	87679	+	NM_177694	58766604	58849215	22
chr7	58877199	58926496	Slc17a6	49297	+	NM_080853	58878004	58924730	12
chr7	59115948	59117637	Fancf	1689	-	NM_001115087	59116592	59117624	1
chr7	59134514	59249828	Gas2	115314	+	NM_008087	59143298	59248879	8
chr7	59252530	59261388	Svip	8858	-	NM_001160345	59255132	59261161	4
chr7	59267049	59271086	1700015G11Rik	4037	-	NM_001195601	59267199	59271052	4
chr7	61147130	61147259	Mir6238	129	-	NR_105746	61147259	61147259	1
chr7	62090614	62524258	Luzp2	433644	+	NM_178705	62091328	62520736	12
chr7	63023553	63034295	Siglech	10742	+	NM_178706	63023655	63027944	6
chr7	63049517	63086817	Tubgcp5	37300	+	NM_146190	63049564	63086258	23
chr7	63097440	63188003	Cyfip1	90563	+	NM_001164661	63127229	63185532	32
chr7	63186635	63217863	Nipa2	31228	-	NM_001256132	63188285	63199989	7
chr7	63217900	63235466	A230056P14Rik	17566	+	NR_015495	63235466	63235466	6
chr7	63233853	63274943	Nipa1	41090	-	NM_153578	63234761	63274938	5
chr7	63305524	63487168	Herc2	181644	+	NM_010418	63306246	63486502	93
chr7	63495140	63791887	Oca2	296747	+	NM_021879	63510157	63791399	24
chr7	63979611	64642241	Gabrg3	662630	-	NM_008074	63979782	64642143	10
chr7	64642641	64665311	Gm9962	22670	+	NR_033504	64665311	64665311	3
chr7	64663038	64765379	Gabra5	102341	-	NM_176942	64663976	64763434	10
chr7	64836430	64836532	Mir6389	102	+	NR_105812	64836532	64836532	1
chr7	64845887	65084171	Gabrb3	238284	+	NM_001038701	64845938	65080129	9
chr7	65913571	66084796	Atp10a	171225	+	NM_009728	65913824	66084107	21
chr7	66484121	66562097	Ube3a	77976	+	NM_011668	66498819	66560300	13
chr7	66563293	66579519	C230091D08Rik	16226	-	NR_015479	66579519	66579519	3
chr7	66874527	66934248	Ipw	59721	-	NR_015351	66934248	66934248	6
chr7	66931359	66931449	Snord116l1	90	-	NR_033778	66931449	66931449	1
chr7	66931359	66931449	Snord116	90	-	NR_002895	66931449	66931449	1
chr7	66938957	66939047	Snord116l2	90	-	NR_033779	66939047	66939047	1
chr7	67114462	67119317	Snhg14	4855	-	NR_015456	67119317	67119317	3
chr7	67123696	67123742	Snord64	46	-	NR_028529	67123742	67123742	1
chr7	67127386	67150042	Snurf	22656	-	NM_033174	67140334	67149935	10
chr7	67127387	67285105	Snrpn	157718	-	NM_001082962	67128125	67133490	11
chr7	68674295	68760213	B230209E15Rik	85918	-	NR_045727	68760213	68760213	5
chr7	68828009	68828078	Mir344d-1	69	-	NR_037215	68828078	68828078	1
chr7	68830157	68830237	Mir344d-2	80	-	NR_037216	68830237	68830237	1
chr7	68850735	69072460	A230057D06Rik	221725	-	NR_015533	69072460	69072460	9
chr7	68871134	68871214	Mir344d-3	80	-	NR_037209	68871214	68871214	1
chr7	68880422	68880488	Mir344e	66	-	NR_037284	68880488	68880488	1
chr7	68884235	68884295	Mir344h-2	60	-	NR_049202	68884295	68884295	1
chr7	68887251	68887311	Mir344h-1	60	-	NR_049201	68887311	68887311	1
chr7	68935404	68935467	Mir344b	63	-	NR_037285	68935467	68935467	1
chr7	68982196	68982288	Mir344c	92	-	NR_037286	68982288	68982288	1
chr7	69022655	69022750	Mir344	95	-	NR_029772	69022750	69022750	1
chr7	69084912	69084992	Mir344-2	80	-	NR_030557	69084992	69084992	1
chr7	69088786	69127189	A330076H08Rik	38403	-	NR_015599	69127189	69127189	4
chr7	69127174	69127245	Mir344g	71	-	NR_037287	69127245	69127245	1
chr7	69191066	69191134	Mir344f	68	-	NR_037288	69191134	69191134	1
chr7	69230108	69230196	Mir344i	88	-	NR_049204	69230196	69230196	1
chr7	69493162	69494813	Ndn	1651	+	NM_010882	69493293	69494271	1
chr7	69521864	69526526	Magel2	4662	+	NM_013779	69522235	69526090	1
chr7	69562478	69565025	Mkrn3	2547	-	NM_011746	69563292	69564927	1
chr7	69606756	69609396	Peg12	2640	-	NM_013788	69608381	69609233	1
chr7	70243577	70357412	Chrna7	113835	-	NM_007390	70244109	70357362	10
chr7	70489577	70589415	4930554H23Rik	99838	-	NR_131089	70589415	70589415	10
chr7	70589657	70903913	Otud7a	314256	+	NM_130880	70795700	70903617	14
chr7	71031236	71083801	Klf13	52565	-	NM_021366	71036393	71083432	2
chr7	71061742	71065425	E030018B13Rik	3683	+	NM_001256311	71061947	71064957	3
chr7	71298720	71414645	Trpm1	115925	+	NM_001039104	71298917	71414016	27
chr7	71350691	71350797	Mir211	106	+	NR_029805	71350797	71350797	1
chr7	71394868	71394985	Mir6416	117	-	NR_105844	71394985	71394985	1
chr7	71432555	71485692	Mtmr10	53137	+	NM_172742	71432667	71482915	16
chr7	71491643	71518981	Fan1	27338	-	NM_177893	71491643	71518389	14
chr7	71521426	71537122	Mphosph10	15696	-	NM_026483	71521540	71537080	11
chr7	71537656	71557005	Mcee	19349	+	NM_028626	71537683	71556873	3
chr7	71646591	71898762	Apba2	252171	+	NM_007461	71839949	71898028	15
chr7	71900981	72301414	Fam189a1	400433	-	NM_183087	71903982	72301209	10
chr7	72016535	72017926	Ndnl2	1391	-	NM_023239	72016964	72017804	1
chr7	72441050	72516130	Tjp1	75080	-	NM_009386	72442458	72515722	28
chr7	72726916	72764233	BC046251	37317	+	NR_131060	72764233	72764233	8
chr7	72789783	72836979	Tarsl2	47196	+	NM_172310	72789830	72836205	19
chr7	72838302	72846799	Tm2d3	8497	+	NM_178056	72838364	72846644	6
chr7	72948937	72951109	1810008I18Rik	2172	+	NR_045301	72951109	72951109	2
chr7	73007021	73195272	Pcsk6	188251	+	NM_011048	73007056	73193889	22
chr7	73205221	73219473	Snrpa1	14252	+	NM_021336	73205496	73219266	9
chr7	73224534	73234291	Vimp	9757	+	NM_024439	73224599	73233738	6
chr7	73254400	73318684	Chsy1	64284	+	NM_001081163	73254796	73317307	3
chr7	73403632	73533227	Lrrk1	129595	-	NM_146191	73404801	73526434	34
chr7	73526552	73526610	Mir7057	58	-	NR_106024	73526610	73526610	1
chr7	73535778	73572363	Aldh1a3	36585	-	NM_053080	73537574	73572298	13
chr7	73789456	73834447	Asb7	44991	-	NR_003961	73834447	73834447	8
chr7	73834774	73862142	Lins1	27368	+	NM_152815	73853004	73859539	8
chr7	73888389	73968578	Cers3	80189	+	NM_001164201	73888530	73966728	11
chr7	73984620	74297511	Adamts17	312891	+	NM_001033877	73984721	74294952	23
chr7	74348967	74367344	1700112J16Rik	18377	-	NR_131044	74367344	74367344	3
chr7	74367429	74373354	Lysmd4	5925	+	NM_175215	74368504	74371358	3
chr7	74376048	74517744	Mef2a	141696	-	NM_001033713	74379753	74461731	12
chr7	74658295	74790122	Lrrc28	131827	-	NR_028143	74790122	74790122	10
chr7	74792295	74871462	Ttc23	79167	+	NM_025905	74807232	74871028	12
chr7	74875046	74904628	Synm	29582	-	NM_207663	74878112	74904514	5
chr7	74929423	74948382	4833412C05Rik	18959	-	NR_045954	74948382	74948382	3
chr7	75097142	75378553	Igf1r	281411	+	NM_010513	75097744	75371287	21
chr7	75381493	75409119	Pgpep1l	27626	-	NM_030101	75381824	75382736	4
chr7	75411224	75421480	Gm16157	10256	-	NR_040340	75421480	75421480	4
chr7	75418724	75507976	Fam169b	89252	+	NM_001013811	75418761	75506208	9
chr7	75562309	75571019	4933436H12Rik	8710	+	NR_046208	75571019	75571019	3
chr7	75763341	75764895	Gm5334	1554	+	NR_003648	75764895	75764895	1
chr7	75881879	75894124	Arrdc4	12245	-	NM_001042592	75884362	75893952	8
chr7	76640979	76644575	4930402F11Rik	3596	+	NR_045940	76644575	76644575	3
chr7	77323753	77482708	Gm29683	158955	-	NR_131145	77482708	77482708	4
chr7	77496835	77511632	Nr2f2	14797	-	NM_183261	77499542	77511021	3
chr7	77510268	77556032	B130024G19Rik	45764	+	NR_045850	77556032	77556032	11
chr7	79054580	79084077	4930441H08Rik	29497	+	NR_130995	79084077	79084077	3
chr7	79092412	79106904	Gm36633	14492	-	NR_126483	79106904	79106904	5
chr7	79106060	79172203	1700011C11Rik	66143	+	NR_126462	79172203	79172203	3
chr7	79222715	79451481	Mctp2	228766	-	NM_001024703	79225674	79404449	23
chr7	80242637	80246954	Gm6567	4317	-	NR_046024	80246954	80246954	3
chr7	80455265	80460079	LOC100505025	4814	+	NR_105062	80460079	80460079	3
chr7	80458691	80520660	A730056A06Rik	61969	-	NR_040324	80520660	80520660	3
chr7	80520405	80564785	Rgma	44380	+	NM_177740	80520760	80562919	4
chr7	80571537	80686632	Chd2	115095	-	NM_001081345	80574552	80685719	39
chr7	80684683	80703281	1810026B05Rik	18598	-	NR_037569	80703281	80703281	5
chr7	80830377	80831449	Gm4971	1072	-	NR_033604	80831449	80831449	1
chr7	80885192	80921805	Fam174b	36613	+	NM_001162532	80885388	80919785	3
chr7	80953107	80961389	Gm10619	8282	-	NR_077222	80961389	80961389	4
chr7	80964475	80964527	Mir7234	52	+	NR_106093	80964527	80964527	1
chr7	80970809	80981435	Gm21269	10626	+	NR_102375	80981435	80981435	4
chr7	81084005	81158568	St8sia2	74563	-	NM_009181	81088064	81158380	6
chr7	81420303	81699666	Slco3a1	279363	-	NM_001038643	81420891	81699476	11
chr7	82175096	82220052	4930533N22Rik	44956	+	NR_131122	82220052	82220052	8
chr7	82259780	82454148	Sv2b	194368	-	NM_153579	82262480	82351426	13
chr7	82453587	82476305	1500012K07Rik	22718	+	NR_045814	82476305	82476305	3
chr7	82600419	82899495	Akap13	299076	+	NM_029332	82679704	82895509	37
chr7	82993223	83019016	Klhl25	25793	+	NM_001122780	83010233	83012003	3
chr7	83374772	84269584	Agbl1	894812	+	NM_001199224	83374772	84269584	23
chr7	85336999	85722724	Ntrk3	385725	-	NM_008746	85337444	85722669	17
chr7	85725951	85863106	E430016F16Rik	137155	-	NR_015542	85863106	85863106	11
chr7	85920226	85927975	Mrpl46	7749	-	NM_023331	85920342	85927914	4
chr7	85928016	85937874	Mrps11	9858	+	NM_026498	85928244	85937635	6
chr7	85972359	85992097	Det1	19738	-	NM_029585	85972808	85989140	5
chr7	86033162	86033259	Mir7-2	97	+	NR_029826	86033259	86033259	1
chr7	86040812	86053719	Aen	12907	+	NM_001162939	86047293	86052302	4
chr7	86058309	86065282	Isg20	6973	+	NM_001291221	86059232	86065048	4
chr7	86162938	86198209	Gm26633	35271	-	NR_132432	86198209	86198209	3
chr7	86198368	86259985	Acan	61617	+	NM_007424	86227080	86259162	17
chr7	86261912	86275904	Hapln3	13992	-	NM_178255	86262095	86268379	5
chr7	86278653	86293946	Mfge8	15293	-	NM_008594	86279294	86293853	10
chr7	86418151	86506487	Abhd2	88336	+	NM_018811	86441899	86505042	11
chr7	86519755	86531913	Rlbp1	12158	-	NM_001173483	86520445	86528831	9
chr7	86537223	86595150	Fanci	57927	+	NM_145946	86540797	86594597	38
chr7	86594268	86611159	Polg	16891	-	NM_017462	86594846	86610097	23
chr7	86644911	86679289	AI854517	34378	+	NR_040311	86679289	86679289	5
chr7	86650149	86650239	Mir9-3	90	+	NR_029818	86650239	86650239	1
chr7	86738248	86762543	Rhcg	24295	-	NM_019799	86739691	86762412	11
chr7	86805081	86843031	Ticrr	37950	+	NM_029835	86805225	86841649	22
chr7	86842983	86859072	Kif7	16089	-	NM_010626	86843433	86859044	18
chr7	86866049	86877662	Plin1	11613	-	NM_175640	86866306	86877027	9
chr7	86882149	86887911	Pex11a	5762	-	NM_011068	86882227	86887851	3
chr7	86888048	86930836	Wdr93	42788	+	NM_001037927	86894005	86930698	18
chr7	86937126	86938476	Mesp1	1350	-	NM_008588	86937408	86938413	2
chr7	86955612	86958317	Mesp2	2705	+	NM_008589	86955814	86957696	2
chr7	86966688	86987238	Anpep	20550	-	NM_008486	86967109	86987137	20
chr7	87020210	87065526	Ap3s2	45316	-	NM_009682	87025369	87065463	6
chr7	87070244	87080150	Arpin	9906	-	NM_027420	87071727	87080130	6
chr7	87169699	87237637	Zfp710	67938	+	NM_001146000	87225962	87235229	6
chr7	87207595	87220143	Gm21057	12548	-	NR_045695	87220143	87220143	3
chr7	87239733	87260236	Idh2	20503	-	NM_173011	87240001	87260162	11
chr7	87331726	87371410	Sema4b	39684	+	NM_013659	87343538	87370221	15
chr7	87372041	87377691	Cib1	5650	-	NM_011870	87372250	87377446	7
chr7	87377778	87386306	Gdpgp1	8528	+	NM_178752	87383108	87384269	2
chr7	87391261	87405707	Ttll13	14446	+	NM_177765	87392180	87405411	15
chr7	87406100	87410264	Ngrn	4164	+	NM_031375	87406145	87409870	3
chr7	87414540	87436465	Vps33b	21925	+	NM_178070	87414869	87436080	23
chr7	87439336	87461145	Prc1	21809	+	NM_145150	87439466	87460071	14
chr7	87461501	87469340	Rccd1	7839	-	NM_173445	87461784	87465916	9
chr7	87470178	87485105	Unc45a	14927	-	NM_133952	87470505	87485005	20
chr7	87488022	87490983	Hddc3	2961	+	NM_026812	87488023	87490664	4
chr7	87493982	87516261	Man2a2	22279	-	NM_172903	87496584	87514610	24
chr7	87522643	87532832	Fes	10189	-	NM_010194	87522817	87532220	19
chr7	87534079	87550322	Furin	16243	-	NM_001081454	87535592	87543656	16
chr7	87599878	87680005	Blm	80127	-	NM_001042527	87600144	87659572	22
chr7	87731517	87833763	Crtc3	102246	-	NM_173863	87734628	87833624	15
chr7	87780902	87789270	Gm15880	8368	+	NR_040343	87789270	87789270	5
chr7	87856468	87948217	Iqgap1	91749	-	NM_016721	87858717	87948081	38
chr7	88006993	88021399	Zscan2	14406	+	NM_009553	88008154	88021263	3
chr7	88035608	88046155	Wdr73	10547	-	NM_028026	88036562	88046111	8
chr7	88047112	88049948	Nmb	2836	-	NM_001291280	88047318	88049863	3
chr7	88060264	88092436	Sec11a	32172	-	NM_019951	88060739	88092338	6
chr7	88138569	88190048	Zfp592	51479	+	NM_178707	88168175	88186749	10
chr7	88202485	88250498	Alpk3	48013	+	NM_054085	88202515	88249202	14
chr7	88259684	88315302	Slc28a1	55618	+	NM_001004184	88260424	88314498	18
chr7	88358689	88478508	Pde8a	119819	+	NM_008803	88358800	88478408	22
chr7	88487618	88490120	Rps17	2502	-	NM_009092	88487654	88490090	5
chr7	88491911	88599644	Cpeb1	107733	-	NM_001252526	88493226	88599534	12
chr7	88605284	88638811	Ap3b2	33527	-	NM_021492	88605536	88638506	26
chr7	88639159	88643216	BC048679	4057	-	NM_001193274	88639231	88641753	6
chr7	88668435	88676384	2900076A07Rik	7949	+	NR_045299	88676384	88676384	5
chr7	88674801	88674874	Mir1839	73	+	NR_035501	88674874	88674874	1
chr7	88679239	88711867	Fsd2	32628	-	NM_172904	88679881	88704978	13
chr7	88716177	88741722	Whamm	25545	+	NM_001004185	88716207	88741065	10
chr7	88745366	88851811	Homer2	106445	-	NM_001164086	88755138	88851649	9
chr7	88907838	88914376	Fam103a1	6538	+	NM_025997	88912439	88913444	3
chr7	88927072	88934339	3110040N11Rik	7267	-	NM_026077	88927928	88934270	5
chr7	88936959	88974317	Btbd1	37358	-	NM_146193	88938453	88974277	8
chr7	89003886	89028965	Tm6sf1	25079	+	NM_145375	89004334	89028292	10
chr7	89026141	89079345	Hdgfrp3	53204	-	NM_013886	89030963	89078908	6
chr7	89111547	89137185	Bnc1	25638	-	NM_007562	89113228	89137176	5
chr7	89215272	89226644	Gm20744	11372	+	NR_045744	89226644	89226644	4
chr7	89408417	89455930	Sh3gl3	47513	+	NM_017400	89408638	89455505	9
chr7	89484203	89762958	Adamtsl3	278755	+	NM_001190374	89484417	89761008	30
chr7	89781469	89797038	Saxo2	15569	-	NM_177894	89782973	89796939	3
chr7	89797123	89926362	Eftud1	129239	+	NM_175317	89798050	89926189	20
chr7	89891855	89904154	4933406J10Rik	12299	-	NR_046004	89904154	89904154	4
chr7	90015842	90020086	Mex3b	4244	+	NM_175366	90016160	90018719	2
chr7	90086447	90119901	4933430H16Rik	33454	-	NR_045855	90119901	90119901	4
chr7	90733440	90772219	Tmc3	38779	+	NM_177695	90733601	90771457	23
chr7	90780526	90790838	Stard5	10312	+	NM_023377	90780550	90789079	6
chr7	90791572	90884000	Il16	92428	-	NM_010551	90792398	90871106	19
chr7	90924126	90943349	Cfap161	19223	-	NM_029335	90924479	90943320	7
chr7	91029004	91032851	Mesdc1	3847	-	NM_030705	91030642	91031731	1
chr7	91040509	91050042	Mesdc2	9533	+	NM_023403	91040799	91046515	3
chr7	91081366	91235015	Cemip	153649	-	NM_030728	91084130	91151915	29
chr7	91257865	91300403	Abhd17c	42538	-	NM_133722	91259091	91300354	3
chr7	91394784	91558548	Arnt2	163764	-	NM_007488	91398565	91558395	19
chr7	91677463	91726849	Gm2115	49386	+	NR_045098	91726849	91726849	3
chr7	91733669	91754452	Fah	20783	-	NM_010176	91733774	91754233	14
chr7	91763563	91827861	Zfand6	64298	-	NM_022985	91764329	91782902	8
chr7	91838149	91925059	2610206C17Rik	86910	+	NR_038175	91925059	91925059	5
chr7	92002080	92005828	Olfr291	3748	+	NM_146415	92004874	92005828	3
chr7	92064290	92065238	Olfr290	948	+	NM_146416	92064290	92065238	1
chr7	92088678	92112519	Vmn2r65	23841	-	NM_001105180	92088678	92112519	6
chr7	92143154	92160530	Vmn2r66	17376	-	NM_001033878	92143154	92160530	6
chr7	92284749	92304412	Vmn2r67	19663	-	NM_001102579	92284749	92304412	6
chr7	92370027	92386214	Vmn2r68	16187	-	NM_001105181	92370027	92386214	6
chr7	92554885	92564186	Vmn2r69	9301	-	NM_001105182	92554885	92564186	6
chr7	92707212	92717598	Vmn2r70	10386	-	NM_001105183	92707212	92717598	6
chr7	92763971	92773057	Vmn2r71	9086	+	NM_001105184	92763971	92773057	6
chr7	92886293	92903491	Vmn2r72	17198	-	NM_001105185	92886293	92903491	6
chr7	93006056	93024448	Vmn2r73	18392	-	NM_001105186	93006056	93024448	6
chr7	93100376	93109992	Vmn2r74	9616	-	NM_001105187	93100376	93109992	6
chr7	93296551	93320234	Vmn2r75	23683	-	NM_001102578	93296551	93320234	6
chr7	93373715	93394711	Vmn2r76	20996	-	NM_001102580	93373715	93394711	6
chr7	93417239	93418321	Olfr310	1082	-	NM_001011520	93417298	93418297	1
chr7	93454694	93455621	Olfr309	927	-	NM_001011866	93454694	93455621	1
chr7	93469533	93470460	Olfr308	927	-	NM_146621	93469533	93470460	1
chr7	93483962	93484904	Olfr307	942	-	NM_146617	93483962	93484904	1
chr7	93511885	93512845	Olfr305	960	-	NM_146616	93511885	93512845	1
chr7	93534166	93535168	Olfr304	1002	-	NM_001011828	93534166	93535168	1
chr7	93543046	93544006	Olfr303	960	-	NM_146619	93543046	93544006	1
chr7	93552358	93561809	Olfr301	9451	+	NM_212436	93560873	93561809	3
chr7	93613922	93614915	Olfr299	993	+	NM_001011767	93613922	93614915	1
chr7	93637060	93638059	Olfr298	999	-	NM_001011751	93637060	93638059	1
chr7	93675268	93676201	Olfr297	933	+	NM_146618	93675268	93676201	1
chr7	93733786	93734716	Olfr295	930	+	NM_146851	93733786	93734716	1
chr7	93764145	93765153	Olfr294	1008	-	NM_001011750	93764145	93765153	1
chr7	93812173	93813184	Olfr293	1011	+	NM_001011752	93812173	93813184	1
chr7	93836850	93843894	Olfr292	7044	+	NM_146620	93842967	93843894	2
chr7	93867485	93924374	Folh1	56889	-	NM_016770	93868168	93924269	19
chr7	93943650	93960542	Vmn2r77	16892	+	NM_001105188	93943650	93960542	6
chr7	94063858	94103687	Vmn2r78	39829	+	NM_001105189	94063858	94103687	6
chr7	94144974	94186478	Vmn2r79	41504	+	NM_001105190	94144974	94186478	6
chr7	94395158	94547218	Nox4	152060	+	NM_001285833	94444362	94545401	20
chr7	94573280	94642022	Tyr	68742	-	NM_011661	94577558	94641860	5
chr7	94732677	95283573	Grm5	550896	+	NM_001143834	94751053	95279379	11
chr7	95426594	95464371	Ctsc	37777	+	NM_009982	95426712	95458412	7
chr7	95578782	95640082	Rab38	61300	+	NM_028238	95578911	95639270	3
chr7	96288230	96487297	Tmem135	199067	-	NM_028343	96290347	96487098	15
chr7	96552875	96558620	Fzd4	5745	+	NM_008055	96553196	96556870	2
chr7	96574815	96580587	AI314278	5772	+	NR_102276	96580587	96580587	2
chr7	96656294	96666096	Prss23	9802	-	NM_029614	96658220	96659369	2
chr7	96781327	97002869	Me3	221542	+	NM_181407	96781420	97000407	14
chr7	97014657	97052139	Ccdc81	37482	-	NM_001162979	97015014	97051770	15
chr7	97067194	97089714	l7Rn6	22520	-	NM_001291288	97067462	97072196	6
chr7	97103163	97129486	Eed	26323	-	NM_021876	97103446	97129035	12
chr7	97177668	97197581	E230029C05Rik	19913	+	NR_110365	97197581	97197581	6
chr7	97273345	97278446	2310010J17Rik	5101	-	NR_046007	97278446	97278446	3
chr7	97278741	97357957	Picalm	79216	+	NM_146194	97279082	97356107	21
chr7	97372387	97413942	Ccdc83	41555	-	NM_183293	97372428	97408034	11
chr7	97450864	97559229	Sytl2	108365	+	NM_001289583	97497301	97558057	20
chr7	97574821	97577174	Ccdc89	2353	+	NM_027298	97575093	97576206	1
chr7	97591290	97596553	Crebzf	5263	+	NR_073438	97596553	97596553	4
chr7	97599221	97605718	Tmem126a	6497	-	NM_025460	97599252	97604022	5
chr7	97617338	97624505	Tmem126b	7167	-	NM_026734	97617487	97624485	5
chr7	98239295	99597756	Dlg2	1358461	+	NM_011807	98239516	99593127	23
chr7	99240715	99268021	4930567K12Rik	27306	-	NR_131016	99268021	99268021	7
chr7	99709658	99730804	Ccdc90b	21146	+	NM_025515	99710045	99730366	9
chr7	99732692	99785652	Ankrd42	52960	-	NM_028665	99732968	99784697	12
chr7	99792221	99818422	Pcf11	26201	-	NM_029078	99793071	99818130	16
chr7	99889215	99889969	4632427E13Rik	754	-	NR_015510	99889969	99889969	2
chr7	99890223	99985627	Rab30	95404	+	NM_029494	99968500	99984449	5
chr7	100006036	100022742	Ddias	16706	-	NM_001080995	100006515	100015193	7
chr7	100023762	100083091	Prcp	59329	+	NM_028243	100023848	100081689	9
chr7	100228388	100230231	Fam181b	1843	+	NM_021427	100228530	100229785	2
chr7	103319753	104059602	Tenm4	739849	+	NM_001310762	103698586	104055101	33
chr7	103397933	103398042	Mir708	109	+	NR_030489	103398042	103398042	1
chr7	103454176	103454275	Mir6394	99	+	NR_105818	103454275	103454275	1
chr7	103487992	103490474	Gm15412	2482	-	NR_046043	103490474	103490474	3
chr7	103939942	103950059	Gm15413	10117	-	NR_045874	103950059	103950059	4
chr7	104100036	104213267	Nars2	113231	+	NM_153591	104100313	104211223	14
chr7	104230260	104457461	Gab2	227201	+	NM_010248	104230335	104453529	10
chr7	104457889	104474474	Usp35	16585	-	NM_001177412	104458841	104474474	10
chr7	104480832	104498726	Kctd21	17894	+	NM_001039039	104495831	104496614	2
chr7	104520126	104540668	Alg8	20542	+	NM_199035	104520147	104540269	13
chr7	104548512	104556310	Ndufc2	7798	+	NM_024220	104548698	104556178	3
chr7	104561442	104566060	Thrsp	4618	-	NM_009381	104565560	104566013	2
chr7	104599843	104608067	Kctd14	8224	+	NM_001136235	104599994	104606754	3
chr7	104629465	104689908	Ints4	60443	+	NM_027256	104629606	104689700	23
chr7	104698840	104728007	Aamdc	29167	-	NM_001177945	104699110	104724163	5
chr7	104728405	104841292	Rsf1	112887	+	NM_001081267	104728413	104834497	16
chr7	104746858	104793622	Rsf1os1	46764	-	NR_126461	104793622	104793622	3
chr7	104845166	104869303	Clns1a	24137	+	NM_023671	104845239	104865028	7
chr7	104874888	104886757	Aqp11	11869	-	NM_175105	104875134	104886497	3
chr7	104991448	105060891	Pak1	69443	+	NM_011035	105002969	105059692	15
chr7	105068467	105198173	Gdpd4	129706	+	NM_177696	105106330	105197121	18
chr7	105199563	105268003	Myo7a	68440	-	NM_001256081	105200136	105266243	49
chr7	105270068	105326784	Capn5	56716	-	NM_007602	105272382	105310590	13
chr7	105291868	105293957	Omp	2089	-	NM_011010	105293436	105293928	1
chr7	105325703	105333309	Gm16938	7606	+	NR_045971	105333309	105333309	4
chr7	105340924	105347985	B3gnt6	7061	-	NM_001081167	105342085	105343261	2
chr7	105362169	105458037	Acer3	95868	-	NM_025408	105365346	105457960	11
chr7	105499177	105509838	Tsku	10661	-	NM_001168539	105500567	105501632	2
chr7	105588925	105625988	Gucy2d	37063	+	NM_001130693	105589018	105625802	19
chr7	105642731	105650340	Lrrc32	7609	+	NM_001113379	105642731	105648516	2
chr7	105739115	105805079	Emsy	65964	-	NM_172280	105739199	105803323	20
chr7	105851872	105866571	Prkrir	14699	+	NM_028410	105851899	105865413	5
chr7	105983621	106003257	Wnt11	19636	+	NM_001285792	105987617	106001797	7
chr7	106035252	106289654	Uvrag	254402	-	NM_178635	106036399	106289460	15
chr7	106302172	106331223	Dgat2	29051	-	NM_026384	106303055	106331022	8
chr7	106367593	106387121	Mogat2	19528	-	NM_177448	106368314	106387075	6
chr7	106408990	106415728	Gm26705	6738	-	NR_103487	106415728	106415728	4
chr7	106415956	106485647	Map6	69691	+	NM_010837	106416531	106485512	4
chr7	106493884	106501749	Serpinh1	7865	-	NM_001111043	106494629	106497931	6
chr7	106530058	106609494	Gdpd5	79436	+	NM_201352	106572622	106608623	18
chr7	106614513	106622530	Klhl35	8017	+	NM_028145	106616760	106622405	7
chr7	106626406	106632219	Rps3	5813	-	NM_012052	106627786	106632131	7
chr7	106628072	106628217	Snord15b	145	-	NR_002173	106628217	106628217	1
chr7	106631294	106631442	Snord15a	148	-	NR_002172	106631442	106631442	1
chr7	106683995	106755281	Arrb1	71286	+	NM_177231	106684288	106749719	16
chr7	106700778	106700873	Mir326	95	+	NR_029760	106700873	106700873	1
chr7	106772576	106775613	Tpbgl	3037	-	NM_001195529	106774003	106775158	1
chr7	106806313	106859850	Slco2b1	53537	-	NM_175316	106808550	106840389	14
chr7	106883654	106884605	Olfr520	951	+	NM_147063	106883654	106884605	1
chr7	106915673	106916639	Olfr521	966	+	NM_146356	106915673	106916639	1
chr7	106959948	106976927	Neu3	16979	-	NM_016720	106961767	106972038	3
chr7	106986078	107007393	Spcs2	21315	-	NM_025668	106988206	107007387	5
chr7	107007727	107066334	Xrra1	58607	+	NM_001164258	107015860	107066149	19
chr7	107068764	107128968	Rnf169	60204	-	NM_175388	107073811	107128944	6
chr7	107154913	107183236	Chrdl2	28323	+	NM_133709	107155075	107183159	11
chr7	107230622	107270010	Pold3	39388	-	NM_133692	107232161	107269933	12
chr7	107307786	107309441	Lipt2	1655	+	NM_026010	107307791	107308913	2
chr7	107325179	107333379	Kcne3	8200	+	NM_001190869	107332687	107332999	5
chr7	107376116	107427382	Pgm2l1	51266	+	NM_027629	107376433	107420939	14
chr7	107413053	107414071	Gpx2-ps1	1018	+	NR_033563	107414071	107414071	1
chr7	107434029	107468209	P4ha3	34180	+	NM_177161	107434042	107467490	13
chr7	107475246	107520406	Ppme1	45160	-	NM_028292	107476373	107520333	14
chr7	107520742	107618668	C2cd3	97926	+	NM_001017985	107520951	107618037	33
chr7	107621499	107634941	Ucp3	13442	+	NM_009464	107627975	107633617	7
chr7	107641866	107648138	Ucp2	6272	+	NM_011671	107645331	107647859	8
chr7	107651528	107663324	Dnajb13	11796	-	NM_153527	107651665	107663269	8
chr7	107685613	107688326	Coa4	2713	+	NM_183270	107687595	107687859	2
chr7	107697630	107756510	Mrpl48	58880	-	NR_003559	107756510	107756510	8
chr7	107756099	107789782	Rab6a	33683	+	NM_024287	107756737	107787833	8
chr7	107792409	107810908	Plekhb1	18499	-	NM_013746	107793446	107810450	9
chr7	107855215	107990144	Fam168a	134929	+	NM_178764	107935335	107983953	9
chr7	107994361	108011927	Relt	17566	-	NM_177073	107995743	108001625	11
chr7	108018259	108080675	Arhgef17	62416	-	NM_001081116	108021913	108080253	21
chr7	108030819	108030923	Mir3102	104	-	NR_037289	108030923	108030923	1
chr7	108086147	108112880	P2ry6	26733	-	NM_183168	108086677	108087664	3
chr7	108145081	108160567	P2ry2	15486	-	NM_001302346	108146488	108147610	3
chr7	108257288	108432919	Fchsd2	175631	+	NM_199012	108257532	108431047	21
chr7	108438129	108450602	Atg16l2	12473	-	NM_001111111	108438360	108450541	18
chr7	108469832	108494826	Stard10	24994	+	NM_019990	108470340	108494651	7
chr7	108496582	108561100	Arap1	64518	+	NM_001040111	108521506	108559835	34
chr7	108570204	108661343	Pde2a	91139	+	NM_001008548	108570438	108660177	31
chr7	108623889	108623957	Mir139	68	+	NR_029791	108623957	108623957	1
chr7	108700966	108709379	Art2a-ps	8413	-	NR_033804	108709379	108709379	4
chr7	108727373	108729675	Art2b	2302	-	NM_019915	108727373	108729675	3
chr7	108812281	108938682	Clpb	126401	+	NM_009191	108812324	108936267	16
chr7	108966826	108971240	Phox2a	4414	+	NM_008887	108967011	108970659	3
chr7	108971145	108986740	Inppl1	15595	-	NM_010567	108971826	108985266	29
chr7	108988501	109005704	Folr2	17203	-	NM_001303239	108988688	108992328	6
chr7	109006844	109019302	Folr1	12458	-	NM_008034	109006977	109012600	7
chr7	109029838	109048059	Anapc15	18221	+	NM_001291353	109046308	109047755	6
chr7	109048321	109054873	Tomt	6552	-	NM_001081679	109048816	109050785	4
chr7	109054350	109060417	Lamtor1	6067	+	NM_025605	109054512	109059879	5
chr7	109061502	109082371	Lrrc51	20869	-	NM_027053	109061584	109069232	6
chr7	109118356	109163473	Numa1	45117	+	NM_133947	109125922	109162761	25
chr7	109163590	109166669	Il18bp	3079	-	NM_010531	109164259	109165828	7
chr7	109168385	109213646	Rnf121	45261	-	NM_029211	109168885	109213642	9
chr7	109214004	109232276	Xndc1	18272	+	NM_001286689	109219830	109230787	11
chr7	109214004	109245378	Xntrpc	31374	+	NR_104582	109245378	109245378	22
chr7	109231629	109245378	Trpc2	13749	+	NM_001109897	109231685	109244765	13
chr7	109245392	109248743	Art5	3351	-	NR_111935	109248743	109248743	6
chr7	109250256	109259662	Art1	9406	+	NM_009710	109254816	109259315	5
chr7	109259779	109265227	Chrna10	5448	-	NM_001081424	109260552	109264831	5
chr7	109267913	109358680	Nup98	90767	-	NM_001287164	109268967	109344374	33
chr7	109358848	109387078	Pgap2	28230	+	NM_001291358	109374794	109386045	7
chr7	109387636	109398632	Rhog	10996	-	NM_019566	109388182	109388758	2
chr7	109416337	109585369	Stim1	169032	+	NM_009287	109416928	109584414	12
chr7	109590208	109618285	Rrm1	28077	+	NM_009103	109590538	109616997	19
chr7	109625286	109626416	Olfr543	1130	-	NM_001011782	109625371	109626382	1
chr7	109632627	109636821	Olfr544	4194	-	NM_020289	109632627	109633632	2
chr7	109642336	109643287	Olfr545	951	-	NM_146840	109642336	109643287	1
chr7	109683262	109684202	Olfr547	940	+	NM_147079	109683262	109684198	1
chr7	109702799	109703750	Olfr549	951	+	NM_147101	109702799	109703750	1
chr7	109706433	109713996	Trim21	7563	-	NM_009277	109707635	109712603	8
chr7	109726982	109728020	Olfr550	1038	+	NM_147104	109727010	109727961	1
chr7	109736254	109737333	Olfr551	1079	-	NM_146755	109736307	109737255	1
chr7	109752869	109753823	Olfr552	954	+	NM_147102	109752869	109753823	1
chr7	109762520	109763501	Olfr553	981	-	NM_207621	109762520	109763501	1
chr7	109788761	109789715	Olfr554	954	+	NM_146325	109788761	109789715	1
chr7	109807336	109808284	Olfr555	948	+	NM_147103	109807336	109808284	1
chr7	109818414	109819437	Olfr556	1023	+	NM_146754	109818435	109819410	1
chr7	109826098	109835841	Trim68	9743	-	NM_198012	109826800	109832987	7
chr7	109846729	109847786	Olfr557	1057	+	NM_146361	109846753	109847722	1
chr7	109850836	109860568	Olfr558	9732	+	NM_147093	109857774	109858728	2
chr7	109861968	109862925	Olfr33	957	-	NM_147073	109861968	109862925	1
chr7	109872045	109873002	Olfr559	957	-	NM_147112	109872045	109873002	1
chr7	109889234	109907985	Olfr78	18751	-	NM_130866	109890552	109891515	4
chr7	109901496	109902441	Olfr560	945	-	NM_147113	109901496	109902441	1
chr7	109923039	109923984	Olfr561	945	+	NM_147092	109923039	109923984	1
chr7	109951993	109952944	Olfr564	951	+	NM_146359	109951993	109952944	1
chr7	110004834	110005785	Olfr566	951	-	NM_001011536	110004834	110005785	1
chr7	110025635	110026577	Olfr568	942	+	NM_147091	110025635	110026577	1
chr7	110035720	110036665	Olfr569	945	-	NM_147088	110035720	110036665	1
chr7	110048882	110049821	Olfr570	939	+	NM_147110	110048882	110049821	1
chr7	110057382	110058351	Olfr571	969	-	NM_147085	110057382	110058351	1
chr7	110076143	110077100	Olfr572	957	+	NM_147089	110076143	110077100	1
chr7	110096980	110098021	Olfr574	1041	+	NM_146360	110096980	110098021	1
chr7	110103177	110104134	Olfr575	957	-	NM_147114	110103177	110104134	1
chr7	110113615	110114554	Olfr576	939	+	NM_001001805	110113615	110114554	1
chr7	110121565	110122504	Olfr577	939	-	NM_147109	110121565	110122504	1
chr7	110132734	110133676	Olfr578	942	-	NM_147115	110132734	110133676	1
chr7	110189994	110190954	Olfr582	960	+	NM_147053	110189994	110190954	1
chr7	110199813	110200773	Olfr583	960	+	NM_146757	110199813	110200773	1
chr7	110234033	110234993	Olfr584	960	+	NM_147054	110234033	110234993	1
chr7	110246256	110247213	Olfr585	957	+	NM_147087	110246256	110247213	1
chr7	110270342	110271296	Olfr586	954	-	NM_147111	110270342	110271296	1
chr7	110303305	110304259	Olfr589	954	-	NM_147052	110303305	110304259	1
chr7	110321204	110322149	Olfr591	945	-	NM_001011847	110321204	110322149	1
chr7	110335116	110336055	Olfr592	939	+	NM_207556	110335116	110336055	1
chr7	110360375	110361359	Olfr593	984	+	NM_146380	110360375	110361359	1
chr7	110368233	110369169	Olfr594	936	+	NM_207143	110368233	110369169	1
chr7	110398599	110401019	Usp17ld	2420	-	NM_001001559	110398599	110401019	2
chr7	110458236	110459175	Olfr596	939	+	NM_001190381	110458236	110459175	1
chr7	110468926	110469874	Olfr597	948	+	NM_001011845	110468926	110469874	1
chr7	110477001	110477961	Olfr598	960	+	NM_001011793	110477001	110477961	1
chr7	110486569	110487517	Olfr599	948	+	NM_146731	110486569	110487517	1
chr7	110494495	110495440	Olfr600	945	-	NM_147046	110494495	110495440	1
chr7	110506737	110507727	Olfr601	990	-	NM_146314	110506761	110507706	1
chr7	110531575	110532514	Olfr603	939	-	NM_147070	110531575	110532514	1
chr7	110565209	110567688	Usp17lc	2479	+	NM_010089	110565231	110567651	2
chr7	110590653	110591664	Olfr605	1011	-	NM_001011854	110590690	110591635	1
chr7	110599852	110600812	Olfr606	960	+	NM_147094	110599852	110600812	1
chr7	110618554	110619505	Olfr608	951	+	NM_146756	110618554	110619505	1
chr7	110640430	110641390	Olfr609	960	-	NM_147082	110640430	110641390	1
chr7	110654510	110655458	Olfr610	948	-	NM_147081	110654510	110655458	1
chr7	110665924	110666896	Olfr611	972	-	NM_146727	110665924	110666896	1
chr7	110686774	110687746	Olfr612	972	-	NM_001200027	110686774	110687746	1
chr7	110698881	110704018	Olfr613	5137	+	NM_147100	110700300	110701254	1
chr7	110708992	110709934	Olfr615	942	+	NM_147080	110708992	110709934	1
chr7	110712837	110713791	Olfr616	954	-	NM_147099	110712837	110713791	1
chr7	110732537	110733494	Olfr617	957	+	NM_146841	110732537	110733494	1
chr7	110745831	110746788	Olfr618	957	+	NM_147047	110745831	110746788	1
chr7	110752102	110753225	Olfr619	1123	+	NM_147076	110752169	110753132	1
chr7	110759923	110760865	Olfr620	942	-	NM_146812	110759923	110760865	1
chr7	110787698	110788652	Olfr622	954	-	NM_147083	110787698	110788652	1
chr7	110808757	110809832	Olfr623	1075	-	NM_147122	110808808	110809762	1
chr7	110818616	110819543	Olfr624	927	-	NM_001011865	110818616	110819543	1
chr7	110865109	110866060	Olfr243	951	+	NM_001025386	110865109	110866060	1
chr7	110880441	110881392	Olfr628	951	+	NM_147097	110880441	110881392	1
chr7	110888714	110889836	Olfr629	1122	-	NM_146821	110888807	110889752	1
chr7	110902663	110905864	Olfr630	3201	-	NM_147098	110903137	110904097	2
chr7	110915790	110920108	Olfr69	4318	-	NM_013621	110915958	110916909	3
chr7	110925909	110926857	Olfr68	948	-	NM_013620	110925909	110926857	1
chr7	110935725	110940344	Olfr67	4619	-	NM_013619	110935826	110936789	2
chr7	110961037	110962437	Hbb-b2	1400	-	NM_016956	110961169	110962383	3
chr7	110961037	110962437	Hbb-bt	1400	-	NM_008220	110961169	110962383	3
chr7	110975036	110976442	Hbb-bs	1406	-	NM_001201391	110975178	110976389	3
chr7	110975045	110976443	Hbb-b1	1398	-	NM_001278161	110975178	110976389	3
chr7	110987637	110989035	Hbb-bh2	1398	-	NM_001127686	110987658	110988941	3
chr7	110990151	110991676	Hbb-bh1	1525	-	NM_008219	110990265	110991624	3
chr7	111000267	111001721	Hbb-y	1454	-	NM_008221	111000387	111001666	3
chr7	111029819	111030755	Olfr66	936	-	NM_013618	111029819	111030755	1
chr7	111041323	111042985	Olfr64	1662	-	NM_013617	111041323	111042247	1
chr7	111054855	111055961	Olfr65	1106	+	NM_013616	111054954	111055902	1
chr7	111063575	111078425	Olfr631	14850	+	NM_146959	111077338	111078298	5
chr7	111085895	111086849	Olfr632	954	+	NM_147119	111085895	111086849	1
chr7	111095081	111096020	Olfr633	939	+	NM_146354	111095081	111096020	1
chr7	111127689	111128655	Olfr635	966	+	NM_147118	111127689	111128655	1
chr7	111151772	111152738	Olfr638	966	+	NM_147120	111151772	111152738	1
chr7	111160263	111161214	Olfr639	951	-	NM_147084	111160263	111161214	1
chr7	111169885	111170830	Olfr640	945	-	NM_146822	111169885	111170830	1
chr7	111188311	111189250	Olfr641	939	+	NM_147072	111188311	111189250	1
chr7	111197921	111198866	Olfr642	945	-	NM_146329	111197921	111198866	1
chr7	111207169	111208114	Olfr643	945	-	NM_147077	111207169	111208114	1
chr7	111216598	111217543	Olfr644	945	-	NM_147121	111216598	111217543	1
chr7	111232644	111233592	Olfr645	948	-	NM_207144	111232644	111233592	1
chr7	111254794	111255733	Olfr646	939	+	NM_147056	111254794	111255733	1
chr7	111276426	111278337	4931431F19Rik	1911	-	NM_027634	111276596	111278129	1
chr7	111289136	111291786	Ubqln3	2650	-	NM_198623	111289418	111291395	2
chr7	111296772	111299070	Ubqlnl	2298	-	NM_198624	111296969	111298802	1
chr7	111301526	111313330	Olfm5	11804	-	NM_172905	111302277	111313319	6
chr7	111327969	111328920	Olfr648	951	-	NM_146751	111327969	111328920	1
chr7	111337780	111338719	Olfr649	939	-	NM_147055	111337780	111338719	1
chr7	111367308	111383666	Trim6	16358	+	NM_001013616	111374071	111381446	8
chr7	111392970	111410750	Trim34a	17780	+	NM_030684	111396244	111409964	8
chr7	111412961	111436620	Trim5	23659	-	NM_001310602	111413880	111428246	8
chr7	111448410	111464009	Trim12a	15599	-	NM_023835	111449350	111455845	8
chr7	111463544	111473352	Gm15133	9808	+	NR_040749	111473352	111473352	7
chr7	111477984	111485131	Trim34b	7147	+	NM_001243916	111478061	111485131	7
chr7	111487267	111501872	Trim12c	14605	-	NM_001146007	111489288	111496861	8
chr7	111503911	111507160	Trim30b	3249	-	NM_175648	111505681	111506161	2
chr7	111557539	111613707	Trim30a	56168	-	NM_009099	111559590	111584515	8
chr7	111618528	111656363	Trim30d	37835	-	NM_199146	111620556	111636509	8
chr7	111681472	111683875	Trim30e-ps1	2403	-	NR_033673	111683875	111683875	3
chr7	111701397	111702466	Olfr651	1069	+	NM_146813	111701434	111702376	1
chr7	111712665	111713726	Olfr652	1061	+	NM_147048	111712736	111713693	1
chr7	111728137	111729183	Olfr653	1046	+	NM_147074	111728161	111729115	1
chr7	111736268	111737294	Olfr654	1026	+	NM_146379	111736268	111737294	1
chr7	111744766	111745693	Olfr655	927	-	NM_146820	111744766	111745693	1
chr7	111766170	111767160	Olfr656	990	+	NM_147075	111766170	111767160	1
chr7	111784189	111785149	Olfr657	960	+	NM_146312	111784189	111785149	1
chr7	111791393	111795819	Olfr658	4426	-	NM_147049	111792912	111793884	2
chr7	111819217	111820186	Olfr659	969	+	NM_147050	111819217	111820186	1
chr7	111836530	111837490	Olfr661	960	+	NM_146748	111836530	111837490	1
chr7	111852082	111853117	Olfr663	1035	+	NM_001011757	111852082	111853117	1
chr7	111916562	111925984	Usp17le	9422	-	NM_001256973	111916824	111925984	3
chr7	111988825	111991018	Usp17lb	2193	-	NM_201409	111988825	111991018	2
chr7	112005529	112011181	Usp17la	5652	+	NM_007887	112007906	112010284	3
chr7	112029222	112030173	Olfr665	951	+	NM_146814	112029222	112030173	1
chr7	112041183	112042140	Olfr666	957	-	NM_147096	112041183	112042140	1
chr7	112064827	112065808	Olfr667	981	-	NM_147060	112064827	112065808	1
chr7	112073319	112074276	Olfr668	957	-	NM_147059	112073319	112074276	1
chr7	112087041	112087995	Olfr669	954	+	NM_147043	112087041	112087995	1
chr7	112108305	112109244	Olfr670	939	-	NM_207146	112108305	112109244	1
chr7	112123555	112124497	Olfr671	942	-	NM_001011755	112123555	112124497	1
chr7	112144477	112145416	Olfr672	939	-	NM_146760	112144477	112145416	1
chr7	112172538	112173480	Olfr675	942	-	NM_001011848	112172538	112173480	1
chr7	112183713	112184667	Olfr676	954	+	NM_147095	112183713	112184667	1
chr7	112204761	112205700	Olfr677	939	+	NM_146358	112204761	112205700	1
chr7	112217982	112218924	Olfr678	942	+	NM_146758	112217982	112218924	1
chr7	112234231	112235179	Olfr679	948	+	NM_147044	112234231	112235179	1
chr7	112269972	112270920	Olfr681	948	+	NM_207557	112269972	112270920	1
chr7	112291863	112292823	Olfr683	960	-	NM_147045	112291863	112292823	1
chr7	112305255	112306194	Olfr684	939	-	NM_207249	112305255	112306194	1
chr7	112328874	112329825	Olfr685	951	-	NM_001011857	112328874	112329825	1
chr7	112351901	112352855	Olfr686	954	-	NM_147069	112351901	112352855	1
chr7	112436608	112437574	Olfr688	966	+	NM_001011533	112436608	112437574	1
chr7	112462519	112463482	Olfr689	963	+	NM_146750	112462519	112463482	1
chr7	112477730	112478792	Olfr690	1062	-	NM_020290	112477756	112478704	1
chr7	112485259	112486228	Olfr691	969	-	NM_147061	112485259	112486228	1
chr7	112516841	112517831	Olfr692	990	+	NM_146355	112516841	112517831	1
chr7	112519724	112548568	Fam160a2	28844	-	NM_001242363	112527284	112538672	13
chr7	112523611	112526801	Gm5901	3190	+	NM_001195727	112523611	112526801	3
chr7	112553081	112557252	Cnga4	4171	+	NM_001033317	112553205	112556624	6
chr7	112574244	112584853	Cckbr	10609	+	NM_007627	112574538	112583936	5
chr7	112629129	112630711	Prkcdbp	1582	-	NM_028444	112629334	112630673	2
chr7	112702873	112706903	Smpd1	4030	+	NM_011421	112703045	112706547	6
chr7	112706978	112730167	Apbb1	23189	-	NM_009685	112707396	112722916	14
chr7	112740124	112748630	Hpx	8506	-	NM_017371	112740195	112748604	10
chr7	112752976	112782085	Trim3	29109	-	NM_001285873	112753121	112774050	12
chr7	112782714	112788930	Arfip2	6216	-	NM_029802	112784751	112787937	8
chr7	112789053	112790359	Timm10b	1306	+	NM_019502	112789106	112789718	3
chr7	112880243	112885899	Rrp8	5656	-	NM_133951	112881537	112885815	7
chr7	112885103	112891439	Ilk	6336	+	NM_001161724	112885662	112891176	13
chr7	112891407	112892852	Taf10	1445	-	NM_020024	112891487	112892832	5
chr7	112893329	112900749	Tpp1	7420	-	NM_009906	112895145	112900701	13
chr7	112901502	112936064	Dchs1	34562	-	NM_001162943	112901971	112921725	21
chr7	112952295	112959601	Mrpl17	7306	-	NM_025301	112958370	112959495	3
chr7	113010294	113011841	Gm15645	1547	+	NR_033578	113011841	113011841	1
chr7	113043632	113102481	Gm4070	58849	-	NM_001243039	113045073	113052357	4
chr7	113043632	113102484	Gvin1	58852	-	NM_029000	113045073	113052357	4
chr7	113072848	113077205	Gm18853	4357	-	NR_040456	113077205	113077205	1
chr7	113072857	113077205	Gm17757	4348	-	NR_040453	113077205	113077205	1
chr7	113219244	113222662	Gm8979	3418	-	NR_030719	113222662	113222662	1
chr7	113219245	113221378	Gm8989	2133	-	NR_030720	113221378	113221378	1
chr7	113565063	113584587	Gm4759	19524	-	NR_003967	113584587	113584587	3
chr7	113739062	113788159	Gm1966	49097	-	NM_001277183	113740256	113747549	6
chr7	113821047	113821999	Olfr693	952	-	NM_146453	113821047	113821998	1
chr7	113832295	113833243	Olfr694	948	-	NM_146452	113832295	113833243	1
chr7	113857245	113859859	Olfr695	2614	-	NM_146598	113857245	113858193	3
chr7	113884421	113885470	Olfr697	1049	-	NM_146599	113884492	113885446	1
chr7	113895964	113896900	Olfr698	936	-	NM_146602	113895964	113896900	1
chr7	113933562	113934513	Olfr699	951	-	NM_001011862	113933562	113934513	1
chr7	113949023	113949974	Olfr700	951	-	NM_146600	113949023	113949974	1
chr7	113957657	113964223	Olfr701	6566	+	NM_028910	113961598	113962549	5
chr7	113967002	113970257	Olfr702	3255	-	NM_146597	113967081	113968038	2
chr7	113988126	113989086	Olfr703	960	+	NM_146596	113988126	113989086	1
chr7	114008495	114009443	Olfr704	948	+	NM_001011749	114008495	114009443	1
chr7	114016806	114017757	Olfr705	951	-	NM_147032	114016806	114017757	1
chr7	114029378	114030329	Olfr706	951	-	NM_146353	114029378	114030329	1
chr7	114034697	114035621	Olfr707	924	-	NM_001005570	114034697	114035621	1
chr7	114057713	114058637	Olfr1532-ps1	924	+	NM_001011542	114057713	114058637	1
chr7	114087580	114091826	Olfr710	4246	-	NM_146601	114087580	114088513	2
chr7	114099497	114100448	Olfr6	951	-	NM_206897	114099497	114100448	1
chr7	114114881	114118965	Olfr711	4084	-	NM_147035	114114911	114115856	3
chr7	114144388	114146119	Olfr2	1731	-	NM_010983	114144388	114145372	2
chr7	114179649	114180624	Olfr713	975	+	NM_147034	114179649	114180624	1
chr7	114217343	114218297	Olfr714	954	+	NM_147033	114217343	114218297	1
chr7	114240980	114241928	Olfr17	948	+	NM_020598	114240980	114241928	1
chr7	114249425	114250373	Gm10081	948	-	NM_001162940	114249425	114250373	1
chr7	114271865	114272996	Olfr715	1131	-	NM_146780	114271957	114272905	1
chr7	114290831	114291776	Olfr716	945	+	NM_146604	114290831	114291776	1
chr7	114310503	114341617	Nlrp14	31114	+	NM_001002894	114324686	114341423	11
chr7	114352958	114354430	Rbmxl2	1472	+	NM_029660	114353023	114354181	1
chr7	114514303	114692169	Syt9	177866	+	NM_021889	114514516	114690042	7
chr7	114710946	114734879	Olfml1	23933	+	NM_172907	114711279	114733945	3
chr7	114738564	114888410	Ppfibp2	149846	+	NM_008905	114780760	114887885	25
chr7	114891968	114901546	Cyb5r2	9578	-	NM_001205227	114893737	114900776	9
chr7	114925057	114944693	Ovch2	19636	-	NM_172908	114925151	114944693	16
chr7	114958099	114959020	Olfr467	921	+	NM_001005488	114958099	114959020	1
chr7	114966036	114966981	Olfr469	945	-	NM_146426	114966036	114966981	1
chr7	114988300	114989245	Olfr470	945	-	NM_146425	114988300	114989245	1
chr7	115046232	115047165	Olfr472	933	+	NM_146774	115046232	115047165	1
chr7	115077035	115077968	Olfr473	933	+	NM_146775	115077035	115077968	1
chr7	115098156	115099089	Olfr474	933	+	NM_146495	115098156	115099089	1
chr7	115110912	115111845	Olfr476	933	+	NM_146924	115110912	115111845	1
chr7	115133880	115134813	Olfr477	933	+	NM_146926	115133880	115134813	1
chr7	115174910	115175855	Olfr478	945	-	NM_146734	115174910	115175855	1
chr7	115198497	115199481	Olfr479	984	+	NM_001011742	115198497	115199481	1
chr7	115209281	115210310	Olfr480	1029	-	NM_020291	115209281	115210310	1
chr7	115224309	115225248	Olfr481	939	+	NM_146925	115224309	115225248	1
chr7	115238110	115239082	Olfr482	972	-	NM_146733	115238110	115239082	1
chr7	115246824	115247772	Olfr483	948	+	NM_146735	115246824	115247772	1
chr7	115267809	115268775	Olfr484	966	-	NM_146499	115267809	115268775	1
chr7	115302431	115303385	Olfr485	954	-	NM_001011810	115302431	115303385	1
chr7	115315311	115316256	Olfr486	945	-	NM_146496	115315311	115316256	1
chr7	115355096	115356041	Olfr487	945	-	NM_001011811	115355096	115356041	1
chr7	115398705	115399650	Olfr488	945	-	NM_146732	115398705	115399650	1
chr7	115429693	115430638	Olfr490	945	-	NM_146498	115429693	115430638	1
chr7	115460409	115461342	Olfr491	933	+	NM_146736	115460409	115461342	1
chr7	115466243	115467188	Olfr492	945	-	NM_146497	115466243	115467188	1
chr7	115489548	115490493	Olfr493	945	-	NM_146310	115489548	115490493	1
chr7	115511005	115511950	Olfr494	945	+	NM_146737	115511005	115511950	1
chr7	115538635	115539628	Olfr495	993	+	NM_146364	115538635	115539628	1
chr7	115566086	115567031	Olfr497	945	+	NM_146738	115566086	115567031	1
chr7	115608839	115609832	Olfr498	993	+	NM_146307	115608839	115609832	1
chr7	115666517	115667462	Olfr502	945	-	NM_146739	115666517	115667462	1
chr7	115688040	115689012	Olfr503	972	+	NM_001011527	115688040	115689012	1
chr7	115708350	115709307	Olfr504	957	-	NM_001011858	115708350	115709307	1
chr7	115755822	115756767	Olfr506	945	+	NM_001011871	115755822	115756767	1
chr7	115765327	115766278	Olfr507	951	+	NM_146743	115765327	115766278	1
chr7	115773507	115774440	Olfr508	933	+	NM_146773	115773507	115774440	1
chr7	115789122	115790088	Olfr509	966	-	NM_146372	115789122	115790088	1
chr7	115810931	115811876	Olfr510	945	+	NM_146311	115810931	115811876	1
chr7	115856868	115857849	Olfr512	981	+	NM_146724	115856868	115857849	1
chr7	115898371	115899301	Olfr513	930	+	NM_146723	115898371	115899301	1
chr7	115968578	115969511	Olfr514	933	-	NM_146726	115968578	115969511	1
chr7	115988577	115989522	Olfr516	945	-	NM_146725	115988577	115989522	1
chr7	116011721	116012666	Olfr517	945	-	NM_001011846	116011721	116012666	1
chr7	116024116	116025118	Olfr518	1002	-	NM_146306	116024116	116025118	1
chr7	116036974	116037919	Olfr519	945	-	NM_207160	116036974	116037919	1
chr7	116065366	116073672	Nlrp10	8306	-	NM_175532	116067763	116070643	3
chr7	116077928	116085456	Eif3f	7528	+	NM_025344	116077945	116085052	8
chr7	116154393	116177973	Tub	23580	+	NM_021885	116154614	116173771	12
chr7	116177832	116226845	Ric3	49013	-	NM_001311161	116181957	116226800	6
chr7	116282078	116318721	Lmo1	36643	-	NM_001302205	116282384	116318473	4
chr7	116422729	116582567	Stk33	159838	-	NM_054103	116423178	116485015	14
chr7	116592514	116651648	Trim66	59134	-	NM_001170912	116597488	116651465	20
chr7	116662708	116665883	Rpl27a	3175	+	NM_011975	116662733	116665243	5
chr7	116663645	116663765	Snora3	120	+	NR_028079	116663765	116663765	1
chr7	116667424	116760661	St5	93237	-	NM_001001326	116668159	116713600	20
chr7	116847250	116855695	Akip1	8445	+	NM_020616	116847465	116855407	6
chr7	116855694	116867285	BC051019	11591	-	NM_001040700	116856041	116866799	6
chr7	116870978	116875246	Ascl3	4268	-	NM_020051	116871099	116871624	2
chr7	116879349	116895777	Tmem9b	16428	-	NM_020050	116880349	116895692	5
chr7	116901569	116925059	Nrip3	23490	-	NM_020610	116904687	116924987	7
chr7	116942204	117009193	Scube2	66989	-	NM_020052	116942766	117009100	22
chr7	117037294	117103984	Dennd5a	66690	-	NM_001311139	117038145	117103696	22
chr7	117115700	117129744	Tmem41b	14044	-	NM_153525	117118295	117129596	7
chr7	117141890	117150160	1600010M07Rik	8270	-	NR_037959	117150160	117150160	3
chr7	117161938	117198628	Ipo7	36690	+	NM_181517	117161938	117198628	25
chr7	117189877	117190061	Snora23	184	+	NR_033336	117190061	117190061	1
chr7	117205215	117238906	Zfp143	33691	+	NM_009281	117213004	117237888	16
chr7	117265572	117286813	Wee1	21241	+	NM_009516	117265863	117285626	11
chr7	117365216	117427020	Swap70	61804	+	NM_009302	117365324	117424851	12
chr7	117451526	117758434	Sbf2	306908	-	NM_177324	117452911	117758275	41
chr7	117771182	117773333	Adm	2151	+	NM_009627	117771792	117772682	4
chr7	117911719	117955922	Ampd3	44203	+	NM_001276301	117921317	117954424	15
chr7	117960048	117987895	Rnf141	27847	-	NM_025999	117960213	117980733	6
chr7	117994120	118006467	Lyve1	12347	-	NM_053247	117995685	118006382	6
chr7	118011771	118125975	Mrvi1	114204	-	NM_194464	118014872	118089406	21
chr7	118048498	118049365	Gm16336	867	+	NR_045267	118049365	118049365	3
chr7	118172464	118199891	Ctr9	27427	+	NM_009431	118172650	118199299	25
chr7	118211498	118226544	Eif4g2	15046	-	NM_013507	118216205	118225061	22
chr7	118261186	118266189	1700012D14Rik	5003	-	NR_015573	118266189	118266189	3
chr7	118615174	118923491	Galnt18	308317	-	NM_173739	118615450	118923061	11
chr7	119167019	119254900	Usp47	87881	+	NM_177249	119167221	119253633	29
chr7	119259532	119302571	Dkk3	43039	-	NM_015814	119261724	119301909	8
chr7	119369349	119498708	Mical2	129359	+	NM_177282	119414819	119495237	20
chr7	119511821	119556618	Micalcl	44797	+	NM_027587	119523807	119556501	10
chr7	119571219	119735202	Parva	163983	+	NM_020606	119571478	119732130	13
chr7	119822833	120050319	Tead1	227486	+	NM_001166584	119902996	120042174	14
chr7	120097475	120100972	Rassf10	3497	+	NM_175279	120097707	120099234	1
chr7	120243749	120285529	4930543E12Rik	41780	-	NR_045978	120285529	120285529	6
chr7	120350978	120457640	Arntl	106662	+	NM_007489	120424176	120457133	20
chr7	120459157	120512853	Btbd10	53696	-	NM_133700	120459942	120495395	11
chr7	120529089	120532087	Pth	2998	-	NM_020623	120529330	120529794	3
chr7	120657347	120714402	Far1	57055	+	NM_027379	120682791	120711771	13
chr7	120681539	120708501	Far1os	26962	-	NR_126544	120708501	120708501	6
chr7	120909511	121186889	Spon1	277378	+	NM_145584	120909842	121183478	16
chr7	121190295	121261295	Rras2	71000	-	NM_025846	121191677	121261017	6
chr7	121359072	121398194	Copb1	39122	-	NM_033370	121359391	121397474	22
chr7	121408063	121419630	Psma1	11567	-	NM_011965	121408413	121419517	10
chr7	121458992	121558675	4933406I18Rik	99683	-	NR_029437	121558675	121558675	4
chr7	121558767	121681451	Pde3b	122684	+	NM_011055	121559064	121679762	16
chr7	121693676	121706486	Cyp2r1	12810	-	NM_177382	121693785	121706471	5
chr7	121774991	121779871	Calca	4880	-	NM_001033954	121775953	121778726	5
chr7	121862156	121866879	Calcb	4723	+	NM_054084	121863255	121865651	5
chr7	121889279	121993894	Insc	104615	+	NM_173767	121912490	121993458	13
chr7	122092163	122127481	A730082K24Rik	35318	+	NR_040317	122127481	122127481	4
chr7	122614385	123182258	Sox6	567873	-	NM_001025559	122620431	122945119	16
chr7	123225275	123236663	1700003G18Rik	11388	-	NR_029433	123236663	123236663	4
chr7	123236893	123248724	1110004F10Rik	11831	+	NM_019772	123236976	123247953	5
chr7	123266998	123451890	Plekha7	184892	-	NM_001305185	123268311	123451847	27
chr7	123475020	123477704	Rps13	2684	-	NM_026533	123475063	123477621	6
chr7	123480789	123586972	Pik3c2a	106183	-	NM_011083	123483554	123562034	33
chr7	123647882	123684102	Nucb2	36220	+	NM_001130479	123665350	123683963	14
chr7	124524492	124811144	Xylt1	286652	+	NM_175645	124524692	124811136	12
chr7	125247889	125259661	Rps15a	11772	-	NM_170669	125252613	125258755	5
chr7	125262403	125273139	Arl6ip1	10736	-	NM_019419	125263805	125273018	6
chr7	125274825	125387151	Smg1	112326	-	NM_001031814	125279054	125386804	63
chr7	125387420	125389065	4930583K01Rik	1645	+	NR_027879	125389065	125389065	2
chr7	125525369	125587066	Syt17	61697	-	NM_138649	125525369	125586862	8
chr7	125628625	125635489	Itpripl2	6864	-	NM_001033380	125633240	125634848	1
chr7	125653172	125676870	Coq7	23698	-	NM_001304758	125653323	125676765	7
chr7	125679357	125728200	Tmc7	48843	-	NM_172476	125681650	125728181	16
chr7	125740810	125818599	Tmc5	77789	+	NM_001105252	125766592	125818177	22
chr7	125832071	125849252	Gde1	17181	-	NM_019580	125832516	125849164	6
chr7	125856124	125880532	Ccp110	24408	+	NM_182995	125858887	125878834	16
chr7	125883784	125985005	9030624J02Rik	101221	+	NM_027815	125884188	125984808	31
chr7	125985731	125999512	Knop1	13781	-	NM_023197	125989296	125999290	5
chr7	125999288	126116166	Iqck	116878	+	NM_001081446	125999288	126115004	9
chr7	126115553	126138725	Gprc5b	23172	-	NM_001195774	126116702	126128158	4
chr7	126287836	126327888	Gpr139	40052	-	NM_001024138	126287836	126327888	2
chr7	126586057	126602786	Gp2	16729	-	NM_025989	126586294	126600762	11
chr7	126606221	126622776	Umod	16555	-	NM_009470	126606730	126621800	11
chr7	126630100	126666996	Pdilt	36896	-	NM_027943	126630237	126663338	12
chr7	126669778	126686874	Acsm5	17096	+	NM_178758	126671951	126686312	14
chr7	126697853	126744208	Acsm2	46355	+	NM_001177977	126697982	126739523	14
chr7	126761341	126806029	Acsm1	44688	+	NM_054094	126766023	126805797	14
chr7	126833539	126858080	Acsm4	24541	+	NM_178414	126837162	126857858	14
chr7	126858607	126864312	Thumpd1	5705	-	NM_145585	126860185	126864255	4
chr7	126904436	126928410	Acsm3	23974	+	NM_016870	126911459	126927874	16
chr7	126927339	126937572	Eri2	10233	-	NM_027698	126928723	126937454	9
chr7	126937643	126992452	2610020H08Rik	54809	+	NM_028129	126948772	126992271	14
chr7	126996676	127039259	Dcun1d3	42583	-	NM_001163703	127001086	127003324	3
chr7	127039374	127060270	Lyrm1	20896	+	NM_001285961	127053317	127059771	5
chr7	127245939	127264500	Tmem159	18561	+	NM_145586	127248247	127263769	5
chr7	127275874	127288804	Zp2	12930	-	NM_011775	127275902	127288774	18
chr7	127299628	127309515	4930505K13Rik	9887	+	NR_130979	127309515	127309515	3
chr7	127317371	127327230	Anks4b	9859	+	NM_028085	127317432	127326533	2
chr7	127329897	127345502	Crym	15605	-	NM_016669	127330147	127345438	8
chr7	127347477	127468866	Abca14	121389	+	NM_026458	127350892	127468692	31
chr7	127472197	127551201	Abca15	79004	+	NM_177213	127475684	127551035	31
chr7	127553160	127688327	Abca16	135167	+	NM_001278943	127579444	127688311	27
chr7	127741138	127741989	E130201H02Rik	851	+	NR_024324	127741989	127741989	1
chr7	127778702	127803037	Uqcrc2	24335	+	NM_025899	127778803	127802618	14
chr7	127802809	127813857	Pdzd9	11048	-	NM_001040136	127803476	127813710	4
chr7	127821133	127878368	BC030336	57235	+	NM_001164580	127821278	127874175	3
chr7	127883070	127949054	Vwa3a	65984	+	NM_177697	127883624	127948039	34
chr7	127986344	128050733	Eef2k	64389	+	NM_007908	128001933	128046905	18
chr7	128061257	128090946	Polr3e	29689	+	NM_025298	128066446	128089046	21
chr7	128100549	128125826	Cdr2	25277	-	NM_007672	128101446	128125566	5
chr7	128126022	128158301	4933427G17Rik	32279	+	NM_028955	128132499	128158163	8
chr7	128177958	128220349	Mettl9	42391	+	NM_021554	128178324	128219849	5
chr7	128207580	128218044	Igsf6	10464	-	NM_030691	128208974	128218019	6
chr7	128226951	128306603	Otoa	79652	+	NM_139310	128235057	128306445	29
chr7	128535809	128645282	Hs3st2	109473	+	NM_001081327	128536243	128644550	2
chr7	128730899	128733350	4933432K03Rik	2451	-	NR_102286	128733350	128733350	3
chr7	128733416	128735105	1700025J12Rik	1689	+	NR_131051	128735105	128735105	2
chr7	128785534	128850767	Usp31	65233	-	NM_001033173	128791697	128850767	16
chr7	128877992	128911996	Scnn1g	34004	+	NM_011326	128881431	128911063	13
chr7	129008551	129062242	Scnn1b	53691	+	NM_001272023	129042752	129061573	13
chr7	129066352	129125207	Cog7	58855	-	NM_001033318	129066815	129125099	17
chr7	129130235	129164712	Gga2	34477	-	NM_028758	129133204	129164602	17
chr7	129177675	129210600	Ears2	32925	-	NM_026140	129182588	129210557	9
chr7	129210711	129225713	Ubfd1	15002	+	NM_138589	129210796	129222074	7
chr7	129231557	129245362	Ndufab1	13805	-	NM_028177	129235107	129245336	5
chr7	129250775	129276460	Palb2	25685	-	NM_001081238	129251031	129276281	13
chr7	129276554	129292558	Dctn5	16004	+	NM_021608	129276647	129291668	6
chr7	129302948	129313398	Plk1	10450	+	NM_011121	129303056	129313104	10
chr7	129313406	129329745	Ern2	16339	-	NM_001316689	129313579	129329666	22
chr7	129363009	129366053	Chp2	3044	+	NM_027363	129363225	129365689	7
chr7	129432638	129777915	Prkcb	345277	+	NM_008855	129432858	129771328	17
chr7	129815257	129912907	Cacng3	97650	+	NM_019430	129815287	129912360	4
chr7	130112571	130113973	4930413G21Rik	1402	-	NR_045614	130113973	130113973	1
chr7	130114077	130146086	Rbbp6	32009	+	NM_011247	130114475	130145658	18
chr7	130267398	130338810	Tnrc6a	71412	+	NM_144925	130267841	130336465	24
chr7	130358379	130416765	Slc5a11	58386	+	NM_146198	130379133	130416717	17
chr7	130422662	130513429	Arhgap17	90767	-	NM_001122640	130428934	130513320	21
chr7	130521495	130573872	Lcmt1	52377	+	NM_025304	130521662	130573669	11
chr7	130605807	130611517	Aqp8	5710	+	NM_007474	130605960	130610970	6
chr7	130622153	130643963	Zkscan2	21810	-	NM_001081329	130623363	130643481	7
chr7	131126694	131542503	Hs3st4	415809	+	NM_001252072	131126694	131540976	2
chr7	131769183	131852449	3100003L05Rik	83266	-	NR_045907	131852449	131852449	4
chr7	132475295	132493300	4933440M02Rik	18005	-	NR_045803	132493300	132493300	4
chr7	132512374	132514527	4930571K23Rik	2153	+	NM_001145759	132512535	132512994	1
chr7	132588133	132605782	Kdm8	17649	+	NM_029842	132595750	132604765	8
chr7	132611153	132635056	Nsmce1	23903	-	NM_026330	132611277	132634957	8
chr7	132695795	132722988	Il4ra	27193	+	NM_001008700	132709168	132720568	11
chr7	132746942	132777084	Il21r	30142	+	NM_021887	132766395	132776505	9
chr7	132784467	132851202	Gtf3c1	66735	-	NM_207239	132785019	132851191	37
chr7	132851389	133018311	D430042O09Rik	166922	+	NM_001081022	132851455	133017019	28
chr7	133021932	133225925	Gsg1l	203993	-	NM_001101488	133024654	133225692	7
chr7	133245228	133344013	Xpo6	98785	-	NM_001311143	133245802	133343415	24
chr7	133367760	133391752	1700123J17Rik	23992	-	NR_131046	133391752	133391752	5
chr7	133416132	133438513	Sbk1	22381	+	NM_145587	133433377	133436163	4
chr7	133507341	133513082	Lat	5741	-	NM_010689	133507716	133512764	12
chr7	133511484	133511559	Mir7058	75	-	NR_106025	133511559	133511559	1
chr7	133513573	133521448	Spns1	7875	-	NR_045537	133521448	133521448	13
chr7	133526367	133540251	Nfatc2ip	13884	-	NM_010900	133528494	133540229	8
chr7	133551961	133558384	Cd19	6423	-	NM_009844	133552885	133558350	15
chr7	133572280	133589421	Rabep2	17141	+	NM_030566	133572645	133588912	13
chr7	133589373	133606587	Atp2a1	17214	-	NM_007504	133590095	133606436	23
chr7	133610506	133618644	Sh2b1	8138	-	NM_001289540	133611268	133616525	11
chr7	133630868	133634245	Tufm	3377	+	NM_172745	133630961	133634008	10
chr7	133635221	133646816	Atxn2l	11595	-	NM_183020	133635679	133646706	23
chr7	133690424	133709880	Eif3c	19456	-	NM_146200	133690511	133709693	21
chr7	133714913	133727794	Cln3	12881	-	NM_001146311	133715780	133726559	17
chr7	133722987	133723046	Mir7059	59	-	NR_106026	133723046	133723046	1
chr7	133728521	133732606	Apobr	4085	+	NM_138310	133728525	133731840	4
chr7	133732808	133738424	Il27	5616	-	NM_145636	133732808	133738424	5
chr7	133766759	133768984	Nupr1	2225	-	NM_019738	133768416	133768948	3
chr7	133792822	133816293	Sgf29	23471	+	NM_029339	133804587	133816200	10
chr7	133816383	133819871	Sult1a1	3488	-	NM_133670	133816922	133819832	7
chr7	133832440	133839297	Slx1b	6857	-	NM_029420	133835139	133839117	6
chr7	133839513	133840207	Bola2	694	+	NM_175103	133839550	133840168	3
chr7	133843287	133848330	Coro1a	5043	-	NM_009898	133843394	133846687	11
chr7	133903139	133909330	Mapk3	6191	+	NM_011952	133903159	133908359	9
chr7	133909927	133919159	Gdpd3	9232	+	NM_024228	133909984	133919141	10
chr7	133920488	133924028	Ypel3	3540	+	NM_026875	133921350	133923630	5
chr7	133924996	133929062	Tbx6	4066	+	NM_011538	133925020	133928682	8
chr7	133929381	133935985	Ppp4c	6604	-	NM_019674	133929675	133935672	9
chr7	133938747	133943961	Aldoa	5214	-	NM_001177308	133938932	133941269	9
chr7	133960398	133973733	Fam57b	13335	+	NM_026884	133963343	133973013	8
chr7	133973987	133975010	4930451I11Rik	1023	-	NM_183131	133974110	133974994	4
chr7	133991066	133996219	Doc2a	5153	+	NM_010069	133992099	133995550	11
chr7	133995946	134004977	Ino80e	9031	-	NM_153580	133996283	134004841	5
chr7	134005485	134008636	Hirip3	3151	+	NM_172746	134005965	134008411	7
chr7	134009190	134028481	Taok2	19291	-	NM_001163774	134009910	134024142	19
chr7	134029732	134041792	Tmem219	12060	-	NM_026827	134032436	134040704	6
chr7	134072392	134089123	Kctd13	16731	+	NM_172747	134072568	134088635	6
chr7	134089521	134093095	Asphd1	3574	-	NM_001039645	134089614	134091890	4
chr7	134094048	134114120	Sez6l2	20072	+	NM_144926	134094551	134113596	18
chr7	134119427	134124015	Cdipt	4588	+	NM_026638	134120277	134123194	6
chr7	134130373	134158108	Mvp	27735	-	NM_080638	134130496	134158034	15
chr7	134158564	134160866	Pagr1a	2302	-	NM_030240	134158783	134160435	3
chr7	134161055	134164725	Prrt2	3670	-	NM_001102563	134162233	134163805	4
chr7	134165650	134169993	Maz	4343	-	NM_010772	134166527	134169933	5
chr7	134171244	134185934	Kif22	14690	-	NM_145588	134171306	134185915	14
chr7	134193669	134195491	Zg16	1822	-	NM_026918	134193797	134195487	3
chr7	134234949	134237563	AI467606	2614	+	NM_178901	134235768	134236446	2
chr7	134251283	134265543	Qprt	14260	-	NM_133686	134251536	134265499	4
chr7	134275745	134281337	Spn	5592	-	NR_110337	134281337	134281337	4
chr7	134335173	134339591	Cd2bp2	4418	-	NM_001285907	134337333	134338952	7
chr7	134340973	134351982	Tbc1d10b	11009	-	NM_144522	134342084	134351877	9
chr7	134355121	134357801	Mylpf	2680	+	NM_016754	134355274	134357709	7
chr7	134357955	134361959	Sept1	4004	-	NM_017461	134358271	134361923	11
chr7	134375931	134376644	Gm4532	713	-	NR_030674	134376644	134376644	1
chr7	134376956	134381374	Zfp553	4418	+	NM_146201	134378788	134380564	2
chr7	134388039	134398315	Zfp771	10276	+	NM_177362	134388507	134398131	3
chr7	134400475	134404181	Dctpp1	3706	-	NM_023203	134400549	134404137	3
chr7	134415394	134417573	Sephs2	2179	-	NM_009266	134416074	134417433	1
chr7	134439773	134478651	Itgal	38878	+	NM_008400	134439982	134477124	31
chr7	134486308	134488828	Zfp768	2520	-	NM_146202	134486770	134488750	2
chr7	134516050	134519564	Zfp747	3514	-	NM_175560	134517241	134519340	3
chr7	134525773	134530680	9130019O22Rik	4907	-	NM_030226	134527810	134530471	3
chr7	134534349	134537135	E430018J23Rik	2786	-	NM_198011	134534941	134536950	3
chr7	134547181	134550336	Zfp764	3155	-	NM_146203	134548175	134550118	3
chr7	134562479	134565548	Zfp688	3069	-	NM_026999	134562640	134565518	3
chr7	134585649	134592672	Zfp689	7023	-	NM_175163	134587467	134592372	3
chr7	134615127	134620272	Prr14	5145	+	NM_145589	134615468	134620174	11
chr7	134628734	134635027	Fbrs	6293	+	NM_010183	134628753	134633797	11
chr7	134632764	134632901	Mir7060	137	+	NR_106027	134632901	134632901	1
chr7	134653951	134656383	1700008J07Rik	2432	-	NR_024331	134656383	134656383	1
chr7	134655496	134704733	Srcap	49237	+	NM_001304266	134659661	134704283	34
chr7	134671410	134671517	Snora30	107	+	NR_034045	134671517	134671517	1
chr7	134704736	134708784	Tmem265	4048	+	NM_001304267	134706638	134708459	3
chr7	134716861	134726821	Phkg2	9960	+	NM_026888	134717385	134726543	10
chr7	134725896	134732109	Ccdc189	6213	-	NM_001033040	134726924	134731603	9
chr7	134732211	134747119	Rnf40	14908	+	NM_172281	134732510	134746157	20
chr7	134747416	134747959	1700120K04Rik	543	-	NR_027915	134747959	134747959	1
chr7	134750548	134757947	Zfp629	7399	-	NM_177226	134753545	134756253	3
chr7	134848491	134852280	Bcl7c	3789	-	NM_009746	134848563	134852041	6
chr7	134852000	134852076	Mir762	76	+	NR_030428	134852076	134852076	1
chr7	134856249	134861699	Ctf1	5450	+	NM_007795	134856268	134860985	3
chr7	134862473	134869130	Ctf2	6657	-	NM_198858	134862724	134869096	3
chr7	134890288	134912442	Fbxl19	22154	+	NM_172748	134891787	134911444	11
chr7	134913328	134918664	Orai3	5336	+	NM_198424	134913502	134917715	2
chr7	134920902	134943633	Setd1a	22731	+	NM_178029	134921641	134942993	19
chr7	134944122	134947316	Hsd3b7	3194	+	NM_001040684	134944675	134946715	7
chr7	134950357	134968045	Stx1b	17688	-	NM_024414	134950822	134967803	10
chr7	134985321	134992479	Stx4a	7158	+	NM_009294	134985552	134992166	11
chr7	135008872	135020337	Zfp668	11465	-	NM_146259	135009664	135011916	3
chr7	135021214	135029510	Zfp646	8296	+	NM_172749	135022166	135029057	3
chr7	135028957	135034484	Prss53	5527	-	NM_001081268	135029775	135034430	11
chr7	135036576	135039131	Vkorc1	2555	-	NM_178600	135036802	135039095	3
chr7	135047586	135053178	Bckdk	5592	+	NM_009739	135048444	135051825	12
chr7	135056030	135069276	Kat8	13246	+	NM_026370	135056045	135069165	11
chr7	135069230	135073627	Prss8	4397	-	NM_133351	135069839	135073396	6
chr7	135076151	135090239	Prss36	14088	-	NM_001081374	135076343	135089962	15
chr7	135110992	135125545	Fus	14553	+	NM_139149	135111078	135125344	15
chr7	135134886	135137381	Pycard	2495	-	NM_023258	135136225	135137167	3
chr7	135147891	135154907	Trim72	7016	+	NM_001079932	135147997	135153975	6
chr7	135206153	135262005	Itgam	55852	+	NM_001082960	135206256	135260891	30
chr7	135273081	135294171	Itgax	21090	+	NM_021334	135273133	135293708	30
chr7	135317459	135349017	Itgad	31558	+	NM_001029872	135317486	135348689	31
chr7	135335563	135346842	4931431B13Rik	11279	-	NR_045183	135346842	135346842	3
chr7	135348948	135349880	Cox6a2	932	-	NM_009943	135349242	135349809	3
chr7	135377964	135381545	9130023H24Rik	3581	-	NM_177001	135379919	135380933	1
chr7	135380870	135388614	Armc5	7744	+	NM_146205	135381640	135388331	6
chr7	135390325	135399213	Tgfb1i1	8888	+	NM_001289551	135390509	135396730	11
chr7	135409210	135415947	Slc5a2	6737	+	NM_133254	135409210	135415701	14
chr7	135414892	135441645	BC017158	26753	-	NM_145590	135416031	135441597	13
chr7	135431882	135431949	Mir3103	67	-	NR_037290	135431949	135431949	1
chr7	135517138	135561686	Rgs10	44548	-	NM_026418	135517409	135561628	5
chr7	135583290	135605027	Tial1	21737	-	NM_009383	135586046	135604670	12
chr7	135667096	135690493	Bag3	23397	+	NM_013863	135667372	135689910	4
chr7	135754878	135839950	Inpp5f	85072	+	NM_178641	135755108	135838839	20
chr7	135839972	135883943	Mcmbp	43971	-	NM_145955	135841957	135883704	16
chr7	135888383	135928349	Sec23ip	39966	+	NM_001029982	135888535	135923231	19
chr7	136400607	136534821	Plpp4	134214	+	NM_001080963	136400627	136534569	7
chr7	136735376	136779252	Wdr11	43876	+	NM_172255	136735491	136778489	29
chr7	137105678	137122183	Gm4265	16505	+	NR_046077	137122183	137122183	4
chr7	137305964	137410322	Fgfr2	104358	-	NM_010207	137307472	137405428	18
chr7	137535007	137663883	Ate1	128876	-	NM_001029895	137538071	137663475	12
chr7	137676039	137690895	Nsmce4a	14856	-	NM_001162855	137677105	137690788	11
chr7	137720997	137908298	Tacc2	187301	+	NM_206856	137720997	137907833	21
chr7	137917582	137969413	Btbd16	51831	+	NM_001081038	137920641	137967891	16
chr7	138009423	138056816	Plekha1	47393	+	NM_133942	138021267	138054660	10
chr7	138051781	138051849	Mir7061	68	+	NR_106028	138051849	138051849	1
chr7	138079716	138129172	Htra1	49456	+	NM_019564	138079785	138128645	9
chr7	138175589	138265142	Dmbt1	89553	+	NM_007769	138175598	138264749	47
chr7	138281860	138289797	4933402N03Rik	7937	-	NM_173409	138282009	138289775	3
chr7	138289952	138294092	1700029B22Rik	4140	+	NR_040531	138294092	138294092	5
chr7	138317915	138394459	5430419D17Rik	76544	+	NM_175166	138317934	138394076	23
chr7	138452067	138465806	Cuzd1	13739	-	NM_008411	138452254	138465561	9
chr7	138469444	138473013	1700007K09Rik	3569	-	NM_027037	138469612	138470839	4
chr7	138478135	138480230	Fam24a	2095	+	NM_183272	138479022	138480193	3
chr7	138486231	138506212	2310057M21Rik	19981	-	NM_026655	138487083	138506185	6
chr7	138514659	138531352	Pstk	16693	+	NM_001039534	138514687	138531331	6
chr7	138532162	138553992	Ikzf5	21830	-	NM_175115	138535150	138540315	4
chr7	138554114	138589725	Acadsb	35611	+	NM_025826	138554259	138587821	11
chr7	138686476	138688445	Hmx3	1969	+	NM_008257	138686476	138688149	2
chr7	138697575	138700096	Hmx2	2521	+	NM_145998	138697820	138699494	2
chr7	138703883	138715406	Bub3	11523	+	NM_009774	138704223	138714402	8
chr7	139158142	139177316	Gpr26	19174	+	NM_173410	139158610	139175999	3
chr7	139234492	139346424	Cpxm2	111932	-	NM_018867	139235575	139346296	14
chr7	139427937	139508838	Chst15	80901	-	NM_029935	139429956	139462233	8
chr7	139507346	139509974	Gm10584	2628	+	NR_028578	139509974	139509974	1
chr7	139749157	139768081	Oat	18924	-	NM_016978	139749852	139761787	10
chr7	139787921	139791320	Nkx1-2	3399	-	NM_009123	139788795	139791209	2
chr7	139802325	139898102	Lhpp	95777	+	NM_029609	139802388	139897371	7
chr7	139903766	140004879	Fam53b	101113	-	NM_212473	139907325	139970896	5
chr7	140019143	140044330	Mettl10	25187	-	NM_028095	140019446	140044291	6
chr7	140050907	140076797	Fam175b	25890	+	NM_198017	140050917	140075187	9
chr7	140141304	140175634	Zranb1	34330	+	NM_207302	140141304	140175634	9
chr7	140178693	140315166	Ctbp2	136473	-	NM_009980	140179853	140217453	11
chr7	140319933	140334140	4930483O08Rik	14207	+	NR_046279	140334140	140334140	3
chr7	140778706	140793798	Tex36	15092	-	NM_028654	140778864	140793701	4
chr7	140829357	140864700	Edrf1	35343	+	NM_178115	140829495	140863223	25
chr7	140865952	140871744	Mmp21	5792	-	NM_152944	140866088	140871729	7
chr7	140878037	140900978	Uros	22941	-	NM_009479	140878661	140894075	10
chr7	140901015	140912828	Bccip	11813	+	NM_025392	140901040	140912560	7
chr7	140912617	140974468	Dhx32	61851	-	NM_001286031	140912910	140951385	12
chr7	140968573	141073215	Fank1	104642	+	NM_025850	140968640	141072343	11
chr7	141074882	141416780	Adam12	341898	-	NM_007400	141079624	141416560	23
chr7	141457944	141568511	D7Ertd443e	110567	-	NM_001081331	141458295	141541484	8
chr7	141862369	142365330	Dock1	502961	+	NM_001033420	141862481	142364225	52
chr7	142073590	142130113	Fam196a	56523	-	NM_001143802	142076090	142110482	4
chr7	142383447	142387685	1700120G07Rik	4238	-	NR_046050	142387685	142387685	4
chr7	142460301	142464625	Nps	4324	+	NM_001163611	142460321	142464055	3
chr7	142602049	142605298	Foxi2	3249	+	NM_183193	142602067	142603715	2
chr7	142703138	142720337	Clrn3	17199	-	NM_178669	142705621	142720186	3
chr7	142729506	142877977	Ptpre	148471	+	NM_011212	142835547	142874989	21
chr7	142757844	142757965	Mir1962	121	+	NR_035488	142757965	142757965	1
chr7	142840139	142843997	5830432E09Rik	3858	-	NR_015548	142843997	142843997	3
chr7	142881470	142908062	Mki67	26592	-	NM_001081117	142881771	142907822	14
chr7	143460006	143510194	C030029H02Rik	50188	+	NR_102277	143510194	143510194	4
chr7	143523898	143541098	C230079O03Rik	17200	-	NR_040459	143541098	143541098	5
chr7	143859637	143902287	Gm6249	42650	-	NR_046021	143902287	143902287	6
chr7	144086293	144319871	Mgmt	233578	+	NM_008598	144142962	144319777	5
chr7	144385353	144506128	Ebf3	120775	-	NM_001113415	144388053	144505596	16
chr7	144426365	144434292	Gm10578	7927	+	NR_045885	144434292	144434292	4
chr7	144567251	144602439	9430038I01Rik	35188	-	NM_029886	144568004	144602391	4
chr7	144629330	144660277	Glrx3	30947	+	NM_023140	144629356	144659666	11
chr7	144629356	144659663	Gm12669	30307	+	NR_033611	144659663	144659663	11
chr7	145400654	145589413	Tcerg1l	188759	-	NM_183289	145401373	145589336	12
chr7	145745924	145758677	4930543N07Rik	12753	+	NR_131022	145758677	145758677	5
chr7	146027500	146037950	Mapk1ip1	10450	-	NM_001045483	146027590	146028382	2
chr7	146038068	146074739	Ppp2r2d	36671	+	NM_026391	146038191	146074171	9
chr7	146082518	146101189	Bnip3	18671	-	NM_009760	146083597	146101076	6
chr7	146132412	146269875	Jakmip3	137463	+	NM_028708	146181031	146250590	15
chr7	146271899	146287690	Dpysl4	15791	+	NM_011993	146272021	146286892	14
chr7	146289536	146399206	Stk32c	109670	-	NM_001162540	146290121	146311145	12
chr7	146398886	146428872	Lrrc27	29986	+	NM_027164	146400621	146428665	11
chr7	146434380	146453152	Pwwp2b	18772	+	NM_001033206	146434417	146452384	3
chr7	146575007	146765551	Inpp5a	190544	+	NM_001127363	146575288	146764161	16
chr7	146765274	146768696	Nkx6-2	3422	-	NR_027857	146768696	146768696	4
chr7	146786813	146869714	Cfap46	82901	-	NM_001302546	146787056	146869669	59
chr7	146964916	146965025	Mir6401	109	+	NR_105827	146965025	146965025	1
chr7	147020072	147063987	Adgra1	43915	+	NM_177469	147026704	147062093	8
chr7	147080594	147127439	Kndc1	46845	+	NM_177261	147081085	147125857	31
chr7	147129754	147131011	Utf1	1257	+	NM_009482	147129772	147130889	2
chr7	147143464	147143521	Mir7686	57	-	NR_106157	147143521	147143521	1
chr7	147143587	147143659	Mir202	72	-	NR_029589	147143659	147143659	1
chr7	147158201	147164654	6430531B16Rik	6453	-	NM_001033465	147158365	147164581	7
chr7	147164830	147178461	Adam8	13631	-	NM_007403	147165375	147178370	24
chr7	147172707	147172773	Mir7062	66	-	NR_106029	147172773	147172773	1
chr7	147181853	147222573	Tubgcp2	40720	-	NM_001286007	147181929	147219661	18
chr7	147222289	147226504	Zfp511	4215	+	NM_027201	147222352	147226220	6
chr7	147232055	147234987	Msx3	2932	-	NM_010836	147233638	147234898	2
chr7	147255778	147268447	Caly	12669	-	NM_026769	147256245	147259974	6
chr7	147279294	147283102	Prap1	3808	+	NM_009475	147279359	147282995	5
chr7	147283713	147288340	Fuom	4627	-	NR_104415	147288340	147288340	6
chr7	147291621	147302322	Echs1	10701	-	NM_053119	147292210	147302293	8
chr7	147311583	147320233	Paox	8650	+	NM_153783	147311624	147320052	7
chr7	147323462	147336685	Mtg1	13223	+	NM_199301	147323563	147336172	11
chr7	147336526	147340558	Sprn	4032	-	NM_183147	147339112	147339556	2
chr7	147347908	147348847	Olfr522	939	-	NM_146952	147347908	147348847	1
chr7	147362002	147362956	Olfr523	954	+	NM_146518	147362002	147362956	1
chr7	147387710	147388667	Olfr524	957	-	NM_001011814	147387710	147388667	1
chr7	147404165	147417044	Cd163l1	12879	+	NM_172909	147404463	147416365	14
chr7	147433276	147485690	5830411N06Rik	52414	+	NM_001128146	147433279	147485690	16
chr7	147508599	147509529	Olfr525	930	+	NM_146956	147508599	147509529	1
chr7	147521762	147522680	Olfr527	918	+	NM_001011776	147521762	147522680	1
chr7	147530950	147531886	Olfr60	936	-	NM_146955	147530950	147531886	1
chr7	147558583	147559507	Olfr530	924	-	NM_146519	147558583	147559507	1
chr7	147586028	147586943	Olfr531	915	-	NM_146953	147586028	147586943	1
chr7	147604740	147605670	Olfr532	930	-	NM_147026	147604740	147605670	1
chr7	147652101	147653064	Olfr533	963	+	NM_001011815	147652101	147653064	1
chr7	147678538	147679477	Olfr535	939	+	NM_146954	147678538	147679477	1
chr7	147686751	147693217	Olfr536	6466	-	NM_146520	147689432	147690356	4
chr7	147760053	147760986	Olfr538	933	+	NM_001011867	147760053	147760986	1
chr7	147787238	147797023	Olfr46	9785	+	NM_146934	147796066	147797023	3
chr7	147823601	147824537	Olfr61	936	+	NM_146964	147823601	147824537	1
chr7	147832350	147838818	Olfr53	6468	+	NM_146960	147837879	147838818	2
chr7	147853187	147854147	Olfr539	960	+	NM_146961	147853187	147854147	1
chr7	147876805	147877741	Olfr45	936	+	NM_146963	147876805	147877741	1
chr7	147890151	147891090	Olfr541	939	+	NM_146962	147890151	147891090	1
chr7	147949730	147960876	Cyp2e1	11146	+	NM_021282	147949749	147960641	9
chr7	147963127	147973753	Syce1	10626	-	NM_001143765	147963559	147973713	13
chr7	147995575	148008077	Zfp941	12502	-	NM_001001180	147997327	148007936	3
chr7	148021394	148023867	Urah	2473	+	NM_029821	148021519	148023674	3
chr7	148023119	148031588	C330022C24Rik	8469	-	NR_045717	148031588	148031588	4
chr7	148031463	148032668	Scgb1c1	1205	+	NM_001099742	148031475	148032531	3
chr7	148033814	148036824	Odf3	3010	+	NM_027019	148034253	148036695	7
chr7	148039282	148042282	Bet1l	3000	-	NM_018742	148040354	148042138	4
chr7	148043295	148049630	Ric8	6335	+	NM_053194	148043369	148048330	10
chr7	148049561	148068208	Sirt3	18647	-	NM_022433	148049961	148063902	7
chr7	148068292	148084541	Psmd13	16249	+	NM_011875	148068370	148084187	13
chr7	148084840	148086345	Cox8b	1505	-	NM_007751	148084886	148086241	2
chr7	148091962	148093866	BC024386	1904	+	NR_015583	148093866	148093866	3
chr7	148106800	148115091	Nlrp6	8291	+	NM_133946	148106956	148113421	8
chr7	148127479	148133557	Athl1	6078	+	NM_145387	148128208	148132743	14
chr7	148134860	148136138	Ifitm5	1278	-	NM_053088	148135134	148136108	2
chr7	148140737	148141860	Ifitm2	1123	-	NM_030694	148140883	148141814	2
chr7	148153327	148155726	Ifitm1	2399	+	NM_026820	148154154	148155525	3
chr7	148195488	148196643	Ifitm3	1155	-	NM_025378	148195623	148196544	2
chr7	148201710	148202791	Ifitm6	1081	-	NM_001033632	148201902	148202757	2
chr7	148247172	148258018	B4galnt4	10846	+	NM_177897	148247172	148258018	20
chr7	148264127	148276409	Pkp3	12282	+	NM_001162924	148264222	148276065	14
chr7	148277073	148286445	Sigirr	9372	-	NM_023059	148277236	148280687	10
chr7	148287117	148303705	Ano9	16588	-	NM_178381	148287798	148303618	24
chr7	148317184	148342053	Ptdss2	24869	+	NM_013782	148317300	148341419	12
chr7	148346224	148358750	Rnh1	12526	-	NM_001172100	148346376	148352667	10
chr7	148375832	148379903	Hras	4071	-	NM_008284	148377246	148378839	6
chr7	148380028	148395954	Lrrc56	15926	+	NM_001172064	148382891	148395629	13
chr7	148395941	148399979	Lmntd2	4038	-	NM_028050	148395971	148399957	13
chr7	148401758	148404557	Rassf7	2799	+	NM_025886	148402626	148404200	6
chr7	148407282	148407392	Mir210	110	-	NR_029793	148407392	148407392	1
chr7	148414686	148448650	Phrf1	33964	+	NM_001081118	148417147	148448451	18
chr7	148449081	148452323	Irf7	3242	-	NM_001252601	148449123	148451535	10
chr7	148454983	148462685	Cdhr5	7702	-	NM_001114322	148455048	148462617	15
chr7	148464227	148465032	Sct	805	-	NM_001287171	148464308	148464997	4
chr7	148477904	148480900	Drd4	2996	+	NM_007878	148477936	148480760	4
chr7	148483074	148524682	Deaf1	41608	-	NM_001282073	148483410	148510374	12
chr7	148514028	148523054	Tmem80	9026	+	NM_001141950	148519557	148521949	6
chr7	148524900	148548915	Eps8l2	24015	+	NM_133191	148527829	148548135	21
chr7	148545076	148551009	B230206H07Rik	5933	-	NR_033532	148551009	148551009	2
chr7	148578058	148588875	Taldo1	10817	+	NM_011528	148578120	148588675	8
chr7	148594082	148600024	Pddc1	5942	-	NM_172116	148594856	148599964	8
chr7	148612349	148615319	Cend1	2970	-	NM_021316	148613354	148613804	2
chr7	148615647	148623773	Slc25a22	8126	-	NM_026646	148617003	148620074	10
chr7	148624413	148629254	Pidd1	4841	-	NM_022654	148624487	148629176	15
chr7	148633548	148637241	Rplp2	3693	+	NM_026020	148633807	148637207	5
chr7	148634701	148634835	Snora52	134	+	NR_034049	148634835	148634835	1
chr7	148641086	148646642	Pnpla2	5556	+	NR_028142	148646642	148646642	10
chr7	148646992	148652501	Cracr2b	5509	+	NM_001025103	148649309	148652122	10
chr7	148653260	148657380	Cd151	4120	+	NM_009842	148655160	148656596	8
chr7	148657758	148661052	Polr2l	3294	-	NM_025593	148659194	148661021	2
chr7	148661134	148679326	Tspan4	18192	+	NM_053082	148668402	148678852	8
chr7	148679034	148725756	Chid1	46722	-	NM_001142681	148681946	148718837	13
chr7	148748078	148818910	Ap2a2	70832	+	NM_007459	148748258	148817268	22
chr7	148795964	148799646	Gm16982	3682	-	NR_040337	148799646	148799646	4
chr7	148806599	148806690	Mir7063	91	+	NR_106030	148806690	148806690	1
chr7	148819947	148841207	Muc6	21260	-	NM_181729	148819947	148841207	34
chr7	148876238	148940599	Muc2	64361	+	NM_023566	148876267	148940442	46
chr7	148974915	149005040	Muc5ac	30125	+	NM_010844	148974915	149004791	50
chr7	149024976	149058990	Muc5b	34014	+	NM_028801	149025021	149058475	49
chr7	149067489	149088311	Tollip	20822	-	NM_023764	149070271	149088213	6
chr7	149135655	149190148	Brsk2	54493	+	NM_001276763	149135990	149188399	20
chr7	149178083	149178146	Mir3104	63	+	NR_037291	149178146	149178146	1
chr7	149194457	149246939	Mob2	52482	-	NM_028308	149195172	149246906	5
chr7	149265391	149281189	Dusp8	15798	-	NM_008748	149267764	149276079	7
chr7	149360436	149361910	Krtap5-2	1474	-	NM_027844	149360742	149361846	1
chr7	149387268	149388920	Krtap5-3	1652	+	NM_023860	149387332	149388403	1
chr7	149414699	149415876	Krtap5-5	1177	-	NM_001037822	149415090	149415816	1
chr7	149459668	149460268	Gm4559	600	-	NM_001199309	149459668	149460268	1
chr7	149482281	149482974	Krtap5-1	693	-	NM_015808	149482281	149482974	1
chr7	149489406	149490408	Krtap5-4	1002	+	NM_015809	149489499	149490171	1
chr7	149512014	149558164	Ifitm10	46150	-	NM_177265	149514447	149557005	4
chr7	149561820	149573775	Ctsd	11955	-	NM_009983	149562475	149573709	9
chr7	149620881	149626301	Syt8	5420	+	NM_018802	149624078	149626206	9
chr7	149628372	149630310	Tnni2	1938	+	NM_009405	149628395	149630215	6
chr7	149646716	149680773	Lsp1	34057	+	NM_001136071	149646803	149676553	11
chr7	149676984	149692676	Prr33	15692	-	NR_033261	149692676	149692676	3
chr7	149684740	149701914	Tnnt3	17174	+	NM_001163665	149687542	149701735	18
chr7	149719021	149726647	Mrpl23	7626	+	NM_011288	149719082	149726567	5
chr7	149730513	149744503	Nctc1	13990	-	NR_002452	149744503	149744503	3
chr7	149761434	149764051	H19	2617	-	NR_130974	149764051	149764051	5
chr7	149762968	149763052	Mir675	84	-	NR_030416	149763052	149763052	1
chr7	149836672	149852721	Igf2	16049	-	NM_001315488	149839720	149841715	4
chr7	149840828	149840901	Mir483	73	-	NR_030251	149840901	149840901	1
chr7	149845597	149856261	Igf2os	10664	+	NR_002855	149856261	149856261	4
chr7	149864560	149865631	Ins2	1071	-	NM_008387	149864617	149865438	3
chr7	150078680	150085871	Th	7191	-	NM_009377	150078935	150085866	13
chr7	150152726	150155169	Ascl2	2443	-	NM_008554	150153822	150154885	3
chr7	150190950	150205390	Tspan32	14440	+	NM_001128080	150191014	150204644	9
chr7	150207688	150239591	R74862	31903	-	NR_110354	150239591	150239591	5
chr7	150238654	150253835	Cd81	15181	+	NM_133655	150238905	150253279	8
chr7	150255272	150256992	Tssc4	1720	+	NM_138631	150255861	150256705	4
chr7	150257433	150280547	Trpm5	23114	-	NM_020277	150258252	150275513	25
chr7	150293158	150612947	Kcnq1	319789	+	NM_008434	150293263	150612030	16
chr7	150399015	150482452	Kcnq1ot1	83437	-	NR_001461	150482452	150482452	1
chr7	150508676	150516555	4933417O13Rik	7879	-	NR_045842	150516555	150516555	3
chr7	150644243	150646955	Cdkn1c	2712	-	NM_001161624	150645021	150646612	4
chr7	150659659	150685237	Slc22a18	25578	+	NM_008767	150662102	150685177	11
chr7	150687452	150688429	Phlda2	977	-	NM_009434	150687720	150688395	2
chr7	150699483	150735025	Nap1l4	35542	-	NM_008672	150704784	150727666	16
chr7	150743134	150785995	Cars	42861	-	NM_013742	150743776	150785911	23
chr7	150756575	150756664	Mir7064	89	-	NR_106031	150756664	150756664	1
chr7	150793589	150813750	Tnfrsf26	20161	-	NM_175649	150795948	150813747	8
chr7	150820712	150835569	Tnfrsf22	14857	-	NM_023680	150825162	150835536	7
chr7	150851711	150871780	Tnfrsf23	20069	-	NR_131763	150871780	150871780	6
chr7	150874666	150927868	Osbpl5	53202	-	NM_024289	150875723	150927628	22
chr7	150949614	150952898	Mrgprg	3284	-	NM_203492	150950408	150951278	2
chr7	150964267	150970405	Mrgpre	6138	-	NM_175534	150966736	150967669	2
chr7	150981496	151008757	Nadsyn1	27261	-	NM_030221	150981853	151008648	21
chr7	151009071	151034315	Dhcr7	25244	+	NM_007856	151022548	151033422	9
chr7	151119019	151119113	Mir6404	94	+	NR_105830	151119113	151119113	1
chr7	151195158	151195243	Mir3105	85	+	NR_037292	151195243	151195243	1
chr7	151361424	151608580	Shank2	247156	+	NM_001113373	151361824	151607040	16
chr7	151621628	151656840	Cttn	35212	-	NM_007803	151622869	151649903	18
chr7	151662659	151739634	Ppfia1	76975	-	NM_001195086	151664943	151738438	32
chr7	151764227	151768341	Fadd	4114	-	NM_010175	151766433	151768294	2
chr7	151774453	151924497	Ano1	150044	-	NM_178642	151775903	151924400	26
chr7	152024516	152029253	Fgf3	4737	+	NM_008007	152024612	152028893	3
chr7	152047290	152051148	Fgf4	3858	+	NM_010202	152047409	152048846	3
chr7	152082436	152086856	Fgf15	4420	+	NM_008003	152082583	152085853	3
chr7	152101098	152107042	Oraov1	5944	+	NM_028184	152101142	152105583	5
chr7	152115835	152125830	Ccnd1	9995	-	NM_007631	152118511	152125598	5
chr7	152368914	152469916	Tpcn2	101002	-	NR_132643	152469916	152469916	23
chr7	152391722	152394024	1810010D01Rik	2302	-	NR_033626	152394024	152394024	3
chr7	152486813	152495462	Mrgprf	8649	+	NM_145379	152489785	152494639	3
chr7	152500739	152509964	Mrgprd	9225	+	NM_203490	152507298	152508264	2
chr8	3150921	3279617	Insr	128696	-	NM_010568	3155668	3279128	21
chr8	3353414	3390299	A430078G23Rik	36885	+	NM_001033378	3353726	3389099	11
chr8	3393007	3456600	Arhgef18	63593	+	NM_133962	3427422	3454535	20
chr8	3458816	3467648	Pex11g	8832	-	NM_026951	3459199	3467631	5
chr8	3470861	3487178	1700019B03Rik	16317	+	NM_029598	3475848	3487158	9
chr8	3493137	3497208	Zfp358	4071	+	NM_080461	3495419	3497135	2
chr8	3500518	3515231	Mcoln1	14713	+	NM_053177	3500596	3515050	14
chr8	3515383	3544267	Pnpla6	28884	+	NM_001122818	3516544	3544028	35
chr8	3567997	3584776	C330021F23Rik	16779	+	NM_001024728	3580468	3584254	6
chr8	3587449	3609075	Camsap3	21626	+	NM_027171	3587811	3608903	17
chr8	3610089	3621296	Xab2	11207	-	NM_026156	3610157	3621278	19
chr8	3621550	3624235	Pet100	2685	+	NM_001195244	3621584	3623307	4
chr8	3623373	3625545	Pcp2	2172	-	NM_001129803	3623438	3625520	4
chr8	3631159	3643644	Stxbp2	12485	+	NM_011503	3631167	3642731	19
chr8	3655769	3659818	Retn	4049	+	NM_001204959	3656015	3657386	5
chr8	3665761	3668905	Mcemp1	3144	+	NM_026985	3665781	3668345	7
chr8	3676476	3680921	Trappc5	4445	+	NM_025701	3679023	3679590	2
chr8	3681736	3694174	Fcer2a	12438	-	NM_001253743	3682809	3691140	12
chr8	3716070	3720651	Clec4g	4581	-	NM_029465	3716414	3720645	9
chr8	3743394	3748984	Cd209a	5590	-	NM_133238	3744083	3748906	7
chr8	3803124	3803361	Rprl3	237	-	NR_024198	3803361	3803361	1
chr8	3847972	3854286	Cd209e	6314	-	NM_130905	3849083	3854253	6
chr8	3871823	3878499	Cd209d	6676	-	NM_130904	3871956	3878483	7
chr8	3917654	3926841	Cd209b	9187	-	NM_001287211	3918676	3926792	10
chr8	3940221	3946863	Cd209c	6642	-	NM_130903	3940279	3945908	5
chr8	4102792	4105764	Cd209f	2972	-	NM_026956	4103107	4105738	8
chr8	4134735	4137707	Cd209g	2972	+	NM_027343	4135193	4137402	8
chr8	4166566	4193701	Evi5l	27135	+	NM_001039578	4183518	4193608	11
chr8	4209542	4217312	Prr36	7770	-	NM_207203	4210518	4216548	7
chr8	4226826	4237470	Lrrc8e	10644	+	NM_028175	4231666	4236164	3
chr8	4238739	4247897	Map2k7	9158	+	NM_001042557	4238909	4247759	13
chr8	4248213	4251423	Tgfbr3l	3210	+	NM_001195258	4248282	4251311	7
chr8	4253101	4256220	Snapc2	3119	+	NM_133968	4253121	4255806	5
chr8	4257645	4259274	Ctxn1	1629	-	NM_183315	4258380	4258629	2
chr8	4259730	4275905	Timm44	16175	-	NM_011592	4260135	4275887	13
chr8	4284781	4325100	Elavl1	40319	-	NM_010485	4289599	4311770	6
chr8	4325209	4360020	Ccl25	34811	+	NR_033527	4360020	4360020	6
chr8	4493404	4526079	Cers4	32675	+	NM_026058	4515555	4523780	11
chr8	4613169	4630231	Zfp958	17062	+	NM_145591	4613275	4629380	4
chr8	4735979	4779534	Shcbp1	43555	-	NM_011369	4736093	4779523	13
chr8	5085622	5105232	Slc10a2	19610	-	NM_011388	5086155	5105183	6
chr8	8617438	8660773	Efnb2	43335	-	NM_010111	8620587	8660614	5
chr8	8666575	8690537	Arglu1	23962	-	NM_176849	8667251	8690317	4
chr8	8690092	8690162	Mir7654	70	-	NR_106114	8690162	8690162	1
chr8	9125411	9132288	4933430N04Rik	6877	-	NR_045854	9132288	9132288	4
chr8	9144668	9149050	4930453L07Rik	4382	+	NR_073360	9149050	9149050	3
chr8	9206009	9771023	Fam155a	565014	-	NM_173446	9207742	9771018	3
chr8	9970019	9976323	Lig4	6304	-	NM_176953	9971042	9973778	2
chr8	9977716	9992154	Abhd13	14438	+	NM_026868	9987404	9988418	3
chr8	10006632	10035999	Tnfsf13b	29367	+	NM_033622	10006842	10035441	7
chr8	10153922	10633950	Myo16	480028	+	NM_001081397	10272571	10633650	36
chr8	10870421	10882454	B930025P03Rik	12033	-	NR_040705	10882454	10882454	6
chr8	10899921	10902334	4833411C07Rik	2413	+	NR_102285	10902334	10902334	3
chr8	10924426	10928457	3930402G23Rik	4031	-	NR_030715	10928457	10928457	3
chr8	10986963	11008430	Irs2	21467	-	NM_001081212	10987009	11008430	2
chr8	11007849	11054541	9530052E02Rik	46692	+	NR_046017	11054541	11054541	5
chr8	11198422	11312826	Col4a1	114404	-	NR_133670	11312826	11312826	53
chr8	11312804	11449287	Col4a2	136483	+	NM_009932	11313463	11448316	48
chr8	11453976	11478499	Rab20	24523	-	NM_011227	11453996	11478499	2
chr8	11477928	11480241	E230013L22Rik	2313	+	NR_126558	11480241	11480241	2
chr8	11497505	11513286	Carkd	15781	+	NM_001190357	11497586	11513045	10
chr8	11514016	11550771	Cars2	36755	-	NM_024248	11514113	11550677	15
chr8	11555761	11563251	Ing1	7490	+	NM_001302458	11561563	11562121	2
chr8	11611580	11635757	Ankrd10	24177	-	NM_001281975	11612483	11623740	7
chr8	11635693	11635736	Mir7238	43	-	NR_106097	11635736	11635736	1
chr8	11654923	11678750	1700016D06Rik	23827	-	NM_024271	11655604	11678669	6
chr8	11692981	11694514	Gm6524	1533	-	NR_028307	11694514	11694514	1
chr8	11728104	11827152	Arhgef7	99048	+	NM_001113517	11728251	11824719	19
chr8	11840520	11855761	Tex29	15241	+	NM_029326	11840918	11855705	7
chr8	12385770	12436732	Gm5607	50962	+	NR_027975	12436732	12436732	8
chr8	12395518	12399555	Sox1	4037	+	NM_009233	12396360	12397536	1
chr8	12573048	12600738	Spaca7	27690	+	NM_024279	12573105	12600583	7
chr8	12614276	12672100	Tubgcp3	57824	-	NM_198031	12615137	12672030	22
chr8	12706943	12719127	Gm15348	12184	-	NR_033546	12719127	12719127	4
chr8	12757015	12868728	Atp11a	111713	+	NM_001293668	12757313	12861717	30
chr8	12828337	12831919	Gm15350	3582	-	NR_045775	12831919	12831919	3
chr8	12915892	13020509	Mcf2l	104617	+	NM_178076	12915975	13018867	31
chr8	12947940	12948070	Gm38671	130	+	NR_128567	12948070	12948070	1
chr8	13026033	13035805	F7	9772	+	NM_010172	13026058	13035316	8
chr8	13037307	13056676	F10	19369	+	NM_007972	13037837	13055882	9
chr8	13060907	13075006	Proz	14099	+	NM_025834	13061029	13073930	8
chr8	13077524	13105343	Pcid2	27819	-	NM_178708	13078199	13104810	14
chr8	13105720	13147939	Cul4a	42219	+	NM_146207	13105755	13146627	20
chr8	13136071	13136132	Mir7065	61	+	NR_106032	13136132	13136132	1
chr8	13159160	13175338	Lamp1	16178	+	NM_001317353	13159388	13174558	9
chr8	13176868	13200624	Grtp1	23756	-	NM_025768	13177052	13200527	8
chr8	13189030	13189098	Mir1968	68	-	NR_035494	13189098	13189098	1
chr8	13235661	13254162	Adprhl1	18501	-	NM_172750	13235830	13254028	7
chr8	13255962	13288126	Dcun1d2	32164	-	NM_001024504	13257896	13287806	7
chr8	13288012	13322924	Tmco3	34912	+	NM_172282	13291727	13320874	13
chr8	13338750	13378448	Tfdp1	39698	+	NM_001291765	13339727	13377289	12
chr8	13386208	13396778	Atp4b	10570	-	NM_009724	13386625	13396753	7
chr8	13405080	13421949	Grk1	16869	+	NM_011881	13405117	13416252	7
chr8	13435458	13461451	Tmem255b	25993	+	NM_001143671	13435612	13461369	9
chr8	13465373	13494535	Gas6	29162	-	NM_019521	13465745	13494339	15
chr8	13550721	13562461	1700029H14Rik	11740	-	NM_025601	13551766	13562348	9
chr8	13567217	13677587	Rasa3	110370	-	NM_009025	13568690	13677447	24
chr8	13705888	13743066	4932443I19Rik	37178	+	NM_001101519	13705966	13742660	4
chr8	13757689	13781882	Cdc16	24193	+	NM_027276	13757806	13781631	18
chr8	13785614	13798537	Upf3a	12923	+	NM_025924	13785683	13798474	9
chr8	13835230	13838089	AF366264	2859	-	NM_153093	13836580	13838089	1
chr8	13869640	13881639	Champ1	11999	+	NM_181854	13877843	13880252	2
chr8	13884787	13890271	Coprs	5484	-	NM_025556	13885031	13890235	4
chr8	13907805	13940521	Fbxo25	32716	+	NM_025785	13914950	13939652	10
chr8	13952007	13974777	Tdrp	22770	-	NM_173744	13953786	13974642	3
chr8	13986089	14003561	Gm5907	17472	+	NR_131137	14003561	14003561	3
chr8	14027564	14090327	Erich1	62763	-	NM_001034862	14028079	14090262	6
chr8	14095874	14847686	Dlgap2	751812	+	NM_172910	14179666	14846708	16
chr8	14888535	14901719	Cln8	13184	+	NM_012000	14894687	14896854	3
chr8	14911662	15001085	Arhgef10	89423	+	NM_172751	14925183	14999830	29
chr8	15011024	15033332	Kbtbd11	22308	+	NM_029116	15027402	15029304	2
chr8	15041445	15046078	BB014433	4633	-	NR_037972	15046078	15046078	2
chr8	15057652	15133419	Myom2	75767	+	NM_008664	15063853	15132956	37
chr8	15892544	17535385	Csmd1	1642841	-	NM_053171	15895716	17534974	70
chr8	16168756	16168838	Mir3106	82	-	NR_037214	16168838	16168838	1
chr8	18595172	18803188	Mcph1	208016	+	NM_173189	18595595	18801461	14
chr8	18690262	18741562	Angpt2	51300	-	NM_007426	18692047	18741278	9
chr8	18846278	18884413	Agpat5	38135	+	NM_026792	18846559	18881963	8
chr8	18932728	18950975	Xkr5	18247	-	NM_001113350	18933493	18950933	7
chr8	18974939	18978116	Defb40	3177	-	NM_183039	18974966	18978116	2
chr8	18986232	18991055	Defb37	4823	-	NM_181683	18986313	18990973	2
chr8	19023463	19026529	Defb38	3066	-	NM_183036	19023463	19026529	2
chr8	19052825	19064810	Defb39	11985	-	NM_183038	19052852	19064810	2
chr8	19111930	19114833	Defb12	2903	-	NM_152802	19112656	19114820	3
chr8	19123751	19126540	Defb34	2789	+	NM_183035	19123751	19126540	2
chr8	19140758	19143010	Spag11b	2252	+	NM_001039563	19140797	19142749	3
chr8	19157886	19159578	Spag11a	1692	+	NM_153115	19157944	19159411	2
chr8	19194327	19195309	Defb14	982	+	NM_183026	19194356	19195212	2
chr8	19198703	19201547	Defb4	2844	+	NM_019728	19198732	19201310	2
chr8	19210461	19212760	Defa-ps12	2299	+	NR_002878	19212760	19212760	2
chr8	19225477	19228209	Defb6	2732	+	NM_054074	19225504	19228105	2
chr8	19239915	19242143	Defb46	2228	+	NM_001025351	19239915	19242143	2
chr8	19247591	19250828	Defb5	3237	+	NM_030734	19247591	19250828	2
chr8	19293360	19295339	Defb3	1979	+	NM_013756	19293372	19295221	2
chr8	19300676	19304794	Defa-ps13	4118	+	NR_002881	19304794	19304794	2
chr8	19445769	19447606	Defb8	1837	-	NM_153108	19445859	19447593	2
chr8	19495096	19497775	Defb7	2679	+	NM_139220	19495107	19497696	2
chr8	19729575	19753602	4930467E23Rik	24027	+	NM_001039553	19729745	19752236	10
chr8	19863863	19893010	6820431F20Rik	29147	-	NR_030708	19893010	19893010	5
chr8	19933241	19958780	Gm15319	25539	-	NM_001177408	19934532	19958610	10
chr8	19981359	20020392	2610005L07Rik	39033	-	NR_028428	20020392	20020392	6
chr8	22040296	22041664	Gm15056	1368	-	NM_001177471	22040343	22041664	3
chr8	22056168	22061750	Gm6040	5582	-	NM_001025353	22056689	22057370	3
chr8	22083372	22084427	AY761185	1055	-	NM_001012640	22083535	22084389	2
chr8	22165223	22166196	Defa21	973	+	NM_183253	22165266	22166102	2
chr8	22194718	22195695	Defa23	977	+	NM_001012307	22194759	22195600	2
chr8	22194718	22195696	Defa-rs7	978	+	NM_007848	22194759	22195600	2
chr8	22204716	22205680	Gm10104	964	+	NM_001177481	22204744	22205587	2
chr8	22224120	22224964	Defa25	844	+	NM_007849	22224120	22224964	2
chr8	22234649	22235729	Gm14851	1080	-	NM_001177482	22234752	22235729	2
chr8	22274328	22275277	Gm15284	949	+	NM_001177485	22274341	22275182	2
chr8	22301955	22302928	Defa22	973	+	NM_207658	22301998	22302834	2
chr8	22341282	22342125	Gm15293	843	+	NM_001177486	22341282	22342125	2
chr8	22371748	22371912	Defa4	164	-	NM_010039	22371748	22371912	1
chr8	22389440	22390140	Gm15292	700	+	NM_001177487	22389440	22390140	2
chr8	22427087	22428056	Defa3	969	+	NM_007850	22427121	22427962	2
chr8	22437072	22438054	Defa5	982	+	NM_007851	22437117	22437960	2
chr8	22455224	22456066	Gm15299	842	+	NM_001170955	22455224	22456066	2
chr8	22465566	22466699	Defa-rs1	1133	-	NM_007844	22465677	22466654	2
chr8	22565898	22566989	Gm7849	1091	-	NM_001177518	22566010	22566989	2
chr8	22566010	22566989	Gm7861	979	-	NM_001177526	22566010	22566989	2
chr8	22619729	22620708	Defa2	979	+	NM_001195634	22619772	22620615	2
chr8	22619729	22620709	Defa20	980	+	NM_183268	22619772	22620615	2
chr8	22639501	22640484	Gm15308	983	+	NM_001177521	22639546	22640390	2
chr8	22639501	22640484	Gm21002	983	+	NM_001270555	22639546	22640390	2
chr8	22675857	22676816	Gm21498	959	+	NM_001270613	22675885	22676728	2
chr8	22675857	22676822	Gm14850	965	+	NM_001177522	22675885	22676728	2
chr8	22693498	22694339	Gm6696	841	+	NM_001177523	22693498	22694339	2
chr8	22728639	22729444	Defa26	805	+	NM_001079933	22728654	22729354	2
chr8	22766238	22767208	Defa17	970	+	NM_001167790	22766272	22767113	2
chr8	22776268	22777205	Gm15315	937	+	NM_001177528	22776268	22777111	2
chr8	22805483	22806325	Defa-ps1	842	+	NR_003146	22806325	22806325	2
chr8	22812995	22814119	AY761184	1124	-	NM_001007582	22813099	22814074	2
chr8	22844965	22845943	Defa24	978	+	NM_001024225	22845008	22845849	2
chr8	22845008	22845849	Defa6	841	+	NM_007852	22845008	22845849	2
chr8	22887026	22905657	Defb1	18631	+	NM_007843	22887123	22905048	2
chr8	22934010	22941768	Defb50	7758	+	NM_199067	22934082	22941689	2
chr8	22950397	22953953	Defb2	3556	+	NM_010030	22950430	22953898	2
chr8	22969372	22972482	Defb10	3110	+	NM_139225	22969399	22972434	2
chr8	22992184	22995906	Defb9	3722	-	NM_139219	22992263	22995866	2
chr8	23015845	23016904	Defb11	1059	-	NM_139221	23015897	23016851	2
chr8	23040284	23043182	Defb15	2898	-	NM_139222	23040341	23043148	2
chr8	23048823	23051350	Defb35	2527	+	NM_139224	23048823	23051275	2
chr8	23057233	23059094	Defb13	1861	+	NM_139223	23057262	23059094	2
chr8	23069185	23074775	Fam90a1a	5590	+	NM_001081662	23069713	23074392	5
chr8	23081067	23084513	Ccdc70	3446	+	NM_026459	23083667	23084339	2
chr8	23104819	23170546	Atp7b	65727	-	NM_007511	23105122	23170527	21
chr8	23171192	23182099	Alg11	10907	+	NM_001243161	23171198	23178624	4
chr8	23184087	23235525	Nek5	51438	-	NM_177898	23184557	23234132	20
chr8	23238754	23276907	Nek3	38153	-	NM_011848	23239156	23272912	16
chr8	23278623	23296291	Ckap2	17668	-	NM_001004140	23279202	23296264	9
chr8	23303331	23329069	Vps36	25738	+	NM_027338	23303342	23328964	14
chr8	23337774	23371804	Thsd1	34030	+	NM_019576	23349011	23370142	5
chr8	23393912	23481890	Tpte	87978	+	NM_199257	23395387	23481713	28
chr8	23486021	23509093	Slc25a15	23072	-	NM_181325	23488328	23506239	7
chr8	23509192	23510063	1810012K16Rik	871	+	NR_045473	23510063	23510063	3
chr8	23521811	23540137	Mrps31	18326	+	NM_020560	23521937	23539882	7
chr8	23573085	23587351	Smim19	14266	-	NM_001012667	23573782	23584897	5
chr8	23587171	23680088	Slc20a2	92917	+	NM_011394	23645755	23678892	11
chr8	23687546	23704285	Vdac3	16739	-	NM_011696	23687982	23699264	9
chr8	23734514	23738018	Dkk4	3504	+	NM_145592	23734654	23737510	4
chr8	23738590	23763909	Polb	25319	-	NM_011130	23738746	23763846	14
chr8	23744856	23747281	A930013F10Rik	2425	-	NR_027886	23747281	23747281	1
chr8	23769676	23817055	Ikbkb	47379	-	NM_001159774	23770862	23816658	22
chr8	23868193	23893320	Plat	25127	+	NM_008872	23877576	23892578	14
chr8	23897825	23916126	Ap3m2	18301	-	NM_001122820	23899824	23914504	9
chr8	23970010	24053734	Kat6a	83724	+	NM_001081149	23972673	24051114	18
chr8	24085307	24260969	Ank1	175662	+	NM_001110783	24085607	24252166	44
chr8	24249256	24260057	Gm15816	10801	-	NM_001282148	24249932	24251539	6
chr8	24253026	24253154	Mir486	128	+	NR_030254	24253154	24253154	1
chr8	24253044	24253134	Mir3107	90	-	NR_037293	24253134	24253134	1
chr8	24263742	24269420	Nkx6-3	5678	+	NM_029002	24264056	24268287	3
chr8	24283417	24318925	Gpat4	35508	-	NM_018743	24285023	24301352	13
chr8	24337081	24348140	Gins4	11059	-	NM_024240	24337550	24347547	8
chr8	24351797	24367552	Golga7	15755	-	NM_001042484	24355217	24367256	6
chr8	24521973	24560104	Sfrp1	38131	+	NM_013834	24522256	24556960	3
chr8	24780132	25173588	Zmat4	393456	+	NM_001277239	25012501	25170233	8
chr8	25548087	25549418	1810011O10Rik	1331	-	NM_026931	25549047	25549368	1
chr8	25642363	25686805	Ido2	44442	-	NM_145949	25644074	25686720	10
chr8	25694604	25707424	Ido1	12820	-	NM_008324	25694873	25707411	10
chr8	25712717	25785227	Adam18	72510	-	NM_010084	25721456	25785169	20
chr8	25787705	25836297	Adam3	48592	-	NM_009619	25791189	25836228	22
chr8	25837564	25934841	Adam5	97277	-	NM_001272058	25837829	25934466	21
chr8	25946614	26059276	Adam32	112662	-	NM_153397	25946787	26059267	22
chr8	26060082	26127394	Adam9	67312	-	NM_007404	26061388	26127253	23
chr8	26127682	26133732	Tm2d2	6050	+	NM_027194	26127840	26133251	4
chr8	26135399	26149434	Htra4	14035	-	NM_001081187	26136040	26149346	9
chr8	26149616	26212283	Plekha2	62667	-	NM_031257	26153147	26198954	12
chr8	26265023	26312014	Tacc1	46991	-	NM_177089	26270223	26311757	13
chr8	26269596	26269705	Mir8108	109	-	NR_106187	26269705	26269705	1
chr8	26413121	26416742	5430421F17Rik	3621	-	NR_040352	26416742	26416742	3
chr8	26629230	26686190	Fgfr1	56960	+	NM_010206	26642809	26684393	18
chr8	26659144	26666555	Gm16159	7411	-	NR_110510	26666555	26666555	5
chr8	26688961	26707959	Letm2	18998	-	NM_173012	26689213	26706880	11
chr8	26751048	26830139	Whsc1l1	79091	+	NM_001081269	26751092	26824872	23
chr8	26830519	26835359	Plpp5	4840	+	NM_001293703	26830561	26833561	8
chr8	26835795	26864752	Ddhd2	28957	-	NM_028102	26838127	26863639	18
chr8	26875010	26895681	Bag4	20671	-	NM_026121	26878395	26895643	5
chr8	26896062	26914447	Lsm1	18385	+	NM_026032	26896143	26912570	4
chr8	26918984	26926454	Star	7470	+	NM_011485	26919040	26923358	7
chr8	26926472	26958166	Ash2l	31694	-	NM_001080793	26927872	26950333	16
chr8	26960094	27048406	Kcnu1	88312	+	NM_008432	26960127	27048274	27
chr8	27054930	27087216	Hgsnat	32286	-	NM_029884	27055605	27087183	18
chr8	27091075	27104593	Pomk	13518	-	NM_029037	27093345	27096996	5
chr8	27109193	27126073	Fnta	16880	-	NM_008033	27109919	27126052	9
chr8	27131892	27229696	Hook3	97804	-	NM_207659	27142361	27229486	22
chr8	27193080	27206992	1700047A11Rik	13912	+	NR_110583	27206992	27206992	5
chr8	27229851	27254341	Rnf170	24490	+	NM_029965	27230955	27251552	8
chr8	27268640	27274623	Thap1	5983	+	NM_199042	27268922	27273271	3
chr8	27925068	27934895	2310008N11Rik	9827	-	NR_045904	27934895	27934895	3
chr8	28087807	28091934	Zfp703	4127	+	NM_001110508	28087825	28088859	3
chr8	28134270	28149907	Erlin2	15637	+	NM_153592	28135543	28147108	12
chr8	28153026	28166604	Prosc	13578	+	NM_054057	28153086	28163886	8
chr8	28196312	28233908	Adgra2	37596	+	NM_054044	28196417	28232507	19
chr8	28234303	28239104	Brf2	4801	-	NM_025686	28234365	28239046	4
chr8	28249244	28285118	Rab11fip1	35874	-	NM_001080813	28253647	28285057	6
chr8	28253381	28260178	4933416M07Rik	6797	+	NR_045840	28260178	28260178	4
chr8	28307930	28313019	Got1l1	5089	-	NM_029674	28308010	28312958	9
chr8	28336247	28340060	Adrb3	3813	-	NM_013462	28337225	28338891	4
chr8	28370798	28386128	Eif4ebp1	15330	+	NM_007918	28370880	28385583	3
chr8	28406516	28407672	Gm9731	1156	+	NR_003107	28407672	28407672	1
chr8	28454865	28459660	Tex24	4795	+	NM_001013609	28454917	28456390	3
chr8	28479182	28510202	Chrnb3	31020	+	NM_173212	28479440	28507266	6
chr8	28513683	28524416	Chrna6	10733	-	NM_021369	28514862	28524174	6
chr8	28558141	28605644	Poteg	47503	+	NM_027618	28558289	28605508	14
chr8	29193665	29195325	Gm8096	1660	-	NR_033590	29195325	29195325	1
chr8	29757188	30330108	Unc5d	572920	-	NM_153135	29763239	30329810	18
chr8	31678866	31686045	4933433F19Rik	7179	+	NR_045856	31686045	31686045	4
chr8	32200133	32207519	Dusp26	7386	+	NM_025869	32202351	32206860	5
chr8	32222317	32241945	Rnf122	19628	+	NM_175136	32222619	32239165	6
chr8	32260787	32275175	Tti2	14388	+	NM_001199988	32261321	32272345	8
chr8	32269939	32279196	Mak16	9257	-	NM_026453	32270860	32279151	10
chr8	32297802	32372396	Fut10	74594	+	NM_001286422	32305680	32370605	6
chr8	32478220	32492910	7420700N18Rik	14690	+	NR_046272	32492910	32492910	4
chr8	32928499	33028675	Nrg1	100176	-	NM_178591	32928499	33028675	9
chr8	33262366	33292319	Gm8179	29953	+	NR_046039	33292319	33292319	3
chr8	33998976	34060498	Gm3985	61522	-	NM_001177589	34000946	34052954	4
chr8	34344844	34495999	Wrn	151155	-	NM_001122822	34346808	34463844	34
chr8	34496796	34527941	Purg	31145	+	NM_001098233	34496807	34527133	2
chr8	34594782	34596229	Hmgb1-rs17	1447	+	NR_033589	34596229	34596229	1
chr8	34681015	34696057	Tex15	15042	+	NM_031374	34681015	34696007	4
chr8	34710092	34730276	Ppp2cb	20184	+	NM_017374	34710388	34729666	7
chr8	34730057	34752448	Ubxn8	22391	-	NM_178648	34732001	34752409	8
chr8	34763709	34808634	Gsr	44925	+	NM_010344	34764011	34807767	13
chr8	34842385	34887645	Gtf2e2	45260	+	NM_001167921	34846209	34887041	8
chr8	34852583	34858242	Smim18	5659	-	NM_001206849	34852779	34853061	2
chr8	34893115	35040335	Rbpms	147220	-	NM_019733	34905559	35040013	9
chr8	35153474	35171766	Dctn6	18292	-	NM_001293757	35153797	35168142	8
chr8	35178083	35188239	Mboat4	10156	+	NM_001126314	35178147	35187772	3
chr8	35198625	35209793	Leprotl1	11168	-	NM_026609	35200775	35209754	4
chr8	35217616	35233901	Saraf	16285	+	NM_026432	35217697	35233175	6
chr8	35229675	35229766	Mir6395	91	-	NR_105820	35229766	35229766	1
chr8	35652473	35703370	B930018H19Rik	50897	-	NR_040706	35703370	35703370	5
chr8	35870663	35882948	Dusp4	12285	+	NM_176933	35870782	35881837	4
chr8	35892232	36028744	Tnks	136512	-	NM_175091	35894688	36028719	27
chr8	36438794	36451191	Ppp1r3b	12397	+	NM_177741	36447062	36447917	2
chr8	36528318	36558587	Eri1	30269	-	NM_026067	36532181	36558421	7
chr8	36645556	36652074	Gm16793	6518	-	NR_040376	36652074	36652074	3
chr8	36650851	36742503	Mfhas1	91652	+	NM_001081279	36651426	36739817	3
chr8	36887762	36889613	Cldn23	1851	-	NM_027998	36888495	36889386	1
chr8	36927138	36946011	5430403N17Rik	18873	-	NR_046181	36946011	36946011	3
chr8	37157881	37210841	D8Ertd82e	52960	+	NM_172911	37162750	37210471	6
chr8	37279117	37312570	Lonrf1	33453	-	NM_001081150	37280496	37312533	12
chr8	37552244	37576067	6430573F11Rik	23823	+	NM_176952	37561381	37575642	4
chr8	37630792	38015496	Dlc1	384704	-	NM_001194940	37633336	38001687	18
chr8	38048626	38087292	G630064G18Rik	38666	-	NR_126063	38087292	38087292	3
chr8	38056628	38058587	AI429214	1959	+	NM_001039220	38056753	38057635	1
chr8	38585607	39724562	Sgcz	1138955	-	NM_145841	38586315	39723817	8
chr8	39315186	39315256	Mir383	70	-	NR_029884	39315256	39315256	1
chr8	40068920	40250468	Tusc3	181548	+	NM_030254	40069116	40250195	10
chr8	40383333	40453622	Gm6213	70289	+	NR_044988	40453622	40453622	4
chr8	40667053	40728032	Msr1	60979	-	NM_001113326	40667085	40727974	10
chr8	41364519	41372307	Fgf20	7788	-	NM_030610	41365113	41372061	3
chr8	41393228	41393283	Mir7666	55	-	NR_106126	41393283	41393283	1
chr8	41393404	41471658	Micu3	78254	+	NM_030110	41393404	41467531	15
chr8	41509168	41570196	Zdhhc2	61028	+	NM_178395	41509396	41560129	13
chr8	41577891	41601201	Cnot7	23310	-	NM_001271542	41579340	41595485	7
chr8	41597136	41636488	Vps37a	39352	+	NM_033560	41597462	41630378	12
chr8	41635512	41720146	Mtmr7	84634	-	NM_001040699	41636904	41720075	14
chr8	41760447	41767553	Adam24	7106	+	NM_010086	41764848	41767134	2
chr8	41837561	41841530	Adam25	3969	+	NM_011781	41839052	41841335	2
chr8	41878626	41882657	Adam20	4031	+	NM_001009548	41880208	41882491	2
chr8	41908362	41912215	Adam39	3853	+	NM_001025380	41909927	41912198	2
chr8	41947720	42007424	Slc7a2	59704	+	NM_007514	41984306	42001888	12
chr8	42011586	42076124	Pdgfrl	64538	+	NM_026840	42011724	42075857	6
chr8	42076265	42219080	Mtus1	142815	-	NM_001005863	42078773	42170031	14
chr8	42102821	42109570	B430010I23Rik	6749	+	NR_015457	42109570	42109570	3
chr8	42276787	42300510	Fgl1	23723	-	NM_145594	42276874	42295843	8
chr8	42325112	42419441	Pcm1	94329	+	NM_023662	42341368	42417362	38
chr8	42425999	42460051	Asah1	34052	-	NM_019734	42426949	42459938	14
chr8	42482807	42502472	Frg1	19665	-	NM_013522	42482961	42502315	9
chr8	42912620	43131556	2810404M03Rik	218936	+	NR_045497	43131556	43131556	6
chr8	44215160	44226840	Triml1	11680	-	NM_177742	44215503	44226746	6
chr8	44268475	44279238	Triml2	10763	+	NM_001160412	44268533	44279104	7
chr8	44380420	44392363	Zfp42	11943	-	NM_009556	44380949	44381816	4
chr8	44605217	44613491	Adam26b	8274	-	NM_001009547	44605217	44607317	2
chr8	44653629	44662061	Adam26a	8432	-	NM_010085	44653711	44655805	2
chr8	44710328	44712539	Gm5346	2211	-	NM_001025240	44710328	44712539	1
chr8	44735662	44750914	Adam34	15252	-	NM_145745	44735815	44737960	2
chr8	44759011	44784845	Gm5347	25834	-	NM_001079931	44759173	44761315	3
chr8	46035561	46137611	Fat1	102050	+	NM_001081286	46035567	46136763	26
chr8	46146055	46150772	AY512931	4717	-	NR_033588	46150772	46150772	5
chr8	46154563	46173860	Mtnr1a	19297	+	NM_008639	46154563	46173419	2
chr8	46245847	46250499	Gm6329	4652	-	NR_040690	46250499	46250499	3
chr8	46326521	46347385	F11	20864	-	NM_028066	46326801	46346434	15
chr8	46354806	46380189	Klkb1	25383	-	NM_008455	46355255	46379485	15
chr8	46391155	46418550	Cyp4v3	27395	-	NM_133969	46392289	46418332	11
chr8	46422068	46467645	Fam149a	45577	-	NM_153535	46424652	46467114	14
chr8	46481018	46495893	Tlr3	14875	-	NM_126166	46482266	46488495	7
chr8	46593141	46913260	Sorbs2	320119	+	NM_001205219	46821546	46911160	24
chr8	46808678	46904651	Sorbs2os	95973	-	NR_045739	46904651	46904651	6
chr8	46970838	47004900	Pdlim3	34062	+	NM_016798	46970933	47004368	7
chr8	47020002	47029499	Ccdc110	9497	+	NM_001033246	47020058	47029476	7
chr8	47038959	47060606	1700029J07Rik	21647	-	NM_001033148	47039099	47058957	7
chr8	47060881	47082310	Ufsp2	21429	+	NM_138668	47064585	47082142	12
chr8	47082261	47085204	Ankrd37	2943	-	NM_001039562	47082478	47084997	5
chr8	47095955	47114830	Lrp2bp	18875	+	NM_026278	47096488	47112671	9
chr8	47118614	47209500	Snx25	90886	-	NM_207213	47119095	47209437	18
chr8	47254909	47280944	Cfap97	26035	+	NM_025747	47254928	47278066	4
chr8	47292697	47296363	Slc25a4	3666	-	NM_007450	47292816	47296276	4
chr8	47377401	47380025	Helt	2624	-	NM_173789	47377589	47379404	4
chr8	47556390	47621405	Acsl1	65015	+	NM_007981	47578185	47619834	21
chr8	47637422	47664938	Cenpu	27516	+	NM_027973	47637440	47663722	13
chr8	47660947	47702554	Primpol	41607	-	NM_001001184	47664277	47695973	15
chr8	47702644	47725052	Casp3	22408	+	NM_001284409	47715102	47723502	7
chr8	47816323	47824869	Gm16675	8546	-	NR_045750	47824869	47824869	3
chr8	47825098	47932812	Irf2	107714	+	NM_008391	47878852	47931576	9
chr8	48072278	48180249	Enpp6	107971	+	NM_177304	48072324	48178553	8
chr8	48265401	48437702	Stox2	172301	-	NM_175162	48277033	48288607	5
chr8	48575481	48618824	Trappc11	43343	-	NM_177240	48576227	48616209	30
chr8	48618998	48638191	Rwdd4a	19193	+	NM_203507	48619273	48636081	7
chr8	48752531	48760513	Ing2	7982	-	NM_023503	48754019	48760034	2
chr8	48794697	48799285	Cdkn2aip	4588	-	NM_172407	48796338	48799124	3
chr8	48907496	48908159	Cldn24	663	+	NM_001111318	48907496	48908159	1
chr8	48909835	48910829	Cldn22	994	+	NM_029383	48909882	48910545	1
chr8	48912963	49075905	Wwc2	162942	-	NM_133791	48914071	49075550	23
chr8	49184445	49227021	Dctd	42576	+	NM_001161516	49197018	49225775	6
chr8	49311018	49760044	Tenm3	449026	-	NM_011857	49313799	49759995	29
chr8	51453465	51501443	Gm2516	47978	+	NR_046067	51501443	51501443	6
chr8	54597055	54608776	Aga	11721	+	NM_001005847	54597158	54608630	9
chr8	54672220	54724419	Neil3	52199	-	NM_146208	54672498	54724265	10
chr8	55162885	55271808	Vegfc	108923	+	NM_009506	55163132	55271422	7
chr8	55605786	55615351	Spcs3	9565	-	NM_029701	55608616	55615258	5
chr8	55635683	55673189	Asb5	37506	+	NM_029569	55635797	55672714	7
chr8	55686133	55695451	Spata4	9318	+	NM_133711	55686153	55695302	6
chr8	55714968	55809721	Wdr17	94753	-	NM_001172152	55715143	55781744	30
chr8	55864786	56146231	Gpm6a	281445	+	NM_001253754	55864999	56144282	7
chr8	58349708	58385761	Adam29	36053	-	NM_175939	58349922	58352214	2
chr8	58419621	58604149	Glra3	184528	+	NM_080438	58419652	58604149	10
chr8	58773348	58799843	Hpgd	26495	+	NM_008278	58773416	58799002	7
chr8	58944418	58963765	4930518J21Rik	19347	-	NR_131020	58963765	58963765	3
chr8	59010318	59029363	Cep44	19045	-	NM_001009951	59010486	59026273	11
chr8	59029930	59072736	Fbxo8	42806	+	NM_015791	59043362	59070420	6
chr8	59783210	59799656	LOC102636514	16446	-	NR_110474	59799656	59799656	5
chr8	59799779	59803314	Hand2	3535	+	NM_010402	59800703	59802657	2
chr8	59811231	59833377	5033428I22Rik	22146	+	NR_131041	59833377	59833377	3
chr8	59934719	59956382	Scrg1	21663	+	NM_009136	59953113	59956195	3
chr8	59961498	59966657	Sap30	5159	-	NM_021788	59961724	59966363	4
chr8	59966759	59989059	2500002B13Rik	22300	+	NR_126553	59989059	59989059	4
chr8	59990639	59994796	Hmgb2	4157	+	NM_008252	59991395	59992924	5
chr8	60002621	60131852	Galnt7	129231	-	NM_001167981	60004910	60131775	12
chr8	60130549	60142227	AW046200	11678	+	NR_040698	60142227	60142227	4
chr8	60252848	61390424	Galntl6	1137576	-	NM_175032	60255978	61390271	12
chr8	61177645	61179593	Gm15881	1948	-	NM_001177534	61178642	61179593	1
chr8	61390551	61393095	BC030500	2544	+	NM_173411	61391305	61392002	3
chr8	62304445	62323518	4930470O06Rik	19073	+	NR_126087	62323518	62323518	4
chr8	62984920	63024474	Aadat	39554	+	NM_011834	62985009	63024061	13
chr8	63111621	63155528	Mfap3l	43907	+	NM_027756	63135388	63150752	3
chr8	63369247	63386369	2700029M09Rik	17122	+	NM_028299	63369285	63386265	8
chr8	63389185	63462108	Clcn3	72923	-	NM_173874	63391813	63454688	14
chr8	63471989	63610143	Nek1	138154	+	NM_001293637	63485456	63608954	35
chr8	63702967	63874869	Sh3rf1	171902	+	NM_021506	63704722	63872634	12
chr8	63760318	63767669	1700001D01Rik	7351	-	NR_045475	63767669	63767669	5
chr8	63966530	63982297	Cbr4	15767	+	NM_145595	63966645	63982008	5
chr8	63990225	64381491	Palld	391266	-	NM_001293772	63992148	64356638	22
chr8	64406883	64516498	Ddx60	109615	+	NM_001293783	64418899	64515931	38
chr8	64535838	64601990	Anxa10	66152	-	NM_001136089	64536538	64601825	12
chr8	65430028	65835893	Spock3	405865	+	NM_001252620	65430596	65834178	12
chr8	66403490	66430967	Sgol2b	27477	-	NM_001195687	66403490	66422017	8
chr8	66493566	66684790	Tll1	191224	-	NM_009390	66494842	66684180	21
chr8	66993128	66993238	Mir710	110	-	NR_030491	66993238	66993238	1
chr8	67071348	67171837	Cpe	100489	-	NM_013494	67071919	67171746	9
chr8	67196941	67212375	Msmo1	15434	-	NM_025436	67197782	67206675	6
chr8	67218471	67373822	Klhl2	155351	-	NM_178633	67219742	67373556	15
chr8	67471083	67492935	Tmem192	21852	+	NM_028427	67471205	67492733	6
chr8	67505549	67511543	Trim75	5994	-	NM_001033429	67506291	67507695	2
chr8	67522346	67542587	Trim60	20241	-	NM_153097	67524093	67525494	2
chr8	67536874	67542587	Trim61	5713	-	NM_153110	67537120	67538506	3
chr8	67552315	67561235	Apela	8920	-	NM_001297554	67559564	67560864	4
chr8	67609512	67653436	BC030870	43924	-	NR_033217	67653436	67653436	3
chr8	68141938	68995536	March1	853598	+	NM_001293784	68645687	68992429	9
chr8	69000244	69010406	Tma16	10162	-	NM_025465	69000573	69010313	7
chr8	69035638	69043098	Tktl2	7460	+	NM_001271574	69035690	69037574	2
chr8	69203863	69211993	Npy5r	8130	-	NM_016708	69204637	69206038	2
chr8	69221320	69230697	Npy1r	9377	+	NM_010934	69227828	69229087	3
chr8	69384115	69414463	Naf1	30348	+	NM_001163564	69384265	69413417	8
chr8	70014656	70016002	Nat1	1346	+	NM_008673	70014872	70015745	1
chr8	70018773	70026477	Nat2	7704	+	NM_001168577	70025138	70026011	2
chr8	70047752	70072526	Nat3	24774	+	NM_008674	70071369	70072242	3
chr8	70212980	70498473	Psd3	285493	-	NM_177698	70220870	70498062	15
chr8	70800426	70871603	Sh2d4a	71177	+	NM_028182	70806129	70870645	9
chr8	70880679	71259045	Csgalnact1	378366	-	NM_001252623	70882322	70985450	11
chr8	70892357	70899609	1700125H03Rik	7252	+	NR_038181	70899609	70899609	4
chr8	71317827	71353309	Ints10	35482	+	NM_001293792	71317918	71351332	18
chr8	71404453	71430831	Lpl	26378	+	NM_008509	71404651	71428405	10
chr8	71561606	71613121	Slc18a1	51515	-	NM_153054	71562693	71599056	17
chr8	71612634	71637616	Atp6v1b2	24982	+	NM_007509	71612691	71636468	14
chr8	71659401	71664852	Lzts1	5451	-	NM_199364	71659401	71664852	3
chr8	71732944	71754438	Zfp930	21494	+	NM_001013379	71733055	71752879	4
chr8	71794978	71827274	D130040H23Rik	32296	+	NM_172491	71824674	71827061	6
chr8	71894923	71919443	Gm10033	24520	-	NR_038043	71919443	71919443	6
chr8	72134552	72149447	Zfp868	14895	-	NM_172754	72135312	72143251	5
chr8	72178454	72188352	Zfp964	9898	+	NM_001177527	72178492	72188069	4
chr8	72229036	72240801	Zfp869	11765	-	NM_001039967	72230230	72234623	6
chr8	72265537	72273861	Zfp963	8324	-	NM_001200023	72266548	72273733	4
chr8	72285222	72298810	Zfp866	13588	-	NM_177899	72289304	72298691	4
chr8	72315061	72331647	Atp13a1	16586	+	NM_133224	72315153	72331428	26
chr8	72332585	72345769	Gmip	13184	+	NM_198101	72332700	72344875	21
chr8	72346463	72355001	Lpar2	8538	+	NM_020028	72347461	72350503	3
chr8	72356602	72396191	Pbx4	39589	+	NM_001024954	72356607	72395986	8
chr8	72404264	72411291	Cilp2	7027	-	NM_026818	72404756	72411250	8
chr8	72418080	72426457	Ndufa13	8377	-	NM_023312	72418119	72425534	5
chr8	72426082	72427417	Tssk6	1335	+	NM_032004	72426206	72427028	1
chr8	72430967	72520283	Gatad2a	89316	-	NM_145596	72433742	72459934	13
chr8	72540021	72566633	Mau2	26612	-	NM_001167939	72543384	72566584	19
chr8	72566711	72595852	Sugp1	29141	+	NM_027481	72566945	72595731	14
chr8	72596822	72603965	Tm6sf2	7143	+	NM_001293795	72596893	72603727	10
chr8	72607427	72614761	Hapln4	7334	+	NM_177900	72607459	72612420	5
chr8	72616983	72644743	Ncan	27760	-	NM_007789	72620218	72640560	15
chr8	72626422	72626485	Mir7066	63	-	NR_106033	72626485	72626485	1
chr8	72654704	72663096	Rfxank	8392	-	NM_011266	72657291	72662114	9
chr8	72655225	72657650	Nr2c2ap	2425	+	NM_001025587	72655460	72657045	5
chr8	72663397	72672533	Borcs8	9136	+	NR_132132	72672533	72672533	7
chr8	72663397	72691387	2310045n01rik-mef2b	27990	+	NM_001310055	72688149	72691184	9
chr8	72676659	72691387	Mef2b	14728	+	NM_001045484	72688149	72691184	9
chr8	72696306	72707580	Tmem161a	11274	+	NM_145597	72696336	72706038	12
chr8	72708238	72736180	Slc25a42	27942	-	NM_001007570	72710367	72718103	8
chr8	72744091	72758321	Armc6	14230	-	NM_133972	72744563	72755299	8
chr8	72758124	72787004	Sugp2	28880	+	NM_172755	72760581	72784488	11
chr8	72806897	72818260	Homer3	11363	+	NM_001146153	72809200	72817065	10
chr8	72816764	72826351	Ddx49	9587	-	NM_001024922	72817406	72826336	13
chr8	72826683	72836889	Cope	10206	+	NM_021538	72826705	72836805	10
chr8	72839673	72855487	Cers1	15814	+	NM_138647	72839758	72853479	8
chr8	72839673	72855491	Gdf1	15818	+	NM_001163282	72853880	72855376	8
chr8	72855420	72877172	Upf1	21752	-	NM_001122829	72856521	72876892	24
chr8	72897446	72905965	Comp	8519	+	NM_016685	72897470	72905831	19
chr8	72906256	72963472	Crtc1	57216	-	NM_001004062	72910022	72963457	14
chr8	72974126	73000842	Klhl26	26716	-	NM_178771	72975336	73000804	3
chr8	73007769	73011257	Tmem59l	3488	-	NM_182991	73008201	73011216	8
chr8	73017029	73027980	Crlf1	10951	+	NM_018827	73017150	73027527	9
chr8	73028194	73030638	2810428I15Rik	2444	-	NM_025577	73028335	73030632	5
chr8	73032164	73034266	Uba52	2102	-	NM_019883	73032230	73033522	4
chr8	73037294	73047079	Kxd1	9785	-	NM_029366	73037834	73043936	5
chr8	73051641	73059227	Fkbp8	7586	+	NM_010223	73053312	73058852	9
chr8	73063573	73116757	Ell	53184	+	NM_007924	73063605	73115513	12
chr8	73118379	73121189	Isyna1	2810	+	NM_023627	73118527	73121097	11
chr8	73121388	73132213	Ssbp4	10825	-	NM_133772	73121637	73132079	17
chr8	73140742	73144749	Lrrc25	4007	+	NM_153074	73141469	73144562	3
chr8	73153292	73155534	Gdf15	2242	-	NM_011819	73153441	73155511	2
chr8	73170334	73183637	Pgpep1	13303	-	NM_023217	73174491	73183542	5
chr8	73197129	73202651	Lsm4	5522	+	NM_015816	73197353	73202350	5
chr8	73221637	73224515	Jund	2878	+	NM_001286944	73223100	73223982	1
chr8	73242441	73246534	Gm3336	4093	+	NM_001195253	73242452	73245990	4
chr8	73247962	73275075	Pde4c	27113	+	NM_201607	73248424	73274006	17
chr8	73278577	73282585	Rab3a	4008	+	NM_001166399	73279754	73281987	5
chr8	73282547	73284820	Mpv17l2	2273	-	NM_183170	73282884	73284805	5
chr8	73286671	73290562	Ifi30	3891	-	NM_023065	73286873	73290530	8
chr8	73292079	73300611	Pik3r2	8532	-	NM_008841	73292588	73298876	16
chr8	73300760	73301505	2010320M18Rik	745	+	NR_029440	73301505	73301505	1
chr8	73302015	73316332	Mast3	14317	-	NM_199308	73303312	73316213	26
chr8	73322033	73322091	Mir7240	58	+	NR_106099	73322091	73322091	1
chr8	73332347	73345322	Il12rb1	12975	+	NM_008353	73332450	73344770	16
chr8	73359036	73363619	Arrdc2	4583	-	NM_027560	73359839	73363300	8
chr8	73365947	73380907	Kcnn1	14960	-	NM_032397	73368214	73379295	10
chr8	73392125	73397389	Ccdc124	5264	-	NM_026964	73392339	73393962	5
chr8	73406787	73416656	Slc5a5	9869	-	NM_053248	73407762	73416560	15
chr8	73418620	73421342	Rpl18a	2722	-	NM_029751	73419313	73421275	5
chr8	73419406	73419469	Mir7067	63	-	NR_106034	73419469	73419469	1
chr8	73419657	73419755	Snora68	98	-	NR_002901	73419755	73419755	1
chr8	73429872	73441428	Map1s	11556	+	NM_173013	73429902	73441106	7
chr8	73449423	73449517	Mir1969	94	+	NR_035495	73449517	73449517	1
chr8	73530626	73550654	1700026F02Rik	20028	-	NR_045487	73550654	73550654	3
chr8	73689942	73730847	Gm38415	40905	-	NR_131056	73730847	73730847	5
chr8	73775022	73796489	Haus8	21467	-	NM_001163042	73775292	73796211	11
chr8	73796612	73884611	Myo9b	87999	+	NM_001142322	73814195	73883872	40
chr8	73890746	73893631	Use1	2885	+	NM_001145780	73890935	73893608	9
chr8	73895196	73897588	Ocel1	2392	+	NM_029865	73895573	73896973	4
chr8	73898017	73905851	Nr2f6	7834	-	NM_010150	73898381	73905170	4
chr8	73908172	73919700	Ushbp1	11528	-	NM_181418	73909514	73919292	13
chr8	73920753	73928671	Babam1	7918	+	NM_026636	73921627	73928297	9
chr8	73929910	73934441	Ankle1	4531	+	NM_172756	73929934	73933298	9
chr8	73980598	73987556	Abhd8	6958	-	NM_022419	73981081	73987374	5
chr8	73988824	73989652	Mrpl34	828	+	NM_053162	73988901	73989362	2
chr8	73993092	73999996	Dda1	6904	+	NM_025600	73993221	73998497	5
chr8	73999917	74009966	Ano8	10049	-	NM_001164679	74000283	74009758	17
chr8	74012001	74017299	Gtpbp3	5298	+	NM_032544	74012686	74016663	9
chr8	74021651	74035668	Plvap	14017	-	NM_032398	74022297	74035615	6
chr8	74058160	74061336	Bst2	3176	-	NM_198095	74058588	74061326	5
chr8	74066828	74071925	Mvb12a	5097	+	NM_028617	74066872	74071723	9
chr8	74078201	74082770	Tmem221	4569	-	NM_001100462	74078985	74082708	4
chr8	74084453	74090548	Nxnl1	6095	-	NM_145598	74086507	74090478	2
chr8	74092825	74110607	Slc27a1	17782	+	NM_011977	74094620	74109958	14
chr8	74116082	74120166	Pgls	4084	+	NM_025396	74116115	74120090	5
chr8	74121544	74132048	Fam129c	10504	+	NM_001166213	74121667	74131465	15
chr8	74134922	74148810	Colgalt1	13888	+	NM_146211	74135098	74147659	12
chr8	74150611	74195656	Unc13a	45045	-	NM_001029873	74153321	74195546	42
chr8	74154945	74155005	Mir6769b	60	-	NR_106035	74155005	74155005	1
chr8	74200281	74214476	Jak3	14195	+	NM_010589	74202236	74212046	25
chr8	74213150	74214476	Insl3	1326	+	NM_013564	74213156	74214264	2
chr8	74215617	74225699	B3gnt3	10082	-	NM_028189	74216502	74217782	3
chr8	74232285	74249580	Fcho1	17295	-	NM_028715	74232707	74245177	28
chr8	74405966	74416464	Zfp709	10498	+	NM_145624	74406104	74414811	4
chr8	74432504	74442750	Zfp882	10246	+	NM_001166645	74432634	74438897	3
chr8	74446723	74458529	Zfp617	11806	+	NM_133358	74446868	74457406	4
chr8	74474964	74494232	Zfp961	19268	+	NM_001164581	74474993	74492878	4
chr8	74512380	74533525	Cyp4f18	21145	-	NM_024444	74512458	74533140	13
chr8	74581558	74582574	Olfr372	1016	+	NM_207555	74581580	74582525	1
chr8	74623660	74624605	Olfr373	945	+	NM_146539	74623660	74624605	1
chr8	74630938	74634408	Olfr374	3470	+	NM_146338	74633466	74634408	2
chr8	74659190	74677028	Tpm4	17838	+	NM_001001491	74659220	74675723	8
chr8	74685098	74705265	Rab8a	20167	+	NM_023126	74685257	74704036	8
chr8	74713566	74724857	Hsh2d	11291	+	NM_197944	74717359	74724679	6
chr8	74728233	74736736	Cib3	8503	-	NM_001080812	74728307	74736647	5
chr8	74743628	74747674	Fam32a	4046	+	NM_026455	74743685	74746149	4
chr8	74764030	74781278	Ap1m1	17248	+	NM_007456	74764100	74780656	12
chr8	74842960	74845553	Klf2	2593	+	NM_008452	74842976	74844818	3
chr8	74864895	74945373	Eps15l1	80478	-	NM_007944	74865279	74945336	24
chr8	74948081	74967677	Calr3	19596	-	NM_028500	74948513	74967582	9
chr8	74967778	74984440	1700030K09Rik	16662	+	NM_028170	74968649	74984050	8
chr8	74984381	74999132	Cherp	14751	-	NM_138585	74985213	74998981	18
chr8	74993914	74993988	Mir7068	74	-	NR_106036	74993988	74993988	1
chr8	75001893	75016513	Slc35e1	14620	-	NM_177766	75007664	75016485	6
chr8	75018457	75072209	Med26	53752	-	NM_027485	75019385	75071865	3
chr8	75089096	75094947	Smim7	5851	-	NM_172396	75091691	75094928	5
chr8	75096001	75111183	Tmem38a	15182	+	NM_144534	75096002	75109985	6
chr8	75170609	75238645	Nwd1	68036	+	NM_176940	75177386	75235790	19
chr8	75247168	75282102	Sin3b	34934	+	NM_009188	75247208	75281304	19
chr8	75285778	75287784	F2rl3	2006	+	NM_007975	75285801	75287236	2
chr8	75338496	75877439	Large	538943	-	NM_001317391	75339722	75738129	16
chr8	75540410	75540490	Mir28b	80	+	NR_039551	75540490	75540490	1
chr8	77397072	77417405	Isx	20333	+	NM_027837	77397539	77416803	4
chr8	77517548	77555877	Hmgxb4	38329	+	NM_001316753	77524616	77553932	12
chr8	77557584	77594020	Tom1	36436	+	NM_001136259	77557674	77593303	16
chr8	77617516	77624492	Hmox1	6976	+	NM_010442	77617648	77623918	5
chr8	77633407	77652338	Mcm5	18931	+	NM_001302540	77633606	77651223	17
chr8	77737842	77748012	Rasd2	10170	+	NM_029182	77742443	77746147	3
chr8	77972592	78508406	1700007B14Rik	535814	+	NM_001164235	78078789	78508194	14
chr8	79272985	79424072	Gm10649	151087	-	NR_028579	79424072	79424072	2
chr8	79426406	79767538	Nr3c2	341132	+	NM_001083906	79432170	79766429	9
chr8	79774264	80041806	Arhgap10	267542	-	NM_030113	79774817	80041682	23
chr8	80040954	80042477	0610038B21Rik	1523	+	NR_028125	80042477	80042477	1
chr8	80073295	80105237	Prmt10	31942	+	NM_001081240	80073446	80105148	12
chr8	80119878	80134552	Tmem184c	14674	-	NM_145599	80120261	80134124	10
chr8	80148070	80152855	1700092C02Rik	4785	+	NR_045467	80152855	80152855	3
chr8	80186927	80248351	Ednra	61424	-	NM_010332	80188874	80244346	8
chr8	80737240	80918225	Ttc29	180985	+	NM_183096	80742692	80917582	14
chr8	80956907	80960551	Pou4f2	3644	-	NM_138944	80958635	80960303	2
chr8	81029167	81032827	Rbmxl1	3660	-	NM_009033	81029444	81030611	2
chr8	81033226	81257911	Slc10a7	224685	+	NM_029736	81033473	81255537	12
chr8	81328766	81345051	Lsm6	16285	-	NM_001191004	81332109	81336968	5
chr8	81552335	81717665	Zfp827	165330	+	NM_178267	81552585	81712063	15
chr8	81734328	81772482	1700011L22Rik	38154	-	NM_026315	81734548	81772351	6
chr8	81790322	81818855	Mmaa	28533	-	NM_133823	81791826	81805505	7
chr8	81818976	81831673	Gm4890	12697	+	NR_045822	81831673	81831673	3
chr8	81862297	81923367	Smad1	61070	-	NM_008539	81863547	81896082	7
chr8	82163574	82201654	Otud4	38080	+	NM_001081164	82163804	82197881	21
chr8	82207340	82235639	Abce1	28299	-	NM_015751	82209128	82232424	18
chr8	82235718	82301220	Anapc10	65502	+	NM_026904	82237063	82299061	5
chr8	82489749	82581907	Hhip	92158	-	NM_020259	82496231	82581414	13
chr8	83017943	83034684	Gypa	16741	+	NM_010369	83017952	83033373	8
chr8	83134937	83219456	Frem3	84519	+	NM_001167898	83134978	83219255	8
chr8	83223842	83263358	Smarca5	39516	-	NM_053124	83224961	83262995	24
chr8	83288329	83404418	Gab1	116089	-	NM_001301298	83290227	83403502	11
chr8	83504631	83538805	Usp38	34174	-	NM_027554	83505717	83538335	10
chr8	83866460	84651816	Inpp4b	785356	+	NM_001297596	84265308	84646634	25
chr8	84855522	84926485	Il15	70963	-	NM_001254747	84855812	84869510	8
chr8	85287518	85298025	Zfp330	10507	-	NM_145600	85288127	85296898	10
chr8	85387254	85615170	Rnf150	227916	+	NM_177378	85387908	85607453	7
chr8	85689250	85796839	Tbc1d9	107589	+	NM_001111304	85689973	85795509	21
chr8	85814246	85822355	Ucp1	8109	+	NM_009463	85814481	85821870	6
chr8	85836530	85856385	Elmod2	19855	-	NM_178736	85840214	85855151	9
chr8	85872370	85903301	Mgat4d	30931	+	NM_026233	85872383	85903144	11
chr8	85913789	85950728	Clgn	36939	+	NM_009904	85919350	85950505	15
chr8	85958390	85982295	Scoc	23905	-	NM_001039137	85959796	85982238	4
chr8	86064991	86066087	Olfr370	1096	+	NM_146270	86065044	86065989	1
chr8	86090656	86095522	Ndufb7	4866	+	NM_025843	86090717	86095464	3
chr8	86095596	86118390	Tecr	22794	-	NM_134118	86095706	86118253	13
chr8	86132073	86136552	Dnajb1	4479	+	NM_018808	86132230	86134718	3
chr8	86176576	86188688	Gipc1	12112	+	NM_018771	86184891	86188168	7
chr8	86190538	86194002	Ptger1	3464	+	NM_013641	86191794	86193432	3
chr8	86193660	86223078	Pkn1	29418	-	NM_177262	86194063	86222886	22
chr8	86239075	86247250	Ddx39	8175	+	NM_197982	86243289	86247040	11
chr8	86247149	86265210	Adgre5	18061	-	NM_011925	86247771	86265036	20
chr8	86247776	86247883	Mir1668	107	-	NR_106188	86247883	86247883	1
chr8	86423996	86465853	Adgrl1	41857	+	NM_181039	86439397	86462985	23
chr8	86479592	86494094	Asf1b	14502	+	NM_024184	86479727	86493239	4
chr8	86496876	86520341	Prkaca	23465	+	NM_008854	86497085	86519316	10
chr8	86521570	86524285	Samd1	2715	+	NM_001081415	86521570	86523774	5
chr8	86525604	86528669	1700067K01Rik	3065	+	NM_183097	86525640	86528524	6
chr8	86529526	86529663	Mir8111	137	+	NR_106191	86529663	86529663	1
chr8	86534126	86535619	2210011C24Rik	1493	-	NM_001291292	86534376	86535583	3
chr8	86535413	86535532	Mir1199	119	-	NR_035431	86535532	86535532	1
chr8	86545372	86554194	Palm3	8822	+	NM_028877	86545386	86553964	7
chr8	86554184	86566474	Il27ra	12290	-	NM_016671	86554929	86566433	14
chr8	86566965	86568878	Rln3	1913	-	NM_173184	86566991	86568855	2
chr8	86590734	86620891	Rfx1	30157	+	NM_009055	86597670	86619865	21
chr8	86609997	86610085	Mir709	88	+	NR_030490	86610085	86610085	1
chr8	86620970	86628661	Dcaf15	7691	-	NM_172502	86621351	86628647	13
chr8	86649887	86656416	Podnl1	6529	+	NM_001013384	86649997	86656126	10
chr8	86656726	86671652	Cc2d1a	14926	-	NM_145970	86657135	86671605	29
chr8	86671936	86696496	4930432K21Rik	24560	+	NM_029045	86672756	86696186	9
chr8	86697631	86700451	Nanos3	2820	-	NM_194059	86697803	86700430	2
chr8	86702614	86702686	Mir181d	72	-	NR_030534	86702686	86702686	1
chr8	86702771	86702860	Mir181c	89	-	NR_029821	86702860	86702860	1
chr8	86732416	86732491	Mir23a	75	+	NR_029740	86732491	86732491	1
chr8	86732570	86732657	Mir27a	87	+	NR_029746	86732657	86732657	1
chr8	86732713	86732820	Mir24-2	107	+	NR_029741	86732820	86732820	1
chr8	86732723	86732806	Mir3074-2	83	-	NR_037294	86732806	86732806	1
chr8	86734840	86760941	Zswim4	26101	-	NM_172503	86735844	86760903	14
chr8	86770133	86773660	D8Ertd738e	3527	-	NM_001007571	86770451	86773602	3
chr8	86774474	86781223	Mri1	6749	-	NM_026423	86775449	86781159	5
chr8	86781665	86794301	Ccdc130	12636	-	NM_026350	86782379	86790737	10
chr8	86939262	87164148	Cacna1a	224886	+	NM_001252060	86939543	87163635	48
chr8	87185229	87186751	Ier2	1522	-	NM_010499	87185984	87186650	1
chr8	87194377	87211761	Nacc1	17384	-	NM_025788	87196940	87201143	6
chr8	87213145	87223707	Trmt1	10562	+	NM_001164560	87213213	87223663	17
chr8	87225355	87228615	Lyl1	3260	+	NM_008535	87226562	87228206	4
chr8	87228610	87324237	Nfix	95627	-	NM_001081982	87237684	87323923	10
chr8	87339303	87356164	Dand5	16861	-	NR_033145	87356164	87356164	2
chr8	87356180	87359381	Gadd45gip1	3201	+	NM_183358	87356189	87358325	2
chr8	87358550	87364564	Rad23a	6014	-	NM_001297606	87359459	87364464	9
chr8	87365986	87370830	Calr	4844	-	NM_007591	87366545	87370697	9
chr8	87380884	87393156	Farsa	12272	+	NM_025648	87380933	87392903	13
chr8	87391845	87391907	Mir7069	62	+	NR_106037	87391907	87391907	1
chr8	87396009	87411345	Syce2	15336	+	NM_027954	87396137	87411078	5
chr8	87410285	87417820	Gcdh	7535	-	NM_001044744	87410878	87417580	12
chr8	87425826	87429194	Klf1	3368	+	NM_010635	87425873	87428838	3
chr8	87432522	87435360	Dnase2a	2838	+	NM_010062	87432674	87434931	6
chr8	87435751	87461252	Mast1	25501	-	NM_019945	87435884	87461176	26
chr8	87437233	87446814	Gm38426	9581	+	NR_103491	87446814	87446814	3
chr8	87470889	87480502	Rtbdn	9613	+	NM_144929	87474406	87480126	6
chr8	87480508	87489910	Rnaseh2a	9402	-	NM_027187	87481621	87489885	8
chr8	87493520	87498709	Prdx2	5189	+	NM_011563	87494140	87497984	6
chr8	87500807	87502647	Junb	1840	-	NM_008416	87501293	87502328	1
chr8	87514493	87527263	Hook2	12770	+	NM_001167991	87514606	87526910	22
chr8	87531100	87538430	Best2	7330	-	NR_052011	87538430	87538430	10
chr8	87541829	87549177	Asna1	7348	-	NM_019652	87542022	87549164	7
chr8	87550731	87554185	2310036O22Rik	3454	+	NM_026760	87550797	87553881	3
chr8	87560813	87581481	Tnpo2	20668	+	NM_145390	87562289	87579346	25
chr8	87577058	87584359	A230103J11Rik	7301	-	NR_110582	87584359	87584359	4
chr8	87584017	87591019	Fbxw9	7002	+	NM_026791	87584026	87590563	10
chr8	87585984	87586070	Mir7070	86	+	NR_106038	87586070	87586070	1
chr8	87591466	87591881	Gm5741	415	-	NM_001195531	87591487	87591793	2
chr8	87595655	87599060	Dhps	3405	+	NM_001039514	87595745	87598928	9
chr8	87598933	87604645	Wdr83	5712	-	NM_026399	87599092	87604514	9
chr8	87604861	87606238	Wdr83os	1377	+	NM_001001493	87604912	87605911	4
chr8	87607167	87622638	Man2b1	15471	+	NM_010764	87607228	87621416	24
chr8	87633065	87646994	Zfp791	13929	-	NM_001037745	87633545	87643536	5
chr8	87675822	87697521	Cks1brt	21699	+	NM_001037922	87695418	87695709	2
chr8	87754395	87755334	Olfr371	939	+	NM_146859	87754395	87755334	1
chr8	87784290	87823396	Vps35	39106	-	NM_022997	87785028	87823356	17
chr8	87823530	87832178	Orc6	8648	+	NM_019716	87823826	87831609	7
chr8	87848827	87904940	Mylk3	56113	-	NM_001297612	87849359	87904844	13
chr8	87932657	87956740	4921524J17Rik	24083	-	NM_025722	87933670	87956623	4
chr8	88016515	88051457	Gpt2	34942	+	NM_173866	88016825	88049525	12
chr8	88061538	88079170	Dnaja2	17632	-	NM_019794	88063114	88079146	9
chr8	88160486	88214908	Neto2	54422	-	NM_001081324	88164434	88214872	9
chr8	88224803	88224920	Mir8109	117	+	NR_106189	88224920	88224920	1
chr8	88241455	88364848	Itfg1	123393	-	NM_028007	88242766	88364637	18
chr8	88364900	88584541	Phkb	219641	+	NM_199446	88366959	88583341	32
chr8	89028739	89090489	Abcc12	61750	-	NM_172912	89029116	89090456	29
chr8	89147941	89240535	Lonp2	92594	+	NM_025827	89148082	89240370	15
chr8	89247836	89269905	Siah1a	22069	-	NM_009172	89248904	89249753	2
chr8	89269597	89270959	Gm10638	1362	+	NR_027829	89270959	89270959	1
chr8	89365037	89409157	N4bp1	44120	-	NM_030563	89368585	89408918	7
chr8	89693645	89723749	Gm10637	30104	-	NR_040697	89723749	89723749	7
chr8	89992751	89996491	Cbln1	3740	-	NM_019626	89994152	89996139	3
chr8	89996710	90049453	Gm2694	52743	+	NR_033430	90049453	90049453	4
chr8	90087805	90113096	4933402J07Rik	25291	+	NM_177901	90087914	90112995	6
chr8	90159996	90166109	1700096P03Rik	6113	-	NR_131165	90166109	90166109	2
chr8	90185708	90483494	Zfp423	297786	-	NM_033327	90186376	90483134	8
chr8	90642657	90659096	Cnep1r1	16439	+	NM_029074	90642743	90657728	6
chr8	90661783	90695842	Heatr3	34059	+	NM_172757	90661918	90694880	15
chr8	90662104	90662173	Mir7071	69	+	NR_106039	90662173	90662173	1
chr8	90723111	90783621	Papd5	60510	+	NM_001164498	90723862	90781174	13
chr8	90796301	90853861	Adcy7	57560	+	NM_007406	90830498	90851717	28
chr8	90856209	90886090	Brd7	29881	-	NM_012047	90856386	90885853	17
chr8	91045242	91118786	Nkd1	73544	+	NM_027280	91045405	91116051	10
chr8	91150726	91160027	Snx20	9301	-	NM_027840	91151057	91155788	4
chr8	91171245	91212373	Nod2	41128	+	NM_145857	91176771	91210601	13
chr8	91220926	91275845	Cyld	54919	+	NM_001128171	91229274	91270912	18
chr8	91548633	91548730	Mir8110	97	+	NR_106190	91548730	91548730	1
chr8	91551142	91568061	Sall1	16919	-	NM_021390	91552276	91566326	4
chr8	92771010	92872151	Tox3	101141	-	NM_172913	92772172	92871848	7
chr8	93352733	93578407	Chd9	225674	+	NM_177224	93456312	93575871	40
chr8	93593955	93647743	Rbl2	53788	+	NM_001282001	93594074	93646345	22
chr8	93635680	93657926	Aktip	22246	-	NM_001302337	93636523	93654981	10
chr8	93740928	93837121	Rpgrip1l	96193	-	NM_173431	93744075	93834321	26
chr8	93837423	94192332	Fto	354909	+	NM_011936	93837474	94190334	9
chr8	94322409	94325553	Irx3	3144	-	NM_001253822	94322789	94325139	4
chr8	94849929	94880019	Crnde	30090	-	NR_033641	94880019	94880019	7
chr8	94881694	94885355	Irx5	3661	+	NM_018826	94882082	94884795	3
chr8	95198187	95204855	Irx6	6668	+	NM_022428	95198933	95203552	6
chr8	95351226	95377319	Mmp2	26093	+	NM_008610	95351523	95376564	13
chr8	95379248	95443178	Lpcat2	63930	+	NM_173014	95379353	95442118	14
chr8	95425293	95426308	Capns2	1015	+	NM_027112	95425383	95426127	1
chr8	95484945	95525566	Slc6a2	40621	+	NM_009209	95485146	95521548	14
chr8	95544113	95572091	Ces1a	27978	-	NM_001013764	95544316	95572007	14
chr8	95580625	95603916	Ces1b	23291	-	NM_001081372	95580785	95603815	14
chr8	95622914	95655182	Ces1c	32268	-	NM_007954	95623063	95655157	13
chr8	95689970	95721703	Ces1d	31733	-	NM_053200	95690153	95721618	14
chr8	95725116	95753518	Ces1e	28402	-	NM_133660	95725302	95753320	14
chr8	95780134	95803635	Ces1f	23501	-	NM_144930	95780327	95803599	14
chr8	95826267	95861108	Ces1g	34841	-	NM_021456	95826803	95861053	14
chr8	96038094	96059607	Ces5a	21513	-	NM_001003951	96038094	96059607	10
chr8	96334737	96493288	Gnao1	158551	+	NM_010308	96335235	96490955	9
chr8	96335593	96337455	4930488L21Rik	1862	-	NR_026888	96337455	96337455	1
chr8	96495487	96536540	Amfr	41053	-	NM_011787	96497066	96536361	14
chr8	96543302	96560939	Nudt21	17637	-	NM_026623	96543582	96560792	7
chr8	96561097	96591822	Ogfod1	30725	+	NM_177767	96561188	96588240	13
chr8	96591853	96622711	Bbs2	30858	-	NM_026116	96592175	96622252	17
chr8	96661103	96662931	Mt4	1828	+	NM_008631	96661141	96662767	3
chr8	96676506	96678048	Mt3	1542	+	NM_013603	96676699	96677910	3
chr8	96696517	96697467	Mt2	950	+	NM_008630	96696747	96697327	3
chr8	96702988	96704227	Mt1	1239	+	NM_013602	96703210	96704093	3
chr8	96738500	96838966	Nup93	100466	+	NM_172410	96751576	96838595	23
chr8	96848210	96848281	Mir138-2	71	+	NR_029552	96848281	96848281	1
chr8	96853107	96890121	Slc12a3	37014	+	NM_019415	96853137	96889861	25
chr8	96910399	96919258	Herpud1	8859	+	NM_022331	96910491	96918655	8
chr8	96957026	96959003	9330175E14Rik	1977	-	NR_015514	96959003	96959003	3
chr8	96996662	97051172	Nlrc5	54510	+	NM_001033207	96996662	97049975	49
chr8	97028945	97029005	Mir7072	60	+	NR_106040	97029005	97029005	1
chr8	97056927	97094429	Cpne2	37502	+	NM_153507	97072265	97093978	16
chr8	97098840	97125626	Fam192a	26786	-	NM_028221	97099536	97112802	8
chr8	97125840	97184176	Rspry1	58336	+	NM_026274	97146885	97182700	15
chr8	97190499	97198357	Arl2bp	7858	+	NM_024191	97190763	97197018	6
chr8	97198794	97220142	Pllp	21348	-	NM_026385	97200062	97220070	4
chr8	97269583	97275288	Ccl22	5705	+	NM_009137	97269613	97273786	3
chr8	97296079	97306326	Cx3cl1	10247	+	NM_009142	97296164	97304456	3
chr8	97334352	97335936	Ccl17	1584	+	NM_011332	97334371	97335753	3
chr8	97343718	97362240	Ciapin1	18522	-	NM_134141	97346996	97356571	9
chr8	97362316	97378795	Coq9	16479	+	NM_026452	97362321	97378049	9
chr8	97381349	97388140	Polr2c	6791	+	NM_009090	97381455	97387496	9
chr8	97387727	97400212	Dok4	12485	-	NM_053246	97389028	97394825	9
chr8	97426768	97441998	Ccdc102a	15230	-	NM_001033533	97427161	97437564	9
chr8	97447593	97467190	Adgrg5	19597	+	NM_001145972	97457265	97466032	12
chr8	97501008	97538108	Adgrg1	37100	+	NM_001198894	97526349	97536887	14
chr8	97541591	97569149	Adgrg3	27558	+	NM_173036	97541668	97568417	12
chr8	97579002	97602041	Drc7	23039	+	NM_001042715	97579908	97601889	18
chr8	97605100	97623774	Katnb1	18674	+	NM_028805	97606753	97622686	20
chr8	97623727	97666440	Kifc3	42713	-	NM_001145831	97624568	97653114	22
chr8	97762942	97830485	Cngb1	67543	-	NM_001195413	97765093	97827729	33
chr8	97835497	97845229	Tepp	9732	+	NM_199455	97836856	97845090	8
chr8	97850035	97855850	Zfp319	5815	-	NM_024467	97851727	97853473	2
chr8	97856183	97871413	Usb1	15230	+	NM_133954	97856261	97870531	7
chr8	97876236	97898193	Mmp15	21957	+	NM_008609	97876768	97896420	10
chr8	97944149	97958769	Cfap20	14620	-	NM_008187	97944563	97958471	6
chr8	97969995	98012720	Csnk2a2	42725	-	NM_009974	97977266	98012347	12
chr8	98057999	98082788	Ccdc113	24789	+	NM_172914	98058071	98082723	9
chr8	98083032	98099507	Prss54	16475	-	NM_001310539	98083191	98099097	6
chr8	98157458	98168959	Gins3	11501	+	NM_030198	98157497	98167237	3
chr8	98226936	98239019	Ndrg4	12083	+	NM_001195006	98227056	98237232	15
chr8	98239812	98242904	Setd6	3092	+	NM_001035123	98239836	98242681	7
chr8	98243350	98331362	Cnot1	88012	-	NM_178078	98244306	98312631	49
chr8	98277050	98277114	Mir7073	64	-	NR_106041	98277114	98277114	1
chr8	98330729	98345628	4930513N10Rik	14899	+	NR_015574	98345628	98345628	4
chr8	98359822	98377391	Slc38a7	17569	-	NM_172758	98361468	98372550	12
chr8	98388036	98412265	Got2	24229	-	NM_010325	98389028	98412205	10
chr8	101535786	101556641	Gm15679	20855	+	NR_110579	101556641	101556641	3
chr8	101548370	101940371	Cdh8	392001	-	NM_001285913	101548718	101924877	13
chr8	101940573	102257338	A330008L17Rik	316765	+	NR_132435	102257338	102257338	5
chr8	105155994	105309011	Cdh11	153017	-	NM_009866	105158213	105203739	13
chr8	105867777	105871434	1600027J07Rik	3657	-	NR_036588	105871434	105871434	3
chr8	106127698	106204282	4933400L20Rik	76584	+	NR_045730	106204282	106204282	5
chr8	106612815	106629773	Gm29682	16958	-	NR_131138	106629773	106629773	3
chr8	106625524	106668402	Cdh5	42878	+	NM_009868	106636798	106666898	12
chr8	106694412	106742997	Bean1	48585	+	NM_001141922	106705630	106741167	7
chr8	106750590	106772458	Tk2	21868	-	NM_021028	106752152	106772433	10
chr8	106774760	106788836	Cklf	14076	+	NM_001037841	106774917	106787413	3
chr8	106804941	106817081	Cmtm2a	12140	-	NM_027022	106805390	106816956	5
chr8	106817441	106834045	Cmtm1	16604	-	NM_181990	106817509	106833895	4
chr8	106846126	106854664	Cmtm2b	8538	+	NM_028524	106846254	106854542	4
chr8	106864493	106871572	Cmtm3	7079	+	NM_024217	106864648	106870666	5
chr8	106872092	106919707	Cmtm4	47615	-	NM_153582	106879026	106919536	4
chr8	106941573	106966947	Dync1li2	25374	-	NM_001013380	106944481	106966701	13
chr8	106970618	107033787	Ccdc79	63169	-	NM_180958	106971042	107031720	20
chr8	107034927	107058537	Nae1	23610	-	NM_144931	107035057	107058464	20
chr8	107058599	107074243	Car7	15644	+	NM_001301164	107067437	107073579	7
chr8	107115367	107120749	Pdp2	5382	+	NM_001024606	107117420	107119019	2
chr8	107125814	107148296	Cdh16	22482	-	NM_001252628	107126078	107147325	18
chr8	107151965	107155221	Rrad	3256	-	NM_019662	107152350	107154813	5
chr8	107163738	107165628	Fam96b	1890	-	NM_026753	107163888	107165590	5
chr8	107257902	107265534	Ces2a	7632	+	NM_133960	107257971	107265316	12
chr8	107319136	107322692	4932416K20Rik	3556	+	NM_001002775	107319162	107322327	1
chr8	107355543	107362552	Ces2b	7009	+	NM_198171	107355571	107362356	12
chr8	107370967	107378382	Ces2c	7415	+	NM_145603	107371032	107378164	12
chr8	107391323	107397982	Ces2d-ps	6659	+	NR_033726	107397982	107397982	12
chr8	107450159	107458572	Ces2e	8413	+	NM_001163756	107450220	107457614	13
chr8	107471255	107479862	Ces2f	8607	+	NM_001079865	107471278	107478616	13
chr8	107485617	107493437	Ces2g	7820	+	NM_197999	107485687	107492331	12
chr8	107524752	107544310	Ces2h	19558	+	NM_001272045	107524752	107544310	12
chr8	107572498	107582314	Ces3a	9816	+	NM_198672	107572520	107582003	13
chr8	107607654	107617491	Ces3b	9837	+	NM_144511	107607674	107617162	13
chr8	107655699	107674009	Ces4a	18310	+	NM_146213	107655851	107673420	14
chr8	107694573	107741888	Cbfb	47315	+	NM_022309	107694875	107739872	6
chr8	107749087	107776951	D230025D16Rik	27864	+	NM_145604	107749322	107775584	16
chr8	107776537	107779053	B3gnt9	2516	-	NM_178879	107777454	107778654	2
chr8	107782474	107788494	Tradd	6020	-	NM_001033161	107782884	107784572	5
chr8	107788547	107793226	Fbxl8	4679	+	NM_015821	107790913	107792882	3
chr8	107793700	107799745	Hsf4	6045	+	NM_001256042	107793773	107799558	13
chr8	107800346	107805839	Nol3	5493	+	NM_030152	107802875	107803802	4
chr8	107804308	107813428	4931428F04Rik	9120	-	NM_028888	107805879	107809713	8
chr8	107813823	107819998	Exoc3l	6175	-	NM_177788	107813860	107819559	14
chr8	107821562	107829270	E2f4	7708	+	NM_148952	107821640	107828588	10
chr8	107829500	107834523	Elmo3	5023	+	NM_172760	107829651	107833777	20
chr8	107832263	107832360	Mir328	97	-	NR_029761	107832360	107832360	1
chr8	107836239	107850176	Lrrc29	13937	-	NM_177449	107836676	107839089	5
chr8	107850263	107852957	Tmem208	2694	+	NM_025486	107850368	107852809	6
chr8	107853059	107871870	Fhod1	18811	-	NM_177699	107853296	107871753	22
chr8	107872157	107893781	Slc9a5	21624	+	NM_001081332	107873276	107892375	16
chr8	107899280	107906762	Plekhg4	7482	+	NM_001081333	107899280	107906141	21
chr8	107906706	107937402	Kctd19	30696	-	NM_177791	107906855	107937356	17
chr8	107937521	107987986	Lrrc36	50465	+	NM_001170788	107937540	107987868	14
chr8	107991391	107995322	Tppp3	3931	-	NM_026481	107991735	107992527	4
chr8	107996324	108020770	Zdhhc1	24446	-	NM_175160	107996500	108007683	14
chr8	108042645	108047888	Hsd11b2	5243	+	NM_008289	108042764	108047319	5
chr8	108048369	108089940	Atp6v0d1	41571	-	NM_013477	108048802	108089812	8
chr8	108090594	108103745	Agrp	13151	-	NM_001271806	108090655	108091389	5
chr8	108129128	108146118	Fam65a	16990	+	NM_001081241	108138321	108145802	22
chr8	108139365	108139473	Mir1966	108	+	NR_035492	108139473	108139473	1
chr8	108160437	108206822	Ctcf	46385	+	NM_181322	108187662	108205519	12
chr8	108214805	108222065	Rltpr	7260	+	NM_001033320	108215070	108222043	17
chr8	108222058	108224995	Acd	2937	-	NM_001012638	108222155	108224918	11
chr8	108225047	108227394	Pard6a	2347	+	NM_001047436	108225202	108227262	3
chr8	108227551	108232068	Enkd1	4517	-	NM_198299	108227760	108231808	8
chr8	108232202	108234068	4933405L10Rik	1866	+	NM_027655	108232331	108233997	4
chr8	108240012	108282507	Gfod2	42495	-	NM_027469	108240651	108252146	3
chr8	108292207	108351250	Ranbp10	59043	-	NM_145824	108295486	108351168	14
chr8	108351643	108368576	Tsnaxip1	16933	+	NM_024445	108351686	108368524	16
chr8	108368577	108375908	Cenpt	7331	-	NM_177150	108368771	108375883	13
chr8	108379002	108380850	Thap11	1848	+	NM_021513	108379260	108380178	1
chr8	108384533	108404301	Nutf2	19768	+	NM_026532	108399459	108402818	5
chr8	108384559	108403237	Nutf2-ps1	18678	+	NR_033574	108403237	108403237	5
chr8	108404780	108417125	Edc4	12345	+	NM_001301100	108404976	108416762	29
chr8	108417466	108418923	Nrn1l	1457	+	NM_001301174	108417479	108418808	3
chr8	108424373	108455702	Pskh1	31329	+	NM_173432	108436589	108453868	3
chr8	108455893	108457762	Ctrl	1869	-	NM_023182	108455954	108457730	7
chr8	108459627	108462292	Psmb10	2665	-	NM_013640	108459693	108461910	8
chr8	108463450	108467302	Lcat	3852	-	NM_008490	108463471	108467278	6
chr8	108467489	108490015	Slc12a4	22526	-	NM_001253804	108467981	108489939	24
chr8	108475536	108475599	Mir7074	63	-	NR_106042	108475599	108475599	1
chr8	108497419	108503319	Dpep3	5900	-	NM_027960	108497490	108503191	10
chr8	108508845	108520323	Dpep2	11478	-	NM_176913	108508956	108520294	12
chr8	108533515	108535386	Ddx28	1871	-	NM_028038	108533701	108535324	1
chr8	108535377	108577740	Dus2	42363	+	NM_025518	108539739	108577429	16
chr8	108583502	108654437	Nfatc3	70935	+	NM_010901	108583790	108651942	10
chr8	108655082	108660874	Esrp2	5792	-	NM_176838	108655393	108660667	15
chr8	108659299	108662622	1810019D21Rik	3323	+	NR_040344	108662622	108662622	5
chr8	108674298	108688615	Pla2g15	14317	+	NM_133792	108674386	108687236	6
chr8	108692774	108722604	Slc7a6	29830	+	NM_178798	108703037	108720538	10
chr8	108724337	108734833	Slc7a6os	10496	-	NM_001007567	108724921	108734813	5
chr8	108734953	108775594	Prmt7	40641	+	NM_145404	108736376	108775549	18
chr8	108776447	108861888	Smpd3	85441	-	NM_021491	108779158	108789819	9
chr8	108806128	108859654	4930506A18Rik	53526	+	NR_126090	108859654	108859654	4
chr8	108939238	108949789	Zfp90	10551	+	NM_011764	108939637	108949467	4
chr8	109034751	109080811	Cdh3	46060	+	NM_001037809	109034858	109079350	16
chr8	109111042	109118720	1110028F18Rik	7678	+	NR_045470	109118720	109118720	3
chr8	109127249	109194147	Cdh1	66898	+	NM_009864	109127394	109192515	16
chr8	109206967	109375339	Tango6	168372	+	NM_173037	109207052	109374255	18
chr8	109394141	109406802	Has3	12661	+	NM_008217	109397807	109402728	4
chr8	109407762	109417493	Chtf8	9731	-	NM_145412	109410201	109411223	4
chr8	109417539	109446994	Cirh1a	29455	+	NM_011574	109418492	109446881	17
chr8	109459649	109538092	Sntb2	78443	+	NM_009229	109459701	109535284	7
chr8	109555225	109569656	Vps4a	14431	+	NM_126165	109555370	109569040	11
chr8	109570189	109572514	Pdf	2325	-	NM_026513	109571013	109572498	2
chr8	109572608	109580637	Cog8	8029	-	NM_139229	109572707	109580555	5
chr8	109580776	109584828	Nip7	4052	+	NM_025391	109580834	109582396	5
chr8	109585383	109589544	Tmed6	4161	-	NM_025458	109585493	109589511	4
chr8	109593301	109620445	Terf2	27144	-	NR_104410	109620445	109620445	11
chr8	109619924	109620006	Mir7075	82	-	NR_106043	109620006	109620006	1
chr8	109674560	109711370	Cyb5b	36810	+	NM_025558	109674611	109707568	5
chr8	109780063	109983274	Mir5098	203211	+	NR_039557	109983274	109983274	4
chr8	109817369	109903417	Nfat5	86048	+	NM_133957	109862737	109894553	16
chr8	109912124	109927105	Nqo1	14981	-	NM_008706	109912718	109926972	6
chr8	109936388	109948938	Nob1	12550	-	NM_026277	109936813	109948928	9
chr8	109960297	110082495	Wwp2	122198	+	NM_025830	109976893	110080886	24
chr8	110075143	110075213	Mir140	70	+	NR_029553	110075213	110075213	1
chr8	110104279	110112382	Psmd7	8103	-	NM_010817	110104783	110112252	7
chr8	111077151	111108577	Lncbate1	31426	-	NR_077224	111108577	111108577	2
chr8	111238543	111485536	Zfhx3	246993	+	NM_007496	111316147	111481002	10
chr8	111460759	111460838	Mir3108	79	+	NR_037295	111460838	111460838	1
chr8	111599121	111777539	D030068K23Rik	178418	+	NR_126329	111777539	111777539	10
chr8	111863699	111864808	Gm1943	1109	-	NR_002928	111864808	111864808	1
chr8	112017926	112066542	Pmfbp1	48616	+	NM_019938	112018804	112066304	21
chr8	112071923	112089501	Dhx38	17578	-	NM_178380	112072298	112086666	27
chr8	112089885	112097951	Txnl4b	8066	+	NM_175646	112092865	112096759	4
chr8	112099027	112103072	Hp	4045	-	NM_017370	112099170	112102914	5
chr8	112117147	112132573	Dhodh	15426	-	NM_020046	112117976	112132272	9
chr8	112138416	112196492	Pkd1l3	58076	+	NM_001039700	112138416	112196492	34
chr8	112195220	112217194	Ist1	21974	-	NM_028018	112196347	112207663	10
chr8	112229445	112248832	Zfp821	19387	+	NM_001167946	112233387	112248518	9
chr8	112250350	112261639	Atxn1l	11289	-	NM_001080930	112255464	112257528	4
chr8	112302482	112388109	Ap1g1	85627	+	NM_009677	112326849	112384095	24
chr8	112363211	112363275	Snord71	64	+	NR_028532	112363275	112363275	1
chr8	112392502	112468571	Phlpp2	76069	+	NM_001122594	112392518	112464808	19
chr8	112471808	112486105	Marveld3	14297	-	NM_212447	112471924	112486007	3
chr8	112514335	112523704	Tat	9369	+	NM_146214	112515384	112522789	12
chr8	112552974	112563234	Chst4	10260	-	NM_011998	112553713	112554880	2
chr8	112571331	112581076	8030455M16Rik	9745	+	NR_131069	112581076	112581076	3
chr8	112603633	112616652	Zfp612	13019	+	NM_175480	112606618	112614081	5
chr8	112666437	112692106	Calb2	25669	-	NM_007586	112666983	112692037	11
chr8	112741859	112748389	Cmtr2	6530	+	NM_146215	112744959	112747263	2
chr8	112790876	113134153	Hydin	343277	+	NM_172916	112791235	113133957	87
chr8	113019265	113026256	Gm21283	6991	-	NR_105058	113026256	113026256	3
chr8	113142537	113244299	Vac14	101762	+	NM_146216	113142789	113243869	19
chr8	113245375	113265301	Mtss1l	19926	+	NM_198625	113245621	113262977	14
chr8	113265728	113329824	Il34	64096	-	NM_029646	113266344	113279158	8
chr8	113334391	113370703	Sf3b3	36312	-	NM_133953	113334840	113368432	26
chr8	113362434	113362498	Snord111	64	-	NR_028559	113362498	113362498	1
chr8	113370499	113406134	Cog4	35635	+	NM_001310607	113373827	113405765	19
chr8	113406355	113426388	Fuk	20033	-	NM_172283	113406866	113423814	24
chr8	113443764	113496397	St3gal2	52633	+	NM_009179	113481611	113494175	7
chr8	113498890	113521723	Ddx19a	22833	-	NM_007916	113499928	113521623	12
chr8	113527085	113555651	Ddx19b	28566	-	NM_001190786	113532149	113555623	12
chr8	113540349	113540430	Mir3473d	81	-	NR_039583	113540430	113540430	1
chr8	113557741	113579469	Aars	21728	+	NM_146217	113560829	113579104	21
chr8	113580238	113581564	Exosc6	1326	+	NM_028274	113580270	113581092	1
chr8	113593396	113605608	Clec18a	12212	-	NM_181549	113593789	113605541	12
chr8	113618644	113659044	Pdpr	40400	+	NM_198308	113625766	113658912	18
chr8	113651343	113669398	9430091E24Rik	18055	-	NR_040363	113669398	113669398	4
chr8	113681457	113783102	Glg1	101645	-	NM_009149	113681793	113783096	26
chr8	113794843	113824122	Rfwd3	29279	-	NM_146218	113796919	113824080	13
chr8	113835697	113862105	Mlkl	26408	-	NM_001310613	113835924	113857652	11
chr8	113869037	113917721	Fa2h	48684	-	NM_178086	113870341	113917652	7
chr8	113972683	114046007	Wdr59	73324	-	NM_001170743	113974743	114045881	27
chr8	113974099	113974222	Mir1957b	123	+	NR_105819	113974222	113974222	1
chr8	114060539	114149930	Znrf1	89391	+	NM_001168621	114061040	114145553	5
chr8	114150170	114154222	Ldhd	4052	-	NM_027570	114150924	114154210	11
chr8	114167342	114194911	Zfp1	27569	+	NM_011742	114182326	114194460	4
chr8	114210409	114214910	Ctrb1	4501	-	NM_025583	114210486	114214892	7
chr8	114213500	114213574	Mir7076	74	-	NR_106044	114213574	114213574	1
chr8	114234374	114267749	Bcar1	33375	-	NM_009954	114234781	114267600	7
chr8	114292372	114378210	Cfdp1	85838	-	NM_011801	114292596	114378107	7
chr8	114388797	114400575	Tmem170	11778	-	NM_025781	114390265	114400535	3
chr8	114413034	114434099	Chst5	21065	-	NM_019950	114413698	114414886	2
chr8	114435917	114457691	Tmem231	21774	-	NM_001033321	114437831	114457666	7
chr8	114464602	114476815	Gabarapl2	12213	+	NM_026693	114464718	114476305	4
chr8	114490807	114516202	Adat1	25395	-	NM_013925	114492305	114514273	10
chr8	114517338	114535254	Kars	17916	-	NM_001286384	114517507	114532252	16
chr8	114535258	114544428	Terf2ip	9170	+	NM_020584	114535381	114542134	3
chr8	115078516	115093475	Gm26994	14959	-	NR_132433	115093475	115093475	6
chr8	115093942	115406607	Cntnap4	312665	+	NM_130457	115094034	115405782	24
chr8	115591161	115617233	Gm10280	26072	+	NR_033584	115617233	115617233	4
chr8	116041181	116074708	4930571O06Rik	33527	+	NR_110476	116074708	116074708	3
chr8	116159485	116169092	Mon1b	9607	+	NM_001048143	116160021	116166030	6
chr8	116167112	116179433	Syce1l	12321	+	NM_029139	116167136	116179058	12
chr8	116222036	116372739	Adamts18	150703	-	NM_172466	116222868	116372376	23
chr8	116657473	116676212	Nudt7	18739	+	NM_024446	116657565	116675916	4
chr8	116729539	116897970	Vat1l	168431	+	NM_173016	116729615	116895645	9
chr8	116865060	116875378	4933408N05Rik	10318	-	NR_045831	116875378	116875378	3
chr8	116941933	116952033	Clec3a	10100	+	NM_001007223	116941985	116949746	3
chr8	116963551	117876612	Wwox	913061	+	NM_019573	116963671	117875726	9
chr8	118227152	118230794	Maf	3642	-	NM_001025577	118229650	118230763	1
chr8	119028914	119039815	Dynlrb2	10901	+	NM_029297	119028946	119039623	4
chr8	119092623	119256891	Cdyl2	164268	-	NM_029441	119099028	119256721	7
chr8	119305611	119325312	4930563M20Rik	19701	-	NR_046193	119325312	119325312	4
chr8	119412584	119445336	Cmc2	32752	-	NM_026844	119413672	119435108	4
chr8	119445639	119465403	Cenpn	19764	+	NM_028131	119449991	119464817	12
chr8	119467292	119484345	Atmin	17053	+	NM_177700	119467326	119481959	4
chr8	119493498	119502843	1700030J22Rik	9345	-	NM_027103	119495036	119497561	3
chr8	119505727	119517349	Gcsh	11622	-	NM_026572	119506528	119517326	5
chr8	119519578	119606349	Pkd1l2	86771	-	NM_029686	119519578	119606349	43
chr8	119619764	119657620	Bco1	37856	+	NM_001163028	119619930	119655118	12
chr8	119682034	119729086	Gan	47052	+	NM_001081151	119682034	119728228	11
chr8	119780918	119985405	Cmip	204487	+	NM_001163262	119781001	119983282	21
chr8	119976922	119976979	Mir7077	57	+	NR_106045	119976979	119976979	1
chr8	119983164	119983228	Mir7078	64	+	NR_106046	119983228	119983228	1
chr8	120022174	120159042	Plcg2	136868	+	NM_172285	120028080	120158727	33
chr8	120185298	120195415	Sdr42e1	10117	-	NM_028725	120186615	120188954	3
chr8	120205521	120217098	Gm38416	11577	+	NR_131057	120217098	120217098	8
chr8	120225845	120282929	Hsd17b2	57084	+	NM_008290	120225895	120282845	5
chr8	120315544	120325829	Mphosph6	10285	-	NM_026758	120316085	120325802	5
chr8	120807510	121848827	Cdh13	1041317	+	NM_019707	120807753	121847302	14
chr8	121868437	121872829	Hsbp1	4392	+	NM_024219	121868475	121869631	4
chr8	121918791	121934988	Mlycd	16197	+	NM_019966	121918845	121934421	5
chr8	121961061	121970156	Osgin1	9095	+	NM_027950	121965335	121969805	6
chr8	121970618	121996535	Necab2	25917	+	NM_054095	121970954	121996070	13
chr8	122003502	122025598	Slc38a8	22096	-	NM_001009950	122004648	122025089	11
chr8	122032051	122082661	Mbtps1	50610	-	NM_019709	122032678	122071462	24
chr8	122085877	122099100	Hsdl1	13223	-	NM_175185	122087938	122091885	5
chr8	122099134	122122354	Dnaaf1	23220	+	NM_026648	122099261	122121565	12
chr8	122121873	122129140	Taf1c	7267	-	NM_021441	122122510	122128277	15
chr8	122136646	122140826	Adad2	4180	+	NM_029428	122136680	122140618	10
chr8	122147753	122159580	Kcng4	11827	-	NM_025734	122149548	122157535	3
chr8	122190264	122211920	Wfdc1	21656	+	NM_023395	122190440	122210219	7
chr8	122223908	122281618	Atp2c2	57710	+	NM_026922	122224064	122281386	27
chr8	122284486	122302316	Tldc1	17830	-	NM_028883	122285613	122297318	8
chr8	122333113	122364479	Cotl1	31366	-	NM_028071	122334144	122364300	4
chr8	122386204	122400889	Klhl36	14685	+	NM_146219	122388919	122400749	5
chr8	122434259	122481459	Usp10	47200	+	NM_001310630	122434818	122480670	14
chr8	122516337	122576694	Crispld2	60357	+	NM_030209	122534411	122574237	15
chr8	122604994	122625372	Zdhhc7	20378	-	NM_133967	122606439	122611968	8
chr8	122638051	122689207	6430548M08Rik	51156	+	NM_172286	122669234	122685164	13
chr8	122690296	122701369	Fam92b	11073	-	NM_001033980	122690471	122701233	8
chr8	122728333	122752130	A330074K22Rik	23797	-	NR_110496	122752130	122752130	3
chr8	123012765	123105283	Gse1	92518	+	NM_198671	123013014	123102503	16
chr8	123062595	123062654	Mir7687	59	+	NR_106159	123062654	123062654	1
chr8	123105165	123112975	Gins2	7810	-	NM_178856	123105585	123112915	5
chr8	123132499	123192042	Emc8-1190005i06rik	59543	-	NM_001308449	123132871	123191878	4
chr8	123132501	123158282	1190005I06Rik	25781	-	NM_197988	123132871	123158254	4
chr8	123177813	123192012	Emc8	14199	-	NM_010926	123181988	123191878	5
chr8	123192124	123198109	Cox4i1	5985	+	NM_009941	123192145	123198007	5
chr8	123260257	123280592	Irf8	20335	+	NM_008320	123263717	123279075	9
chr8	123578781	123607010	Fendrr	28229	-	NR_045471	123607010	123607010	6
chr8	123608285	123612054	Foxf1	3769	+	NM_010426	123608298	123610779	2
chr8	123621456	123632279	Mthfsd	10823	-	NM_001166482	123622611	123632203	9
chr8	123640070	123642794	Foxc2	2724	+	NM_013519	123640514	123641999	1
chr8	123651584	123654544	Foxl1	2960	+	NM_008024	123651861	123652872	1
chr8	124054683	124065854	1700018B08Rik	11171	-	NM_029597	124054922	124065655	7
chr8	124068287	124071552	1700030M09Rik	3265	+	NR_045903	124071552	124071552	3
chr8	124073342	124102706	Fbxo31	29364	-	NM_133765	124076122	124102655	9
chr8	124114367	124121947	Map1lc3b	7580	+	NM_026160	124114424	124120670	4
chr8	124122602	124175833	Zcchc14	53231	-	NM_080855	124126175	124175801	13
chr8	124254458	124314983	Jph3	60525	+	NM_020605	124254522	124313379	5
chr8	124320207	124353469	Klhdc4	33262	-	NM_145605	124320446	124353380	12
chr8	124405045	124431586	Slc7a5	26541	-	NM_011404	124406939	124431506	10
chr8	124431732	124442328	BC048644	10596	+	NM_001033485	124440961	124441654	2
chr8	124440043	124468812	Car5a	28769	-	NM_007608	124440263	124468693	7
chr8	124474391	124553160	Banp	78769	+	NM_001110100	124498395	124549535	14
chr8	124501923	124501986	Mir7237	63	+	NR_106096	124501986	124501986	1
chr8	124806040	124861147	Zfpm1	55107	+	NM_009569	124806382	124861091	10
chr8	124880866	124884646	Trhr2	3780	-	NM_133202	124881010	124884599	3
chr8	124900508	124941265	Zc3h18	40757	+	NM_001310650	124907313	124940574	18
chr8	124945984	124947539	Il17c	1555	+	NM_145834	124945984	124947468	2
chr8	124948670	124956840	Cyba	8170	-	NM_007806	124948777	124956767	6
chr8	124957495	124967322	Mvd	9827	-	NR_028354	124967322	124967322	11
chr8	124967555	124970376	9330133O14Rik	2821	+	NR_045696	124970376	124970376	1
chr8	124969167	124975222	Gm20735	6055	-	NR_015497	124975222	124975222	3
chr8	124978105	124984592	Snai3	6487	-	NM_013914	124978752	124984514	3
chr8	124990046	124999964	Rnf166	9918	-	NM_001033142	124991068	124999917	6
chr8	125000042	125006992	Ctu2	6950	+	NM_153775	125000127	125005556	15
chr8	125005597	125075229	Piezo1	69632	-	NM_001037298	125005881	125074938	51
chr8	125091914	125097030	Cdt1	5116	+	NM_026014	125091955	125096554	10
chr8	125098536	125100807	Aprt	2271	-	NM_009698	125098784	125100732	5
chr8	125102136	125135387	Galns	33251	-	NM_016722	125103010	125135238	14
chr8	125135525	125139491	Trappc2l	3966	+	NM_021502	125135560	125139336	5
chr8	125143370	125146635	Pabpn1l	3265	-	NM_001007462	125143633	125146576	7
chr8	125146164	125146275	Mir6396	111	-	NR_105821	125146275	125146275	1
chr8	125149035	125223009	Cbfa2t3	73974	-	NM_009824	125154606	125222793	12
chr8	125299404	125341781	Acsf3	42377	+	NM_144932	125303869	125341436	10
chr8	125372273	125391297	Cdh15	19024	+	NM_007662	125372387	125390923	14
chr8	125407721	125566184	Ankrd11	158463	-	NR_037865	125566184	125566184	14
chr8	125566474	125568502	2810013P06Rik	2028	+	NR_045268	125568502	125568502	1
chr8	125589407	125621651	Spg7	32244	+	NM_153176	125589426	125621458	17
chr8	125626249	125629142	Rpl13	2893	+	NM_016738	125626558	125629102	6
chr8	125626957	125627005	Snord68	48	+	NR_028128	125627005	125627005	1
chr8	125628874	125628943	Mir7079	69	+	NR_106047	125628943	125628943	1
chr8	125641273	125659085	Cpne7	17812	+	NM_170684	125641396	125658477	15
chr8	125654005	125654072	Mir7080	67	+	NR_106048	125654072	125654072	1
chr8	125666746	125682180	Sult5a1	15434	-	NM_020564	125666930	125681480	7
chr8	125710134	125725713	Dpep1	15579	+	NM_007876	125717982	125724959	11
chr8	125728160	125736688	Chmp1a	8528	-	NM_145606	125729624	125736572	7
chr8	125736757	125745945	Spata33	9188	+	NM_177279	125736860	125745929	3
chr8	125748740	125756156	Cdk10	7416	+	NM_194446	125748781	125755631	13
chr8	125756157	125760109	Spata2l	3952	-	NM_030176	125757167	125759720	3
chr8	125758990	125766259	4933417D19Rik	7269	+	NR_045849	125766259	125766259	3
chr8	125766255	125778122	Vps9d1	11867	-	NM_001310661	125766995	125777986	15
chr8	125778094	125794451	Zfp276	16357	+	NM_020497	125778615	125791940	11
chr8	125792143	125842476	Fanca	50333	-	NM_016925	125792341	125842453	43
chr8	125856612	125893418	Spire2	36806	+	NM_172287	125856664	125893294	15
chr8	125897610	125928074	Tcf25	30464	+	NM_001037877	125897772	125927055	18
chr8	125930981	125934647	Mc1r	3666	+	NM_008559	125931409	125932357	1
chr8	125935463	125945910	Tubb3	10447	+	NM_023279	125935505	125945582	4
chr8	125966855	125987799	Def8	20944	+	NM_001253783	125970069	125985466	14
chr8	126001761	126027816	Afg3l1	26055	+	NM_054070	126001809	126025966	17
chr8	126028617	126039355	Dbndd1	10738	-	NM_001170976	126029580	126039265	3
chr8	126042734	126060550	Gas8	17816	+	NM_018855	126042849	126060422	11
chr8	126062683	126062804	Gm25018	121	-	NR_046127	126062804	126062804	1
chr8	126074564	126074685	Gm23284	121	-	NR_046155	126074685	126074685	1
chr8	126076261	126076382	Gm22109	121	-	NR_046147	126076382	126076382	1
chr8	126076261	126076382	Gm26391	121	-	NR_046140	126076382	126076382	1
chr8	126081387	126081508	Gm22291	121	-	NR_046154	126081508	126081508	1
chr8	126081387	126081508	Gm25212	121	-	NR_046152	126081508	126081508	1
chr8	126177828	126187780	Rhou	9952	+	NM_133955	126177845	126185216	3
chr8	126257857	126263841	6030466F02Rik	5984	+	NR_040702	126263841	126263841	4
chr8	126329895	126359191	Rab4a	29296	+	NM_009003	126330035	126358030	8
chr8	126364743	126384109	Ccsap	19366	-	NM_028536	126366241	126383310	4
chr8	126415657	126418675	Acta1	3018	-	NM_001272041	126415908	126417597	8
chr8	126421022	126473165	Nup133	52143	-	NM_172288	126423273	126473076	26
chr8	126476358	126507022	Abcb10	30664	-	NM_019552	126478207	126506713	13
chr8	126520215	126545209	Taf5l	24994	-	NM_133966	126521208	126533730	5
chr8	126546540	126546622	Mir1967	82	+	NR_035493	126546622	126546622	1
chr8	126547372	126572404	Urb2	25032	+	NM_001029876	126547372	126571206	9
chr8	126755293	126869622	Galnt2	114329	+	NM_139272	126755426	126867358	16
chr8	126892948	126957836	Pgbd5	64888	-	NM_171824	126894390	126908508	7
chr8	127044666	127075907	Cog2	31241	+	NM_029746	127044779	127075392	18
chr8	127080486	127093607	Agt	13121	-	NM_007428	127080829	127088466	5
chr8	127100010	127142631	Capn9	42621	+	NM_023709	127100044	127142408	20
chr8	127159655	127187269	2310022B05Rik	27614	-	NM_175149	127161807	127187083	4
chr8	127195226	127245875	Ttc13	50649	-	NM_145607	127195982	127245862	18
chr8	127246038	127258023	Arv1	11985	+	NM_026855	127246083	127255839	6
chr8	127264156	127275709	Fam89a	11553	-	NM_001081120	127264943	127275709	2
chr8	127316918	127358604	Trim67	41686	+	NM_198632	127317800	127352985	10
chr8	127363254	127386929	2810004N23Rik	23675	-	NM_025615	127363733	127386872	7
chr8	127386932	127413957	Gnpat	27025	+	NM_010322	127387137	127413215	16
chr8	127414198	127421605	Exoc8	7407	-	NM_198103	127419375	127421526	1
chr8	127421785	127427713	Sprtn	5928	+	NM_001111141	127422057	127427363	5
chr8	127432486	127473154	Egln1	40668	-	NM_053207	127434607	127472954	5
chr8	127536896	127558092	Tsnax	21196	+	NM_016909	127537096	127556774	6
chr8	127578094	127785051	Disc1	206957	+	NM_174854	127578129	127785048	13
chr8	127941962	128016610	Sipa1l2	74648	-	NM_001081337	127943044	128016496	21
chr8	128108537	128140570	4930567H12Rik	32033	+	NR_015535	128140570	128140570	3
chr8	128193717	128197265	Map10	3548	+	NM_028908	128193769	128196445	1
chr8	128258102	128272135	Ntpcr	14033	+	NM_025636	128258215	128271666	5
chr8	128275407	128422217	Pcnxl2	146810	-	NM_175561	128276038	128421981	34
chr8	128434349	128471339	BC021891	36990	+	NM_145608	128434576	128468883	10
chr8	128519001	128554585	Kcnk1	35584	+	NM_008430	128519359	128553651	3
chr8	128822478	128919877	Slc35f3	97399	+	NM_175434	128822685	128918567	7
chr8	128946400	128949335	Coa6	2935	+	NM_174987	128946586	128948998	2
chr8	128950551	128998965	Gm17296	48414	-	NM_001159907	128950871	128998965	30
chr8	129112195	129117336	Irf2bp2	5141	-	NM_001164598	129115012	129117336	2
chr8	129454563	129469821	Tomm20	15258	-	NM_024214	129458914	129469624	5
chr8	129471072	129494979	Rbm34	23907	-	NM_172762	129473134	129494939	11
chr8	129587955	130136186	Pard3	548231	+	NM_033620	129588253	130134674	25
chr8	130802047	130802125	Mir21c	78	-	NR_105822	130802125	130802125	1
chr8	130882972	131029375	Nrp1	146403	+	NM_008737	130883459	131026714	17
chr8	130883140	130883220	Mir1903	80	+	NR_035436	130883220	130883220	1
chr8	131209553	131257479	Itgb1	47926	+	NM_010578	131229312	131255988	16
chr8	131503918	131589392	Ccdc7a	85474	-	NM_029061	131503930	131585746	14
chr8	131591033	131707632	Ccdc7b	116599	+	NM_001168369	131596343	131707518	15
chr8_random	17590	30203	LOC664787	12613	-	NR_131980	30203	30203	7
chr8_random	111571	163011	Csprs	51440	-	NM_033616	113162	114053	2
chr8_random	311631	316688	Defb33	5057	-	NM_001039119	311717	314229	3
chr8_random	320241	332856	Gm21944	12615	-	NR_002880	332856	332856	2
chr8_random	689551	717784	Gm21119	28233	-	NM_001270553	690842	717614	10
chr9	3038668	3038743	Mir101c	75	-	NR_039546	3038743	3038743	1
chr9	3190268	3199813	4930433N12Rik	9545	-	NR_027988	3199813	3199813	5
chr9	3335230	3385846	Alkbh8	50616	+	NM_026303	3338462	3385599	12
chr9	3404084	3479236	Cwf19l2	75152	+	NM_027545	3404097	3477960	18
chr9	3532348	3905787	Gucy1a2	373439	+	NM_001033322	3532802	3894711	8
chr9	4294792	4309494	Aasdhppt	14702	-	NM_026276	4296674	4309436	6
chr9	4309742	4331732	Kbtbd3	21990	+	NM_001164574	4316850	4331451	3
chr9	4383536	4386869	Msantd4	3333	+	NM_145609	4383680	4385314	2
chr9	4417892	4796234	Gria4	378342	-	NM_001113180	4420151	4795274	17
chr9	5298516	5307281	Casp1	8765	+	NM_009807	5298716	5306768	10
chr9	5308848	5336791	Casp4	27943	+	NM_007609	5308907	5336094	9
chr9	5345475	5373034	Casp12	27559	+	NM_009808	5345518	5358823	11
chr9	6168611	6377519	Pdgfd	208908	+	NM_027924	6168794	6377020	7
chr9	6265027	6266547	Ddi1	1520	-	NM_027942	6265140	6266367	1
chr9	6928502	7177046	Dync2h1	248544	-	NM_029851	6929464	7176957	89
chr9	7184565	7207031	Dcun1d5	22466	+	NM_029775	7184796	7206775	8
chr9	7272513	7283333	Mmp13	10820	+	NM_008607	7272554	7282118	10
chr9	7347373	7360461	Mmp12	13088	+	NM_008605	7347424	7358327	10
chr9	7367669	7388026	Mmp1b	20357	-	NM_032007	7368240	7387992	10
chr9	7445821	7455974	Mmp3	10153	+	NM_010809	7445897	7455690	10
chr9	7464140	7476869	Mmp1a	12729	+	NM_032006	7464196	7476295	10
chr9	7502341	7510242	Mmp10	7901	+	NM_019471	7502393	7509991	10
chr9	7558428	7568486	Mmp8	10058	+	NM_008611	7558535	7567538	10
chr9	7571395	7581885	Mmp27	10490	+	NM_001310717	7571457	7581393	10
chr9	7628230	7674968	Mmp20	46738	+	NM_013903	7628252	7673163	10
chr9	7669428	7695631	AV064505	26203	-	NR_126562	7695631	7695631	4
chr9	7692110	7699416	Mmp7	7306	+	NM_010810	7692125	7699357	6
chr9	7764076	7794332	Tmem123	30256	+	NM_133739	7764221	7792195	5
chr9	7784389	7784440	Mir5618	51	+	NR_049191	7784440	7784440	1
chr9	7818225	7837057	Birc2	18832	-	NM_007465	7818749	7834478	8
chr9	7848700	7873170	Birc3	24470	-	NM_007464	7849262	7861315	9
chr9	7932000	8004596	Yap1	72596	-	NM_001171147	7934496	8004390	9
chr9	8021671	8042823	9230110C19Rik	21152	-	NM_199017	8022415	8042779	7
chr9	8076632	8134294	Cep126	57662	-	NM_001045524	8076883	8134210	11
chr9	8221888	8241987	1700128F08Rik	20099	+	NR_033618	8241987	8241987	3
chr9	8246785	8246881	Mir1899	96	+	NR_035437	8246881	8246881	1
chr9	8544141	8680741	Trpc6	136600	+	NM_013838	8544431	8680565	13
chr9	8644077	8740988	Gm32014	96911	-	NR_110513	8740988	8740988	5
chr9	8899832	8968611	Pgr	68779	+	NM_008829	8900467	8965138	8
chr9	8994952	9239013	Arhgap42	244061	-	NM_027823	8997596	9238779	23
chr9	9236287	9260885	Gm16833	24598	+	NR_045754	9260885	9260885	4
chr9	9660890	10904775	Cntn5	1243885	-	NM_001170787	9661362	10419090	25
chr9	9894430	9894521	Mir6237	91	+	NR_105745	9894521	9894521	1
chr9	13091266	13105855	4930568E12Rik	14589	-	NR_040755	13105855	13105855	4
chr9	13234580	13235960	Phxr4	1380	+	NR_028271	13235960	13235960	1
chr9	13424432	13513977	Maml2	89545	+	NM_001013813	13424432	13511048	4
chr9	13553624	13610925	Mtmr2	57301	+	NR_024025	13610925	13610925	16
chr9	13612226	13631551	Cep57	19325	-	NM_001310721	13613050	13631344	10
chr9	13632170	13650966	Fam76b	18796	+	NM_176836	13632418	13648562	10
chr9	14080744	14130578	Sesn3	49834	+	NM_030261	14080995	14130150	10
chr9	14158433	14185686	Endod1	27253	-	NM_028013	14161125	14185414	2
chr9	14267024	14304926	Kdm4d	37902	-	NM_173433	14267471	14269004	2
chr9	14305062	14315064	Cwc15	10002	+	NM_023153	14306367	14314773	7
chr9	14346410	14419444	Amotl1	73034	-	NM_001081395	14352235	14419226	13
chr9	14506801	14545177	Piwil4	38376	-	NM_177905	14506801	14545177	19
chr9	14552902	14556566	Fut4	3664	-	NM_010242	14555138	14556440	1
chr9	14562637	14575474	1700012B09Rik	12837	-	NM_029306	14562894	14575412	4
chr9	14584641	14587408	Ankrd49	2767	-	NM_019683	14585593	14587313	2
chr9	14589097	14641571	Mre11a	52474	+	NM_018736	14589952	14638107	20
chr9	14664653	14675233	Gpr83	10580	+	NM_010287	14664977	14673243	4
chr9	14690257	14708395	Izumo1r	18138	-	NM_176807	14690735	14706964	5
chr9	14810228	14849922	Panx1	39694	-	NM_019482	14810581	14849481	5
chr9	14856284	14916552	Hephl1	60268	-	NM_001164797	14858061	14916548	20
chr9	15043488	15063857	Vstm5	20369	+	NM_026955	15043714	15062695	4
chr9	15064794	15084311	Med17	19517	-	NM_144933	15066670	15084237	12
chr9	15087780	15110892	4931406C07Rik	23112	-	NM_001199484	15089261	15105865	9
chr9	15110657	15121441	Taf1d	10784	+	NR_028401	15121441	15121441	12
chr9	15117054	15117113	Gm25500	59	+	NR_106108	15117113	15117113	1
chr9	15121357	15162232	Cep295	40875	-	NM_176976	15121540	15162187	27
chr9	15130732	15130774	Scarna9	42	-	NR_028568	15130774	15130774	1
chr9	15309938	15349703	Smco4	39765	+	NM_133214	15349063	15349243	3
chr9	15364307	15432377	Ccdc67	68070	-	NM_181816	15365652	15431126	12
chr9	15424300	15445664	4930540M03Rik	21364	+	NR_040746	15445664	15445664	5
chr9	15514212	15543233	Slc36a4	29021	+	NM_172289	15514235	15542822	11
chr9	15667057	15679000	Mtnr1b	11943	-	NM_145712	15667110	15678904	2
chr9	15714636	16182675	Fat3	468039	-	NM_001080814	15719442	16182669	25
chr9	18096710	18118444	Chordc1	21734	+	NM_025844	18096840	18117365	11
chr9	18127464	18190372	Naalad2	62908	-	NM_028279	18127877	18190318	19
chr9	18208861	18215946	Ubtfl1	7085	+	NM_001033793	18213621	18214806	3
chr9	18235058	18250760	Mbd3l2	15702	+	NM_144934	18248042	18249511	3
chr9	18258497	18278003	Zfp558	19506	-	NM_028935	18260710	18273753	8
chr9	18282838	18289736	Mbd3l1	6898	+	NM_028557	18289024	18289585	3
chr9	18559135	18560077	Olfr24	942	-	NM_146606	18559135	18560077	1
chr9	18619797	18620736	Olfr828	939	-	NM_146605	18619797	18620736	1
chr9	18661070	18662036	Olfr829	966	+	NM_147067	18661070	18662036	1
chr9	18679772	18680720	Olfr830	948	+	NM_146566	18679772	18680720	1
chr9	18749093	18750032	Olfr832	939	+	NM_001011824	18749093	18750032	1
chr9	18792433	18793372	Olfr834	939	+	NM_001011823	18792433	18793372	1
chr9	18839568	18840504	Olfr835	936	+	NM_001012266	18839568	18840504	1
chr9	18925400	18926355	Olfr836	955	+	NM_146564	18925400	18926354	1
chr9	18941371	18942411	Olfr837	1040	+	NM_146565	18941438	18942377	1
chr9	19052800	19053907	Olfr843	1107	-	NM_146567	19052899	19053841	1
chr9	19142902	19143844	Olfr845	942	+	NM_207145	19142905	19143844	1
chr9	19164858	19165800	Olfr846	942	-	NM_146282	19164858	19165797	1
chr9	19179384	19180323	Olfr847	939	-	NM_146525	19179384	19180323	1
chr9	19245358	19246297	Olfr849	939	+	NM_146527	19245358	19246297	1
chr9	19281744	19282692	Olfr850	948	-	NM_146523	19281744	19282692	1
chr9	19301193	19302132	Olfr851	939	+	NM_146905	19301193	19302132	1
chr9	19341454	19342372	Olfr853	918	-	NM_146906	19341454	19342372	1
chr9	19370878	19371826	Olfr854	948	-	NM_146522	19370878	19371826	1
chr9	19388954	19389946	Olfr855	992	+	NM_146524	19388982	19389921	1
chr9	19426534	19454175	Zfp317	27641	+	NM_172918	19445667	19452492	9
chr9	19461482	19463124	Olfr856-ps1	1642	-	NR_033621	19463124	19463124	1
chr9	19517272	19518202	Olfr857	930	+	NM_001012265	19517272	19518202	1
chr9	19584726	19588508	Olfr58	3782	+	NM_011001	19587578	19588508	2
chr9	19612763	19613693	Olfr859	930	+	NM_146526	19612763	19613693	1
chr9	19650066	19654191	Olfr860	4125	-	NM_146528	19650107	19651061	2
chr9	19687826	19688747	Olfr862	921	-	NM_146562	19687826	19688747	1
chr9	19721672	19726954	Olfr77	5282	+	NM_146339	19724654	19725593	3
chr9	19831402	19832479	Olfr866	1077	-	NM_146558	19831441	19832380	1
chr9	19858909	19859905	Olfr867	996	-	NM_001011748	19858909	19859905	1
chr9	19903069	19906134	Olfr868	3065	+	NM_146559	19905204	19906134	2
chr9	19933563	19942533	Olfr869	8970	+	NM_146557	19933589	19942533	2
chr9	19975077	19976013	Olfr870	936	-	NM_146904	19975077	19976013	1
chr9	20016650	20017797	Olfr871	1147	+	NM_146903	20016794	20017730	1
chr9	20041605	20065357	Olfr872	23752	+	NM_146560	20041657	20065257	2
chr9	20086794	20091092	Olfr39	4298	+	NM_146825	20086920	20091080	2
chr9	20104654	20105614	Olfr873	960	+	NM_146561	20104654	20105614	1
chr9	20118335	20140538	Olfr18	22203	-	NM_146563	20118366	20140409	2
chr9	20149579	20189602	Zfp560	40023	-	NM_001004190	20151743	20158532	7
chr9	20232761	20264604	Zfp26	31843	-	NM_011753	20240830	20250214	10
chr9	20272992	20297190	Zfp426	24198	-	NM_001310742	20274438	20282601	9
chr9	20299512	20325863	Zfp266	26351	-	NM_001135019	20303508	20311196	9
chr9	20385771	20399637	Zfp846	13866	+	NM_172919	20392334	20398915	6
chr9	20411918	20421715	Fbxl12os	9797	+	NR_033729	20421715	20421715	3
chr9	20442192	20449211	Fbxl12	7019	-	NM_001286530	20442820	20443642	4
chr9	20447761	20451233	Ubl5	3472	+	NM_025401	20449647	20451103	5
chr9	20456573	20471028	Pin1	14455	+	NM_023371	20456583	20467728	4
chr9	20472429	20532658	Olfm2	60229	-	NM_173777	20472550	20532601	6
chr9	20574500	20619511	Col5a3	45011	-	NM_001317388	20575278	20619397	67
chr9	20622947	20630607	Rdh8	7660	+	NM_001030290	20622947	20630111	6
chr9	20673085	20678751	A230050P20Rik	5666	+	NM_175687	20673359	20678215	8
chr9	20678252	20684154	Angptl6	5902	-	NM_145154	20678325	20683038	6
chr9	20692618	20696623	Ppan	4005	+	NM_145610	20692743	20696490	11
chr9	20698792	20703034	Eif3g	4242	-	NM_016876	20698870	20703007	11
chr9	20711649	20764332	Dnmt1	52683	-	NM_001199432	20711964	20745898	39
chr9	20718533	20718608	Mir7081	75	-	NR_106049	20718608	20718608	1
chr9	20770395	20781237	S1pr2	10842	-	NM_010333	20771915	20772974	2
chr9	20807180	20813281	Mrpl4	6101	+	NM_023167	20807384	20813083	9
chr9	20820403	20833240	Icam1	12837	+	NM_010493	20820478	20832390	7
chr9	20833816	20834975	Icam4	1159	+	NM_023892	20833897	20834938	3
chr9	20836481	20843480	Icam5	6999	+	NM_008319	20836573	20843344	11
chr9	20836694	20836772	Mir1900	78	-	NR_035438	20836772	20836772	1
chr9	20866836	20871537	Zglp1	4701	-	NM_001103168	20867031	20871523	5
chr9	20871957	20896452	Gm38431	24495	-	NR_038081	20896452	20896452	17
chr9	20871963	20877958	Fdx1l	5995	-	NM_001039824	20872212	20877950	5
chr9	20878608	20896432	Raver1	17824	-	NM_027911	20879793	20896421	13
chr9	20879940	20880032	Mir7082	92	-	NR_106050	20880032	20880032	1
chr9	20908511	20935719	Tyk2	27208	-	NM_018793	20909492	20931775	25
chr9	20942984	20954350	Cdc37	11366	-	NM_016742	20944251	20954301	8
chr9	20970157	21017692	Pde4a	47535	+	NM_183408	20970371	21015788	15
chr9	21034173	21043776	Keap1	9603	-	NM_001110306	21035145	21042153	6
chr9	21047360	21052887	S1pr5	5527	-	NM_053190	21048369	21049572	3
chr9	21069728	21079281	Atg4d	9553	+	NM_153583	21069926	21077880	10
chr9	21077900	21092413	Kri1	14513	-	NM_145416	21078364	21092397	19
chr9	21099900	21116777	Ap1m2	16877	-	NM_001110300	21100275	21116692	11
chr9	21125162	21159472	Slc44a2	34310	+	NM_001199186	21125264	21158232	22
chr9	21172314	21209807	Ilf3	37493	+	NM_001277321	21192238	21209276	21
chr9	21209685	21216164	Gm16853	6479	-	NR_045742	21216164	21216164	5
chr9	21216280	21224723	Qtrt1	8443	+	NM_021888	21216298	21224632	10
chr9	21229351	21312203	Dnm2	82852	+	NM_001253894	21229539	21311906	21
chr9	21300938	21301008	Mir199a-1	70	-	NR_029585	21301008	21301008	1
chr9	21311823	21314630	Tmed1	2807	-	NM_010744	21312616	21314620	4
chr9	21330620	21349775	AB124611	19155	+	NM_001198794	21330708	21349237	7
chr9	21351337	21393909	Carm1	42572	+	NM_021531	21351451	21392632	16
chr9	21393125	21397275	Yipf2	4150	-	NM_001205158	21394090	21397002	10
chr9	21397165	21400414	1810026J23Rik	3249	+	NM_178619	21397402	21398282	2
chr9	21411530	21412773	Gm7904	1243	-	NR_003372	21412773	21412773	1
chr9	21417887	21418020	Mir1946b	133	-	NR_035496	21418020	21418020	1
chr9	21420612	21508674	Smarca4	88062	+	NM_001174079	21437276	21507412	34
chr9	21528019	21554362	Ldlr	26343	+	NM_001252659	21528221	21552620	18
chr9	21559885	21564730	Spc24	4845	-	NM_026282	21560620	21564722	5
chr9	21571216	21602990	Kank2	31774	-	NM_145611	21573394	21600560	12
chr9	21604623	21657079	Dock6	52456	-	NM_177030	21604800	21657032	50
chr9	21614384	21614444	Mir7083	60	-	NR_106051	21614444	21614444	1
chr9	21639953	21641791	Angptl8	1838	+	NM_001080940	21639961	21641531	4
chr9	21711954	21722565	Rab3d	10611	-	NM_031874	21714927	21720376	5
chr9	21725452	21731979	Tmem205	6527	-	NR_045606	21731979	21731979	5
chr9	21731914	21740316	Ccdc159	8402	+	NM_025977	21732161	21740244	13
chr9	21741453	21753351	Plppr2	11898	+	NM_001290299	21743756	21752391	10
chr9	21759727	21760450	LOC100049077	723	-	NR_132099	21760450	21760450	1
chr9	21760196	21762714	Swsap1	2518	+	NM_025870	21760205	21761714	2
chr9	21763342	21768020	Epor	4678	-	NM_010149	21763502	21767875	8
chr9	21775970	21793897	Rgl3	17927	-	NM_023622	21776334	21793841	19
chr9	21794314	21807078	Ccdc151	12764	-	NM_001163787	21794569	21806918	13
chr9	21807431	21818689	Prkcsh	11258	+	NM_008925	21807902	21817606	18
chr9	21819448	21856467	Elavl3	37019	-	NM_010487	21822946	21856042	7
chr9	21859854	21875820	Zfp653	15966	-	NM_177318	21860159	21875785	9
chr9	21875445	21890575	Gm16845	15130	+	NR_040406	21890575	21890575	4
chr9	21876689	21889871	Ecsit	13182	-	NM_012029	21876767	21882687	9
chr9	21903696	21913665	Cnn1	9969	+	NM_009922	21903799	21912675	7
chr9	21917432	21918613	Elof1	1181	-	NM_170777	21917987	21918367	2
chr9	21918387	21918457	Mir7084	70	-	NR_106052	21918457	21918457	1
chr9	21931170	21940190	Acp5	9020	-	NM_001102405	21931463	21934573	5
chr9	21961289	21962798	Pigyl	1509	+	NM_001082532	21962438	21962654	2
chr9	21992609	22006567	Zfp872	13958	+	NM_001033813	21992672	22005068	4
chr9	22011229	22018304	1810064F22Rik	7075	-	NR_027981	22018304	22018304	2
chr9	22030146	22047798	Zfp809	17652	+	NM_172763	22030273	22047641	6
chr9	22051873	22064339	Zfp599	12466	-	NM_181419	22053664	22064203	5
chr9	22081191	22112082	Zfp810	30891	-	NM_145612	22082668	22094985	8
chr9	22134585	22135134	Gm6607	549	-	NR_033622	22135134	22135134	1
chr9	22135657	22193650	Anln	57993	-	NM_028390	22137493	22193431	24
chr9	22216020	22249123	9530077C05Rik	33103	+	NM_026739	22216168	22248674	7
chr9	22252755	22272800	Rp9	20045	-	NM_018739	22253099	22272645	6
chr9	22280158	22692724	Bbs9	412566	+	NM_178415	22295272	22692337	23
chr9	23027519	23289659	Bmper	262140	+	NM_028472	23028084	23288476	15
chr9	23902461	24120842	Npsr1	218381	+	NM_175678	23902643	24118257	10
chr9	24216224	24307584	Dpy19l1	91360	-	NM_172920	24218710	24307574	22
chr9	24361491	24500737	Dpy19l2	139246	-	NM_001166207	24362480	24500607	22
chr9	24429628	24430272	Cypt4	644	+	NM_173412	24429659	24430121	1
chr9	24429647	24430181	Cypt9	534	+	NM_001039942	24429659	24430121	1
chr9	24429647	24430181	Cypt10	534	+	NM_001039944	24429659	24430121	2
chr9	24525255	24578747	Tbx20	53492	-	NM_194263	24529895	24578289	8
chr9	24912573	24956280	Herpud2	43707	-	NM_020586	24913287	24955465	8
chr9	25060039	25116156	Sept7	56117	+	NM_001205367	25060239	25115137	13
chr9	25289181	25411695	Eepd1	122514	+	NM_026189	25290026	25411193	8
chr9	26541392	26568935	B3gat1	27543	+	NM_001310766	26559180	26565364	7
chr9	26570628	26614053	Glb1l2	43425	-	NM_001310768	26572321	26613968	19
chr9	26625537	26668408	Glb1l3	42871	-	NM_001113323	26625765	26668160	20
chr9	26687151	26730666	Gm1110	43515	-	NM_001281475	26687540	26728980	21
chr9	26781725	26807134	Acad8	25409	-	NM_025862	26783292	26807081	11
chr9	26807261	26814919	Thyn1	7658	+	NM_144543	26807598	26814789	8
chr9	26812086	26837679	Vps26b	25593	-	NM_178027	26817475	26837206	6
chr9	26837759	26902900	Ncapd3	65141	+	NM_178113	26838354	26902390	36
chr9	26904968	26963006	Jam3	58038	-	NM_023277	26905950	26962951	9
chr9	27106812	27142348	Igsf9b	35536	+	NM_001129787	27107038	27142322	18
chr9	27160269	27165128	AI414108	4859	+	NR_027907	27165128	27165128	1
chr9	27204391	27209296	Spata19	4905	+	NM_029299	27204453	27208463	7
chr9	27598853	28732633	Opcml	1133780	+	NM_177906	27598970	28727772	8
chr9	28803548	29770714	Ntm	967166	-	NM_172290	28804118	29770511	8
chr9	30234913	30274311	Snx19	39398	+	NM_028874	30235152	30272003	11
chr9	30706739	30730037	Adamts15	23298	-	NM_001024139	30709599	30729822	8
chr9	30750147	30770443	Adamts8	20296	+	NM_013906	30750421	30769803	9
chr9	30838228	30883470	Zbtb44	45242	+	NM_001115130	30860880	30876340	6
chr9	30896174	30939384	St14	43210	-	NM_011176	30897450	30939211	19
chr9	30942991	31066970	Mir3471-1	123979	-	NR_037304	31066970	31066970	4
chr9	30957141	31019400	Aplp2	62259	-	NM_001102455	30958455	31019312	17
chr9	31078985	31082970	Gm7244	3985	+	NM_001101597	31082482	31082860	2
chr9	31122691	31186128	Prdm10	63437	+	NM_001080817	31122691	31186128	21
chr9	31193776	31228918	Nfrkb	35142	+	NM_172766	31196499	31227765	26
chr9	31233780	31271823	Tmem45b	38043	-	NM_144936	31234429	31239089	6
chr9	31653628	31720870	Barx2	67242	-	NM_013800	31654373	31720676	4
chr9	31923720	32073096	Arhgap32	149376	+	NM_001195632	31923720	32068733	22
chr9	32122367	32151822	Kcnj5	29455	-	NM_010605	32125164	32130602	4
chr9	32180002	32206779	Kcnj1	26777	+	NM_019659	32203926	32205045	2
chr9	32229788	32349037	Fli1	119249	-	NM_008026	32231360	32348793	9
chr9	32503626	32565405	Ets1	61779	+	NM_011808	32503968	32562010	8
chr9	32711653	32736551	Gm27162	24898	-	NR_131058	32736551	32736551	4
chr9	33849955	33866604	7630403G23Rik	16649	+	NR_040744	33866604	33866604	3
chr9	34296315	34843892	Kirrel3	547577	+	NM_001190911	34296688	34842865	17
chr9	34854163	34924395	St3gal4	70232	-	NM_009178	34855017	34863174	11
chr9	34924312	34938507	4930581F22Rik	14195	+	NR_029475	34938507	34938507	6
chr9	34931998	34983572	Dcps	51574	-	NM_027030	34932156	34983553	6
chr9	34991975	35007876	Tirap	15901	-	NM_001177845	34995495	34998693	7
chr9	35011805	35018640	Foxred1	6835	-	NM_001291448	35012453	35018476	11
chr9	35018787	35024588	Srpr	5801	+	NM_026130	35018873	35023651	14
chr9	35024549	35075390	Fam118b	50841	-	NM_001286604	35025318	35052284	10
chr9	35075465	35083542	Rpusd4	8077	+	NM_028040	35075474	35082888	7
chr9	35088689	35093008	4933422A05Rik	4319	+	NR_040715	35093008	35093008	5
chr9	35259660	35315237	Cdon	55577	+	NM_021339	35259689	35311805	19
chr9	35349432	35366055	Ddx25	16623	-	NM_013932	35349582	35365985	12
chr9	35367050	35374985	Pus3	7935	+	NM_023292	35372401	35374504	4
chr9	35368405	35377654	Hyls1	9249	-	NM_029762	35368758	35371661	4
chr9	35414677	35419470	Pate4	4793	-	NM_020264	35415354	35419431	3
chr9	35452697	35455787	Gm17365	3090	-	NM_001167592	35453646	35455704	3
chr9	35477223	35480474	Pate2	3251	+	NM_001033421	35477276	35478648	4
chr9	35492663	35494956	Gm17252	2293	-	NM_001199953	35492674	35494956	5
chr9	35548633	35549837	Gm17677	1204	+	NM_001167588	35548633	35549837	3
chr9	35584108	35585694	Gm17727	1586	-	NM_001167673	35584197	35585470	3
chr9	35595634	35597697	D730048I06Rik	2063	-	NM_026593	35596551	35597601	3
chr9	35645913	35651735	9230110F15Rik	5822	-	NM_029863	35646605	35651646	3
chr9	35656129	35657465	Gm3428	1336	-	NR_030730	35657465	35657465	4
chr9	35927518	35936364	Gm5916	8846	-	NM_001167587	35928262	35936275	3
chr9	35941871	35943215	Gm3434	1344	-	NR_030729	35943215	35943215	4
chr9	36239468	36242523	Gm7257	3055	+	NM_001167586	36239468	36241062	4
chr9	36283222	36284765	Gm9513	1543	+	NM_001128510	36283222	36284765	3
chr9	36339987	36349548	Gm5615	9561	-	NM_001033783	36341932	36349457	3
chr9	36388862	36390220	Gm17689	1358	-	NM_001167584	36388862	36390220	3
chr9	36443338	36446187	A630095E13Rik	2849	-	NM_001033325	36444820	36446131	4
chr9	36476440	36500774	1700027I24Rik	24334	-	NR_040741	36500774	36500774	4
chr9	36500804	36506422	Acrv1	5618	+	NM_007391	36500896	36506205	4
chr9	36516066	36534243	Chek1	18177	-	NM_007691	36517919	36533446	13
chr9	36539997	36575163	Stt3a	35166	-	NM_008408	36540508	36572726	18
chr9	36586737	36604978	Ei24	18241	-	NM_001199494	36587691	36600920	11
chr9	36651243	36686225	Fez1	34982	+	NM_183171	36651291	36686167	9
chr9	36698563	36954907	Pknox2	256344	-	NM_001029838	36700409	36776049	13
chr9	37015807	37030813	Tmem218	15006	+	NM_025464	37025851	37030198	4
chr9	37036733	37063323	Slc37a2	26590	-	NM_001145960	37040663	37062942	19
chr9	37083419	37155977	Ccdc15	72558	-	NM_001081429	37084146	37155651	16
chr9	37175190	37194156	Hepacam	18966	+	NM_175189	37175261	37192396	7
chr9	37209481	37221608	Robo4	12127	+	NM_028783	37209636	37220972	18
chr9	37223629	37240760	Robo3	17131	-	NM_001164767	37223972	37240586	28
chr9	37296905	37331735	Msantd2	34830	+	NM_146222	37296908	37331127	4
chr9	37335673	37345904	Esam	10231	+	NM_027102	37335805	37345367	7
chr9	37346839	37351790	Vsig2	4951	+	NM_020518	37346959	37351727	7
chr9	37352077	37360330	Nrgn	8253	-	NM_022029	37353537	37360136	4
chr9	37410878	37421305	Spa17	10427	-	NM_011449	37410924	37419574	5
chr9	37421431	37455903	Siae	34472	+	NM_011734	37421444	37454109	10
chr9	37456766	37464897	Tbrg1	8131	-	NM_025289	37456942	37464729	9
chr9	37467486	37476807	Panx3	9321	-	NM_172454	37468658	37476640	4
chr9	37518932	37519865	Olfr160	933	-	NM_030553	37518932	37519862	1
chr9	37537561	37538646	Olfr151	1085	-	NM_207664	37537637	37538566	1
chr9	37553720	37554653	Olfr874	933	+	NM_146882	37553720	37554653	1
chr9	37580221	37581225	Olfr875	1004	+	NM_146749	37580245	37581178	1
chr9	37611473	37612521	Olfr876	1048	+	NM_146883	37611497	37612430	1
chr9	37662404	37663340	Olfr877	936	+	NM_146417	37662404	37663340	1
chr9	37704990	37705923	Olfr145	933	+	NM_146313	37704990	37705923	1
chr9	37726132	37727197	Olfr878	1065	+	NM_146798	37726228	37727173	1
chr9	37800076	37801024	Olfr881	948	+	NM_146418	37800078	37801023	1
chr9	37833392	37834322	Olfr883	930	+	NM_146419	37833392	37834322	1
chr9	37854808	37855738	Olfr884	930	+	NM_001011798	37854808	37855738	1
chr9	37868906	37869836	Olfr885	930	+	NM_001011739	37868906	37869836	1
chr9	37892422	37893352	Olfr887	930	+	NM_146423	37892422	37893352	1
chr9	37916272	37917217	Olfr888	945	+	NM_146424	37916272	37917217	1
chr9	37923382	37924312	Olfr889	930	+	NM_146482	37923382	37924312	1
chr9	37950721	37951666	Olfr890	945	+	NM_146481	37950721	37951666	1
chr9	37987455	37988406	Olfr891	951	-	NM_146478	37987455	37988406	1
chr9	38016636	38017578	Olfr893	942	+	NM_146336	38016639	38017578	1
chr9	38026402	38027351	Olfr894	949	+	NM_146868	38026409	38027351	1
chr9	38061003	38061945	Olfr143	942	+	NM_146806	38061003	38061945	1
chr9	38076099	38077050	Olfr895	951	+	NM_146875	38076099	38077050	1
chr9	38137076	38138144	Olfr25	1068	+	NM_146870	38137173	38138115	1
chr9	38156669	38157620	Olfr898	951	+	NM_146871	38156669	38157620	1
chr9	38175132	38176128	Olfr250	996	+	NM_207552	38175132	38176128	1
chr9	38175132	38176128	Olfr899	996	+	NM_146479	38175132	38176128	1
chr9	38185467	38186418	Olfr251	951	+	NM_207553	38185467	38186418	1
chr9	38185467	38186418	Olfr900	951	+	NM_146874	38185467	38186418	1
chr9	38209295	38211414	Olfr147	2119	+	NM_146869	38210460	38211414	2
chr9	38237868	38238804	Olfr901	936	+	NM_001011806	38237868	38238804	1
chr9	38256376	38257432	Olfr902	1056	+	NM_146802	38256458	38257388	1
chr9	38271627	38272560	Olfr904	933	+	NM_146801	38271627	38272560	1
chr9	38280333	38281266	Olfr905	933	+	NM_146804	38280333	38281266	1
chr9	38295615	38296551	Olfr906	936	+	NM_146803	38295615	38296551	1
chr9	38306255	38307188	Olfr907	933	+	NM_146805	38306255	38307188	1
chr9	38323618	38324550	Olfr908	932	+	NM_146872	38323618	38324550	2
chr9	38331314	38332254	Olfr911-ps1	940	+	NM_146873	38331318	38332254	1
chr9	38345466	38347414	Olfr910	1948	+	NM_146811	38346481	38347414	2
chr9	38387828	38389796	Olfr912	1968	+	NM_146810	38388863	38389796	2
chr9	38400387	38402746	Olfr913	2359	+	NM_001011523	38401807	38402746	2
chr9	38414051	38415002	Olfr914	951	+	NM_146786	38414051	38415002	1
chr9	38454174	38455107	Olfr915	933	-	NM_146785	38454174	38455107	1
chr9	38465042	38465975	Olfr916	933	-	NM_146784	38465042	38465975	1
chr9	38472497	38473427	Olfr917	930	-	NM_001011864	38472497	38473427	1
chr9	38480088	38481066	Olfr918	978	-	NM_146375	38480088	38481066	1
chr9	38505013	38505961	Olfr919	948	-	NM_146440	38505013	38505961	1
chr9	38525852	38550922	Vwa5a	25070	+	NM_172767	38529972	38549358	20
chr9	38560380	38564448	Olfr920	4068	+	NM_146787	38563274	38564207	2
chr9	38580672	38583939	Olfr921	3267	+	NM_146782	38582841	38583783	3
chr9	38622992	38624124	Olfr922	1132	+	NM_146781	38623089	38624025	1
chr9	38635199	38636267	Olfr923	1068	+	NM_146816	38635277	38636231	1
chr9	38655700	38656627	Olfr924	927	+	NM_207560	38655700	38656627	1
chr9	38662644	38663575	Olfr26	931	+	NM_146783	38662648	38663575	1
chr9	38684762	38685689	Olfr926	927	+	NM_146815	38684762	38685689	1
chr9	38737757	38738684	Olfr930	927	+	NM_146272	38737757	38738684	1
chr9	38783262	38784189	Olfr933	927	+	NM_146441	38783262	38784189	1
chr9	38789694	38790627	Olfr934	933	-	NM_146442	38789694	38790627	1
chr9	38802091	38803018	Olfr935	927	-	NM_146746	38802091	38803018	1
chr9	38826203	38827124	Olfr146	921	-	NM_146747	38826203	38827124	1
chr9	38854198	38855134	Olfr936	936	-	NM_207139	38854198	38855002	1
chr9	38867313	38868249	Olfr937	936	-	NM_146439	38867313	38868249	1
chr9	38885380	38886328	Olfr938	948	-	NM_146438	38885380	38886328	1
chr9	38935751	38952655	Olfr27	16904	+	NM_146829	38951686	38952622	2
chr9	38951686	38952603	Olfr242	917	+	NM_010974	38951686	38952603	1
chr9	38973894	38992709	Olfr943	18815	+	NM_146326	38991764	38992709	3
chr9	39024943	39025879	Olfr944	936	+	NM_146507	39024943	39025879	1
chr9	39045071	39046016	Olfr1537	945	-	NM_207665	39045071	39046016	1
chr9	39065304	39066264	Olfr945	960	-	NM_146506	39065304	39066264	1
chr9	39095510	39107066	Olfr947-ps1	11556	-	NR_033620	39107066	39107066	2
chr9	39126231	39127197	Olfr948	966	-	NM_001011756	39126231	39127197	1
chr9	39201377	39202322	Olfr951	945	+	NM_001011812	39201377	39202322	1
chr9	39233709	39234654	Olfr952	945	-	NM_146503	39233709	39234654	1
chr9	39269017	39269962	Olfr954	945	+	NM_146331	39269017	39269962	1
chr9	39277364	39278309	Olfr955	945	-	NM_207141	39277364	39278309	1
chr9	39291788	39301573	Olfr44	9785	-	NM_146830	39291891	39292836	2
chr9	39318367	39319303	Olfr957	936	-	NM_146745	39318367	39319303	1
chr9	39357515	39358454	Olfr958	939	-	NM_146330	39357515	39358454	1
chr9	39379906	39380842	Olfr959	936	-	NM_146508	39379906	39380842	1
chr9	39394980	39411709	AW551984	16729	-	NM_178737	39396630	39408407	20
chr9	39421153	39422086	Olfr148	933	+	NM_146505	39421153	39422086	1
chr9	39430709	39431660	Olfr960	951	+	NM_146279	39430709	39431660	1
chr9	39454312	39455257	Olfr961	945	+	NM_146504	39454312	39455257	1
chr9	39476643	39477579	Olfr963	936	+	NM_001011827	39476643	39477579	1
chr9	39509416	39510352	Olfr149	936	-	NM_207138	39509416	39510352	1
chr9	39526813	39527752	Olfr965	939	+	NM_001011859	39526813	39527752	1
chr9	39544401	39545340	Olfr150	939	+	NM_146609	39544401	39545340	1
chr9	39557972	39558905	Olfr967	933	+	NM_001011826	39557972	39558905	1
chr9	39579356	39580383	Olfr968	1027	-	NM_146612	39579438	39580383	1
chr9	39602961	39603897	Olfr969	936	+	NM_146826	39602961	39603897	1
chr9	39627225	39628161	Olfr970	936	+	NM_146611	39627225	39628161	1
chr9	39647020	39647944	Olfr971	924	+	NM_146614	39647020	39647944	1
chr9	39680861	39681806	Olfr972	945	+	NM_146610	39680861	39681806	1
chr9	39717389	39718313	Olfr229	924	+	NM_146613	39717389	39718313	1
chr9	39749846	39750779	Olfr974	933	+	NM_147107	39749846	39750779	1
chr9	39757421	39758354	Olfr975	933	-	NM_146828	39757421	39758354	1
chr9	39761841	39764654	Olfr976	2813	-	NM_146367	39763573	39764554	1
chr9	39801396	39802332	Olfr978	936	+	NM_147105	39801396	39802332	1
chr9	39807790	39808835	Olfr979	1045	-	NM_147108	39807874	39808810	1
chr9	39813578	39814614	Olfr980	1036	-	NM_147106	39813599	39814532	1
chr9	39829979	39830912	Olfr981	933	+	NM_146286	39829979	39830912	1
chr9	39858142	39860610	1700001J11Rik	2468	+	NR_033613	39860610	39860610	1
chr9	39881881	39882847	Olfr982	966	+	NM_146854	39881881	39882847	1
chr9	39899601	39901143	Olfr983	1542	-	NM_146827	39899601	39900549	2
chr9	39908128	39909073	Olfr984	945	-	NM_146608	39908128	39909073	1
chr9	39934508	39935624	Olfr985	1116	-	NM_146855	39934608	39935544	1
chr9	39955706	39958463	Tmem225	2757	+	NM_029379	39955910	39958369	4
chr9	39994663	39995679	Olfr986	1016	+	NM_146615	39994701	39995640	1
chr9	39999900	40021189	Zfp202	21289	+	NM_030713	40014877	40019454	7
chr9	40076800	40099203	Scn3b	22403	+	NM_001083917	40077577	40096022	7
chr9	40105491	40263349	Gramd1b	157858	-	NM_172768	40105574	40263255	20
chr9	40141056	40150922	1700110K17Rik	9866	+	NR_040728	40150922	40150922	3
chr9	40494046	40592129	Clmp	98083	+	NM_133733	40494417	40590693	7
chr9	40609355	40613282	Hspa8	3927	+	NM_031165	40610005	40613200	9
chr9	40682209	40686055	Bsx	3846	+	NM_178245	40682260	40685930	3
chr9	40702931	40772195	4931429I11Rik	69264	-	NM_001081121	40703621	40769294	9
chr9	40780880	40812711	Crtam	31831	-	NM_019465	40781595	40812669	10
chr9	40821723	40965577	Ubash3b	143854	-	NM_176860	40822981	40965509	14
chr9	41014237	41025710	1700063D05Rik	11473	+	NR_040392	41025710	41025710	5
chr9	41184608	41398102	3110039I08Rik	213494	+	NR_131928	41398102	41398102	5
chr9	41339507	41339587	Mir100	80	+	NR_029790	41339587	41339587	1
chr9	41344798	41344894	Mirlet7a-2	96	+	NR_029726	41344894	41344894	1
chr9	41390008	41390085	Mir125b-1	77	+	NR_029822	41390085	41390085	1
chr9	41776571	41932372	Sorl1	155801	-	NM_011436	41776685	41932196	48
chr9	41990320	42017314	4930546K05Rik	26994	-	NR_040754	42017314	42017314	7
chr9	42062259	42072383	Sc5d	10124	-	NM_172769	42063424	42067974	6
chr9	42137704	42208012	Tecta	70308	-	NM_009347	42138307	42206359	24
chr9	42220399	42280309	Tbcel	59910	-	NM_173038	42223913	42259828	8
chr9	42328494	42752454	Grik4	423960	-	NM_175481	42328911	42616657	21
chr9	42771924	42913801	Arhgef12	141877	-	NM_027144	42777264	42913293	41
chr9	42916735	42924653	Tmem136	7918	-	NM_001034863	42919402	42921742	3
chr9	42932021	43013838	Pou2f3	81817	-	NM_011139	42933173	43013764	13
chr9	43029360	43047899	Oaf	18539	-	NM_178644	43030656	43047656	4
chr9	43067961	43088158	D630033O11Rik	20197	+	NM_001243261	43067998	43088086	3
chr9	43118845	43144208	Trim29	25363	+	NM_023655	43118958	43143255	9
chr9	43552658	43615544	Pvrl1	62886	+	NM_021424	43552726	43612099	6
chr9	43851466	43856662	Thy1	5196	+	NM_009382	43854064	43855534	4
chr9	43875103	43903710	Usp2	28607	+	NM_198092	43883489	43901944	13
chr9	43909852	43917270	C1qtnf5	7418	+	NM_001190313	43915840	43916895	14
chr9	43909852	43917270	Mfrp	7418	+	NM_001190314	43909975	43914550	14
chr9	43918863	43921134	Rnf26	2271	-	NM_153762	43919757	43921032	1
chr9	43942740	43950809	Mcam	8069	+	NM_023061	43942772	43949896	16
chr9	43957344	44042129	Cbl	84785	-	NM_007619	43959527	44041971	16
chr9	44048759	44055389	Ccdc153	6630	+	NM_001081369	44049089	44054968	7
chr9	44055394	44059547	Pdzd3	4153	-	NM_133226	44056069	44059538	11
chr9	44060795	44076682	Nlrx1	15887	-	NM_001163742	44061300	44073896	10
chr9	44081272	44096327	Abcg4	15055	-	NM_138955	44082714	44095536	15
chr9	44103755	44113754	Hinfp	9999	-	NM_172162	44104278	44110661	10
chr9	44117319	44128365	C2cd2l	11046	-	NM_027909	44119138	44127971	14
chr9	44134927	44141683	Dpagt1	6756	+	NM_007875	44135121	44141205	9
chr9	44142797	44144156	H2afx	1359	+	NM_010436	44142844	44143276	1
chr9	44144430	44152311	Hmbs	7881	-	NM_013551	44144754	44152125	14
chr9	44156187	44169753	Vps11	13566	-	NM_027889	44156502	44169714	16
chr9	44187572	44200452	Hyou1	12880	+	NM_021395	44188602	44199133	26
chr9	44205009	44211051	Slc37a4	6042	+	NM_001293631	44206556	44210551	9
chr9	44208505	44208571	Mir7085	66	+	NR_106053	44208571	44208571	1
chr9	44211841	44215631	Trappc4	3790	-	NM_021789	44212102	44215384	5
chr9	44215796	44218489	Rps25	2693	+	NM_024266	44215837	44218131	5
chr9	44218246	44226090	Ccdc84	7844	-	NM_201372	44218386	44226071	11
chr9	44242316	44248951	Foxr1	6635	-	NM_001033469	44243259	44248900	5
chr9	44260797	44262850	Upk2	2053	-	NM_009476	44261055	44262789	5
chr9	44307218	44318495	Bcl9l	11277	+	NM_030256	44307606	44317866	9
chr9	44319869	44334504	Cxcr5	14635	-	NM_007551	44321316	44334461	2
chr9	44412974	44448814	Ddx6	35840	+	NM_007841	44415475	44443941	14
chr9	44481315	44494388	Treh	13073	+	NM_021481	44481343	44494099	15
chr9	44494390	44543281	Phldb1	48891	-	NM_153537	44495640	44536162	22
chr9	44550227	44575891	Arcn1	25664	-	NM_145985	44552009	44575755	10
chr9	44581091	44600797	Ift46	19706	+	NM_023831	44586679	44598663	12
chr9	44601861	44607299	Tmem25	5438	-	NM_027865	44603057	44606816	9
chr9	44607482	44611034	Ttc36	3552	-	NM_138951	44607553	44610902	3
chr9	44611437	44689357	Kmt2a	77920	-	NM_001081049	44615984	44689357	36
chr9	44721330	44728825	Atp5l	7495	-	NM_013795	44721450	44728744	3
chr9	44731209	44773683	Ube4a	42474	-	NM_145400	44733931	44768182	20
chr9	44777654	44788514	Cd3g	10860	-	NM_009850	44778790	44788403	7
chr9	44789868	44795135	Cd3d	5267	+	NM_013487	44789968	44794427	5
chr9	44806825	44817673	Cd3e	10848	-	NM_007648	44807613	44817479	8
chr9	44850426	44862126	Mpzl2	11700	+	NM_007962	44850819	44857798	6
chr9	44863263	44883125	Mpzl3	19862	+	NM_001093749	44863325	44882866	6
chr9	44887265	44916614	Amica1	29349	+	NM_001005421	44892146	44915527	11
chr9	44915258	44943689	Gm10684	28431	-	NR_033547	44943689	44943689	3
chr9	44925958	44938153	Scn2b	12195	+	NM_001014761	44926106	44934387	4
chr9	44947124	44962144	Scn4b	15020	+	NM_001013390	44947124	44958587	5
chr9	44980808	45012158	Tmprss4	31350	-	NM_145403	44981479	45011870	13
chr9	45003848	45058068	BC049352	54220	+	NM_001198971	45004069	45052341	5
chr9	45061921	45077229	Il10ra	15308	-	NM_008348	45063612	45077155	7
chr9	45074725	45074790	Mir7086	65	-	NR_106054	45074790	45074790	1
chr9	45126348	45130162	1700003G13Rik	3814	-	NR_040720	45130162	45130162	4
chr9	45127182	45155663	Tmprss13	28481	+	NM_001013373	45127217	45154101	13
chr9	45178267	45204242	Fxyd6	25975	+	NM_022004	45198075	45200787	8
chr9	45207791	45218361	Fxyd2	10570	+	NR_028499	45218361	45218361	6
chr9	45224708	45239315	4833428L15Rik	14607	-	NR_040732	45239315	45239315	5
chr9	45238375	45561796	Dscaml1	323421	+	NM_001081270	45238375	45561247	33
chr9	45575028	45636721	Cep164	61693	-	NM_001081373	45576340	45631810	30
chr9	45646611	45670567	Bace1	23956	+	NM_011792	45647110	45668378	9
chr9	45671507	45714994	Rnf214	43487	-	NM_001310840	45673015	45712995	15
chr9	45714651	45737805	Pcsk7	23154	+	NR_104055	45737805	45737805	18
chr9	45737710	45744141	Tagln	6431	-	NM_011526	45738453	45739844	5
chr9	45745939	45763332	Sidt2	17393	-	NM_001289668	45747336	45762989	27
chr9	45747603	45747673	Mir7087	70	-	NR_106055	45747673	45747673	1
chr9	45773393	45792954	Pafah1b2	19561	-	NM_008775	45776770	45786805	6
chr9	45820902	46032277	Sik3	211375	+	NM_027498	45820940	46029304	25
chr9	46036712	46038552	Apoa1	1840	+	NM_009692	46037039	46038485	4
chr9	46041132	46043719	Apoc3	2587	-	NM_001289756	46041305	46042796	4
chr9	46048926	46051541	Apoa4	2615	+	NM_007468	46049236	46051373	3
chr9	46076690	46080002	Apoa5	3312	+	NM_080434	46077180	46078817	4
chr9	46081146	46090725	Zpr1	9579	+	NM_011752	46081279	46089255	14
chr9	46091094	46106866	Bud13	15772	+	NM_146000	46091113	46106591	10
chr9	46111443	46128069	4931429L15Rik	16626	-	NM_183104	46112103	46119670	13
chr9	46721685	46735449	2900052N01Rik	13764	+	NR_015605	46735449	46735449	4
chr9	46806823	46811943	Gm4791	5120	+	NM_001243258	46807013	46811421	3
chr9	47338252	47661474	Cadm1	323222	+	NM_001310841	47338455	47658473	12
chr9	47607242	47626291	Gm10677	19049	-	NR_046048	47626291	47626291	3
chr9	48126086	48148981	Nxpe2	22895	-	NM_030069	48127473	48148677	6
chr9	48170123	48208108	Nxpe4	37985	+	NM_172921	48198342	48207153	9
chr9	48262444	48262828	Gm8884	384	+	NR_026561	48262828	48262828	1
chr9	48276618	48288716	Rexo2	12098	-	NM_024233	48276921	48288658	7
chr9	48296801	48303435	Rbm7	6634	-	NR_037589	48303435	48303435	6
chr9	48303447	48304080	Gm5617	633	+	NM_001004191	48303672	48304026	1
chr9	48399981	48413228	Nnmt	13247	-	NM_001311062	48400224	48413063	4
chr9	48462401	48644050	Zbtb16	181649	-	NM_001033324	48465246	48641115	7
chr9	48707317	48719204	Htr3a	11887	-	NM_001099644	48707796	48719070	9
chr9	48743112	48773095	Htr3b	29983	-	NM_020274	48744004	48772890	9
chr9	48793489	48850622	Usp28	57133	+	NM_175482	48793585	48849654	24
chr9	48863685	48886878	Zw10	23193	+	NM_012039	48863787	48886424	16
chr9	48910883	48925693	Tmprss5	14810	+	NM_030709	48914245	48925096	13
chr9	49058635	49088699	Gm4894	30064	+	NM_177701	49076676	49086888	4
chr9	49148766	49215319	Drd2	66553	+	NM_010077	49203720	49215199	8
chr9	49223326	49235126	Ankk1	11800	-	NM_172922	49223744	49235096	8
chr9	49245065	49294330	Ttc12	49265	-	NM_172770	49246485	49292832	22
chr9	49310233	49607498	Ncam1	297265	-	NM_001311065	49313547	49606834	18
chr9	49326392	49376130	Gm11149	49738	+	NR_029465	49376130	49376130	6
chr9	50040627	50041287	2310003N18Rik	660	-	NR_131161	50041287	50041287	2
chr9	50296903	50312910	Plet1os	16007	-	NR_040714	50312910	50312910	3
chr9	50302629	50313744	Plet1	11115	+	NM_029639	50302667	50312650	4
chr9	50329721	50336746	Pts	7025	-	NM_011220	50330317	50336741	6
chr9	50341191	50363243	Bco2	22052	-	NM_133217	50341510	50358807	12
chr9	50365252	50369373	Tex12	4121	-	NM_025687	50365451	50367387	5
chr9	50373472	50389942	Il18	16470	+	NM_008360	50383377	50389819	6
chr9	50404444	50411954	Sdhd	7510	-	NM_025848	50405189	50411894	4
chr9	50412005	50413425	Timm8b	1420	+	NM_013897	50412060	50413205	2
chr9	50413344	50425569	AU019823	12225	-	NM_001134902	50415536	50423656	7
chr9	50425425	50433105	Pih1d2	7680	+	NM_028300	50426577	50433099	6
chr9	50442737	50467885	Dlat	25148	-	NM_145614	50444529	50467571	14
chr9	50470857	50545840	Dixdc1	74983	-	NM_001311069	50474299	50545805	20
chr9	50547795	50554626	2310030G06Rik	6831	-	NM_025865	50548605	50554620	4
chr9	50559176	50560459	Hspb2	1283	-	NM_001164708	50559383	50560375	2
chr9	50559429	50564740	Cryab	5311	+	NM_001289782	50561381	50564600	4
chr9	50570932	50576257	1110032A03Rik	5325	-	NM_023483	50571960	50576004	4
chr9	50576342	50580775	Fdxacb1	4433	+	NM_198675	50576388	50580712	5
chr9	50583329	50651744	Alg9	68415	+	NM_133981	50583489	50650962	15
chr9	50665028	50702334	Ppp2r1b	37306	+	NM_001034085	50665089	50699787	17
chr9	50700905	50817178	Sik2	116273	-	NM_178710	50701463	50816980	16
chr9	50864884	50885199	Layn	20315	-	NM_001033534	50865400	50885075	8
chr9	50889417	50910183	4833427G06Rik	20766	-	NM_177702	50889577	50910075	6
chr9	50911138	50911215	Mir34c	77	-	NR_029654	50911215	50911215	1
chr9	50911666	50911750	Mir34b	84	-	NR_029655	50911750	50911750	1
chr9	50924105	50927805	Btg4	3700	+	NM_019493	50924636	50927459	5
chr9	51021794	51048184	Pou2af1	26390	+	NM_011136	51021890	51046485	5
chr9	51078362	51086659	Gm684	8297	-	NM_001195681	51078655	51085760	5
chr9	51097790	51137022	1810046K07Rik	39232	-	NM_027217	51098151	51103068	5
chr9	51573456	51661164	Arhgap20	87708	+	NM_175535	51573611	51658504	15
chr9	51647597	51683990	Arhgap20os	36393	-	NR_033560	51683990	51683990	4
chr9	51722533	51735108	4933407I05Rik	12575	+	NR_040731	51735108	51735108	3
chr9	51751129	51771707	Fdx1	20578	-	NM_007996	51751639	51771572	4
chr9	51810165	51856810	Gm6981	46645	-	NR_023357	51856810	51856810	3
chr9	51855254	51896843	Rdx	41589	+	NM_001104616	51868996	51894584	14
chr9	51920089	51976216	Zc3h12c	56127	-	NM_001162921	51923510	51976216	6
chr9	51923727	51923844	Mir6244	117	+	NR_105750	51923844	51923844	1
chr9	52481136	52487885	AI593442	6749	-	NM_001286641	52485780	52486380	2
chr9	52487967	52606877	Gm1715	118910	+	NR_045333	52606877	52606877	5
chr9	52906558	53056217	Ddx10	149659	-	NM_029936	52907189	53056108	18
chr9	53109774	53189263	Exph5	79489	+	NM_176846	53109837	53185608	6
chr9	53192127	53209972	Kdelc2	17845	+	NM_212445	53192204	53207917	8
chr9	53208909	53208991	Mir130c	82	-	NR_105807	53208991	53208991	1
chr9	53213390	53240908	4930550C14Rik	27518	+	NM_029247	53216166	53240668	9
chr9	53245226	53344776	Atm	99550	-	NM_007499	53247850	53342041	64
chr9	53345151	53383732	Npat	38581	+	NM_001081152	53345256	53380753	18
chr9	53388626	53418455	Acat1	29829	-	NM_144784	53390649	53418380	12
chr9	53422686	53475612	Cul5	52926	-	NM_027807	53425920	53475391	19
chr9	53492214	53514337	Rab39	22123	-	NM_175562	53494414	53514220	2
chr9	53619341	53665968	Slc35f2	46627	+	NM_028060	53619591	53664778	8
chr9	53698057	53701656	Sln	3599	+	NM_025540	53701279	53701375	2
chr9	53759266	53823108	Elmod1	63842	-	NM_177769	53760528	53794671	11
chr9	53873412	53916218	Tnfaip8l3	42806	-	NM_001033535	53874881	53916077	2
chr9	54013743	54041249	Cyp19a1	27506	-	NM_007810	54014563	54041208	9
chr9	54116386	54149377	Gldnos	32991	-	NR_045805	54149377	54149377	3
chr9	54134292	54189584	Gldn	55292	+	NM_177350	54134330	54186623	10
chr9	54212964	54349433	Dmxl2	136469	-	NM_172771	54214224	54349244	44
chr9	54386790	54392827	Sh2d7	6037	+	NM_173778	54387274	54391159	4
chr9	54393158	54407886	Cib2	14728	-	NM_019686	54393269	54407825	6
chr9	54434317	54452469	Idh3a	18152	+	NM_029573	54434323	54451172	11
chr9	54452803	54509692	Acsbg1	56889	-	NM_053178	54453197	54509477	14
chr9	54547365	54564124	Dnaja4	16759	+	NM_021422	54547535	54562483	7
chr9	54556119	54556188	Mir5710	69	+	NR_049206	54556188	54556188	1
chr9	54564959	54582356	Wdr61	17397	-	NM_001025375	54565152	54579205	11
chr9	54612554	54620917	Crabp1	8363	+	NM_013496	54612708	54620683	4
chr9	54711561	54760341	Ireb2	48780	+	NM_022655	54711684	54757548	22
chr9	54765096	54797731	Hykk	32635	+	NM_177351	54768285	54794333	5
chr9	54798063	54798761	AY074887	698	-	NM_145229	54798247	54798646	1
chr9	54798665	54805837	Psma4	7172	+	NM_011966	54799912	54805596	9
chr9	54828686	54855586	Chrna5	26900	+	NM_176844	54828903	54854382	6
chr9	54859149	54874366	Chrna3	15217	-	NM_145129	54860607	54874216	6
chr9	54875962	54896351	Chrnb4	20389	-	NM_148944	54877911	54896302	6
chr9	54997175	55055336	Ube2q2	58161	+	NM_180600	54997441	55053798	13
chr9	55056741	55072240	Fbxo22	15499	+	NM_028049	55056858	55071464	7
chr9	55068028	55131432	Nrg4	63404	-	NM_032002	55075728	55130367	8
chr9	55174755	55286151	Tmem266	111396	+	NM_172923	55225382	55285509	11
chr9	55302242	55360050	Etfa	57808	-	NM_145615	55302530	55359876	12
chr9	55388955	55393985	Isl2	5030	+	NM_027397	55389087	55393346	6
chr9	55397689	55785922	Scaper	388233	-	NM_001081341	55398574	55767336	33
chr9	55810395	55828739	4930563M21Rik	18344	-	NM_183111	55810549	55828695	8
chr9	55875442	55879380	Gm7444	3938	+	NR_033529	55879380	55879380	1
chr9	55889651	55906890	Rcn2	17239	+	NM_011992	55889858	55906018	7
chr9	55937782	55976697	Pstpip1	38915	+	NM_011193	55938215	55976527	15
chr9	55983690	56008877	Tspan3	25187	-	NM_019793	55984449	56008669	7
chr9	56048935	56265857	Peak1	216922	-	NM_172924	56054254	56108449	7
chr9	56266652	56344743	Hmg20a	78091	+	NM_025812	56315168	56337765	10
chr9	56466281	56533060	Lingo1	66779	-	NM_181074	56467265	56469110	4
chr9	56696465	56699770	Odf3l1	3305	-	NM_198673	56696616	56699583	5
chr9	56712910	56747677	Cspg4	34767	+	NM_139001	56712996	56746697	10
chr9	56765006	56776178	Snx33	11172	-	NM_175483	56766257	56774590	2
chr9	56785306	56786205	Imp3	899	+	NM_133976	56785313	56785868	1
chr9	56798730	56831006	Snupn	32276	+	NM_178374	56804825	56830780	9
chr9	56842774	56910614	Ptpn9	67840	+	NM_019651	56843400	56908966	13
chr9	56904703	56919773	Gm10658	15070	-	NR_045886	56919773	56919773	3
chr9	56919846	56976175	Sin3a	56329	+	NM_001110351	56934419	56975185	22
chr9	56977788	56979097	Man2c1os	1309	-	NR_102289	56979097	56979097	2
chr9	56978583	56990017	Man2c1	11434	+	NM_028636	56978595	56989928	26
chr9	56991062	56994841	Neil1	3779	-	NM_028347	56991062	56994841	9
chr9	57002847	57006106	Commd4	3259	-	NM_025417	57003046	57006081	8
chr9	57023081	57033915	1700041C23Rik	10834	+	NR_033784	57033915	57033915	6
chr9	57084362	57097671	Trcg1	13309	+	NM_001014398	57088169	57097591	13
chr9	57100128	57110406	1700017B05Rik	10278	-	NM_028820	57101768	57106896	3
chr9	57238876	57248171	4930430J02Rik	9295	+	NR_040729	57248171	57248171	3
chr9	57260470	57287921	Ppcdc	27451	-	NM_176831	57262447	57282844	7
chr9	57289133	57315867	Scamp5	26734	-	NM_020270	57291476	57299793	7
chr9	57351908	57353254	Rpp25	1346	+	NM_133982	57352043	57352643	1
chr9	57369038	57380233	Cox5a	11195	+	NM_007747	57369134	57379589	5
chr9	57385334	57390994	Fam219b	5660	+	NM_001166364	57385427	57388626	5
chr9	57392074	57400559	Mpi	8485	-	NM_025837	57392526	57400526	8
chr9	57408750	57436605	Scamp2	27855	+	NM_022813	57408860	57435363	9
chr9	57437258	57444040	Ulk3	6782	+	NM_027895	57437391	57442766	16
chr9	57447798	57454088	Cplx3	6290	-	NM_146223	57450043	57453951	3
chr9	57454839	57468581	Lman1l	13742	-	NM_199222	57454954	57468477	13
chr9	57474452	57501438	Csk	26986	-	NM_001304761	57475127	57479188	15
chr9	57524743	57531462	Cyp1a2	6719	-	NM_009993	57525034	57530336	7
chr9	57535734	57551631	Cyp1a1	15897	+	NM_009992	57547897	57550686	7
chr9	57556375	57597969	Edc3	41594	+	NM_153799	57561204	57596302	7
chr9	57598517	57613667	Clk3	15150	-	NM_007713	57598751	57613324	13
chr9	57638315	57682041	Arid3b	43726	-	NM_019689	57640322	57681968	8
chr9	57758792	57777775	Ubl7	18983	+	NM_001122873	57760473	57777657	11
chr9	57787941	57810672	Sema7a	22731	+	NM_011352	57787957	57809408	14
chr9	57862823	57874830	Cyp11a1	12007	+	NM_019779	57862845	57874659	9
chr9	57876488	57966630	Ccdc33	90142	-	NM_001166282	57876564	57966551	20
chr9	57880080	57896804	Gm16130	16724	+	NM_001243265	57881427	57895280	5
chr9	57976894	58001804	Stra6	24910	+	NM_001162475	57982896	58001129	19
chr9	58004070	58007028	Islr	2958	-	NM_012043	58004742	58006029	2
chr9	58044103	58052126	Islr2	8023	-	NM_001161541	58045544	58047782	3
chr9	58050703	58056615	1600029O15Rik	5912	+	NR_033522	58056615	58056615	3
chr9	58064986	58097593	Pml	32607	-	NM_178087	58067609	58097497	9
chr9	58068956	58069061	Mir6385	105	+	NR_105806	58069061	58069061	1
chr9	58100970	58110331	Stoml1	9361	+	NR_028146	58110331	58110331	8
chr9	58135529	58161019	Loxl1	25490	-	NM_010729	58136717	58160693	7
chr9	58207610	58218176	Tbc1d21	10566	-	NM_028854	58207652	58218132	11
chr9	58218310	58221990	1700072B07Rik	3680	+	NR_040727	58221990	58221990	3
chr9	58302979	58317430	4930461G14Rik	14451	+	NR_040736	58317430	58317430	3
chr9	58336409	58347549	6030419C18Rik	11140	+	NM_176921	58338043	58347494	3
chr9	58372106	58388747	Cd276	16641	-	NM_133983	58374145	58388552	7
chr9	58430046	58500686	Nptn	70640	+	NM_009145	58430242	58499125	8
chr9	58500662	58589366	Rec114	88704	-	NM_028598	58500748	58589349	6
chr9	58671318	58708762	Hcn4	37444	+	NM_001081192	58671318	58708570	8
chr9	58722486	58884248	Neo1	161762	-	NM_008684	58725080	58883935	29
chr9	59139378	59164007	Adpgk	24629	+	NM_028121	59139440	59163089	7
chr9	59169772	59201315	Bbs4	31543	-	NM_175325	59170676	59201240	16
chr9	59236360	59334181	Arih1	97821	-	NM_019927	59241100	59334154	14
chr9	59325551	59329548	Gm20199	3997	-	NR_045640	59329548	59329548	1
chr9	59366491	59373308	Tmem202	6817	-	NM_178388	59366860	59373249	5
chr9	59387473	59412912	Hexa	25439	+	NM_010421	59387530	59412691	14
chr9	59426143	59455099	Celf6	28956	+	NM_175235	59426184	59452891	12
chr9	59465090	59498097	Parp6	33007	+	NM_029922	59470347	59497833	24
chr9	59504174	59527182	Pkm	23008	+	NM_001253883	59513019	59526641	11
chr9	59555570	59564231	Gramd2	8661	+	NM_001033498	59555786	59564018	11
chr9	59582065	59598456	Senp8	16391	-	NM_001172068	59584973	59585639	4
chr9	59598980	59776673	Myo9a	177693	+	NM_173018	59627420	59772838	44
chr9	59790577	59797886	Nr2e3	7309	-	NM_013708	59791193	59797691	8
chr9	59799100	59806851	Gm7616	7751	+	NM_001101600	59799192	59800174	4
chr9	59814737	60358842	Thsd4	544105	-	NM_001040426	59820202	60344933	18
chr9	60371773	60393689	9230112J17Rik	21916	-	NR_040463	60393689	60393689	5
chr9	60435043	60535941	Lrrc49	100898	-	NM_145616	60435494	60535666	17
chr9	60560927	60586608	Larp6	25681	+	NM_026235	60561012	60585864	3
chr9	60642354	60728177	Uaca	85823	+	NM_028283	60642415	60728052	19
chr9	60864875	60867604	Gm5122	2729	+	NR_040767	60867604	60867604	3
chr9	60950818	60953193	4933433G08Rik	2375	-	NR_105026	60953193	60953193	2
chr9	60986321	60993066	I730028E13Rik	6745	+	NR_045705	60993066	60993066	3
chr9	61107033	61141616	B930092H01Rik	34583	-	NR_045334	61141616	61141616	5
chr9	61220172	61266304	Tle3	46132	+	NM_001083928	61221244	61264523	20
chr9	61761089	61762317	Rplp1	1228	-	NM_018853	61761130	61762235	3
chr9	61765084	61794606	Kif23	29522	-	NM_024245	61765470	61794429	23
chr9	61801544	61874597	Paqr5	73053	-	NM_028748	61803852	61836850	8
chr9	61905055	61918413	Glce	13358	-	NM_033320	61907817	61918407	3
chr9	61970324	61970401	Mir5133	77	-	NR_039595	61970401	61970401	1
chr9	62090402	62091907	A730043L09Rik	1505	-	NR_040769	62091907	62091907	3
chr9	62118535	62129986	Spesp1	11451	-	NM_025721	62120231	62129869	2
chr9	62189149	62226609	Anp32a	37460	+	NM_009672	62189307	62225422	7
chr9	62267298	62384851	Coro2b	117553	-	NM_175484	62269088	62384474	12
chr9	62525661	62631786	Itga11	106125	+	NM_176922	62525751	62630506	30
chr9	62639635	62659455	Fem1b	19820	-	NM_010193	62643899	62659112	2
chr9	62686593	62699809	Cln6	13216	+	NM_001033175	62686687	62698694	7
chr9	62689283	62709831	Gm10653	20548	-	NR_003965	62709831	62709831	4
chr9	62705910	62723724	Calml4	17814	+	NM_138304	62705965	62723381	5
chr9	62727883	62828686	Pias1	100803	-	NM_019663	62729774	62828678	14
chr9	62985970	62996768	Skor1	10798	-	NM_001163758	62986677	62994375	9
chr9	63011576	63225659	Map2k5	214083	-	NM_011840	63011892	63225064	22
chr9	63242253	63247051	2300009A05Rik	4798	-	NM_027090	63242354	63247028	2
chr9	63269255	63450300	Iqch	181045	-	NM_030068	63269641	63450224	22
chr9	63450461	63489696	Aagab	39235	+	NM_025857	63450505	63488091	10
chr9	63494573	63605801	Smad3	111228	-	NM_016769	63498068	63605484	9
chr9	63800882	63869866	Smad6	68984	-	NM_008542	63801330	63868831	4
chr9	63886271	63889272	1700055C04Rik	3001	-	NR_040726	63889272	63889272	3
chr9	63897635	63901907	1110036E04Rik	4272	+	NR_040713	63901907	63901907	3
chr9	63928567	63935852	Scarletltr	7285	+	NR_040743	63935852	63935852	3
chr9	63964953	63985925	Lctl	20972	+	NM_145835	63965540	63985728	14
chr9	63984950	64020738	Zwilch	35788	-	NM_026507	63987734	64020698	19
chr9	64021193	64026369	Rpl4	5176	+	NM_024212	64021237	64026251	10
chr9	64023238	64023329	Snord16a	91	+	NR_028548	64023329	64023329	1
chr9	64027103	64030495	Snapc5	3392	+	NM_183316	64027137	64030077	3
chr9	64033599	64101412	Map2k1	67813	-	NM_008927	64034491	64101099	11
chr9	64083007	64084169	Uchl4	1162	+	NM_033607	64083045	64083747	1
chr9	64129413	64152599	Tipin	23186	+	NM_025372	64135920	64152277	8
chr9	64154562	64189064	Dis3l	34502	-	NM_001001295	64154849	64188938	17
chr9	64233432	64557012	Megf11	323580	+	NM_001134399	64349335	64554491	25
chr9	64563106	64585563	Rab11a	22457	-	NM_017382	64564655	64585430	5
chr9	64658817	64767474	Dennd4a	108657	+	NM_001162917	64686640	64764902	35
chr9	64770667	64799414	Slc24a1	28747	-	NM_144813	64772227	64797430	10
chr9	64808638	64834788	Vwa9	26150	+	NM_001077631	64812188	64833908	13
chr9	64834789	64869524	Hacd3	34735	-	NM_021345	64836259	64869350	11
chr9	64880264	64930458	Dpp8	50194	+	NM_028906	64882802	64928660	21
chr9	64949292	64985754	Igdcc4	36462	+	NM_001290315	64949341	64983335	20
chr9	64988995	65033677	Igdcc3	44682	+	NM_008988	64989221	65033141	14
chr9	65062496	65087026	Parp16	24530	+	NM_177460	65063265	65085796	7
chr9	65112986	65128412	Cilp	15426	+	NM_173385	65114938	65128184	10
chr9	65142066	65178465	Clpx	36399	+	NM_011802	65142293	65177711	14
chr9	65193874	65207450	Pdcd7	13576	+	NM_016688	65193948	65206524	5
chr9	65208866	65228184	Ubap1l	19318	+	NM_001111145	65217024	65228101	7
chr9	65236490	65239459	Kbtbd13	2969	-	NM_028974	65238082	65239459	1
chr9	65246294	65262660	Rasl12	16366	+	NM_001162923	65246371	65261307	5
chr9	65260559	65270580	Slc51b	10021	-	NM_178933	65260603	65263064	4
chr9	65283588	65300861	Mtfmt	17273	+	NM_027134	65283620	65300012	9
chr9	65308743	65336277	Spg21	27534	+	NM_138584	65313094	65334756	9
chr9	65400383	65427894	Plekho2	27511	-	NM_153119	65403884	65427756	6
chr9	65435011	65443769	Pif1	8758	+	NM_172453	65435616	65442647	12
chr9	65478388	65508325	Rbpms2	29937	+	NM_028030	65478635	65507004	8
chr9	65524354	65538107	Oaz2	13753	+	NM_010952	65524552	65537032	5
chr9	65539389	65675371	Zfp609	135982	-	NM_172536	65543954	65643175	10
chr9	65676732	65756601	Trip4	79869	-	NM_019797	65681187	65732835	16
chr9	65738129	65751358	2810417H13Rik	13229	+	NM_026515	65738235	65749410	4
chr9	65756816	65892821	Csnk1g1	136005	+	NM_173185	65806347	65887438	14
chr9	65907975	65914436	Ppib	6461	+	NM_011149	65908072	65914224	5
chr9	65912982	65917538	Snx22	4556	-	NM_001025612	65914907	65917487	7
chr9	65935933	65972693	Snx1	36760	-	NM_019727	65936325	65972572	15
chr9	65974417	65986775	Fam96a	12358	+	NM_026635	65974653	65986241	5
chr9	66006032	66120049	Dapk2	114017	+	NM_010019	66013150	66119514	12
chr9	66198256	66356582	Herc1	158326	+	NM_145617	66219618	66356131	78
chr9	66356265	66362400	Fbxl22	6135	-	NM_175206	66359449	66362360	2
chr9	66362445	66440922	Usp3	78477	-	NM_144937	66366219	66440681	15
chr9	66561492	66614652	Car12	53160	+	NM_178396	66561655	66612164	11
chr9	66623293	66643230	Aph1b	19937	-	NM_177583	66627019	66643172	6
chr9	66662800	66682513	Aph1c	19713	-	NM_026674	66667100	66682405	6
chr9	66691470	66767512	Rab8b	76042	-	NM_173413	66695525	66767440	8
chr9	66793882	66797329	Rps27l	3447	+	NM_001311101	66793981	66797148	5
chr9	66803199	66823291	Lactb	20092	-	NM_030717	66803481	66823198	6
chr9	66870399	66897020	Tpm1	26621	-	NM_001164249	66871165	66896939	9
chr9	66981367	67011595	Gm19299	30228	+	NR_045748	67011595	67011595	3
chr9	67064891	67407510	Tln2	342619	-	NM_001081242	67069196	67245454	58
chr9	67084466	67084533	Mir190a	67	-	NR_029576	67084533	67084533	1
chr9	67575523	67575587	Mir7241	64	-	NR_106100	67575587	67575587	1
chr9	67577305	67577384	Mir7242	79	-	NR_106101	67577384	67577384	1
chr9	67607243	67608740	C2cd4b	1497	+	NM_001081314	67607530	67608553	2
chr9	67678338	67680137	C2cd4a	1799	-	NM_001163143	67678561	67679566	2
chr9	67688202	67843441	Vps13c	155239	+	NM_177184	67688233	67843196	85
chr9	67865770	67873521	Gm20745	7751	-	NR_045745	67873521	67873521	3
chr9	68318708	68368007	4930502A04Rik	49299	-	NR_040737	68368007	68368007	4
chr9	68501592	69236053	Rora	734461	+	NM_013646	68501613	69226768	11
chr9	68613152	68621129	9530091C08Rik	7977	+	NR_033299	68621129	68621129	1
chr9	69245804	69280881	Ice2	35077	+	NM_145618	69246853	69279976	16
chr9	69301489	69339592	Anxa2	38103	+	NM_007585	69312283	69339312	13
chr9	69304750	69304838	Mir3109	88	+	NR_037296	69304838	69304838	1
chr9	69605516	69608747	Foxb1	3231	-	NM_022378	69607075	69608053	2
chr9	69608952	69678006	B230323A14Rik	69054	+	NR_040765	69678006	69678006	5
chr9	69837272	69859466	Bnip2	22194	+	NM_016787	69843284	69854922	11
chr9	69860354	69870673	Gtf2a2	10319	+	NR_104093	69870673	69870673	6
chr9	69879302	69885895	Gcnt3	6593	-	NM_028087	69881777	69883091	3
chr9	69937116	69989364	Fam81a	52248	-	NM_029784	69938573	69974004	9
chr9	70055156	70247874	Myo1e	192718	+	NM_181072	70055507	70246605	28
chr9	70253500	70253560	Mir5626	60	-	NR_049200	70253560	70253560	1
chr9	70255495	70269361	Ccnb2	13866	-	NM_007630	70255725	70269247	9
chr9	70273235	70351532	Rnf111	78297	-	NM_033604	70274796	70324456	15
chr9	70390676	70440039	Sltm	49363	+	NM_025690	70390726	70439494	21
chr9	70446820	70504981	Fam63b	58161	-	NM_172772	70452967	70504853	9
chr9	70526807	70628036	Adam10	101229	+	NM_007399	70527011	70625901	16
chr9	70645934	70782615	Lipc	136681	-	NM_008280	70646073	70782367	9
chr9	70958465	71011096	Aqp9	52631	-	NR_073483	71011096	71011096	7
chr9	71016582	71055929	Gm32511	39347	+	NR_110517	71055929	71055929	6
chr9	71059719	71063193	Gm3458	3474	-	NR_110518	71063193	71063193	4
chr9	71063595	71144050	Aldh1a2	80455	+	NM_009022	71063653	71141485	14
chr9	71326243	71333790	Polr2m	7547	-	NM_178602	71327203	71333603	4
chr9	71352153	71440167	Myzap	88014	-	NM_001033208	71352939	71440071	13
chr9	71474313	71619409	Cgnl1	145096	-	NM_026599	71477066	71573874	19
chr9	71692058	71959626	Tcf12	267568	-	NM_011544	71697589	71958619	21
chr9	72122694	72211578	Zfp280d	88884	+	NM_146224	72143126	72210314	22
chr9	72286335	72306383	Mns1	20048	+	NM_008613	72286483	72306200	10
chr9	72305861	72339766	Tex9	33905	-	NM_009359	72309007	72339759	12
chr9	72366056	72379665	4930509E16Rik	13609	-	NR_045735	72379665	72379665	3
chr9	72380046	72470756	Rfx7	90710	+	NM_001033536	72380626	72467716	9
chr9	72510153	72597655	Nedd4	87502	+	NM_010890	72510363	72595035	29
chr9	72655080	72765114	Prtg	110034	+	NM_175485	72655263	72760109	20
chr9	72773456	72793822	Pygo1	20366	+	NM_028116	72773718	72793593	3
chr9	72806591	72820874	Dyx1c1	14283	+	NM_026314	72806681	72820249	9
chr9	72827532	72833183	Ccpg1os	5651	-	NM_001198789	72827661	72832974	2
chr9	72833310	72864147	Ccpg1	30837	+	NM_001286545	72845217	72863721	10
chr9	72863502	72887506	Pigb	24004	-	NM_018889	72863958	72887398	12
chr9	72887524	72890589	2310009A05Rik	3065	+	NM_001308425	72890309	72890483	2
chr9	72892616	72945421	Rab27a	52805	+	NM_001301230	72923221	72943263	7
chr9	72950204	72952250	Khdc3	2046	+	NM_001311106	72950316	72952170	4
chr9	72961275	72971140	Rsl24d1	9865	+	NM_198609	72961309	72970144	6
chr9	73327230	73781374	Unc13c	454144	-	NM_001081153	73328676	73781374	31
chr9	73958140	74131010	Wdr72	172870	+	NM_001033500	73982234	74129530	20
chr9	74696243	74700679	Gm16551	4436	+	NR_045284	74700679	74700679	3
chr9	74709727	74737454	Onecut1	27727	+	NM_008262	74710103	74737405	2
chr9	74800859	74880275	Fam214a	79416	+	NM_001113283	74801621	74879475	13
chr9	74885420	74908120	Arpp19	22700	+	NM_001142655	74885437	74904612	4
chr9	74919012	75071494	Myo5a	152482	+	NM_010864	74919439	75065800	41
chr9	75079820	75153257	Myo5c	73437	+	NM_001081322	75079955	75151889	41
chr9	75154094	75193730	Gnb5	39636	+	NM_010313	75159201	75192771	13
chr9	75195564	75199447	Bcl2l10	3883	+	NM_013479	75195709	75198940	2
chr9	75234588	75257823	Mapk6	23235	-	NM_015806	75235858	75245940	6
chr9	75257990	75263344	4933433G15Rik	5354	+	NR_040719	75263344	75263344	4
chr9	75289330	75314239	Leo1	24909	+	NM_001039522	75289384	75314105	12
chr9	75345590	75407464	Tmod3	61874	-	NM_016963	75347922	75380358	10
chr9	75413428	75459132	Tmod2	45704	-	NM_016711	75421895	75445142	10
chr9	75473538	75485580	Lysmd2	12042	+	NM_027309	75473571	75485061	3
chr9	75491172	75531863	Scg3	40691	-	NM_009130	75491632	75531532	12
chr9	75623171	75748123	Bmp5	124952	+	NM_007555	75623899	75746389	7
chr9	75862783	75984157	Hmgcll1	121374	+	NM_173731	75862881	75981672	9
chr9	76011908	76061464	Gfral	49556	-	NM_205844	76012611	76061269	9
chr9	76073686	76171385	Hcrtr2	97699	-	NM_198962	76075957	76171311	8
chr9	76338511	76393611	Fam83b	55100	-	NM_001045518	76338587	76393590	4
chr9	76799504	76893588	Tinag	94084	-	NM_012033	76799703	76893507	11
chr9	76949890	77195677	Mlip	245787	-	NM_027150	76950197	77195570	8
chr9	77214218	77247223	5730403I07Rik	33005	-	NR_040378	77247223	77247223	4
chr9	77278629	77392659	Lrrc1	114030	-	NM_001146048	77279928	77392430	14
chr9	77484538	77507929	Klhl31	23391	+	NM_172925	77497810	77503666	3
chr9	77602341	77642296	Gclc	39955	+	NM_010295	77602616	77641058	16
chr9	77765171	77832326	Elovl5	67155	+	NM_134255	77804955	77830615	8
chr9	77899764	77913431	Gcm1	13667	+	NM_008103	77901723	77912896	6
chr9	77929305	77956872	Fbxo9	27567	-	NM_001081490	77929786	77956814	13
chr9	77956998	78019916	Ick	62918	+	NM_001163780	77979277	78015561	14
chr9	78023720	78026689	C920006O11Rik	2969	+	NR_040401	78026689	78026689	4
chr9	78039772	78057156	Gsta4	17384	+	NM_010357	78046096	78056986	7
chr9	78078475	78090490	Gsta1	12015	+	NM_008181	78080046	78090385	7
chr9	78104935	78116973	Gm3776	12038	+	NM_001243092	78106518	78116868	7
chr9	78137734	78153332	Gm10639	15598	+	NM_001122660	78142612	78153224	7
chr9	78159778	78162604	Omt2a	2826	-	NM_001164523	78160054	78162543	3
chr9	78175836	78177427	Omt2b	1591	+	NM_205822	78175944	78177160	3
chr9	78178826	78194952	Gsta2	16126	-	NM_008182	78178933	78189723	7
chr9	78214860	78216006	Dppa5a	1146	-	NM_025274	78215042	78215906	3
chr9	78224709	78226395	Ooep	1686	-	NM_026480	78225361	78226335	3
chr9	78243583	78271396	Ddx43	27813	+	NM_001191044	78243686	78269618	17
chr9	78278324	78291044	Mb21d1	12720	-	NM_173386	78280731	78290885	5
chr9	78296016	78321959	Mto1	25943	+	NM_026658	78296103	78321692	12
chr9	78326260	78329531	Eef1a1	3271	-	NM_010106	78326540	78328461	8
chr9	78384293	78435852	Slc17a5	51559	-	NM_172773	78385968	78435774	11
chr9	78463352	78564067	Cd109	100715	+	NM_153098	78463688	78562865	33
chr9	79291843	79367109	Gm10635	75266	-	NR_045336	79367109	79367109	3
chr9	79446793	79566529	Col12a1	119736	-	NM_001290308	79448975	79563243	66
chr9	79603047	79607660	Cox7a2	4613	-	NM_009945	79603353	79607464	4
chr9	79616747	79641237	Tmem30a	24490	-	NM_133718	79619092	79641017	7
chr9	79641447	79651042	4930429F24Rik	9595	+	NR_040734	79651042	79651042	3
chr9	79663368	79825689	Filip1	162321	-	NM_001081243	79663497	79746277	6
chr9	79914709	79992588	Senp6	77879	+	NM_001311110	79915330	79991669	24
chr9	80012840	80159536	Myo6	146696	+	NM_001039546	80065447	80155678	33
chr9	80161136	80359045	Impg1	197909	-	NM_022016	80162177	80358896	17
chr9	81524998	81526159	Htr1b	1161	-	NM_010482	81524998	81526159	1
chr9	81525536	81538763	D430036J16Rik	13227	+	NR_040393	81538763	81538763	5
chr9	81757350	81921098	Mei4	163748	+	NM_175213	81783742	81919395	5
chr9	82723412	82741295	Irak1bp1	17883	+	NM_022986	82723634	82740404	4
chr9	82759765	82869096	Phip	109331	-	NM_001081216	82764830	82868898	40
chr9	83003548	83040214	Hmgn3	36666	-	NM_175074	83004022	83040052	6
chr9	83284961	83334734	Lca5	49773	-	NM_029434	83285454	83320398	8
chr9	83325153	83348181	Gm2087	23028	+	NR_102437	83348181	83348181	3
chr9	83441944	83493898	Sh3bgrl2	51954	+	NM_172507	83442065	83490843	4
chr9	83585081	83586854	Gm2109	1773	+	NR_046066	83586854	83586854	3
chr9	83672298	83699912	Elovl4	27614	-	NM_148941	83674146	83699645	6
chr9	83728295	83765997	Ttk	37702	+	NM_009445	83729395	83765675	22
chr9	83818743	84017847	Bckdhb	199104	+	NM_001305935	83818776	84015981	11
chr9	84668004	84677958	4930554C24Rik	9954	+	NR_040739	84677958	84677958	5
chr9	85214045	85220757	Fam46a	6712	-	NM_001160379	85218063	85220375	3
chr9	85580966	85642941	Ibtk	61975	-	NM_001081282	85581989	85637302	29
chr9	85735986	85740662	Tpbg	4676	+	NM_011627	85737586	85738867	2
chr9	86200840	86358523	Ube2cbp	157683	-	NM_027394	86201462	86358424	10
chr9	86360760	86449413	Dopey1	88653	+	NM_177208	86379072	86447928	39
chr9	86446082	86465449	Pgm3	19367	-	NM_028352	86448920	86464012	13
chr9	86465594	86468506	Rwdd2a	2912	+	NM_001145969	86466469	86468258	3
chr9	86474969	86589947	Me1	114978	-	NM_008615	86476343	86589783	14
chr9	86589474	86595286	A330041J22Rik	5812	+	NR_045835	86595286	86595286	3
chr9	86636433	86650678	Prss35	14245	+	NM_178738	86648350	86649580	2
chr9	86659229	86775284	Snap91	116055	-	NM_013669	86668352	86774386	31
chr9	86910371	86914751	Ripply2	4380	+	NM_001037907	86910379	86914644	4
chr9	86916863	86972609	Cyb5r4	55746	+	NM_024195	86917013	86971717	16
chr9	87039140	87078880	Mrap2	39740	+	NM_001177731	87064360	87077666	5
chr9	87086797	87150367	Cep162	63570	-	NM_199316	87087550	87148823	27
chr9	87597634	87626095	Tbx18	28461	-	NM_023814	87600055	87625679	8
chr9	88222446	88266927	Nt5e	44481	+	NM_011851	88222523	88265155	9
chr9	88271584	88333789	Snx14	62205	-	NM_172926	88271738	88333726	28
chr9	88344201	88377235	Syncrip	33034	-	NM_019796	88349091	88375591	12
chr9	88415890	88417735	Snhg5	1845	-	NR_040721	88417735	88417735	5
chr9	88442857	88465924	Zfp949	23067	+	NM_001142943	88449367	88465028	6
chr9	88475873	88483657	Trim43a	7784	+	NM_001034906	88476875	88483318	7
chr9	88490162	88494081	9430037G07Rik	3919	-	NR_040766	88494081	88494081	5
chr9	88583442	88614636	Mthfsl	31194	-	NM_001128601	88583590	88614613	3
chr9	88618125	88626688	Bcl2a1d	8563	-	NM_007536	88618271	88626557	2
chr9	88734001	88743028	Trim43c	9027	+	NM_001177858	88735140	88742683	7
chr9	88736635	88753708	9330159M07Rik	17073	-	NR_037983	88753708	88753708	5
chr9	88851757	88857254	Bcl2a1a	5497	+	NM_009742	88851888	88857108	2
chr9	88979461	88987673	Trim43b	8212	-	NM_001170884	88980081	88986516	7
chr9	89094110	89102676	Bcl2a1b	8566	+	NM_007534	89094197	89102518	2
chr9	89106027	89135063	Mthfs	29036	+	NM_026829	89106032	89134912	3
chr9	89484871	89517824	AF529169	32953	-	NM_153509	89485940	89498180	4
chr9	89594040	89599881	Tmed3	5841	-	NM_025360	89594580	89599763	3
chr9	89623086	89633313	Ankrd34c	10227	-	NM_207260	89623519	89625124	2
chr9	89697097	89697166	Mir184	69	-	NR_029570	89697166	89697166	1
chr9	89721356	89758866	4930524O08Rik	37510	+	NR_040735	89758866	89758866	6
chr9	89804612	89921817	Rasgrf1	117205	+	NM_011245	89804835	89921601	27
chr9	89949104	89970933	Ctsh	21829	+	NM_007801	89949387	89970595	12
chr9	89986506	90009658	Morf4l1	23152	-	NM_001039147	89987155	90009413	13
chr9	90057815	90094940	Adamts7	37125	+	NM_001311115	90058082	90094709	25
chr9	90096886	90165607	Tbc1d2b	68721	-	NM_194334	90099864	90165549	13
chr9	91255182	91260637	Zic1	5455	-	NM_009573	91256406	91259855	3
chr9	91263809	91284186	Zic4	20377	+	NM_009576	91267460	91281373	5
chr9	92087773	92104536	Plscr5	16763	+	NM_001195693	92088065	92104536	7
chr9	92145031	92167399	Plscr1	22368	+	NM_011636	92152899	92166426	9
chr9	92162095	92162199	Mir6386	104	-	NR_105808	92162199	92162199	1
chr9	92170439	92192590	Plscr2	22151	+	NM_001195084	92176957	92192039	8
chr9	92204214	92252714	1700057G04Rik	48500	+	NM_001033184	92238464	92252593	7
chr9	92352215	92387354	Plscr4	35139	+	NM_178711	92366579	92385645	9
chr9	92433638	92437707	B430319G15Rik	4069	-	NR_029474	92437707	92437707	1
chr9	92437060	92503265	Plod2	66205	+	NM_001142916	92437297	92502068	20
chr9	92613553	92690549	4933400C23Rik	76996	+	NR_040770	92690549	92690549	5
chr9	92874753	92900571	1700034K08Rik	25818	-	NR_040756	92900571	92900571	4
chr9	94418282	94438500	1190002N15Rik	20218	-	NM_001033145	94420733	94438294	3
chr9	94570310	95130871	Slc9a9	560561	+	NM_177909	94570480	95129484	16
chr9	94652247	94652309	Mir7656	62	+	NR_106116	94652309	94652309	1
chr9	95301344	95307689	Chst2	6345	-	NM_018763	95305117	95306710	2
chr9	95357312	95412415	U2surp	55103	-	NM_001114977	95361823	95412280	28
chr9	95460235	95462540	Paqr9	2305	+	NM_198414	95460377	95461505	1
chr9	95538046	95595970	Pcolce2	57924	+	NM_029620	95538212	95595515	9
chr9	95605485	95650777	Trpc1	45292	-	NM_011643	95607158	95650306	13
chr9	95653060	95745698	Pls1	92638	-	NM_001033210	95654720	95696250	16
chr9	95755836	95758301	1700065D16Rik	2465	-	NM_001271569	95755866	95758175	2
chr9	95758015	95852063	Atr	94048	+	NM_019864	95758143	95852043	47
chr9	95855178	95958225	Xrn1	103047	+	NM_001311130	95855287	95953228	42
chr9	96019847	96083372	Gk5	63525	+	NM_177352	96019869	96082199	17
chr9	96096693	96224065	Tfdp2	127372	+	NM_178667	96174358	96218390	14
chr9	96233094	96264718	Atp1b3	31624	-	NM_007502	96233942	96264573	7
chr9	96371355	96379094	Rnf7	7739	-	NM_011279	96372152	96379001	3
chr9	96439718	96531922	Rasa2	92204	-	NM_053268	96442863	96531912	24
chr9	96585841	96632094	Zbtb38	46253	-	NM_175537	96585854	96589448	3
chr9	96631993	96653250	E030011O05Rik	21257	-	NR_015511	96653250	96653250	4
chr9	96665980	96674816	C430002N11Rik	8836	+	NR_102296	96674816	96674816	5
chr9	96723761	96789893	Pxylp1	66132	-	NM_001289645	96725103	96756865	7
chr9	96843900	96918774	Spsb4	74874	-	NM_145134	96844995	96896687	3
chr9	96977429	97011460	Slc25a36	34031	-	NM_138756	96979464	97011370	7
chr9	97249980	97270377	Trim42	20397	-	NM_030219	97250157	97270263	5
chr9	97344813	97933586	Clstn2	588773	-	NM_022319	97346071	97933394	18
chr9	97903838	97912594	4921534H16Rik	8756	+	NR_110443	97912594	97912594	2
chr9	98197001	98311847	Nmnat3	114846	+	NM_144533	98254474	98310860	5
chr9	98323379	98346969	Rbp1	23590	+	NM_011254	98325397	98346768	4
chr9	98390955	98410190	Rbp2	19235	+	NM_009034	98391028	98409996	4
chr9	98462878	98464030	4930579K19Rik	1152	-	NR_029444	98464030	98464030	1
chr9	98464149	98488794	Copb2	24645	+	NM_015827	98464239	98488559	22
chr9	98489149	98502098	Mrps22	12949	-	NM_025485	98489249	98502063	8
chr9	98649017	98720506	E330023G01Rik	71489	-	NR_045332	98720506	98720506	3
chr9	98743005	98744064	Prr23a1	1059	+	NM_001134660	98743005	98743782	1
chr9	98757009	98757771	Prr23a2	762	+	NM_001134661	98757009	98757771	1
chr9	98765185	98766999	Prr23a3	1814	+	NM_028033	98765413	98766178	1
chr9	98803537	98805041	7420426K07Rik	1504	+	NM_001033983	98803702	98804263	1
chr9	98849573	98855729	Foxl2os	6156	-	NR_003248	98855729	98855729	8
chr9	98856025	98858545	Foxl2	2520	+	NM_012020	98856079	98857207	1
chr9	98886791	98902438	Faim	15647	+	NM_001122851	98891346	98902123	6
chr9	98907383	98936109	Gm1123	28726	-	NM_001080776	98907480	98936042	8
chr9	98938820	99040630	Pik3cb	101810	-	NM_029094	98940131	99006102	24
chr9	99129794	99137658	Faiml	7864	-	NM_001244762	99129886	99136766	5
chr9	99143886	99200822	Cep70	56936	+	NM_023873	99146776	99200208	18
chr9	99210385	99258949	Esyt3	48564	-	NM_177775	99212059	99258808	23
chr9	99285838	99337131	Mras	51293	-	NM_008624	99288823	99312004	6
chr9	99356661	99380318	Nme9	23657	+	NM_001165957	99356661	99380318	10
chr9	99370839	99375170	1600029I14Rik	4331	+	NR_028123	99375170	99375170	2
chr9	99378809	99469318	Armc8	90509	-	NM_028768	99381162	99469065	22
chr9	99476217	99484762	Dbr1	8545	+	NM_031403	99476347	99484442	8
chr9	99512920	99522786	A4gnt	9866	+	NM_001077424	99513931	99521233	3
chr9	99529949	99570494	Dzip1l	40545	+	NM_028258	99537840	99568222	16
chr9	99591215	99617686	Cldn18	26471	-	NM_001194921	99593141	99617634	5
chr9	99774524	99776589	Sox14	2065	-	NM_011440	99775380	99776103	1
chr9	99922718	99935089	4930519F24Rik	12371	+	NR_040763	99935089	99935089	3
chr9	100358137	100386892	Il20rb	28755	-	NM_001033543	100359543	100386747	7
chr9	100395421	100446472	Nck1	51051	-	NM_010878	100395895	100409073	4
chr9	100452606	100471504	Slc35g2	18898	-	NM_001101483	100452796	100454035	2
chr9	100544041	100858963	Stag1	314922	+	NM_009282	100605644	100856977	34
chr9	100882450	100935303	Pccb	52853	-	NM_025835	100883103	100935276	15
chr9	100978485	101007129	Msl2	28644	+	NM_001100451	100979002	101004492	2
chr9	101007319	101154162	Ppp2r3a	146843	-	NM_001161362	101010172	101115452	14
chr9	101244523	101250347	Gm28979	5824	+	NR_110509	101250347	101250347	3
chr9	101824457	102257023	Ephb1	432566	-	NM_173447	101825815	102256669	16
chr9	102207253	102207305	Mir7243	52	-	NR_106163	102207305	102207305	1
chr9	102408467	102448569	Ky	40102	+	NM_024291	102408472	102445111	11
chr9	102488907	102528454	Cep63	39547	-	NM_001081122	102489183	102528311	17
chr9	102528625	102536574	Anapc13	7949	+	NM_181394	102532119	102536469	3
chr9	102620133	102635747	Amotl2	15614	+	NM_019764	102622472	102634036	10
chr9	102641977	102659015	Gm5627	17038	+	NR_033301	102659015	102659015	4
chr9	102737249	102810637	Ryk	73388	+	NM_001042607	102737385	102809291	15
chr9	102910818	102990179	Slco2a1	79361	+	NM_033314	102910949	102988209	14
chr9	103014403	103087600	Rab6b	73197	+	NM_173781	103014486	103083576	8
chr9	103090362	103104395	Srprb	14033	-	NM_009275	103092537	103104389	7
chr9	103111205	103132616	Trf	21411	-	NM_133977	103111373	103132546	17
chr9	103152859	103190627	1300017J02Rik	37768	-	NM_027918	103152957	103190553	17
chr9	103207656	103252757	Topbp1	45101	+	NM_176979	103208433	103252246	28
chr9	103255431	103268110	Cdv3	12679	-	NM_175833	103257492	103267698	5
chr9	103325907	103363590	5830418P13Rik	37683	+	NR_040466	103363590	103363590	6
chr9	103327253	103382658	Bfsp2	55405	-	NM_001002896	103327470	103382556	7
chr9	103385265	103664167	Tmem108	278902	-	NM_178638	103386990	103512080	6
chr9	103459419	103468221	4932413F04Rik	8802	+	NR_040764	103468221	103468221	3
chr9	103904873	103946141	Nphp3	41268	+	NM_028721	103905110	103944462	27
chr9	103948917	103965451	Uba5	16534	-	NM_025692	103949932	103965276	12
chr9	103966032	104029976	Acad11	63944	+	NM_175324	103966090	104029026	20
chr9	104000467	104028973	Ackr4	28506	-	NM_145700	104001023	104002076	3
chr9	104053926	104165260	Dnajc13	111334	-	NM_001163026	104054646	104149157	56
chr9	104190569	104240052	Acpp	49483	-	NM_207668	104193740	104239989	11
chr9	104328442	104328517	Mir2136	75	+	NR_035516	104328517	104328517	1
chr9	104472117	104936874	Cpne4	464757	+	NM_028719	104588755	104935209	16
chr9	104955597	104979806	Mrpl3	24209	+	NM_053159	104955750	104979475	10
chr9	105031667	105034135	Nudt16	2468	-	NM_029385	105032660	105034110	3
chr9	105045673	105047412	1700080E11Rik	1739	-	NM_028562	105045769	105047258	3
chr9	105064796	105297617	Nek11	232821	-	NM_172461	105065303	105295351	16
chr9	105297721	105308086	Aste1	10365	+	NM_025651	105298892	105307644	5
chr9	105313691	105423587	Atp2c1	109896	-	NM_001253831	105315388	105423477	27
chr9	105545324	105589985	Pik3r4	44661	+	NM_001081309	105546566	105589615	20
chr9	105591746	105730415	Col6a6	138669	-	NM_001102607	105591826	105691285	37
chr9	105758399	105862974	Col6a5	104575	-	NM_001167923	105759647	105850723	42
chr9	105892648	105999022	Col6a4	106374	-	NM_026763	105893109	105985273	38
chr9	106055190	106060469	Glyctk	5279	-	NM_001039586	106057571	106060196	5
chr9	106056454	106056544	Mir135a-1	90	+	NR_029549	106056544	106056544	1
chr9	106073259	106094037	Wdr82	20778	+	NM_029896	106073549	106090956	9
chr9	106081170	106081258	Mirlet7g	88	+	NR_029526	106081258	106081258	1
chr9	106097283	106101564	Ppm1m	4281	-	NM_026447	106097656	106101524	10
chr9	106105438	106117718	Twf2	12280	+	NM_011876	106105590	106117326	9
chr9	106124928	106129207	Tlr9	4279	+	NM_031178	106125034	106128941	2
chr9	106135785	106150285	Alas1	14500	-	NM_020559	106136367	106149288	11
chr9	106183391	106252222	Poc1a	68831	+	NM_027354	106183769	106252111	11
chr9	106270962	106278054	Dusp7	7092	+	NM_153459	106271128	106276277	3
chr9	106331869	106333898	Rpl29	2029	+	NM_009082	106332308	106333780	4
chr9	106335311	106340567	Acy1	5256	-	NM_025371	106335411	106340053	15
chr9	106342381	106350009	Abhd14a	7628	-	NM_145919	106342552	106346632	7
chr9	106350970	106355249	Abhd14b	4279	+	NM_029631	106352351	106354494	4
chr9	106356168	106366342	Pcbp4	10174	+	NM_021567	106362399	106365750	13
chr9	106366290	106368271	Gpr62	1981	-	NM_001159652	106366981	106368058	1
chr9	106372652	106379280	Parp3	6628	-	NM_145619	106373563	106378306	11
chr9	106379639	106387746	Rrp9	8107	+	NM_145620	106379678	106387676	15
chr9	106402297	106404581	Iqcf1	2284	+	NM_001146701	106402369	106404568	2
chr9	106416903	106418334	Iqcf5	1431	+	NM_029300	106416989	106418323	2
chr9	106445719	106463956	Iqcf3	18237	-	NM_026645	106446176	106463903	8
chr9	106470649	106473298	Iqcf4	2649	-	NM_026090	106470662	106473199	3
chr9	106528912	106529943	Iqcf6	1031	+	NM_001101628	106528912	106529943	2
chr9	106546865	106558440	Grm2	11575	-	NM_001160353	106547348	106556619	6
chr9	106561076	106588283	Tex264	27207	-	NM_001081654	106561357	106584456	6
chr9	106590410	106691544	Rad54l2	101134	-	NM_030730	106595046	106656417	22
chr9	106724306	106783323	Vprbp	59017	+	NM_001015507	106731399	106782315	23
chr9	106786315	106789331	Rbm15b	3016	-	NM_175402	106786634	106789298	1
chr9	106789745	106794269	Manf	4524	-	NM_029103	106791371	106794229	4
chr9	106795155	107134240	Dock3	339085	-	NM_153413	106797724	107133839	53
chr9	107095137	107096392	AA543401	1255	+	NR_102273	107096392	107096392	1
chr9	107157257	107192208	Mapkapk3	34951	-	NM_178907	107158513	107191675	11
chr9	107198989	107205115	Cish	6126	+	NM_009895	107199345	107203231	3
chr9	107229412	107240681	Hemk1	11269	-	NM_133984	107230366	107239562	11
chr9	107242970	107252014	6430571L13Rik	9044	+	NM_175486	107244680	107250356	6
chr9	107302210	107431674	Cacna2d2	129464	+	NM_001174047	107302399	107429795	39
chr9	107436275	107440987	Tmem115	4712	+	NM_019704	107436809	107440397	2
chr9	107441341	107444196	Cyb561d2	2855	-	NM_019720	107442212	107443954	3
chr9	107444539	107448037	Nprl2	3498	+	NM_018879	107444706	107447889	11
chr9	107449640	107453650	Zmynd10	4010	+	NM_053253	107449787	107453367	12
chr9	107453885	107464598	Rassf1	10713	+	NM_001243748	107453927	107463876	6
chr9	107465585	107468439	Tusc2	2854	+	NM_019742	107465717	107467243	3
chr9	107471493	107475109	Hyal2	3616	+	NM_010489	107472480	107474799	4
chr9	107479282	107482464	Hyal1	3182	+	NM_008317	107479349	107481745	4
chr9	107482500	107486379	Nat6	3879	+	NM_019750	107485238	107486183	2
chr9	107483626	107489690	Hyal3	6064	+	NM_178020	107487099	107489157	4
chr9	107490048	107495369	Ifrd2	5321	+	NM_025903	107490219	107494886	12
chr9	107500004	107511572	Sema3b	11568	-	NM_001042779	107501101	107507408	20
chr9	107516468	107537673	Gnai2	21205	-	NM_008138	107517965	107537548	9
chr9	107553485	107571299	Slc38a3	17814	-	NM_001199218	107554264	107561526	16
chr9	107576804	107581923	Gnat1	5119	-	NM_008140	107578218	107581879	9
chr9	107583832	107612806	Sema3f	28974	-	NM_011349	107584759	107607873	18
chr9	107642825	107673333	Rbm5	30508	-	NM_148930	107643297	107671908	25
chr9	107675890	107775150	Rbm6	99260	-	NM_029169	107676012	107755382	21
chr9	107790459	107805470	Mon1a	15011	+	NM_028369	107801015	107805333	6
chr9	107809219	107822714	Mst1r	13495	+	NM_009074	107809475	107822401	19
chr9	107830799	107834792	Actl11	3993	+	NM_026338	107830810	107834434	1
chr9	107838250	107852022	Camkv	13772	+	NM_145621	107847618	107850671	11
chr9	107853293	107874599	Traip	21306	+	NM_011634	107853405	107873427	15
chr9	107877897	107886387	Uba7	8490	+	NM_023738	107878015	107886277	24
chr9	107886554	107888247	Fam212a	1693	-	NM_026597	107886597	107888078	2
chr9	107904978	107951113	Ip6k1	46135	+	NM_013785	107926558	107948303	6
chr9	107951620	107954267	Gmppb	2647	+	NM_177910	107951847	107953788	9
chr9	107954002	107981706	Rnf123	27704	-	NM_032543	107954170	107980134	39
chr9	107955489	107958032	Amigo3	2543	+	NM_177275	107955710	107957237	1
chr9	107982766	107987358	Mst1	4592	+	NM_008243	107982809	107987266	18
chr9	107983828	107983914	Mir7088	86	+	NR_106056	107983914	107983914	1
chr9	107987744	107996811	Apeh	9067	-	NM_146226	107987902	107996777	22
chr9	107998352	108092714	Bsn	94362	-	NM_007567	108006008	108092589	12
chr9	108036048	108040898	4930447F24Rik	4850	+	NR_126078	108040898	108040898	3
chr9	108107191	108166289	Dag1	59098	-	NM_001276486	108109589	108120622	4
chr9	108192787	108198827	Nicn1	6040	+	NM_025449	108192861	108197440	6
chr9	108199252	108203928	Amt	4676	+	NM_001013814	108199266	108203829	9
chr9	108205285	108208490	Tcta	3205	-	NM_133986	108206541	108208275	3
chr9	108208490	108240274	Rhoa	31784	+	NM_016802	108229916	108239152	6
chr9	108241410	108242673	Gpx1	1263	+	NM_008160	108241643	108242467	2
chr9	108250161	108294876	Usp4	44715	+	NM_001311157	108250248	108294168	21
chr9	108295164	108300098	1700102P08Rik	4934	+	NM_053216	108295569	108299789	4
chr9	108305963	108330813	Ccdc36	24850	-	NM_001135198	108307093	108330802	7
chr9	108338812	108348414	BC048562	9602	+	NM_001004192	108338883	108348413	4
chr9	108349969	108363912	Klhdc8b	13943	-	NM_030075	108350619	108353582	11
chr9	108362848	108368276	Ccdc71	5428	+	NM_133744	108365320	108366622	2
chr9	108382192	108392861	Lamb2	10669	+	NM_008483	108382389	108392751	33
chr9	108393006	108404668	Usp19	11662	+	NM_001168373	108394937	108404287	27
chr9	108410335	108418272	Qars	7937	+	NM_133794	108410413	108418177	24
chr9	108419417	108462498	Qrich1	43081	+	NM_001114119	108430940	108461769	11
chr9	108462831	108467897	Impdh2	5066	+	NM_011830	108462864	108467850	14
chr9	108468195	108469673	Ndufaf3	1478	-	NM_023247	108468289	108469258	5
chr9	108470649	108470723	Mir191	74	+	NR_029577	108470723	108470723	1
chr9	108471107	108471192	Mir425	85	+	NR_029947	108471192	108471192	1
chr9	108472222	108475102	Dalrd3	2880	+	NM_026378	108472241	108475001	12
chr9	108474643	108481001	Wdr6	6358	-	NM_031392	108475280	108480924	6
chr9	108481156	108499931	P4htm	18775	-	NM_028944	108481418	108499895	9
chr9	108505273	108551711	Arih2	46438	-	NM_011790	108507412	108546608	16
chr9	108564428	108586972	Slc25a20	22544	+	NM_020520	108564558	108586225	9
chr9	108594473	108651842	Prkar2a	57369	+	NM_008924	108594787	108649325	11
chr9	108698324	108708664	Ip6k2	10340	+	NM_029634	108698525	108708370	6
chr9	108710710	108720697	Nckipsd	9987	+	NM_030729	108710814	108720076	13
chr9	108728650	108755300	Celsr3	26650	+	NM_080437	108728650	108753659	35
chr9	108756373	108815380	Slc26a6	59007	+	NM_134420	108758154	108815114	20
chr9	108816949	108817894	Tmem89	945	+	NM_027066	108816964	108817881	2
chr9	108838660	108851686	Uqcrc1	13026	+	NM_025407	108838731	108851544	13
chr9	108855789	108886920	Col7a1	31131	+	NM_007738	108855789	108886557	118
chr9	108871966	108872048	Mir711	82	+	NR_030492	108872048	108872048	1
chr9	108888207	108889209	Ucn2	1002	+	NM_145077	108888216	108888558	1
chr9	108893946	108934739	Pfkfb4	40793	+	NM_173019	108894060	108932902	14
chr9	108941080	108960306	Shisa5	19226	+	NM_025858	108941208	108959222	6
chr9	108960445	108962237	Trex1	1792	-	NM_011637	108960490	108961435	2
chr9	108962260	108976638	Atrip	14378	-	NM_172774	108962354	108976518	13
chr9	108980501	108984895	Tma7	4394	-	NM_183250	108980904	108984856	4
chr9	108985009	108995877	Ccdc51	10868	+	NM_025689	108991858	108994781	4
chr9	108997949	109022429	Plxnb1	24480	+	NM_172775	109002591	109020458	38
chr9	109041967	109064536	Fbxw21	22569	-	NM_177069	109042013	109064503	10
chr9	109081740	109098489	Fbxw13	16749	-	NM_177598	109081792	109098457	10
chr9	109119945	109137268	Fbxw20	17323	-	NM_001008428	109119997	109137216	10
chr9	109173636	109190190	Fbxw14	16554	-	NM_001311159	109173697	109190153	9
chr9	109225399	109242173	Fbxw28	16774	-	NM_001177419	109225678	109242136	10
chr9	109280922	109306808	Fbxw22	25886	-	NM_001014395	109281314	109306777	10
chr9	109334831	109351654	Fbxw16	16823	-	NM_177070	109334915	109351622	10
chr9	109381088	109398368	Fbxw19	17280	-	NM_177703	109381142	109398361	10
chr9	109455115	109470776	Fbxw15	15661	-	NM_199036	109455177	109470744	10
chr9	109503629	109528573	Fbxw24	24944	-	NM_001013776	109503687	109528542	10
chr9	109579247	109605214	Fbxw18	25967	-	NM_001033794	109579305	109605163	10
chr9	109620079	109648603	Fbxw26	28524	-	NM_198674	109620468	109648569	10
chr9	109668558	109693164	Fbxw27	24606	-	NM_001303003	109668618	109693133	10
chr9	109719140	109729141	Spink8	10001	+	NM_183136	109719275	109728915	5
chr9	109732667	109733945	3000002C10Rik	1278	-	NR_033215	109733945	109733945	1
chr9	109735307	109745475	Nme6	10168	+	NM_018757	109737838	109745141	7
chr9	109749890	109751970	Camp	2080	-	NM_009921	109749948	109751948	4
chr9	109778082	109796394	Cdc25a	18312	+	NM_007658	109778493	109794723	15
chr9	109792146	109792214	Mir7089	68	+	NR_106057	109792214	109792214	1
chr9	109834277	109986458	Map4	152181	+	NM_001205330	109881372	109984246	19
chr9	109986822	110020120	Dhx30	33298	-	NM_001252682	109986896	110015502	23
chr9	110034527	110142682	Smarcc1	108155	+	NM_009211	110034620	110140417	28
chr9	110146286	110165080	Cspg5	18794	+	NM_001166273	110148101	110164725	5
chr9	110183790	110183913	Mir6236	123	+	NR_105744	110183913	110183913	1
chr9	110207695	110224606	Elp6	16911	+	NM_001081381	110207799	110223447	7
chr9	110235791	110287453	Scap	51662	+	NM_001103162	110255546	110287305	23
chr9	110287592	110310714	Ptpn23	23122	-	NM_001081043	110287756	110310621	25
chr9	110322311	110325516	Ngp	3205	+	NM_008694	110322365	110324913	4
chr9	110328429	110379198	Klhl18	50769	-	NM_177771	110331134	110379098	10
chr9	110379461	110427678	Kif9	48217	+	NM_010628	110385569	110427438	21
chr9	110435100	110521137	Setd2	86037	+	NM_001081340	110435182	110520483	21
chr9	110523638	110526897	Nradd	3259	-	NM_026012	110523924	110525627	5
chr9	110527292	110556665	Nbeal2	29373	-	NM_183276	110527628	110556451	54
chr9	110538502	110538619	Mir8107	117	-	NR_106186	110538619	110538619	1
chr9	110559006	110614097	Ccdc12	55091	+	NM_028312	110559066	110613837	7
chr9	110624588	110649649	Pth1r	25061	-	NM_011199	110624757	110644804	16
chr9	110666184	110672298	Myl3	6114	+	NM_010859	110666248	110671947	7
chr9	110700688	110706248	Prss42	5560	+	NM_153099	110700701	110705714	5
chr9	110716497	110720503	Prss44	4006	+	NM_148940	110716542	110719829	5
chr9	110729193	110734008	Prss43	4815	+	NM_199471	110729550	110733522	6
chr9	110737091	110743814	Prss45	6723	+	NM_153172	110737137	110743582	6
chr9	110747009	110759026	Prss46	12017	+	NM_183103	110747053	110758758	5
chr9	110760470	110767132	Prss50	6662	+	NM_146227	110760494	110767021	5
chr9	110768549	110782587	Tmie	14038	-	NM_146260	110769363	110776395	6
chr9	110782677	110803034	Als2cl	20357	+	NM_001146059	110786547	110801000	27
chr9	110817242	110819365	Gm590	2123	-	NM_001195437	110817379	110819098	3
chr9	110842111	110848662	Tdgf1	6551	-	NM_011562	110843207	110848347	6
chr9	110854048	110886568	Lrrc2	32520	+	NM_028838	110860325	110884183	9
chr9	110887446	110892217	Rtp3	4771	-	NM_153100	110888374	110892115	3
chr9	110921795	110945270	Ltf	23475	+	NM_008522	110921829	110944686	17
chr9	110957337	110960022	Ccrl2	2685	-	NM_001302376	110957849	110958932	3
chr9	111020614	111128172	Lrrfip2	107558	+	NM_001164838	111043746	111126564	15
chr9	111130731	111174112	Mlh1	43381	-	NM_026810	111130962	111174028	19
chr9	111174348	111181595	Epm2aip1	7247	+	NM_175266	111174464	111176285	1
chr9	111214242	111298279	Trank1	84037	+	NM_001164659	111214345	111296862	22
chr9	111341584	111392115	Dclk3	50531	+	NM_172928	111341768	111391174	5
chr9	111463937	111592720	Stac	128783	-	NM_016853	111465132	111592612	11
chr9	111967594	112135005	Arpp21	167411	-	NM_001177616	111968268	112088238	19
chr9	112021139	112021215	Mir128-2	76	-	NR_029823	112021215	112021215	1
chr9	112129959	112130746	2310075C17Rik	787	+	NR_131053	112130746	112130746	2
chr9	112159077	112251429	2900079G21Rik	92352	+	NR_033433	112251429	112251429	4
chr9	113405863	113496270	AU023762	90407	-	NR_040760	113496270	113496270	5
chr9	113560861	113617377	Pdcd6ip	56516	-	NM_011052	113564050	113617225	18
chr9	113650590	113828815	Clasp2	178225	+	NM_001114347	113650798	113827199	39
chr9	113840051	113886319	Ubp1	46268	+	NM_001083319	113840771	113884501	17
chr9	113886075	113935869	Fbxl2	49794	-	NM_178624	113887950	113935813	15
chr9	113966471	114007851	Susd5	41380	+	NM_001101510	113966662	114006028	5
chr9	114239252	114239696	Bcl2a1c	444	+	NM_007535	114239273	114239660	1
chr9	114250228	114273745	4930525D18Rik	23517	-	NR_040738	114273745	114273745	6
chr9	114277441	114286356	4930520O04Rik	8915	+	NR_040383	114286356	114286356	3
chr9	114284248	114299830	Crtap	15582	-	NM_019922	114284646	114299717	7
chr9	114310195	114383497	Glb1	73302	+	NM_009752	114310309	114383159	16
chr9	114310212	114320319	Tmppe	10107	+	NM_001200002	114313752	114315096	2
chr9	114399433	114405662	Ccr4	6229	-	NM_009916	114401030	114402113	2
chr9	114420390	114473487	Trim71	53097	-	NM_001042503	114421762	114472235	4
chr9	114494991	114549318	Cnot10	54327	-	NM_153585	114500655	114549058	20
chr9	114597948	114632895	Dync1li1	34947	+	NM_146229	114597999	114632483	13
chr9	114640320	114658461	Cmtm6	18141	+	NM_026036	114640353	114655694	4
chr9	114665953	114691111	Cmtm7	25158	-	NM_133978	114666395	114690920	5
chr9	114698462	114753270	Cmtm8	54808	-	NM_027294	114698779	114753045	4
chr9	114808456	114843105	Gpd1l	34649	-	NM_175380	114811523	114842835	8
chr9	114976396	115141341	Osbpl10	164945	+	NM_148958	114976425	115141274	10
chr9	115151699	115219539	Stt3b	67840	-	NM_024222	115153082	115219174	16
chr9	115190209	115191188	Stmn1-rs1	979	-	NR_029430	115191188	115191188	1
chr9	115245278	115251042	4930428G15Rik	5764	+	NR_040730	115251042	115251042	3
chr9	115290936	115291057	Mir467h	121	+	NR_130329	115291057	115291057	1
chr9	115818572	115985294	Gadl1	166722	+	NM_028638	115846279	115983231	15
chr9	115996812	116084481	Tgfbr2	87669	-	NM_009371	115999495	116084155	8
chr9	116481863	117539031	Rbms3	1057168	-	NM_001172121	116487813	117538968	15
chr9	117949639	117978912	Azi2	29273	+	NM_001286507	117958552	117978222	7
chr9	117973644	118059314	Cmc1	85670	-	NM_026442	117974345	118059153	4
chr9	118338956	118346166	4933432G23Rik	7210	+	NR_040716	118346166	118346166	5
chr9	118387306	118395250	Eomes	7944	+	NM_010136	118387777	118394130	6
chr9	118415435	118491637	Golga4	76202	+	NM_018748	118415603	118490990	24
chr9	118515826	118810121	Itga9	294295	+	NM_133721	118516045	118806450	28
chr9	118835653	118953237	Ctdspl	117584	+	NM_133710	118835979	118949767	8
chr9	118940913	118941003	Mir26a-1	90	+	NR_029742	118941003	118941003	1
chr9	118961895	118980643	Vill	18748	+	NM_001164567	118966906	118980365	20
chr9	118980645	119002620	Plcd1	21975	-	NM_019676	118980919	119002509	15
chr9	119011595	119056812	Dlec1	45217	+	NM_177117	119011632	119056812	37
chr9	119057160	119066211	Acaa1b	9051	-	NM_146230	119057455	119066112	12
chr9	119078573	119099511	Slc22a14	20938	-	NM_001037749	119078760	119090145	12
chr9	119102095	119118223	Slc22a13	16128	-	NM_133980	119102398	119118178	10
chr9	119129608	119140810	Slc22a13b-ps	11202	-	NR_033303	119140810	119140810	6
chr9	119147550	119231545	Oxsr1	83995	-	NR_045693	119231545	119231545	19
chr9	119245105	119249158	Myd88	4053	-	NM_010851	119246473	119249077	6
chr9	119250411	119259413	Acaa1a	9002	+	NM_130864	119250632	119259151	12
chr9	119266498	119302915	Xylb	36417	+	NM_001199568	119283425	119300936	20
chr9	119311295	119351266	Acvr2b	39971	+	NM_001313757	119311663	119342579	11
chr9	119354040	119374636	Exog	20596	+	NM_001172136	119354068	119371955	7
chr9	119392525	119488134	Scn5a	95609	-	NM_021544	119394695	119471742	28
chr9	119517573	119628150	Scn10a	110577	-	NM_009134	119518042	119603443	28
chr9	119662882	119734574	Scn11a	71692	-	NM_011887	119663367	119729113	27
chr9	119804012	119835697	Wdr48	31685	+	NM_026236	119804027	119833922	19
chr9	119834790	119846676	Gorasp1	11886	-	NM_028976	119836891	119846635	9
chr9	119846723	119876911	Ttc21a	30188	+	NM_028735	119846841	119876792	29
chr9	119880283	119893776	Csrnp1	13493	-	NM_153287	119881357	119886324	5
chr9	119922872	119932716	Xirp1	9844	-	NM_011724	119925143	119928933	3
chr9	119957800	119977414	Cx3cr1	19614	-	NM_009987	119960387	119961452	2
chr9	120001250	120004024	Ccr8	2774	+	NM_007720	120002938	120004000	2
chr9	120019516	120033437	Slc25a38	13921	+	NM_144793	120019561	120032882	7
chr9	120036883	120041487	Rpsa	4604	+	NM_011029	120037607	120040612	7
chr9	120039551	120039679	Snora62	128	+	NR_002902	120039679	120039679	1
chr9	120058859	120085209	Mobp	26350	+	NM_008614	120076922	120082308	4
chr9	120213190	120383952	Myrip	170762	+	NM_144557	120244748	120381922	17
chr9	120401723	120404445	Eif1b	2722	+	NM_026892	120401928	120404075	4
chr9	120448935	120477443	Entpd3	28508	+	NM_178676	120449781	120475659	11
chr9	120480633	120483770	Rpl14	3137	+	NM_025974	120480655	120483511	6
chr9	120486447	120487190	5830454E08Rik	743	+	NR_073359	120487190	120487190	1
chr9	120822891	120824368	1700020M21Rik	1477	-	NR_040742	120824368	120824368	3
chr9	120833572	120839920	4930593C16Rik	6348	-	NR_040753	120839920	120839920	3
chr9	120842517	120869625	Ctnnb1	27108	+	NM_007614	120859338	120868635	15
chr9	120864203	120864265	Mir7090	62	+	NR_106058	120864265	120864265	1
chr9	120873571	121186290	Ulk4	312719	-	NM_177589	120873662	121182128	37
chr9	121276075	121384036	Trak1	107961	+	NM_175114	121276221	121382117	16
chr9	121398941	121404812	Cck	5871	-	NM_001284508	121399291	121403648	4
chr9	121486960	121550684	Lyzl4	63724	-	NM_026915	121487142	121493590	6
chr9	121496137	121523373	Lyzl4os	27236	+	NR_040740	121523373	121523373	4
chr9	121551833	121582072	Vipr1	30239	+	NM_011703	121551966	121578683	13
chr9	121589162	121614147	Sec22c	24985	-	NM_178677	121593775	121604833	8
chr9	121619506	121622039	Deb1	2533	+	NM_026794	121619520	121621770	3
chr9	121628298	121665959	Nktr	37661	+	NM_010918	121628605	121663450	17
chr9	121665757	121669061	E530011L22Rik	3304	-	NR_033503	121669061	121669061	1
chr9	121669150	121680860	Zfp651	11710	+	NM_001166644	121669340	121676887	6
chr9	121686724	121692937	Klhl40	6213	+	NM_028202	121686893	121692517	6
chr9	121693133	121701625	Hhatl	8492	-	NM_029095	121693233	121699866	12
chr9	121706744	121748579	Ccdc13	41835	-	NM_028384	121707197	121743065	16
chr9	121757677	121767118	Higd1a	9441	-	NM_019814	121758751	121761705	4
chr9	121807472	121820189	Ackr2	12717	+	NM_001276719	121817678	121818815	4
chr9	121823473	121825423	Cyp8b1	1950	-	NM_010012	121823879	121825382	1
chr9	121846392	121856134	1700048O20Rik	9742	+	NR_033553	121856134	121856134	5
chr9	121860105	121889326	Fam198a	29221	+	NM_177743	121873899	121887550	5
chr9	121890723	121905144	Pomgnt2	14421	-	NM_001289558	121891088	121892831	4
chr9	122026383	122078820	Snrk	52437	+	NM_133741	122046130	122076521	7
chr9	122084991	122203541	Ano10	118550	-	NM_001271873	122085530	122184767	13
chr9	122183007	122183146	Mir8106	139	-	NR_106185	122183146	122183146	1
chr9	122260733	122290641	Abhd5	29908	+	NM_026179	122260904	122288720	7
chr9	122291139	122307919	A730085K08Rik	16780	-	NR_045967	122307919	122307919	3
chr9	122481618	122489765	9530059O14Rik	8147	+	NR_015610	122489765	122489765	2
chr9	122591993	122592092	Mir138-1	99	+	NR_029819	122592092	122592092	1
chr9	122656463	122711192	Topaz1	54729	+	NM_001199736	122656463	122711185	20
chr9	122714664	122745450	Tcaim	30786	+	NM_001013405	122717895	122744094	11
chr9	122758027	122775124	Zfp445	17097	-	NM_173364	122761031	122771246	7
chr9	122797588	122805242	Zkscan7	7654	+	NM_001177505	122797659	122805242	5
chr9	122832195	122840146	Zfp105	7951	+	NM_009544	122834225	122839958	4
chr9	122854206	122860118	1110059G10Rik	5912	-	NM_025419	122857011	122860030	3
chr9	122860198	122927851	Kif15	67653	+	NM_010620	122860251	122927245	35
chr9	122930443	122932609	Tmem42	2166	+	NM_025339	122930496	122932091	3
chr9	122943858	122976676	Tgm4	32818	+	NM_177911	122943927	122975991	14
chr9	122981427	123022323	Zdhhc3	40896	-	NM_026917	122987280	123009686	7
chr9	123022348	123045247	Exosc7	22899	+	NM_001081188	123022383	123045121	8
chr9	123060063	123066550	Clec3b	6487	+	NM_011606	123060161	123066265	3
chr9	123081402	123125156	Cdcp1	43754	-	NM_133974	123082620	123125027	9
chr9	123168174	123169907	Tmem158	1733	-	NM_001002267	123168802	123169663	1
chr9	123276057	123371782	Lars2	95725	+	NM_153168	123280990	123370796	21
chr9	123387818	123430670	Limd1	42852	+	NM_013860	123388355	123428361	8
chr9	123438999	123501716	Sacm1l	62717	+	NM_030692	123439007	123500055	20
chr9	123502937	123541683	Slc6a20b	38746	-	NM_011731	123504110	123541477	11
chr9	123546024	123587950	Slc6a20a	41926	-	NM_139142	123546113	123587924	11
chr9	123606710	123626675	Lztfl1	19965	-	NM_033322	123609202	123626646	10
chr9	123676328	123692575	Ccr9	16247	+	NM_001166625	123683693	123689482	4
chr9	123698617	123761020	Fyco1	62403	-	NM_001110253	123701791	123752634	18
chr9	123715594	123720872	Cxcr6	5278	+	NM_030712	123719053	123720109	2
chr9	123761435	123771246	Xcr1	9811	-	NM_011798	123764799	123771174	2
chr9	123836859	123839607	Cdkn2d	2748	+	NM_009878	123837119	123839098	2
chr9	123876958	123883525	Ccr1	6567	-	NM_009912	123878256	123879324	2
chr9	123891781	123893241	Ccr1l1	1460	-	NM_007718	123892170	123893241	1
chr9	123936702	123946421	Ccr3	9719	+	NM_009914	123943361	123944441	2
chr9	124016921	124023879	Ccr2	6958	+	NM_009915	124020423	124021545	3
chr9	124036281	124041922	Ccr5	5641	+	NM_009917	124039100	124040165	2
chr9_random	46928	55944	Ppp2r3d	9016	-	NM_001163415	49380	55591	10
chr9_random	53161	56293	4930526I15Rik	3132	+	NR_102721	56293	56293	3
chr9_random	113043	134706	Nlrp4g	21663	+	NM_001004145	122670	134251	6
chr9_random	202786	223677	2010315B03Rik	20891	-	NM_001243118	203973	223545	5
chr9_random	367889	370841	Jrkl	2952	-	NM_001033181	369182	370754	1
chr9_random	372078	417453	Ccdc82	45375	+	NM_025534	377184	414509	9
chr10	3134303	3227479	Cnksr3	93176	+	NM_172546	3134857	3226253	13
chr10	3308331	3587948	Oprm1	279617	-	NM_001302795	3309379	3587930	6
chr10	3323355	3434998	Ipcef1	111643	+	NM_001033391	3349993	3434626	8
chr10	4424140	4520877	Rgs17	96737	+	NM_001161822	4428322	4513588	6
chr10	4522597	4534654	Mtrf1l	12057	+	NM_175374	4522777	4533335	7
chr10	4541075	4547383	Fbxo5	6308	+	NM_025995	4541203	4546970	5
chr10	4698924	4707323	Vip	8399	-	NM_011702	4701585	4705913	7
chr10	4739751	4752813	Myct1	13062	-	NM_026793	4741839	4752691	2
chr10	4795848	5009592	Syne1	213744	+	NM_153399	4804526	5007338	32
chr10	5340907	5734552	Esr1	393645	-	NM_001302532	5345117	5634157	10
chr10	5785429	5836669	Ccdc170	51240	-	NM_001195672	5785429	5836669	11
chr10	5891400	5913936	Armt1	22536	-	NM_024261	5892304	5913870	5
chr10	5914188	5943372	Rmnd1	29184	+	NM_025343	5918863	5943072	13
chr10	5917374	5943370	Gm5512	25996	+	NR_002891	5943370	5943370	12
chr10	5958432	5979467	Zbtb2	21035	+	NM_001033466	5971798	5978061	3
chr10	5987069	6080212	Akap12	93143	-	NM_031185	5988609	6080022	4
chr10	6179459	6373466	Mthfd1l	194007	-	NM_001170785	6198442	6373286	28
chr10	6379238	6606164	Plekhg1	226926	-	NM_001159942	6382088	6473507	17
chr10	6791663	6806262	Iyd	14599	-	NM_027391	6792328	6806245	5
chr10	6881565	6980391	Ppp1r14c	98826	-	NM_133485	6883077	6979874	4
chr10	7078769	7090333	H60c	11564	+	NM_001204916	7079260	7087235	6
chr10	7213347	7221452	B020014A21Rik	8105	+	NR_045946	7221452	7221452	3
chr10	7309597	7345275	Lrp11	35678	+	NM_172784	7309849	7343582	7
chr10	7350033	7383382	Pcmt1	33349	-	NM_008786	7357843	7383101	8
chr10	7383168	7384421	A630066F11Rik	1253	+	NR_030698	7384421	7384421	1
chr10	7387301	7398684	Nup43	11383	+	NM_145706	7387359	7398595	8
chr10	7398768	7400956	BC020402	2188	-	NR_033219	7400956	7400956	1
chr10	7401006	7436259	Lats1	35253	+	NM_010690	7411264	7432808	8
chr10	7445797	7482948	Katna1	37151	+	NM_011835	7458527	7482786	11
chr10	7487744	7500715	Ginm1	12971	-	NM_145418	7488274	7500672	8
chr10	7512691	7542361	Ppil4	29670	+	NM_026141	7512748	7541001	13
chr10	7552267	7590195	Zc3h12d	37928	+	NM_172785	7559632	7587867	6
chr10	7556178	7556272	Mir5104	94	+	NR_039563	7556272	7556272	1
chr10	7625445	7675921	Tab2	50476	-	NM_138667	7627232	7644584	7
chr10	7924550	8238623	Ust	314073	-	NM_177387	7927184	8238197	8
chr10	8442016	8605868	Sash1	163852	-	NM_175155	8445294	8605656	20
chr10	9347056	9395006	Samd5	47950	-	NM_177271	9348784	9394761	2
chr10	9404519	9411707	Gm6150	7188	+	NR_038036	9411707	9411707	4
chr10	9475344	9620838	Stxbp5	145494	-	NM_001081344	9480710	9620481	26
chr10	10055500	10192112	Adgb	136612	-	NM_001127353	10055735	10192112	37
chr10	10264836	10278005	Rab32	13169	-	NM_026405	10266099	10277886	3
chr10	10325742	10336111	Gm5177	10369	+	NR_033630	10336111	10336111	3
chr10	10405856	10802129	Grm1	396273	-	NM_001114333	10417869	10800336	10
chr10	10470843	10477929	4930567K20Rik	7086	+	NR_046010	10477929	10477929	3
chr10	10869227	10935071	Shprh	65844	+	NM_001077707	10871448	10933342	30
chr10	11001127	11017767	Fbxo30	16640	+	NM_027968	11009333	11015218	3
chr10	11063242	11177275	Epm2a	114033	+	NM_010146	11063268	11177215	4
chr10	12101985	12581533	Utrn	479548	-	NM_011682	12103985	12581444	74
chr10	12636443	12642925	B230208H11Rik	6482	-	NR_038027	12642925	12642925	4
chr10	12659786	12684065	Stx11	24279	-	NM_029075	12660918	12661782	3
chr10	12728255	12728989	Sf3b5	734	+	NM_175102	12728428	12728689	1
chr10	12810593	12851501	Plagl1	40908	+	NM_009538	12844822	12848910	6
chr10	12810650	12815706	Hymai	5056	+	NR_131912	12815706	12815706	1
chr10	12869449	12897829	Zc2hc1b	28380	-	NM_029172	12869945	12897791	6
chr10	12898443	12912943	Ltv1	14500	-	NM_181470	12898691	12912836	11
chr10	12927522	13194202	Phactr2	266680	-	NM_001195065	12934063	13194084	13
chr10	13220833	13237081	Fuca2	16248	+	NM_025799	13220973	13234653	7
chr10	13243647	13272948	Pex3	29301	-	NM_001164195	13243704	13272704	12
chr10	13272712	13283182	Adat2	10470	+	NM_025748	13273071	13282664	6
chr10	13372514	13588636	Aig1	216122	-	NM_025446	13372707	13588564	6
chr10	13686184	13871184	Hivep2	185000	+	NM_010437	13847465	13869542	9
chr10	14122390	14264842	Adgrg6	142452	-	NM_001002268	14127703	14264721	25
chr10	14375138	14425295	Vta1	50157	-	NM_025418	14375505	14425267	8
chr10	14425414	14478825	1700016L04Rik	53411	+	NR_045824	14478825	14478825	6
chr10	14435431	14438020	Gje1	2589	-	NM_029722	14436224	14437954	3
chr10	14480094	14490362	Nmbr	10268	+	NM_008703	14480094	14490362	3
chr10	15511582	15526871	C330004P14Rik	15289	+	NR_131087	15526871	15526871	3
chr10	16670899	16815588	Gm20125	144689	-	NR_038020	16815588	16815588	9
chr10	17443033	17445480	Cited2	2447	+	NM_010828	17443751	17444561	2
chr10	17516024	17565469	Txlnb	49445	+	NM_138628	17518906	17563286	10
chr10	17620271	17667873	Heca	47602	-	NM_001033432	17622018	17667588	4
chr10	17731066	17743058	Abracl	11992	-	NM_028440	17731437	17738705	3
chr10	17775745	17844961	Reps1	69216	+	NM_009048	17775768	17844754	20
chr10	17848827	17930696	Ect2l	81869	-	NM_001195036	17848827	17921159	21
chr10	17933490	17954787	Ccdc28a	21297	-	NM_144820	17933929	17950382	6
chr10	18127480	18253697	Nhsl1	126217	+	NM_173390	18128118	18251779	7
chr10	18259928	18265882	Hebp2	5954	-	NM_019487	18260939	18265601	4
chr10	18307816	18463564	Arfgef3	155748	-	NM_001033258	18309386	18463431	34
chr10	18499532	18506599	Gm4922	7067	-	NM_177706	18503284	18504778	4
chr10	18517104	18551736	4930444F02Rik	34632	-	NR_038035	18551736	18551736	6
chr10	18564876	18576878	Perp	12002	+	NM_022032	18564998	18575682	3
chr10	18720716	18735216	Tnfaip3	14500	-	NM_009397	18722536	18731581	9
chr10	18861554	18927753	Gm20139	66199	+	NR_038021	18927753	18927753	4
chr10	19076344	19078410	Olig3	2066	+	NM_053008	19076434	19077256	1
chr10	19311763	19330031	Ifngr1	18268	+	NM_010511	19311891	19329494	7
chr10	19341833	19354487	Il22ra2	12654	+	NM_178258	19341845	19352724	5
chr10	19432392	19479859	Il20ra	47467	+	NM_172786	19432439	19479459	7
chr10	19567722	19571265	Slc35d3	3543	-	NM_029529	19568645	19570828	2
chr10	19579895	19627480	Pex7	47585	-	NM_008822	19580731	19627379	10
chr10	19654331	19862556	Map3k5	208225	+	NM_008580	19654411	19861386	30
chr10	19868725	20001396	Map7	132671	+	NM_001198635	19868819	19999812	18
chr10	19919052	19921660	4930405J17Rik	2608	-	NR_045350	19921660	19921660	3
chr10	19928244	19928836	Rpl32l	592	+	NM_001101561	19928295	19928697	1
chr10	20017386	20017494	Mir6413	108	-	NR_105840	20017494	20017494	1
chr10	20032274	20062307	Bclaf1	30033	+	NM_001025392	20041818	20059863	13
chr10	20067624	20081475	Mtfr2	13851	+	NM_027930	20067716	20080346	7
chr10	20117809	20444874	Pde7b	327065	-	NM_013875	20120223	20444502	13
chr10	20672352	20800235	Ahi1	127883	+	NM_026203	20679575	20798892	24
chr10	20844735	20880790	Myb	36055	-	NM_001198914	20845978	20880524	16
chr10	21015784	21088695	Hbs1l	72911	+	NM_001042593	21015939	21088106	18
chr10	21038893	21061861	4930455C13Rik	22968	-	NR_045352	21061861	21061861	4
chr10	21097105	21116384	Aldh8a1	19279	+	NM_178713	21097146	21115646	7
chr10	21312950	21342181	1700020N01Rik	29231	+	NR_027968	21342181	21342181	3
chr10	21410650	21413784	Gm5420	3134	+	NR_045843	21413784	21413784	3
chr10	21601989	21719708	Sgk1	117719	+	NM_001161845	21602444	21718633	14
chr10	21786114	21787885	4930444G20Rik	1771	-	NM_053264	21786397	21787885	1
chr10	21832855	21869076	E030030I06Rik	36221	-	NM_001254744	21833937	21868818	2
chr10	21878414	22093945	Raet1a	215531	+	NM_009016	21894125	22092140	10
chr10	21893326	21903720	Raet1e	10394	+	NM_198193	21894125	21901897	7
chr10	21893680	22093919	Raet1b	200239	+	NM_009017	21894125	22092140	7
chr10	21893707	22093945	Raet1c	200238	+	NM_009018	21894125	21901897	6
chr10	21993279	22008654	H60b	15375	+	NM_001177775	22003293	22008555	6
chr10	22026525	22032748	C920009B18Rik	6223	+	NR_015465	22032748	22032748	3
chr10	22081699	22093945	Raet1d	12246	+	NM_020030	22082520	22092140	7
chr10	22122618	22127276	Gm10825	4658	+	NR_028580	22127276	22127276	2
chr10	22364816	22423686	Slc2a12	58870	+	NM_178934	22365004	22421981	5
chr10	22423682	22451253	Tbpl1	27571	-	NM_011603	22425621	22431854	7
chr10	22449177	22449238	Mir7663	61	-	NR_106123	22449238	22449238	1
chr10	22537078	22539934	Tcf21	2856	-	NM_011545	22537542	22539709	2
chr10	22823973	23069709	Eya4	245736	-	NM_010167	22826013	23042886	19
chr10	23504988	23507015	Rps12	2027	-	NM_011295	23505016	23506813	6
chr10	23505152	23505257	Snora33	105	-	NR_037680	23505257	23505257	1
chr10	23505559	23505627	Snord100	68	-	NR_037681	23505627	23505627	1
chr10	23516791	23547774	Slc18b1	30983	+	NM_183116	23516946	23546466	14
chr10	23571267	23589649	Vnn3	18382	+	NM_011979	23571389	23589463	7
chr10	23614493	23625149	Vnn1	10656	+	NM_011704	23614681	23624460	7
chr10	23640211	23641210	Taar1	999	+	NM_053205	23640211	23641210	1
chr10	23658377	23661389	Taar2	3012	+	NM_001007266	23658377	23661389	2
chr10	23669363	23670395	Taar3	1032	+	NM_001008429	23669363	23670395	1
chr10	23680299	23681343	Taar4	1044	+	NM_001008499	23680299	23681343	1
chr10	23690511	23691525	Taar5	1014	+	NM_001009574	23690511	23691525	1
chr10	23704414	23705452	Taar6	1038	-	NM_001010828	23704414	23705452	1
chr10	23712210	23713287	Taar7a	1077	-	NM_001010829	23712210	23713287	1
chr10	23719744	23720821	Taar7b	1077	+	NM_001010827	23719744	23720821	1
chr10	23747027	23748104	Taar7d	1077	+	NM_001010838	23747027	23748104	1
chr10	23757419	23758496	Taar7e	1077	+	NM_001010835	23757419	23758496	1
chr10	23769315	23770392	Taar7f	1077	+	NM_001010839	23769315	23770392	1
chr10	23796305	23797340	Taar8a	1035	+	NM_001010830	23796305	23797340	1
chr10	23811065	23812100	Taar8b	1035	-	NM_001010837	23811065	23812100	1
chr10	23820648	23821757	Taar8c	1109	-	NM_001010840	23820683	23821718	1
chr10	23828293	23829340	Taar9	1047	-	NM_001010831	23828293	23829340	1
chr10	23869122	23908765	Stx7	39643	+	NM_016797	23875105	23907526	10
chr10	23943322	24022589	Moxd1	79267	+	NM_021509	23943409	24021435	12
chr10	24315247	24318488	Ctgf	3241	+	NM_010217	24315531	24317417	5
chr10	24357719	24431965	Enpp1	74246	-	NM_008813	24361611	24431797	25
chr10	24493619	24556001	Enpp3	62382	-	NM_134005	24493707	24555899	25
chr10	24589791	24633335	Med23	43544	+	NM_001166416	24589904	24632633	30
chr10	24630469	24630539	Mir6905	70	+	NR_105870	24630539	24630539	1
chr10	24635012	24647276	Arg1	12264	-	NM_007482	24635415	24647174	8
chr10	24888895	25018969	Akap7	130074	-	NM_018747	24890857	25009444	8
chr10	25079603	25243324	Epb41l2	163721	+	NM_001199265	25161392	25232886	20
chr10	25247748	25256078	Smlr1	8330	-	NM_001195596	25248036	25255893	2
chr10	25499119	25557243	4930401C15Rik	58124	-	NR_045349	25557243	25557243	5
chr10	25710991	25798858	Tmem200a	87867	-	NM_029881	25712699	25714175	2
chr10	25798060	25799253	Gm9767	1193	+	NR_028030	25799253	25799253	1
chr10	25949512	25991978	Samd3	42466	+	NM_001115154	25949931	25991779	11
chr10	25995257	26094991	L3mbtl3	99734	-	NM_172787	25995925	26072166	22
chr10	26393251	26394457	Gm8709	1206	-	NR_033633	26394457	26394457	1
chr10	26492317	26638454	Arhgap18	146137	+	NM_176837	26492389	26636902	15
chr10	26701091	27336748	Lama2	635657	-	NM_008481	26701300	27336602	64
chr10	27109671	27117031	4930579H20Rik	7360	+	NR_131034	27117031	27117031	5
chr10	27794625	28317203	Ptprk	522578	+	NM_008983	27794886	28315661	32
chr10	28388165	28603624	Themis	215459	+	NM_178666	28388465	28583252	6
chr10	28641768	28643313	4930519F09Rik	1545	-	NR_033601	28643313	28643313	1
chr10	28692093	28706112	2310057J18Rik	14019	-	NM_026336	28692384	28706098	6
chr10	28863801	28919434	Soga3	55633	+	NM_026138	28866464	28918861	7
chr10	28931448	28950585	9330159F19Rik	19137	+	NM_001162537	28937925	28947177	6
chr10	29032971	29066467	Echdc1	33496	+	NM_001110195	29037314	29064555	6
chr10	29063981	29082248	Rnf146	18267	-	NM_001110198	29066614	29074102	4
chr10	29172912	29255673	Rspo3	82761	-	NM_028351	29173935	29255134	5
chr10	29915814	29920346	Cenpw	4532	-	NM_001109747	29917005	29920286	3
chr10	30254030	30320555	Trmt11	66525	-	NM_028604	30254918	30320467	13
chr10	30323000	30326440	Gm20300	3440	-	NR_045008	30326440	30326440	1
chr10	30328012	30338172	Hint3	10160	-	NM_025798	30328196	30338158	5
chr10	30365387	30522913	Ncoa7	157526	-	NM_172495	30367321	30491584	16
chr10	30552164	30562589	Hey2	10425	-	NM_013904	30553541	30562454	5
chr10	31033210	31047892	Hddc2	14682	+	NM_027168	31033220	31047784	6
chr10	31052185	31165727	Tpd52l1	113542	-	NM_009413	31052646	31165536	7
chr10	31133531	31134241	Supt4b	710	-	NM_011509	31133617	31133971	1
chr10	31221692	31329531	Rnf217	107839	-	NM_001146349	31222463	31328990	6
chr10	31409124	32609721	Nkain2	1200597	-	NM_001013411	31411483	32609502	7
chr10	32803288	33196515	Trdn	393227	+	NM_029726	32803529	33194324	38
chr10	32942150	32976163	D830005E20Rik	34013	-	NR_040657	32976163	32976163	3
chr10	33232139	33344406	Clvs2	112267	-	NM_175448	33233064	33342738	6
chr10	33486229	33501921	Gm4794	15692	-	NM_001101452	33486229	33501921	6
chr10	33577527	33599281	Sult3a1	21754	+	NM_020565	33583752	33599128	7
chr10	33624916	33635827	Rsph4a	10911	+	NM_001162957	33624961	33634373	6
chr10	33646741	33671018	Zufsp	24277	-	NM_028287	33647191	33669290	10
chr10	33707021	33714861	A830082N09Rik	7840	-	NR_015526	33714861	33714861	1
chr10	33716360	33739422	Rwdd1	23062	-	NM_025614	33716532	33739244	7
chr10	33757402	33829621	Trappc3l	72219	+	NM_001162937	33776660	33822553	7
chr10	33758589	33764119	Fam26d	5530	-	NM_001081165	33761311	33764075	2
chr10	33811157	33816325	Fam26e	5168	-	NM_178908	33811931	33816243	2
chr10	33845872	33847778	Fam26f	1906	-	NM_175449	33845949	33847715	2
chr10	33871198	33927357	Dse	56159	-	NM_172508	33872021	33903913	6
chr10	34001995	34004691	Tspyl1	2696	+	NM_009433	34002086	34003226	1
chr10	34017226	34021126	Tspyl4	3900	+	NM_030203	34017319	34018540	1
chr10	34023417	34138334	Nt5dc1	114917	-	NM_176968	34024654	34138259	12
chr10	34109786	34116891	Col10a1	7105	+	NM_009925	34110427	34115882	3
chr10	34203205	34331036	Frk	127831	+	NM_010237	34203810	34328377	9
chr10	36226612	36554200	Hs3st5	327588	+	NM_001253355	36548508	36553317	6
chr10	36694349	36721694	Hdac2	27345	+	NM_008229	36694557	36721365	14
chr10	36853048	36858732	Marcks	5684	-	NM_008538	36855913	36858341	2
chr10	37895579	37901709	4930591E09Rik	6130	+	NR_131035	37901709	37901709	3
chr10	38540346	38541585	Rfpl4b	1239	-	NM_001177783	38540608	38541409	3
chr10	38685320	38829994	Lama4	144674	+	NM_010681	38685760	38829839	38
chr10	38838613	38853701	Fam229b	15088	-	NM_183254	38838722	38840188	5
chr10	38853828	38870864	Tube1	17036	+	NM_028006	38853888	38869423	12
chr10	38870776	38883600	Wisp3	12824	-	NM_001127376	38870975	38883446	5
chr10	39089604	39285180	Fyn	195576	+	NM_001122893	39231555	39283778	14
chr10	39332739	39375113	Traf3ip2	42374	+	NM_134000	39345663	39374335	9
chr10	39341216	39451813	E130307A14Rik	110597	-	NR_038037	39451813	39451813	3
chr10	39451965	39595011	Rev3l	143046	+	NM_011264	39452280	39594030	32
chr10	39612565	39619044	AA474331	6479	-	NR_033628	39619044	39619044	4
chr10	39640187	39646729	2010001E11Rik	6542	-	NM_001163503	39641062	39644924	4
chr10	39666717	39679959	G630090E17Rik	13242	-	NM_001173500	39667000	39670444	4
chr10	39677866	39706452	BC021785	28586	-	NM_001113388	39680255	39706331	4
chr10	39721378	39745074	AI317395	23696	-	NM_144821	39722427	39744722	4
chr10	39753340	39862060	Slc16a10	108720	-	NM_001114332	39756977	39861842	6
chr10	39943051	39966845	Rpf2	23794	-	NM_023323	39943546	39966781	10
chr10	39969008	39977471	Gtf3c6	8463	-	NM_026113	39969338	39977465	6
chr10	40007263	40021994	Amd1	14731	-	NM_009665	40009134	40021664	8
chr10	40007270	40021992	Amd2	14722	-	NM_007444	40009134	40021664	8
chr10	40069113	40203624	Cdk19	134511	+	NM_001168304	40069399	40199609	13
chr10	40290167	40323938	Slc22a16	33771	+	NM_027572	40290274	40323752	8
chr10	40349816	40401653	Ddo	51837	+	NR_133568	40401653	40401653	5
chr10	40403087	40530889	Mettl24	127802	+	NM_177793	40403161	40530526	5
chr10	40551426	40602949	Cdc40	51523	-	NM_027879	40552984	40602881	15
chr10	40603339	40658375	Wasf1	55036	+	NM_031877	40640081	40657609	9
chr10	40790298	40791390	Gpr6	1092	-	NM_199058	40790298	40791390	1
chr10	40907977	41023047	Fig4	115070	-	NM_133999	40908327	41022858	23
chr10	41170163	41185388	Zbtb24	15225	+	NM_153398	41170925	41184848	7
chr10	41196119	41206836	Mical1	10717	+	NM_138315	41197862	41206694	24
chr10	41206977	41210146	Smpd2	3169	-	NM_009213	41207011	41209838	10
chr10	41210244	41234094	Ppil6	23850	+	NM_028430	41210286	41234008	8
chr10	41239305	41250848	Cd164	11543	+	NM_016898	41239340	41248647	6
chr10	41258654	41326401	Ccdc162	67747	-	NM_001303469	41259097	41326401	21
chr10	41287821	41296282	5730435O14Rik	8461	+	NR_045341	41296282	41296282	4
chr10	41438645	41529674	Cep57l1	91029	-	NM_026643	41439500	41465724	11
chr10	41530379	41628242	Sesn1	97863	+	NM_001162908	41530827	41627164	10
chr10	41634796	41738188	Armc2	103392	-	NM_001034858	41636867	41731791	18
chr10	41905591	41996548	Foxo3	90957	-	NM_019740	41916306	41995239	4
chr10	42032390	42198371	Lace1	165981	-	NM_145743	42033296	42198207	13
chr10	42221859	42255175	Snx3	33316	+	NM_017472	42222136	42254564	4
chr10	42281776	42303394	Nr2e1	21618	-	NM_152229	42283169	42302712	9
chr10	42398721	42422268	Ostm1	23547	+	NM_172416	42398789	42420344	6
chr10	42481301	42552320	Sec63	71019	+	NM_153055	42481570	42548840	21
chr10	42580317	42680588	Scml4	100271	+	NM_172938	42631881	42677550	9
chr10	42722305	42894336	Sobp	172031	-	NM_175407	42740798	42893877	7
chr10	42894504	42896371	9030612E09Rik	1867	+	NR_102361	42896371	42896371	1
chr10	42941291	43184688	Pdss2	243397	+	NM_001168289	42941567	43184442	8
chr10	43198945	43235223	Bend3	36278	+	NM_199028	43213458	43231896	4
chr10	43244926	43260800	1700021F05Rik	15874	-	NM_026411	43245034	43252951	4
chr10	43298974	43304071	Cd24a	5097	+	NM_009846	43299059	43302571	2
chr10	43313232	43350719	F830002L21Rik	37487	+	NR_033558	43350719	43350719	3
chr10	43465963	43485642	1700027J07Rik	19679	+	NR_040581	43485642	43485642	4
chr10	43545712	43553107	4933404K13Rik	7395	+	NR_131055	43553107	43553107	3
chr10	43593995	43621542	Qrsl1	27547	-	NM_001081054	43594288	43621443	11
chr10	43621612	43667668	Rtn4ip1	46056	+	NM_130892	43622068	43666334	9
chr10	43670112	43724652	Aim1	54540	-	NM_172393	43671674	43723874	20
chr10	43890252	43939391	Speer5-ps1	49139	+	NR_001582	43939391	43939391	7
chr10	43988144	44084105	Atg5	95961	+	NM_053069	44005895	44082858	8
chr10	44079481	44079574	Mir1929	93	+	NR_035450	44079574	44079574	1
chr10	44156979	44178554	Prdm1	21575	-	NM_007548	44159472	44178314	7
chr10	44787019	44878801	Prep	91782	+	NM_011156	44787136	44878332	15
chr10	45009110	45038256	Popdc3	29146	+	NM_024286	45034600	45037786	4
chr10	45055567	45089514	Bves	33947	+	NM_024285	45059036	45089115	8
chr10	45096424	45190007	Lin28b	93583	-	NM_001031772	45100870	45189866	5
chr10	45297634	45432151	Hace1	134517	+	NM_172473	45297880	45431342	24
chr10	45527509	45571824	D030045P18Rik	44315	+	NR_040624	45571824	45571824	3
chr10	48813486	48815649	C130030K03Rik	2163	-	NR_046212	48815649	48815649	1
chr10	48819268	49508560	Grik2	689292	-	NM_010349	48824823	49503065	18
chr10	50312474	50571008	Ascc3	258534	+	NM_198007	50324598	50570399	42
chr10	50615456	50708958	Sim1	93502	+	NM_011376	50615702	50704147	11
chr10	51200417	51206135	Lilr4b	5718	+	NM_008147	51200525	51205566	9
chr10	51210703	51216417	Lilrb4a	5714	+	NM_013532	51210823	51216050	9
chr10	51305255	51310266	Fam162b	5011	-	NM_029894	51305297	51310227	4
chr10	51334628	51351264	Gprc6a	16636	-	NM_153071	51334670	51351237	6
chr10	51397565	51450235	Rfx6	52670	+	NM_001159389	51397615	51449612	19
chr10	51475979	51477000	4933411G06Rik	1021	-	NR_045158	51477000	51477000	1
chr10	51742307	51748277	Vgll2	5970	+	NM_153786	51742528	51747817	3
chr10	51765731	51915050	Ros1	149319	-	NM_011282	51765821	51914762	44
chr10	51953424	52041183	Dcbld1	87759	+	NM_025705	51953556	52039802	11
chr10	52056829	52101930	Gopc	45101	-	NM_001199272	52059528	52101704	9
chr10	52111413	52124410	Nepn	12997	+	NM_025684	52111445	52124158	3
chr10	52137352	52159998	Nus1	22646	+	NM_030250	52137547	52156473	5
chr10	52262125	52265545	Zfa-ps	3420	-	NR_037920	52265545	52265545	1
chr10	52410306	52831428	Slc35f1	421122	+	NM_178675	52410802	52828178	8
chr10	52997886	53099657	Cep85l	101771	-	NM_001204983	52997886	53099387	13
chr10	53000075	53003493	Gm19395	3418	+	NR_038015	53003493	53003493	3
chr10	53057491	53065805	Pln	8314	+	NM_001141927	53063669	53063828	3
chr10	53218248	53238795	Gm20597	20547	-	NR_037973	53238795	53238795	4
chr10	53257129	53350245	Mcm9	93116	-	NM_027830	53257129	53350245	14
chr10	53316766	53329021	Asf1a	12255	+	NM_025541	53316995	53327683	4
chr10	53352951	53470715	Fam184a	117764	-	NM_001081428	53353439	53470686	18
chr10	53625838	53795602	Man1a	169764	-	NM_008548	53627242	53794830	13
chr10	53795727	53800887	Gm16998	5160	+	NR_038016	53800887	53800887	3
chr10	55734099	55948495	Tbc1d32	214396	-	NM_001033385	55737390	55948438	33
chr10	55826722	55836686	Msl3l2	9964	+	NM_001163833	55834986	55836102	2
chr10	56097105	56110225	Gja1	13120	+	NM_010288	56107352	56108501	2
chr10	57198188	57206159	4930467K11Rik	7971	-	NR_045353	57206159	57206159	4
chr10	57206190	57232949	Hsf2	26759	+	NM_008297	57206314	57232004	12
chr10	57235581	57252335	Serinc1	16754	-	NM_019760	57236962	57252201	9
chr10	57351786	57460918	Pkib	109132	+	NM_008863	57427899	57456163	6
chr10	57504728	57508256	Fabp7	3528	+	NM_021272	57504814	57507979	4
chr10	57514349	57531636	Smpdl3a	17287	+	NM_020561	57514487	57531321	8
chr10	57693398	57695423	Dux	2025	-	NM_001081954	57693398	57695423	1
chr10	57697595	57699408	Gm4981	1813	-	NM_001034869	57698262	57699138	1
chr10	57718273	57768340	Gcc2	50067	+	NM_027375	57718313	57766912	23
chr10	57786213	57887439	Lims1	101226	+	NM_026148	57786403	57884316	10
chr10	57909599	57956902	Ranbp2	47303	+	NM_011240	57909727	57956716	29
chr10	57960684	58038992	Ccdc138	78308	+	NM_001162956	57960717	58038602	16
chr10	58063535	58138444	Edar	74909	-	NM_010100	58065609	58092862	12
chr10	58159492	58167025	BB019430	7533	+	NR_033565	58167025	58167025	5
chr10	58276106	58601664	Sh3rf3	325558	+	NM_172788	58276322	58598736	10
chr10	58604374	58684595	Sept10	80221	-	NM_001024910	58604397	58684156	10
chr10	58684669	58689181	Sowahc	4512	+	NM_172939	58684791	58686330	1
chr10	58786043	58836052	P4ha1	50009	+	NM_011030	58799828	58833822	15
chr10	58866432	58884724	Pla2g12b	18292	+	NM_023530	58866518	58884332	4
chr10	58885707	58904527	Oit3	18820	-	NM_010959	58886686	58904431	9
chr10	58909731	59079440	Mcu	169709	-	NM_001033259	58911528	59079418	8
chr10	59165310	59326882	Micu1	161572	+	NM_001291443	59190705	59326084	13
chr10	59342338	59360764	Dnajb12	18426	+	NM_019965	59342425	59359219	9
chr10	59412422	59414518	Ddit4	2096	-	NM_029083	59413283	59414260	3
chr10	59450656	59465860	Anapc16	15204	-	NM_025514	59451470	59459337	4
chr10	59465552	59562738	Ascc1	97186	+	NM_026937	59467566	59560957	11
chr10	59569004	59596661	Spock2	27657	+	NM_052994	59569215	59594229	11
chr10	59589523	59589581	Mir6906	58	+	NR_105871	59589581	59589581	1
chr10	59644275	59682008	Chst3	37733	-	NM_016803	59648352	59650978	4
chr10	59740375	59765348	Psap	24973	+	NM_011179	59740490	59764477	15
chr10	59765497	60159238	Cdh23	393741	-	NM_023370	59766121	60120081	69
chr10	59809598	59835432	Vsir	25834	+	NM_001159572	59809769	59831687	7
chr10	59862473	59866306	Gm17455	3833	+	NM_001164374	59865705	59866092	2
chr10	60174819	60215530	Slc29a3	40711	-	NM_023596	60178583	60215482	6
chr10	60225342	60294329	Unc5b	68987	-	NM_029770	60227955	60293913	17
chr10	60385770	60385861	Mir6408	91	+	NR_105835	60385861	60385861	1
chr10	60390973	60400880	Pldi	9907	-	NR_033616	60400880	60400880	3
chr10	60423470	60423592	Mir466j	122	+	NR_130327	60423592	60423592	1
chr10	60494050	60500828	Gm20611	6778	+	NR_040638	60500828	60500828	3
chr10	60552078	60557077	Pcbd1	4999	+	NM_025273	60552161	60556653	4
chr10	60561389	60610432	Sgpl1	49043	-	NM_001316674	60563615	60609032	15
chr10	60634711	60651589	Tbata	16878	+	NM_001017419	60637159	60651423	10
chr10	60659859	60736186	Adamts14	76327	-	NM_001081127	60661225	60735985	22
chr10	60760583	60767011	Prf1	6428	+	NM_011073	60762694	60766677	3
chr10	60782404	60846271	Pald1	63867	-	NM_013753	60783837	60818755	20
chr10	60880719	60888085	Nodal	7366	+	NM_013611	60881047	60887384	3
chr10	60895244	60915417	Eif4ebp2	20173	-	NM_010124	60896544	60915294	3
chr10	60938580	61044976	Lrrc20	106396	+	NM_153542	60945148	61043032	5
chr10	61058231	61089133	Npffr1	30902	+	NM_001177511	61058239	61089133	4
chr10	61111368	61136913	Ppa1	25545	+	NM_026438	61111475	61136598	11
chr10	61137274	61143038	1700022H01Rik	5764	-	NR_126477	61143038	61143038	2
chr10	61143068	61156045	Sar1a	12977	+	NM_009120	61147643	61154149	7
chr10	61158261	61165521	Tysnd1	7260	+	NM_001272090	61158318	61164899	4
chr10	61178010	61202008	Aifm2	23998	+	NM_178058	61188624	61199482	10
chr10	61201394	61246612	H2afy2	45218	-	NM_207000	61202044	61220643	9
chr10	61237484	61237569	Mir5108	85	+	NR_039568	61237569	61237569	1
chr10	61300981	61441856	Col13a1	140875	-	NM_007731	61301453	61441384	41
chr10	61533769	61535319	Gm5424	1550	+	NR_002687	61535319	61535319	1
chr10	61570403	61573761	2010107G23Rik	3358	-	NM_027251	61571601	61572724	4
chr10	61595837	61597511	Neurog3	1674	+	NM_009719	61596210	61596855	2
chr10	61648143	61693966	Tspan15	45823	-	NM_197996	61650760	61693863	8
chr10	61656914	61656975	Mir7662	61	-	NR_106122	61656975	61656975	1
chr10	61715185	61728738	Tacr2	13553	+	NM_009314	61715565	61728015	5
chr10	61731602	61842656	Hk1	111054	-	NM_010438	61732656	61821110	22
chr10	61803354	61812614	Hk1os	9260	+	NR_038038	61812614	61812614	2
chr10	61845884	61885205	Hkdc1	39321	-	NM_145419	61846522	61885108	18
chr10	61892125	61912441	Supv3l1	20316	-	NM_181423	61892167	61912433	15
chr10	61911907	61914101	4930507D05Rik	2194	+	NR_027926	61914101	61914101	1
chr10	61917590	61949553	Vps26a	31963	-	NM_133672	61919492	61949408	9
chr10	61957175	61970503	Srgn	13328	-	NM_011157	61957613	61970462	3
chr10	62021217	62041205	Kif1bp	19988	-	NM_028197	62021755	62041125	7
chr10	62042994	62065046	Ddx21	22052	-	NM_019553	62045097	62064962	15
chr10	62078770	62113946	Ddx50	35176	-	NM_053183	62078985	62113859	15
chr10	62122169	62188847	Stox1	66678	-	NM_001033260	62122267	62188816	4
chr10	62145255	62145306	Mir7215	51	+	NR_106074	62145306	62145306	1
chr10	62206675	62255116	Ccar1	48441	-	NM_026201	62207510	62253741	25
chr10	62267317	62342762	Tet1	75445	-	NM_001253857	62275279	62342762	12
chr10	62383380	62409242	Slc25a16	25862	+	NM_175194	62383499	62407219	9
chr10	62409776	62436936	Dna2	27160	+	NM_177372	62409840	62436067	21
chr10	62442970	62481490	Rufy2	38520	+	NM_027425	62443076	62474481	18
chr10	62477411	62486597	Hnrnph3	9186	-	NM_001079824	62478385	62482252	10
chr10	62487259	62521560	Pbld2	34301	+	NM_026085	62501896	62520501	10
chr10	62524364	62540284	Pbld1	15920	+	NM_026701	62524365	62539209	9
chr10	62562903	62563353	Atoh7	450	+	NM_016864	62562903	62563353	1
chr10	62578542	62666700	Mypn	88158	-	NM_182992	62579604	62656030	20
chr10	62706544	62780629	Herc4	74085	+	NM_030114	62708647	62780236	26
chr10	62781752	62801783	Sirt1	20031	-	NM_019812	62783383	62801718	9
chr10	62845190	62871588	Dnajc12	26398	+	NM_001253685	62860075	62871031	5
chr10	62892845	64466415	Ctnna3	1573570	+	NM_177612	62966784	64465581	18
chr10	63391244	63553003	Lrrtm3	161759	-	NM_178678	63392805	63552461	3
chr10	65583356	65586812	1700023F02Rik	3456	-	NR_038039	65586812	65586812	3
chr10	65608043	65642262	4930407I19Rik	34219	+	NR_131070	65642262	65642262	5
chr10	66467822	66504074	Gm31763	36252	+	NR_110511	66504074	66504074	7
chr10	66471936	66559736	Reep3	87800	-	NM_001204915	66476515	66559569	9
chr10	66590005	66719074	Jmjd1c	129069	+	NM_207221	66590005	66718285	26
chr10	66729436	66748029	Nrbf2	18593	-	NM_001036293	66730206	66747874	4
chr10	67000616	67004936	Egr2	4320	+	NM_010118	67000968	67003736	2
chr10	67007258	67011703	Ado	4445	-	NM_001005419	67010750	67011521	1
chr10	67348852	67375410	Zfp365	26558	-	NM_178679	67351577	67372694	5
chr10	67442345	67506612	Rtkn2	64267	+	NM_001081346	67442521	67504665	13
chr10	67558340	67741474	Arid5b	183134	-	NM_023598	67559251	67741458	10
chr10	67781812	67783890	4930545H06Rik	2078	-	NR_045357	67783890	67783890	3
chr10	67893703	68004623	1700040L02Rik	110920	-	NM_028491	67893996	68004605	8
chr10	68186493	68245402	Tmem26	58909	+	NM_177794	68186647	68241605	6
chr10	68671299	68754532	Rhobtb1	83233	+	NM_001252636	68711528	68752437	11
chr10	68799382	68815660	Cdk1	16278	-	NM_007659	68801245	68812880	8
chr10	68996455	69490184	Ank3	493729	+	NM_170688	68996969	69478381	43
chr10	69559868	69655948	Ccdc6	96080	+	NM_001111121	69560047	69652026	9
chr10	69667411	69682459	Mrln	15048	+	NM_001304739	69682243	69682384	3
chr10	69708023	69748699	Slc16a9	40676	+	NM_025807	69718744	69746803	6
chr10	69903415	70021480	Fam13c	118065	+	NM_001143777	69913901	70020111	15
chr10	70020433	70062039	Phyhipl	41606	-	NM_178621	70021994	70061855	5
chr10	70063796	70118711	D630013N20Rik	54915	-	NR_045292	70118711	70118711	4
chr10	70387847	70622382	Bicc1	234535	-	NM_031397	70387992	70622364	21
chr10	70631484	70644788	C730027H18Rik	13304	-	NR_038040	70644788	70644788	8
chr10	70664492	70667236	1700113B09Rik	2744	+	NR_131003	70667236	70667236	2
chr10	70688224	70700792	Tfam	12568	-	NM_009360	70691306	70700688	7
chr10	70717727	70748010	Ube2d1	30283	-	NM_145420	70718576	70747872	7
chr10	70793241	70807597	Cisd1	14356	-	NM_134007	70793784	70807502	3
chr10	70810540	70848633	Ipmk	38093	+	NM_027184	70810699	70844566	6
chr10	71442632	71443438	1700049L16Rik	806	-	NR_003644	71443438	71443438	1
chr10	72117593	72137712	Zwint	20119	+	NM_001293683	72117666	72120134	8
chr10	72436050	72549453	A330049N07Rik	113403	-	NR_040646	72549453	72549453	5
chr10	73284614	74112477	Pcdh15	827863	+	NM_001142746	73409803	74108817	35
chr10	74420221	74495331	Rsph14	75110	-	NM_027730	74420286	74495318	7
chr10	74429975	74478622	Gnaz	48647	+	NM_010311	74454162	74477957	4
chr10	74499833	74516845	Rab36	17012	+	NM_029781	74501196	74515274	11
chr10	74523640	74647668	Bcr	124028	+	NM_001081412	74523770	74645074	23
chr10	74674817	74775145	Specc1l	100328	+	NM_153406	74693463	74772624	16
chr10	74779621	74797537	Adora2a	17916	+	NM_009630	74788773	74796681	3
chr10	74814799	74815706	Gm5779	907	+	NR_033602	74815706	74815706	1
chr10	74869655	74904424	Upb1	34769	+	NM_133995	74869800	74902709	10
chr10	74912254	74925849	4933407G14Rik	13595	+	NR_045841	74925849	74925849	3
chr10	74969558	74980067	Gucd1	10509	-	NM_175133	74971622	74979941	6
chr10	74980786	74998185	Snrpd3	17399	+	NM_026095	74982079	74998067	4
chr10	75012869	75023075	Lrrc75b	10206	-	NM_198860	75016339	75022865	4
chr10	75031406	75048936	Ggt1	17530	+	NM_001305992	75036980	75048772	14
chr10	75052125	75079713	Ggt5	27588	+	NM_011820	75052454	75077627	12
chr10	75099363	75106753	Susd2	7390	-	NM_027890	75100090	75106688	15
chr10	75108854	75227102	Cabin1	118248	-	NM_172549	75109288	75218116	37
chr10	75233977	75236119	Ddt	2142	-	NM_010027	75234178	75236068	3
chr10	75236866	75244159	Gstt3	7293	-	NM_133994	75237557	75243703	5
chr10	75246557	75261329	Gstt1	14772	-	NM_008185	75246783	75261241	5
chr10	75277688	75285288	Gstt4	7600	-	NM_029472	75277808	75285168	5
chr10	75294589	75297626	Gstt2	3037	-	NM_010361	75294629	75297031	5
chr10	75322097	75322995	Mif	898	-	NM_010798	75322221	75322913	3
chr10	75356142	75358686	Derl3	2544	+	NM_024440	75356169	75358064	7
chr10	75359513	75384359	Smarcb1	24846	-	NM_011418	75359793	75384140	9
chr10	75385966	75395247	Mmp11	9281	-	NM_001306184	75386726	75395198	9
chr10	75398317	75400479	Chchd10	2162	+	NM_175329	75398708	75400339	4
chr10	75400467	75403417	Gm867	2950	-	NM_001277132	75401933	75403163	7
chr10	75411056	75412391	Vpreb3	1335	+	NM_009514	75411102	75412207	2
chr10	75417258	75472334	Gm5134	55076	+	NM_198635	75417316	75471572	14
chr10	75471670	75471762	Mir6409	92	+	NR_105836	75471762	75471762	1
chr10	75495356	75505714	Zfp280b	10358	+	NM_177475	75501033	75502638	2
chr10	75521365	75573763	Slc5a4b	52398	-	NM_023219	75521432	75573681	15
chr10	75610195	75652010	Slc5a4a	41815	+	NM_133184	75610275	75652006	15
chr10	75669970	75700610	Prmt2	30640	-	NR_126571	75700610	75700610	12
chr10	75670070	75670154	Mir678	84	-	NR_030443	75670154	75670154	1
chr10	75716580	75724064	S100b	7484	+	NM_009115	75719779	75722813	3
chr10	75725793	75808036	Dip2a	82243	-	NM_001081419	75727365	75807942	38
chr10	75813998	75905657	Pcnt	91659	-	NM_001282992	75814483	75905363	42
chr10	75851759	75864252	1700094J05Rik	12493	+	NR_040580	75864252	75864252	5
chr10	75911825	75923963	2610028H24Rik	12138	+	NM_029816	75912003	75920867	8
chr10	75922311	75931859	Ybey	9548	-	NM_172550	75925977	75931111	5
chr10	75931715	75978602	Mcm3ap	46887	+	NM_019434	75932799	75978485	29
chr10	75994349	76019884	Lss	25535	+	NM_146006	75994405	76015813	22
chr10	76008615	76024971	4930483K19Rik	16356	-	NR_045354	76024971	76024971	4
chr10	76025016	76032945	Spatc1l	7929	+	NM_029661	76025110	76032737	4
chr10	76038392	76053083	Ftcd	14691	+	NM_080845	76038450	76052057	14
chr10	76058500	76086149	Col6a2	27649	-	NM_146007	76058957	76077950	28
chr10	76171536	76188789	Col6a1	17253	-	NM_009933	76172303	76188658	35
chr10	76224598	76424692	Pcbp3	200094	-	NM_021568	76225234	76288614	16
chr10	76474739	76484959	Gm10787	10220	+	NR_045882	76484959	76484959	3
chr10	76495483	76513177	Slc19a1	17694	+	NM_001199271	76501141	76512551	6
chr10	76514923	76629275	Col18a1	114352	-	NM_009929	76515938	76629194	42
chr10	76720517	76721968	Gm10941	1451	-	NR_026944	76721968	76721968	2
chr10	76722044	76732331	Pofut2	10287	+	NM_030262	76722067	76731425	9
chr10	76753471	76881018	Adarb1	127547	-	NM_130895	76757526	76788638	11
chr10	76881120	76883684	Gm17769	2564	+	NR_027377	76883684	76883684	1
chr10	76949399	76978558	Fam207a	29159	-	NM_133998	76951094	76978485	6
chr10	76993092	77028419	Itgb2	35327	+	NM_008404	77004713	77027985	16
chr10	77044511	77061477	Pttg1ip	16966	+	NM_145925	77044566	77059810	6
chr10	77068841	77081076	Sumo3	12235	+	NR_125904	77081076	77081076	5
chr10	77085065	77108735	Ube2g2	23670	+	NM_019803	77085118	77107304	6
chr10	77103968	77104052	Mir1930	84	+	NR_035451	77104052	77104052	1
chr10	77149313	77349514	Tspear	200201	+	NM_001287074	77149557	77349325	12
chr10	77152701	77153502	Gm19402	801	-	NM_001205032	77152701	77153502	1
chr10	77169331	77169731	Gm10272	400	+	NR_026831	77169731	77169731	1
chr10	77174190	77174754	Gm10024	564	+	NM_001081452	77174201	77174561	1
chr10	77178551	77178914	Gm10142	363	+	NM_001205035	77178551	77178914	1
chr10	77183330	77184001	Krtap12-1	671	+	NM_010670	77183369	77183762	1
chr10	77189230	77189593	Gm10100	363	+	NM_001205033	77189230	77189593	1
chr10	77233377	77234070	Gm3238	693	-	NM_001101630	77233377	77234070	1
chr10	77261131	77261878	Gm19668	747	-	NM_001205034	77261131	77261878	1
chr10	77277426	77278149	Gm2696	723	+	NM_001205009	77277426	77278149	1
chr10	77288913	77289815	Krtap10-4	902	-	NM_001135991	77289121	77289787	1
chr10	77298691	77299996	Krtap10-10	1305	+	NM_001024709	77298743	77299397	1
chr10	77315603	77316533	Gm10318	930	+	NM_001162944	77315606	77316284	1
chr10	77324719	77325383	Gm3285	664	+	NM_001101631	77324763	77325369	1
chr10	77356164	77358856	1700009J07Rik	2692	+	NR_015547	77358856	77358856	2
chr10	77360319	77365281	Lrrc3	4962	-	NM_145152	77363571	77364345	2
chr10	77370466	77432617	Trpm2	62151	-	NM_138301	77372920	77429757	34
chr10	77441394	77448183	1810043G02Rik	6789	+	NM_026431	77441449	77447292	7
chr10	77449693	77472541	Pfkl	22848	-	NM_008826	77450954	77472428	22
chr10	77492766	77506355	Aire	13589	-	NR_073358	77506355	77506355	15
chr10	77505031	77526367	Dnmt3l	21336	+	NM_001081695	77512827	77526094	14
chr10	77532112	77542270	Icosl	10158	+	NM_015790	77532269	77540648	7
chr10	77624811	77632513	D10Jhu81e	7702	-	NM_138601	77625334	77632474	7
chr10	77633654	77647894	Pwp2	14240	-	NM_029546	77634704	77647833	21
chr10	77649470	77707387	Trappc10	57917	-	NM_001081055	77650600	77707247	23
chr10	77734307	77814445	Agpat3	80138	-	NM_053014	77736431	77750769	10
chr10	77802894	77802952	Mir7659	58	-	NR_106119	77802952	77802952	1
chr10	77863106	77875788	Rrp1	12682	-	NM_010925	77863538	77875697	13
chr10	77871219	77871290	Mir6907	71	-	NR_105872	77871290	77871290	1
chr10	77888414	77890367	Cstb	1953	+	NM_007793	77888536	77890184	3
chr10	77897543	77897647	Mir6410	104	+	NR_105837	77897647	77897647	1
chr10	77899491	77927693	Pdxk	28202	-	NM_172134	77903545	77927592	11
chr10	77907839	77907902	Mir6908	63	-	NR_105873	77907902	77907902	1
chr10	78037244	78047247	Ilvbl	10003	+	NM_173751	78037841	78046993	16
chr10	78047247	78054709	Syde1	7462	-	NM_027875	78048246	78054634	8
chr10	78074413	78080819	Olfr1357	6406	-	NM_001011737	78074442	78075384	2
chr10	78174739	78181038	Casp14	6299	-	NM_009809	78176081	78178603	7
chr10	78209668	78215812	Ccdc105	6144	-	NM_027630	78209793	78215719	7
chr10	78243240	78277570	Slc1a6	34330	+	NM_009200	78250513	78277360	10
chr10	78309695	78310658	Olfr1356	963	-	NM_146308	78309695	78310658	1
chr10	78338293	78342851	Olfr1355	4558	+	NM_207571	78341918	78342851	2
chr10	78379586	78380681	Olfr1354	1095	+	NM_001199840	78379586	78380519	1
chr10	78417951	78418884	Olfr8	933	+	NM_207201	78417951	78418884	1
chr10	78426053	78433357	Olfr1353	7304	+	NM_147042	78432395	78433325	3
chr10	78443794	78447466	Olfr1352	3672	+	NM_147071	78446536	78447466	2
chr10	78480068	78481028	Olfr1351	960	+	NM_147040	78480068	78481028	1
chr10	78497467	78498547	Olfr57	1080	+	NM_147041	78497542	78498502	1
chr10	78527118	78560345	2610008E11Rik	33227	-	NM_001004362	78529215	78560223	6
chr10	78611560	78657678	Vmn2r80	46118	+	NM_001103368	78611560	78657678	6
chr10	78710521	78757280	Vmn2r81	46759	+	NM_175936	78710538	78756619	6
chr10	78819335	78859511	Vmn2r82	40176	+	NM_001101572	78819335	78859511	6
chr10	78931702	78954899	Vmn2r83	23197	+	NM_001104537	78931702	78954899	6
chr10	78989168	78996532	Plpp2	7364	-	NM_015817	78989876	78996420	6
chr10	78993773	78993835	Mir6909	62	-	NR_105874	78993835	78993835	1
chr10	79002989	79017873	Mier2	14884	-	NM_001316699	79003922	79017827	14
chr10	79039221	79049881	Theg	10660	-	NM_011583	79039272	79049811	8
chr10	79069598	79076770	C2cd4c	7172	-	NM_001168624	79074796	79076056	2
chr10	79080682	79100663	Shc2	19981	-	NM_001024539	79083803	79100595	13
chr10	79102270	79108483	Odf3l2	6213	-	NM_001033473	79102639	79108438	4
chr10	79127318	79131281	Madcam1	3963	+	NM_013591	79127351	79131112	5
chr10	79132154	79138871	Tpgs1	6717	+	NM_148934	79132154	79138682	2
chr10	79144939	79151143	Cdc34	6204	+	NM_177613	79145158	79150804	5
chr10	79151764	79158006	Gzmm	6242	+	NM_001302485	79152155	79157905	5
chr10	79167102	79174724	Bsg	7622	+	NM_009768	79167262	79174302	8
chr10	79179378	79198853	Hcn2	19475	+	NM_008226	79179413	79198285	8
chr10	79198869	79209326	Polrmt	10457	-	NM_172551	79198978	79209297	21
chr10	79217863	79219706	Fgf22	1843	+	NM_023304	79217863	79219706	3
chr10	79221259	79229697	Rnf126	8438	-	NM_144528	79221831	79229572	9
chr10	79240018	79245375	Fstl3	5357	+	NM_031380	79240045	79244220	5
chr10	79244218	79251730	Prss57	7512	-	NM_001042710	79246013	79251687	5
chr10	79256316	79283641	Palm	27325	+	NM_023128	79256480	79282306	9
chr10	79283765	79293197	Misp	9432	+	NM_030218	79288495	79292845	5
chr10	79314121	79317716	E130317F20Rik	3595	-	NR_029447	79317716	79317716	1
chr10	79317176	79327180	Ptbp1	10004	+	NM_001077363	79317458	79326022	14
chr10	79323219	79337379	Plppr3	14160	-	NM_001170935	79324441	79336839	9
chr10	79325331	79325397	Mir6910	66	+	NR_105875	79325397	79325397	1
chr10	79342411	79345917	Prtn3	3506	+	NM_011178	79342420	79345721	5
chr10	79349056	79350961	Elane	1905	+	NM_015779	79349079	79350862	5
chr10	79353597	79355405	Cfd	1808	+	NM_013459	79353670	79355331	5
chr10	79357451	79371683	Med16	14232	-	NM_198107	79358028	79371640	15
chr10	79372797	79379675	R3hdm4	6878	-	NM_177994	79373783	79379629	8
chr10	79379715	79385017	Kiss1r	5302	+	NM_053244	79381418	79384749	5
chr10	79389787	79417763	Arid3a	27976	+	NM_007880	79393638	79414681	9
chr10	79422896	79431991	Wdr18	9095	+	NM_175450	79422907	79430344	10
chr10	79433468	79439935	Grin3b	6467	+	NM_130455	79433644	79439849	9
chr10	79439864	79447075	Tmem259	7211	-	NM_001003949	79440163	79446876	11
chr10	79451344	79458145	Cnn2	6801	+	NM_007725	79451422	79457359	7
chr10	79460359	79478317	Abca7	17958	+	NM_013850	79460359	79478203	46
chr10	79479416	79494216	Hmha1	14800	+	NM_001142701	79479570	79493793	23
chr10	79498697	79502404	Polr2e	3707	-	NM_025554	79499277	79502384	7
chr10	79509910	79519184	Gpx4	9274	+	NR_110342	79519184	79519184	7
chr10	79519758	79565447	Sbno2	45689	-	NM_183426	79520160	79549082	32
chr10	79578547	79593430	Stk11	14883	+	NR_126043	79593430	79593430	11
chr10	79593178	79602112	Cbarp	8934	-	NR_036582	79602112	79602112	11
chr10	79605059	79608563	Atp5d	3504	+	NM_025313	79605210	79608290	4
chr10	79611016	79621113	Midn	10097	+	NM_021565	79612822	79619387	9
chr10	79630585	79634398	Cirbp	3813	+	NM_007705	79632558	79633743	7
chr10	79635688	79637864	1600002K03Rik	2176	+	NM_027207	79635710	79637562	3
chr10	79642226	79652755	Efna2	10529	+	NM_007909	79642507	79651535	4
chr10	79689342	79707889	Mum1	18547	+	NM_023431	79691126	79706388	14
chr10	79712196	79719537	Ndufs7	7341	+	NM_029272	79712220	79719478	8
chr10	79720895	79723713	Gamt	2818	-	NM_010255	79721061	79723646	6
chr10	79727735	79751158	Dazap1	23423	+	NM_133188	79727894	79750456	12
chr10	79740908	79740977	Mir6911	69	+	NR_105876	79740977	79740977	1
chr10	79755175	79756859	Rps15	1684	+	NM_009091	79755225	79756825	4
chr10	79764564	79781001	Apc2	16437	+	NM_011789	79764582	79778770	14
chr10	79780999	79783293	2310011J03Rik	2294	-	NM_025521	79782092	79783057	2
chr10	79784027	79792218	Pcsk4	8191	-	NM_008793	79784550	79792195	15
chr10	79792889	79799186	Reep6	6297	+	NM_139292	79792975	79797862	6
chr10	79802537	79811193	Adamtsl5	8656	-	NM_001285435	79803899	79808389	13
chr10	79819203	79828234	Plk5	9031	+	NM_183152	79819307	79828026	15
chr10	79843099	79850396	Mex3d	7297	-	NM_198615	79843969	79850165	2
chr10	79855283	79862276	Mbd3	6993	-	NM_001306143	79855844	79861976	7
chr10	79865741	79869566	Uqcr11	3825	-	NM_025650	79866910	79869490	3
chr10	79871909	79896398	Tcf3	24489	-	NM_001164153	79872876	79893756	19
chr10	79957650	79980005	Onecut3	22355	+	NM_139226	79957752	79976891	2
chr10	79982329	80001869	Atp8b3	19540	-	NM_026094	79982613	79999549	28
chr10	80003670	80024305	Rexo1	20635	-	NM_025852	80005137	80024165	15
chr10	80029865	80040041	Klf16	10176	-	NM_078477	80031665	80039945	2
chr10	80046393	80053086	Abhd17a	6693	-	NM_145421	80046582	80049591	5
chr10	80065624	80070399	Adat3	4775	+	NM_001100606	80069074	80070124	2
chr10	80065626	80078528	Scamp4	12902	+	NM_019575	80071588	80077528	7
chr10	80072004	80072074	Mir6912	70	+	NR_105877	80072074	80072074	1
chr10	80085524	80103516	Csnk1g2	17992	+	NM_134002	80097199	80102821	11
chr10	80105361	80119816	Btbd2	14455	-	NM_145361	80106274	80119275	9
chr10	80128062	80139038	Mknk2	10976	-	NM_021462	80129851	80138619	14
chr10	80147997	80164565	Mob3a	16568	-	NM_172457	80149888	80154234	4
chr10	80165437	80168127	Izumo4	2690	+	NM_027829	80165460	80167896	10
chr10	80169722	80204956	Ap3d1	35234	-	NM_007460	80170632	80204736	31
chr10	80217950	80257092	Dot1l	39142	+	NM_199322	80218188	80256259	28
chr10	80258843	80261371	Plekhj1	2528	-	NM_023900	80259156	80260919	6
chr10	80261479	80267667	Sf3a2	6188	+	NM_013651	80263977	80267559	9
chr10	80267992	80270393	Amh	2401	+	NM_007445	80267992	80270393	5
chr10	80271240	80276243	Jsrp1	5003	-	NM_028001	80271316	80275157	7
chr10	80289400	80292035	Oaz1	2635	+	NM_001301034	80289504	80291749	5
chr10	80289440	80291962	Oaz1-ps	2522	+	NR_027656	80291962	80291962	5
chr10	80291541	80291615	Mir1982	74	+	NR_035503	80291615	80291615	1
chr10	80295547	80306784	Lingo3	11237	-	NM_001013758	80297069	80298839	2
chr10	80315569	80317954	Lsm7	2385	-	NM_025349	80315702	80317931	4
chr10	80318019	80331453	Sppl2b	13434	+	NM_175195	80318085	80330387	15
chr10	80342560	80362239	Tmprss9	19679	+	NM_001081688	80342560	80362085	18
chr10	80362194	80363714	Timm13	1520	-	NM_013895	80362905	80363488	3
chr10	80364107	80380990	Lmnb2	16883	-	NM_010722	80365603	80380906	12
chr10	80392835	80394949	Gadd45b	2114	+	NM_008655	80393060	80394391	4
chr10	80411368	80477670	Gng7	66302	-	NM_010319	80414365	80415659	4
chr10	80482334	80488122	Diras1	5788	-	NM_145217	80484563	80485160	2
chr10	80491284	80496657	Slc39a3	5373	-	NM_134135	80493701	80496566	2
chr10	80506817	80522899	Sgta	16082	-	NM_024499	80508939	80514960	12
chr10	80532827	80545105	Thop1	12278	+	NM_022653	80533007	80544764	13
chr10	80547077	80561617	Creb3l3	14540	-	NM_145365	80547499	80555274	12
chr10	80567358	80567418	Mir5615-1	60	-	NR_049186	80567418	80567418	1
chr10	80567360	80567420	Mir5615-2	60	+	NR_049187	80567420	80567420	1
chr10	80568691	80587442	Map2k2	18751	+	NM_023138	80568891	80586475	11
chr10	80599015	80614402	Zbtb7a	15387	+	NM_010731	80606718	80611180	3
chr10	80616715	80630465	Pias4	13750	-	NM_021501	80616845	80630456	11
chr10	80639375	80645254	Eef2	5879	+	NM_007907	80639471	80644827	14
chr10	80641705	80641758	Snord37	53	+	NR_028549	80641758	80641758	1
chr10	80645751	80655942	Dapk3	10191	+	NM_001190474	80645828	80655689	9
chr10	80657435	80671115	Atcayos	13680	+	NR_015477	80671115	80671115	3
chr10	80660914	80664782	Nmrk2	3868	-	NM_027120	80662105	80664721	7
chr10	80667257	80693524	Atcay	26267	-	NM_178662	80669476	80687245	13
chr10	80695907	80714868	Zfr2	18961	+	NM_001034895	80695934	80714179	18
chr10	80715679	80725726	Matk	10047	+	NM_001285855	80721275	80725607	13
chr10	80727466	80729671	Mrpl54	2205	-	NM_025317	80727609	80729635	3
chr10	80730916	80735992	Apba3	5076	+	NM_018758	80731639	80735865	11
chr10	80734341	80734432	Mir3057	91	+	NR_037218	80734432	80734432	1
chr10	80735932	80754326	Tjp3	18394	-	NM_001282095	80736031	80746475	21
chr10	80755707	80782719	Pip5k1c	27012	+	NM_001293646	80755803	80780513	19
chr10	80783847	80788996	Cactin	5149	+	NM_027381	80783955	80788699	9
chr10	80791447	80797919	Tbxa2r	6472	+	NM_009325	80795223	80797452	4
chr10	80800506	80806011	Gipc3	5505	-	NM_148951	80800627	80806002	6
chr10	80808790	80813202	Hmg20b	4412	-	NM_001163166	80809209	80812916	10
chr10	80820314	80826780	Mfsd12	6466	+	NM_028657	80820342	80826537	10
chr10	80826768	80828565	4930404N11Rik	1797	-	NM_001014836	80826808	80828531	4
chr10	80829623	80841115	Fzr1	11492	-	NM_019757	80830253	80834158	14
chr10	80847172	80851097	Dohh	3925	+	NM_133964	80848518	80850768	5
chr10	80849091	80849157	Mir6913	66	+	NR_105878	80849157	80849157	1
chr10	80855808	80857824	Smim24	2016	+	NM_001099917	80855837	80857641	4
chr10	80858935	80889918	Nfic	30983	-	NM_008688	80866122	80889850	10
chr10	80878984	80879042	Mir1191b	58	-	NR_106141	80879042	80879042	1
chr10	80921971	80945454	Celf5	23483	-	NM_001311124	80925070	80945350	12
chr10	80949203	80959108	Ncln	9905	-	NM_134009	80950290	80959008	14
chr10	80960489	80962882	S1pr4	2393	-	NM_010102	80961222	80962383	1
chr10	80965058	80986970	Gna15	21912	-	NM_010304	80965623	80986699	7
chr10	80991476	81007791	Gna11	16315	-	NM_010301	80993539	81007672	7
chr10	81022188	81029116	Aes	6928	+	NM_010347	81022386	81028438	7
chr10	81038031	81053590	Tle2	15559	+	NM_019725	81038412	81053077	21
chr10	81053649	81063645	Tle6	9996	-	NM_053254	81053779	81062824	14
chr10	81069052	81072581	BC025920	3529	+	NR_030677	81072581	81072581	3
chr10	81084530	81090353	Sirt6	5823	-	NM_181586	81085157	81090282	8
chr10	81091284	81110357	Ankrd24	19073	+	NM_027480	81092457	81109922	20
chr10	81111813	81130106	Gm10778	18293	+	NM_001142963	81111908	81126976	4
chr10	81326678	81343831	Zfp433	17153	+	NM_001243067	81326751	81343323	4
chr10	81364655	81393225	Zfp781	28570	-	NM_199062	81367817	81373644	4
chr10	81510871	81524331	Zfp873	13460	+	NM_001024626	81521161	81524074	3
chr10	81590757	81615810	AU041133	25053	+	NM_001163064	81590840	81614756	4
chr10	81687601	81704020	Zfp938	16419	-	NM_001105557	81687789	81703918	4
chr10	81949277	81955363	Gm1553	6086	-	NM_001255990	81950851	81955310	4
chr10	82082595	82085973	1190007I07Rik	3378	-	NM_001135569	82082866	82085560	3
chr10	82092582	82113239	Tdg	20657	+	NM_011561	82101494	82111465	10
chr10	82092586	82113022	Gm9855	20436	+	NR_037190	82113022	82113022	10
chr10	82113177	82153395	Glt8d2	40218	-	NM_029102	82114093	82134826	10
chr10	82161751	82204137	Hcfc2	42386	+	NM_001081218	82161888	82204057	15
chr10	82211444	82226886	Nfyb	15442	-	NM_010914	82213159	82224583	8
chr10	82274867	82286987	1700028I16Rik	12120	+	NR_038042	82286987	82286987	3
chr10	82296695	82360469	Txnrd1	63774	+	NM_001042523	82335714	82358790	15
chr10	82329370	82330674	Eid3	1304	+	NM_025499	82329451	82330579	1
chr10	82448241	82658636	Chst11	210395	+	NM_021439	82448609	82654544	3
chr10	82693883	82800562	Slc41a2	106679	-	NM_177388	82696309	82779354	11
chr10	82822965	82831580	D10Wsu102e	8615	+	NM_026579	82823003	82828667	4
chr10	82950191	82996885	Aldh1l2	46694	-	NM_153543	82953323	82996759	23
chr10	83006685	83059218	A230046K03Rik	52533	+	NM_001033375	83006786	83056983	33
chr10	83062778	83111409	Appl2	48631	-	NM_145220	83063651	83111326	21
chr10	83185609	83225507	1500009L16Rik	39898	+	NM_001145198	83185733	83222342	6
chr10	83834063	83903216	Nuak1	69153	-	NM_001004363	83836990	83903102	7
chr10	83951037	83960421	4930463O16Rik	9384	+	NR_108059	83960421	83960421	4
chr10	83989049	83996633	Ckap4	7584	-	NM_175451	83990214	83996611	2
chr10	84010161	84016083	Platr7	5922	-	NR_040658	84016083	84016083	4
chr10	84039691	84077100	Tcp11l2	37409	+	NM_146008	84047643	84076471	10
chr10	84085181	84189923	Polr3b	104742	+	NM_027423	84085211	84188525	28
chr10	84218792	84369281	Rfx4	150489	+	NM_001024918	84219215	84367972	18
chr10	84380357	84481082	Ric8b	100725	+	NM_183172	84380486	84477932	10
chr10	84559763	84565240	Fhl4	5477	-	NM_010214	84560820	84561660	2
chr10	84565371	84580492	Tmem263	15121	+	NM_001013028	84573549	84577439	3
chr10	84582177	84590772	Mterf2	8595	-	NM_028832	84582345	84583503	3
chr10	84594444	84647799	Cry1	53355	-	NM_007771	84595799	84647216	13
chr10	84849558	85123037	Btbd11	273479	+	NM_028709	84850073	85121094	17
chr10	85334575	85351848	Pwp1	17273	+	NM_133993	85334687	85350887	15
chr10	85354712	85379731	Prdm4	25019	-	NM_001302886	85355874	85375715	12
chr10	85391235	85392392	Ascl4	1157	+	NM_001163614	85391235	85391670	1
chr10	85401381	85420538	Rtcb	19157	-	NM_145422	85401756	85420452	12
chr10	85422435	85474605	Bpifc	52170	-	NM_177772	85423163	85463384	16
chr10	85484673	85511073	Fbxo7	26400	+	NM_153195	85484767	85510853	9
chr10	85511490	85961641	Syn3	450151	-	NM_013722	85518276	85930034	14
chr10	85558598	85576330	4930486F22Rik	17732	+	NR_038024	85576330	85576330	3
chr10	85763156	85812250	Timp3	49094	+	NM_011595	85763598	85808647	5
chr10	86148271	86152699	1810014B01Rik	4428	+	NR_015572	86152699	86152699	3
chr10	86153585	86168189	Hsp90b1	14604	-	NM_011631	86153846	86168100	18
chr10	86168555	86239588	Ttc41	71033	+	NM_001003910	86175688	86239566	16
chr10	86241749	86301134	Nt5dc3	59385	+	NM_175331	86241854	86296928	14
chr10	86303954	86470687	Stab2	166733	-	NM_138673	86304346	86470626	69
chr10	86520790	86693344	1700113H08Rik	172554	+	NM_029685	86536790	86693187	6
chr10	86953785	86956405	Ascl1	2620	-	NM_008553	86955137	86955833	2
chr10	86984539	87046882	Pah	62343	+	NM_008777	86984761	87046323	13
chr10	87321009	87399792	Igf1	78783	+	NM_001314010	87322094	87393479	5
chr10	87429415	87430762	Tyms-ps	1347	+	NR_000040	87430762	87430762	1
chr10	87553816	87555119	Pmch	1303	+	NM_029971	87553881	87554934	3
chr10	87554142	87609686	Parpbp	55544	-	NM_029249	87555599	87606837	11
chr10	87609736	87641140	Nup37	31404	+	NM_027191	87610968	87640992	10
chr10	87663841	87708903	Ccdc53	45062	+	NM_026070	87663986	87708585	7
chr10	87785548	87819820	Dram1	34272	-	NM_027878	87787485	87819667	7
chr10	87842156	87910074	Gnptab	67918	+	NM_001004164	87842163	87908585	21
chr10	87922331	87935981	Sycp3	13650	+	NM_011517	87922410	87935703	9
chr10	87935557	87966715	Chpt1	31158	-	NM_001146690	87935684	87966602	9
chr10	87981023	88067897	Mybpc1	86874	-	NM_001252372	87982682	88067670	29
chr10	88138014	88145768	Spic	7754	-	NM_011461	88138408	88143226	6
chr10	88192285	88193846	Gm4925	1561	-	NM_001037166	88193062	88193461	1
chr10	88194158	88205947	Arl1	11789	+	NM_025859	88194305	88205798	6
chr10	88209351	88289559	Utp20	80208	-	NM_175158	88209648	88289395	62
chr10	88348736	88392260	Slc5a8	43524	+	NM_145423	88349051	88389080	15
chr10	88411738	88720535	Ano4	308797	-	NM_001277188	88414938	88612049	28
chr10	88871567	88906712	Gas2l3	35145	-	NM_001284344	88875907	88896533	12
chr10	88916978	88996367	Nr1h4	79389	-	NM_001163504	88917454	88979248	10
chr10	89036764	89083994	Slc17a8	47230	-	NM_182959	89039060	89083644	12
chr10	89102851	89149030	Scyl2	46179	-	NM_001310704	89103213	89141199	18
chr10	89149107	89163611	1500026H17Rik	14504	+	NR_130956	89163611	89163611	3
chr10	89174717	89195040	Actr6	20323	-	NM_025914	89175175	89194986	11
chr10	89207735	89282614	Uhrf1bp1l	74879	+	NM_029166	89207989	89280796	21
chr10	89336253	90435729	Anks1b	1099476	+	NM_001128086	89336416	90432659	25
chr10	90452055	90545488	Apaf1	93433	-	NM_001282947	90454194	90542769	27
chr10	90545783	90565358	Ikbip	19575	+	NM_027078	90545871	90565249	3
chr10	90579322	90586708	Slc25a3	7386	-	NM_133668	90579708	90586447	8
chr10	90610315	90634364	Tmpo	24049	-	NM_001080129	90612220	90634058	9
chr10	91534830	91534930	Mir135a-2	100	-	NR_029812	91534930	91534930	1
chr10	91544490	91627923	Rmst	83433	-	NR_028262	91627923	91627923	13
chr10	91599884	91599968	Mir1251	84	-	NR_037219	91599968	91599968	1
chr10	91634045	91838118	Gm20757	204073	-	NR_046027	91838118	91838118	9
chr10	92147489	92185163	Nedd1	37674	-	NM_008682	92148935	92182366	15
chr10	92623620	92704087	Cdk17	80467	+	NM_146239	92670945	92702370	17
chr10	92625529	92625648	Mir1931	119	+	NR_035452	92625648	92625648	1
chr10	92710160	92773904	Elk3	63744	-	NM_013508	92712754	92747720	5
chr10	92798976	92811624	Gm17745	12648	+	NR_038014	92811624	92811624	3
chr10	92895851	92895907	Mir7688	56	+	NR_106161	92895907	92895907	1
chr10	92916140	92947641	Lta4h	31501	+	NM_008517	92916254	92947525	19
chr10	92951512	92979506	Hal	27994	+	NM_010401	92951875	92979067	20
chr10	92986082	93002778	Amdhd1	16696	-	NM_027908	92987159	93002715	9
chr10	93003376	93047071	Ccdc38	43695	+	NM_175488	93008213	93045300	16
chr10	93045773	93052403	Snrpf	6630	-	NM_027246	93046208	93052286	4
chr10	93052157	93067990	4933408J17Rik	15833	+	NR_045810	93067990	93067990	4
chr10	93103793	93208717	Ntn4	104924	+	NM_021320	93104198	93208598	10
chr10	93127988	93128599	Gm8580	611	-	NR_027478	93128599	93128599	1
chr10	93136962	93146067	Gm15915	9105	-	NR_038017	93146067	93146067	6
chr10	93294299	93320832	Usp44	26533	+	NM_001206851	93308434	93320673	7
chr10	93321234	93353947	Metap2	32713	-	NM_019648	93324094	93352433	12
chr10	93424266	93498544	Vezt	74278	-	NM_172538	93432937	93498450	12
chr10	93426512	93426608	Mir331	96	-	NR_029764	93426608	93426608	1
chr10	93498745	93608084	Fgd6	109339	+	NM_053072	93499039	93604534	21
chr10	93610675	93659959	Nr2c1	49284	+	NM_011629	93619670	93658096	14
chr10	93661753	93683693	Ndufa12	21940	+	NM_025551	93661777	93683606	4
chr10	93756407	93761448	Gm4792	5041	-	NR_033209	93761448	93761448	3
chr10	93977601	94053699	Tmcc3	76098	+	NM_172051	93977771	94049775	4
chr10	94048881	94048944	Mir7211	63	-	NR_106070	94048944	94048944	1
chr10	94136237	94151358	Cep83os	15121	-	NR_015524	94151358	94151358	3
chr10	94151534	94253081	Cep83	101547	+	NM_029852	94181718	94252553	16
chr10	94253611	94407212	Plxnc1	153601	-	NM_018797	94255930	94407212	31
chr10	94583215	94608459	Gm29684	25244	-	NR_131146	94608459	94608459	4
chr10	94637379	94786731	Cradd	149352	-	NM_009950	94638310	94785517	3
chr10	94798909	94825850	2310039L15Rik	26941	+	NR_045337	94825850	94825850	3
chr10	94874123	94879491	Socs2	5368	-	NM_007706	94875286	94877603	3
chr10	94880008	94891274	5730420D15Rik	11266	+	NR_045339	94891274	94891274	5
chr10	94943439	94964561	Mrpl42	21122	-	NM_026065	94943565	94963083	6
chr10	94977795	95008292	Ube2n	30497	+	NM_080560	94977841	95004946	4
chr10	95009640	95026801	Nudt4	17161	-	NM_027722	95011921	95026391	5
chr10	95021864	95021955	Mir3058	91	-	NR_037212	95021955	95021955	1
chr10	95403296	95508152	Eea1	104856	+	NM_001001932	95403582	95504838	29
chr10	95688840	95711342	4930459C07Rik	22502	+	NR_110448	95711342	95711342	3
chr10	96079634	96085445	Btg1	5811	+	NM_007569	96079958	96081277	2
chr10	96498401	96523693	4930556N09Rik	25292	+	NR_045358	96523693	96523693	5
chr10	96886111	96886196	Mir3966	85	+	NR_039547	96886196	96886196	1
chr10	96942133	96980797	Dcn	38664	+	NM_001190451	96945996	96980289	8
chr10	97028134	97035337	Lum	7203	+	NM_008524	97030878	97034685	3
chr10	97053617	97059565	4930473O22Rik	5948	-	NR_045356	97059565	97059565	3
chr10	97069838	97076322	Kera	6484	+	NM_008438	97071414	97075609	3
chr10	97106701	97144534	Epyc	37833	+	NM_007884	97112333	97143904	8
chr10	97144047	97429724	Gm10754	285677	-	NR_033537	97429724	97429724	5
chr10	97155692	97157560	Ccer1	1868	+	NM_025724	97156110	97157322	1
chr10	97177405	97216336	4930525C09Rik	38931	+	NR_130993	97216336	97216336	3
chr10	97762560	97814501	Gm8633	51941	-	NR_045179	97814501	97814501	5
chr10	98377785	98488777	Atp2b1	110992	+	NM_026482	98431550	98485753	21
chr10	98569804	98660622	Poc1b	90818	+	NM_027740	98569842	98659364	12
chr10	98570768	98575881	Galnt4	5113	+	NM_015737	98571048	98572785	1
chr10	98725864	98730123	Dusp6	4259	+	NM_026268	98726325	98728933	3
chr10	99071804	99120768	Gm20110	48964	+	NR_038019	99120768	99120768	3
chr10	99101364	99104554	Gm18409	3190	-	NR_038018	99104554	99104554	3
chr10	99220338	99222292	Csl	1954	-	NM_027945	99220434	99221835	1
chr10	99478457	99563046	Kitl	84589	+	NM_013598	99478654	99551869	10
chr10	99798309	99799223	Gm4301	914	+	NM_001166637	99798330	99799200	1
chr10	99798309	99799223	Gm4312	914	+	NM_001166636	99798330	99799200	1
chr10	99803471	99804396	Gm4303	925	+	NM_001166638	99803489	99804374	2
chr10	99803471	99804396	Gm4305	925	+	NM_001166639	99803489	99804374	2
chr10	99803471	99804396	Gm4307	925	+	NM_001166641	99803489	99804374	2
chr10	99813724	99824881	Gm4302	11157	+	NM_001166634	99813744	99824859	2
chr10	99906535	99949981	Tmtc3	43446	-	NM_001110013	99909562	99940642	14
chr10	99950922	100036289	Cep290	85367	+	NM_146009	99950940	100035741	53
chr10	100034907	100051893	4930430F08Rik	16986	-	NM_175128	100036199	100051750	7
chr10	100055019	100081025	1700017N19Rik	26006	+	NM_001081246	100057278	100080735	13
chr10	101144120	101854102	Mgat4c	709982	+	NM_001205098	101840791	101851997	8
chr10	101235325	101235406	Mir3059	81	+	NR_037211	101235406	101235406	1
chr10	101944389	101953052	Nts	8663	-	NM_024435	101944964	101952957	4
chr10	101974855	102009194	Rassf9	34339	+	NM_146240	101975171	102008700	2
chr10	102470480	102491411	Alx1	20931	-	NM_172553	102471821	102491240	4
chr10	102525831	102698956	Lrriq1	173125	-	NM_001163559	102525990	102696787	26
chr10	102830441	102882013	Slc6a15	51572	+	NM_175328	102851686	102881028	13
chr10	103605568	103616547	Gm4340	10979	+	NM_001177535	103606924	103616228	3
chr10	103631096	103633547	Gm6763	2451	+	NM_001270899	103632450	103633257	3
chr10	103631096	103633547	Gm8764	2451	+	NM_001270900	103632450	103633257	3
chr10	103631096	103633547	Gm21293	2451	+	NM_001270898	103632450	103633257	3
chr10	103631096	103633547	Gm21304	2451	+	NM_001270901	103632450	103633257	3
chr10	103631096	103633576	Gm20765	2480	+	NM_001270644	103632450	103633257	3
chr10	103631096	103633576	Gm21312	2480	+	NM_001270642	103632450	103633257	3
chr10	103724322	103724430	Mir6411	108	+	NR_105838	103724430	103724430	1
chr10	104624719	105011535	Tmtc2	386816	-	NM_177368	104627150	105010805	12
chr10	105011606	105020926	Gm15663	9320	+	NR_038032	105020926	105020926	3
chr10	105200240	105278436	Mettl25	78196	-	NM_207522	105200415	105278375	12
chr10	105278534	105284566	Ccdc59	6032	+	NM_025602	105278557	105284234	4
chr10	105907365	106370524	Ppfia2	463159	+	NM_001205341	105911689	106366168	32
chr10	105992250	106039536	4930532I03Rik	47286	-	NR_131026	106039536	106039536	7
chr10	106373219	106560720	Acss3	187501	-	NM_001142804	106373219	106560639	16
chr10	106708886	106862199	Lin7a	153313	+	NM_001039354	106708916	106849227	6
chr10	106919963	106923190	Myf5	3227	-	NM_008656	106921075	106922987	3
chr10	106929915	106931785	Myf6	1870	-	NM_008657	106930409	106931760	3
chr10	106954415	107157083	Ptprq	202668	-	NM_001081432	106954415	107156928	45
chr10	107199365	107349190	Otogl	149825	-	NM_001177567	107199365	107349184	58
chr10	107383700	107414888	Gm29685	31188	+	NR_131147	107414888	107414888	6
chr10	107599455	107714631	Ppp1r12a	115176	+	NM_027892	107599455	107711225	26
chr10	107769244	107851447	Pawr	82203	+	NM_054056	107769872	107850810	7
chr10	107934705	108448031	Syt1	513326	-	NM_001252341	107937595	108128102	12
chr10	108136099	108137216	Gm5136	1117	-	NM_203660	108136272	108137148	1
chr10	109120494	109437275	Nav3	316781	-	NM_001081035	109121175	109437275	39
chr10	110037705	110053017	9230102K24Rik	15312	+	NR_028438	110053017	110053017	3
chr10	110182520	110224440	E2f7	41920	+	NM_178609	110183387	110221894	13
chr10	110238229	110333563	1700020G17Rik	95334	-	NR_045979	110333563	110333563	3
chr10	110357231	110376570	Csrp2	19339	+	NM_007792	110369011	110376343	6
chr10	110378835	110447122	Zdhhc17	68287	-	NM_172554	110381448	110447086	17
chr10	110601857	110734303	Osbpl8	132446	+	NM_175489	110641854	110730280	24
chr10	110735734	110738792	Bbs10	3058	+	NM_027914	110735778	110738225	2
chr10	110910247	110933942	Nap1l1	23695	+	NM_015781	110918355	110933131	16
chr10	110937843	110938401	Gm5176	558	+	NR_033603	110938401	110938401	1
chr10	110943341	110945705	Phlda1	2364	+	NM_009344	110943460	110944678	2
chr10	111023774	111031329	4933440J02Rik	7555	-	NR_045344	111031329	111031329	4
chr10	111291576	111311432	Gm20758	19856	-	NR_046029	111311432	111311432	6
chr10	111409750	111425486	Krr1	15736	+	NM_178610	111409848	111421737	10
chr10	111422503	111434320	Glipr1	11817	-	NM_028608	111422583	111434087	6
chr10	111497244	111515566	Glipr1l1	18322	+	NM_027018	111497365	111515502	5
chr10	111520409	111545154	Glipr1l2	24745	+	NM_026223	111520431	111544296	6
chr10	111600676	111653611	Caps2	52935	+	NM_001310675	111612654	111652660	18
chr10	111708178	111903360	Kcnc2	195182	+	NM_001025581	111708761	111899148	5
chr10	112163981	112222655	1700010J16Rik	58674	+	NR_040579	112222655	112222655	7
chr10	112362483	112366082	Atxn7l3b	3599	-	NM_001033474	112365484	112365778	1
chr10	113835876	114238426	Trhde	402550	-	NM_146241	113838450	114238356	19
chr10	114515696	114622078	Tph2	106382	-	NM_173391	114516722	114621945	11
chr10	114634926	114688549	Tbc1d15	53623	-	NM_025706	114636607	114688467	17
chr10	114726917	114752647	Rab21	25730	-	NM_024454	114727827	114752402	7
chr10	114777795	114799318	Tmem19	21523	-	NM_133683	114779561	114798994	7
chr10	114807021	114821491	Thap2	14470	-	NM_025780	114809615	114821331	3
chr10	114822014	114869827	Zfc3h1	47813	+	NM_001033261	114822253	114869089	35
chr10	114887369	115024836	Lgr5	137467	-	NM_010195	114889069	115024549	18
chr10	115007041	115019510	A930009A15Rik	12469	+	NM_029982	115007233	115019052	5
chr10	115254339	115286949	Tspan8	32610	+	NM_001168680	115254656	115286452	9
chr10	115455418	115711985	Ptprr	256567	+	NM_011217	115455810	115710882	14
chr10	115548719	115550973	4933416C03Rik	2254	-	NM_001161855	115549538	115550675	1
chr10	115738429	115826594	Ptprb	88165	+	NM_029928	115738681	115820931	32
chr10	115854923	115910579	Kcnmb4	55656	-	NM_021452	115855293	115910577	3
chr10	115855176	115858291	Kcnmb4os1	3115	+	NR_028107	115858291	115858291	2
chr10	115910218	115912042	Kcnmb4os2	1824	+	NR_130644	115912042	115912042	3
chr10	115922216	116018567	Cnot2	96351	-	NM_001037846	115923255	115986136	16
chr10	116160122	116166233	1700030O20Rik	6111	-	NR_045345	116166233	116166233	3
chr10	116166308	116176816	4930579P08Rik	10508	+	NR_131036	116176816	116176816	3
chr10	116213600	116333935	Myrfl	120335	-	NM_001033333	116213783	116333719	25
chr10	116342839	116387436	Rab3ip	44597	-	NM_001003950	116344091	116376507	10
chr10	116387617	116400335	4933412E12Rik	12718	+	NR_038025	116400335	116400335	4
chr10	116401795	116406163	D630029K05Rik	4368	+	NR_027847	116406163	116406163	3
chr10	116423369	116462096	Best3	38727	+	NM_001007583	116425686	116461902	10
chr10	116482396	116483824	Lrrc10	1428	+	NM_146242	116482478	116483303	1
chr10	116488053	116500870	Cct2	12817	-	NM_007636	116488301	116500764	16
chr10	116507182	116585530	Frs2	78348	-	NM_177798	116510984	116518143	10
chr10	116652196	116661563	Yeats4	9367	-	NM_026570	116652722	116661365	7
chr10	116670808	116675737	9530003J23Rik	4929	-	NM_029906	116671470	116675636	4
chr10	116714596	116719328	Lyz2	4732	-	NM_017372	116715176	116719298	4
chr10	116724850	116729924	Lyz1	5074	-	NM_013590	116725638	116729894	4
chr10	116781722	116814029	Cpsf6	32307	-	NM_001310609	116792993	116813954	10
chr10	117066555	117124408	Cpm	57853	+	NM_027468	117066779	117120576	9
chr10	117125930	117147814	Mdm2	21884	-	NM_010786	117127265	117146836	12
chr10	117170733	117183414	Slc35e3	12681	-	NM_029875	117173102	117183242	5
chr10	117187698	117229761	Nup107	42063	-	NM_134010	117187915	117229667	28
chr10	117251652	117283030	Rap1b	31378	-	NM_024457	117254429	117261706	8
chr10	117362514	117385363	4933411E08Rik	22849	+	NR_045342	117385363	117385363	4
chr10	117578842	117606055	Mdm1	27213	+	NM_001162904	117579000	117605219	15
chr10	117642019	117647102	Il22	5083	+	NM_016971	117642046	117646582	5
chr10	117726685	117732094	Iltifb	5409	-	NM_054079	117727206	117732045	5
chr10	117878101	117882950	Ifng	4849	+	NM_008337	117878210	117882317	4
chr10	117939090	117993581	Tmevpg1	54491	-	NR_104123	117993581	117993581	5
chr10	118296404	118305959	Dyrk2	9555	-	NM_001014390	118296607	118305825	3
chr10	118357436	118364199	Gm38403	6763	-	NR_110482	118364199	118364199	4
chr10	118529960	118540163	1700064J06Rik	10203	+	NR_045348	118540163	118540163	4
chr10	118635867	118677111	Cand1	41244	-	NM_027994	118640036	118676764	15
chr10	118757289	118768918	4930477N07Rik	11629	+	NR_126085	118768918	118768918	5
chr10	118850499	118863920	1700025F24Rik	13421	+	NR_040578	118863920	118863920	4
chr10	118891089	119524316	Grip1	633227	+	NM_001277293	118891420	119524048	25
chr10	119183117	119198755	Grip1os2	15638	-	NR_045359	119198755	119198755	3
chr10	119262259	119289446	Grip1os1	27187	-	NR_131760	119289446	119289446	5
chr10	119520663	119550021	Helb	29358	-	NM_080446	119521867	119549918	13
chr10	119578709	119638593	Irak3	59884	-	NM_028679	119579770	119638515	12
chr10	119645881	119661953	Tmbim4	16072	+	NM_026617	119645901	119661882	7
chr10	119664115	119669126	Llph	5011	+	NM_025431	119665036	119668428	3
chr10	119798330	119913991	Hmga2	115661	-	NM_010441	119801307	119913119	5
chr10	119826578	119829849	9230105E05Rik	3271	+	NR_040626	119829849	119829849	3
chr10	119885046	119885166	Mir763	120	-	NR_030434	119885166	119885166	1
chr10	120202787	120215942	4921513I03Rik	13155	+	NR_038000	120215942	120215942	3
chr10	120218156	120336027	Msrb3	117871	-	NM_177092	120221123	120308166	7
chr10	120294684	120300384	Gm15910	5700	+	NR_038023	120300384	120300384	3
chr10	120360466	120416386	Lemd3	55920	-	NM_001081193	120362448	120416382	13
chr10	120471059	120537698	Wif1	66639	+	NM_011915	120471398	120536935	10
chr10	120700875	120748245	Tbc1d30	47370	-	NM_029057	120703880	120747856	12
chr10	120802145	120834301	Gns	32156	+	NM_029364	120802246	120832182	14
chr10	120847406	120913306	Rassf3	65900	-	NM_138956	120849991	120913166	5
chr10	120983512	121023850	Tbk1	40338	-	NM_019786	120984192	121021338	21
chr10	121024435	121063372	Xpot	38937	-	NM_001081056	121027249	121059973	25
chr10	121078756	121130970	D930020B18Rik	52214	+	NM_177335	121078873	121129541	13
chr10	121176992	121189915	BC048403	12923	+	NM_173022	121177031	121188175	3
chr10	121218046	121484371	Srgap1	266325	-	NM_001081037	121222453	121484249	22
chr10	121515167	121516935	Gm9079	1768	-	NR_004052	121516935	121516935	1
chr10	121518315	121534158	Tmem5	15843	-	NM_153059	121518327	121534127	6
chr10	121556752	121567614	Gm4489	10862	+	NR_027637	121567614	121567614	3
chr10	121885554	121890509	Avpr1a	4955	+	NM_016847	121885860	121889416	2
chr10	122002078	122006947	A130077B15Rik	4869	-	NR_040616	122006947	122006947	3
chr10	122115817	122382849	Ppm1h	267032	+	NM_001110218	122116241	122378428	10
chr10	122116370	122116471	Mir8104	101	+	NR_106182	122116471	122116471	1
chr10	122422695	122422780	Mirlet7i	85	-	NR_029527	122422780	122422780	1
chr10	122429116	122513561	Mon2	84445	-	NM_001163024	122432725	122513018	35
chr10	122542061	122634075	Usp15	92014	-	NM_027604	122550560	122633971	22
chr10	122701131	123178260	Fam19a2	477129	+	NM_182807	122867968	123175971	6
chr10	123906129	123961544	4930503E24Rik	55415	+	NR_028310	123961544	123961544	4
chr10	124664540	124765591	Slc16a7	101051	-	NM_011391	124665067	124731870	7
chr10	125403274	125452415	Lrig3	49141	+	NM_177152	125403531	125451976	19
chr10	126147337	126147447	Mir378d	110	-	NR_105841	126147447	126147447	1
chr10	126225906	126230766	4930484H19Rik	4860	-	NR_131015	126230766	126230766	4
chr10	126305483	126338427	Xrcc6bp1	32944	-	NM_026858	126305712	126338344	6
chr10	126415772	126437031	Ctdsp2	21259	+	NM_001113470	126416293	126433542	8
chr10	126432585	126432669	Mir26a-2	84	+	NR_029803	126432669	126432669	1
chr10	126435495	126435616	Mir546	121	+	NR_030259	126435616	126435616	1
chr10	126437764	126458050	Avil	20286	+	NM_009635	126440440	126457619	20
chr10	126459387	126467870	Tsfm	8483	-	NM_025537	126459575	126467853	6
chr10	126469960	126478450	Mettl21b	8490	-	NM_001205036	126469960	126478450	3
chr10	126478987	126482517	Mettl1	3530	+	NM_010792	126479034	126482484	6
chr10	126485301	126490062	Cyp27b1	4761	+	NM_010009	126485336	126489200	9
chr10	126493105	126497240	March9	4135	-	NM_001033262	126493626	126496810	4
chr10	126500658	126504338	Cdk4	3680	+	NM_009870	126501291	126504077	8
chr10	126504345	126507317	Tspan31	2972	-	NM_025982	126505171	126507233	6
chr10	126507536	126508157	LOC100504703	621	+	NR_040660	126508157	126508157	2
chr10	126515962	126530226	Agap2	14264	+	NM_001033263	126516677	126528868	19
chr10	126531314	126558216	Os9	26902	-	NM_001171026	126533302	126558174	15
chr10	126602211	126609396	B4galnt1	7185	+	NM_008080	126603060	126608889	11
chr10	126609481	126617701	Slc26a10	8220	-	NM_177615	126609593	126617653	17
chr10	126619576	126627110	Arhgef25	7534	-	NM_028027	126619891	126627021	16
chr10	126627433	126632765	Dtx3	5332	-	NM_030714	126628019	126630786	6
chr10	126632304	126639699	F420014N23Rik	7395	+	NR_045715	126639699	126639699	4
chr10	126634122	126648678	Pip4k2c	14556	-	NM_054097	126636119	126648567	10
chr10	126662750	126700419	Kif5a	37669	-	NM_001039000	126666833	126699952	29
chr10	126703317	126719015	Dctn2	15698	+	NM_001190453	126703554	126718543	15
chr10	126719011	126725827	Mbd6	6816	-	NM_033072	126719888	126724570	13
chr10	126727848	126733344	Ddit3	5496	+	NM_007837	126732396	126733147	4
chr10	126733276	126748842	Mars	15566	-	NM_001171582	126733349	126748685	22
chr10	126759019	126766999	Arhgap9	7980	+	NM_001285785	126759171	126766726	16
chr10	126766937	126778635	Gli1	11698	-	NM_010296	126767102	126775576	13
chr10	126786457	126788828	Inhbe	2371	-	NM_008382	126787312	126788601	2
chr10	126793381	126807600	Inhbc	14219	-	NM_010565	126794142	126807452	2
chr10	126827366	126936440	R3hdm2	109074	+	NM_001168292	126881366	126935765	26
chr10	126938772	126945871	Stac3	7099	+	NM_177707	126939839	126945534	12
chr10	126951994	126954210	Ndufa4l2	2216	+	NM_001098789	126952037	126953555	4
chr10	126954178	126959500	Shmt2	5322	-	NM_001252316	126954844	126959376	12
chr10	126962528	126971615	Nxph4	9087	-	NM_183297	126963161	126971488	2
chr10	126975213	127058204	Lrp1	82991	-	NM_008512	126976005	127057743	89
chr10	127080041	127098043	Stat6	18002	+	NM_009284	127083967	127097037	22
chr10	127097973	127103759	Nab2	5786	-	NM_008668	127098725	127103514	7
chr10	127104178	127105907	1700012D01Rik	1729	+	NR_045171	127105907	127105907	2
chr10	127114120	127138103	Tmem194	23983	+	NM_001113211	127114153	127133449	9
chr10	127142311	127157996	Myo1a	15685	+	NM_001081219	127142311	127157775	27
chr10	127161533	127168824	Tac2	7291	+	NM_001199971	127163084	127166587	8
chr10	127176593	127184395	Zbtb39	7802	+	NM_198035	127178614	127180753	2
chr10	127186657	127188854	Gpr182	2197	-	NM_007412	127186939	127188136	2
chr10	127196818	127205355	Rdh1	8537	+	NM_080436	127196993	127202594	4
chr10	127213460	127229753	Rdh9	16293	+	NM_153133	127213540	127228089	4
chr10	127238208	127252895	Rdh16	14687	+	NM_009040	127238253	127250686	4
chr10	127261271	127283621	Rdh18-ps	22350	+	NR_037604	127283621	127283621	4
chr10	127286983	127298232	Rdh19	11249	+	NM_147222	127287076	127297393	4
chr10	127303531	127314375	BC089597	10844	+	NM_145424	127303611	127314147	4
chr10	127321082	127325789	Rdh7	4707	-	NM_001150749	127321606	127325669	4
chr10	127335590	127348815	Sdr9c7	13225	+	NM_027301	127335700	127347018	4
chr10	127427991	127444564	Hsd17b6	16573	-	NM_013786	127428303	127435066	6
chr10	127452270	127467086	Prim1	14816	+	NM_008921	127452304	127466841	13
chr10	127472401	127485693	Naca	13292	+	NM_001113199	127473546	127485563	9
chr10	127496037	127514310	Ptges3	18273	+	NM_019766	127496340	127513142	8
chr10	127520362	127527444	Atp5b	7082	+	NM_016774	127520382	127527175	10
chr10	127522341	127522419	Mir677	78	+	NR_030442	127522419	127522419	1
chr10	127529838	127566359	Baz2a	36521	+	NM_054078	127545951	127563809	30
chr10	127566525	127617353	Rbms2	50828	-	NM_001039080	127570700	127588393	14
chr10	127631690	127647060	Gls2	15370	+	NM_001033264	127631781	127646500	18
chr10	127646965	127648850	Spryd4	1885	-	NM_025716	127647908	127648849	2
chr10	127662865	127668868	Mip	6003	+	NM_008600	127662937	127667560	4
chr10	127669118	127689997	Timeless	20879	+	NM_001164081	127676956	127689312	29
chr10	127691186	127692957	Apon	1771	+	NM_133996	127691510	127692266	2
chr10	127705052	127707207	Apof	2155	+	NM_133997	127705809	127707015	2
chr10	127707631	127729905	Stat2	22274	+	NM_019963	127713548	127728429	24
chr10	127733195	127735140	Il23a	1945	-	NM_031252	127733851	127735028	4
chr10	127740390	127758414	Pan2	18024	+	NM_001252327	127741267	127757821	26
chr10	127759514	127764243	Cnpy2	4729	+	NM_019953	127760410	127764117	6
chr10	127774887	127799535	Cs	24648	+	NM_026444	127774973	127798188	11
chr10	127800152	127807093	Coq10a	6941	-	NM_001081040	127800679	127805893	5
chr10	127814179	127831062	Ankrd52	16883	+	NM_172790	127814278	127827777	28
chr10	127819893	127819962	Mir6914	69	+	NR_105879	127819962	127819962	1
chr10	127825887	127825956	Mir6915	69	+	NR_105880	127825956	127825956	1
chr10	127832987	127838280	Slc39a5	5293	-	NM_001136237	127833102	127837143	12
chr10	127838450	127846852	Nabp2	8402	-	NM_027257	127838779	127846381	7
chr10	127848671	127878497	Rnf41	29826	+	NM_026259	127865669	127875490	8
chr10	127895735	127895824	Mir8105	89	+	NR_106183	127895824	127895824	1
chr10	127896291	127927230	Smarcc2	30939	+	NM_001114096	127896382	127926028	29
chr10	127927914	127930942	Myl6	3028	-	NM_001317217	127928353	127930867	7
chr10	127931212	127935741	Myl6b	4529	-	NM_172259	127931510	127934427	7
chr10	127936302	127941298	A430046D13Rik	4996	+	NR_131150	127941298	127941298	3
chr10	127947305	127962915	Esyt1	15610	-	NM_011843	127947675	127962879	31
chr10	127949023	127949086	Mir6916	63	-	NR_105881	127949086	127949086	1
chr10	127980620	127984800	Zc3h10	4180	-	NM_134003	127981234	127982542	3
chr10	127985165	127986224	Rpl41	1059	-	NM_018860	127985442	127986016	4
chr10	127994821	128002990	Pa2g4	8169	-	NM_011119	127995961	128002883	12
chr10	128006423	128026557	Erbb3	20134	-	NM_010153	128006423	128026557	28
chr10	128021492	128021553	Mir6917	61	-	NR_105882	128021553	128021553	1
chr10	128061584	128063562	Rps26	1978	-	NM_013765	128061656	128063534	4
chr10	128069470	128083049	Ikzf4	13579	-	NM_011772	128071103	128082863	8
chr10	128106942	128110974	Suox	4032	-	NM_173733	128107572	128109647	4
chr10	128114238	128133324	Rab5b	19086	-	NM_177411	128116585	128123966	6
chr10	128134994	128142107	Cdk2	7113	-	NM_183417	128136161	128141883	8
chr10	128143313	128157294	Pmel	13981	+	NM_021882	128143341	128157073	11
chr10	128157191	128181112	Dgka	23921	-	NM_016811	128157478	128174128	24
chr10	128184934	128203624	Pym1	18690	+	NM_030100	128185017	128203146	3
chr10	128227965	128237880	Mmp19	9915	+	NM_001164197	128231621	128236156	9
chr10	128237091	128241426	Tmem198b	4335	-	NM_178066	128238150	128240328	5
chr10	128242731	128256502	Dnajc14	13771	+	NM_028873	128243266	128254467	7
chr10	128254512	128258687	Ormdl2	4175	-	NM_024180	128255935	128257490	4
chr10	128258826	128314694	Sarnp	55868	+	NM_025364	128258991	128314430	11
chr10	128321601	128328774	Gdf11	7173	-	NM_010272	128322161	128328741	3
chr10	128345974	128349874	Cd63	3900	+	NM_001042580	128347461	128349796	8
chr10	128350646	128356353	Rdh5	5707	-	NM_134006	128350768	128355618	5
chr10	128356969	128360580	Bloc1s1	3611	-	NM_015740	128357052	128360491	4
chr10	128370868	128395340	Itga7	24472	+	NM_008398	128371044	128394907	25
chr10	128395332	128398044	Mettl7b	2712	-	NM_027853	128395774	128397994	2
chr10	128426969	128427908	Olfr9	939	+	NM_146861	128426969	128427908	1
chr10	128448342	128449272	Olfr763	930	+	NM_146862	128448342	128449272	1
chr10	128483187	128484117	Olfr765	930	-	NM_001085477	128483187	128484117	1
chr10	128516087	128517017	Olfr767	930	-	NM_146318	128516087	128517017	1
chr10	128530089	128531028	Olfr768	939	-	NM_146864	128530089	128531028	1
chr10	128548540	128549479	Olfr769	939	-	NM_146267	128548540	128549479	1
chr10	128569886	128570822	Olfr770	936	-	NM_146863	128569886	128570822	1
chr10	128597084	128598038	Olfr771	954	-	NM_146547	128597084	128598038	1
chr10	128611106	128612110	Olfr772	1004	-	NM_146266	128611139	128612075	1
chr10	128623539	128624475	Olfr773	936	-	NM_207008	128623539	128624475	1
chr10	128675206	128676145	Olfr774	939	+	NM_207620	128675206	128676145	1
chr10	128687591	128688530	Olfr775	939	+	NM_146545	128687591	128688530	1
chr10	128698018	128698957	Olfr776	939	+	NM_207559	128698018	128698957	1
chr10	128705441	128706377	Olfr777	936	-	NM_146544	128705441	128706377	1
chr10	128758680	128759619	Olfr780	939	+	NM_146284	128758680	128759619	1
chr10	128769938	128770874	Olfr781	936	+	NM_146728	128769938	128770874	1
chr10	128787620	128788565	Olfr782	945	+	NM_001011797	128787620	128788565	1
chr10	128824690	128825650	Olfr784	960	+	NM_146729	128824690	128825650	1
chr10	128846423	128847362	Olfr785	939	+	NM_001305430	128846423	128847362	1
chr10	128873869	128874808	Olfr786	939	+	NM_146549	128873869	128874808	1
chr10	128899733	128900672	Olfr787	939	+	NM_001011822	128899733	128900672	1
chr10	128909749	128910685	Olfr788	936	+	NM_146551	128909749	128910685	1
chr10	128924067	128925006	Olfr789	939	+	NM_001305433	128924067	128925006	1
chr10	128937941	128938910	Olfr790	969	+	NM_146933	128937941	128938910	1
chr10	128963284	128964223	Olfr791	939	+	NM_146930	128963284	128964223	1
chr10	128977594	128978530	Olfr792	936	+	NM_001011849	128977594	128978530	1
chr10	129007712	129008675	Olfr794	963	+	NM_146378	129007712	129008675	1
chr10	129044602	129045535	Olfr796	933	-	NM_146931	129044602	129045535	1
chr10	129062179	129063115	Olfr798	936	-	NM_146556	129062179	129063115	1
chr10	129084185	129085121	Olfr799	936	+	NM_146927	129084185	129085121	1
chr10	129096863	129097799	Olfr800	936	+	NM_146548	129096863	129097799	1
chr10	129106616	129107573	Olfr801	957	-	NM_146285	129106616	129107573	1
chr10	129118854	129119793	Olfr802	939	-	NM_146932	129118854	129119793	1
chr10	129128168	129129095	Olfr803	927	-	NM_146554	129128168	129129095	1
chr10	129141935	129142880	Olfr804	945	+	NM_001011821	129141935	129142880	1
chr10	129159638	129160598	Olfr805	960	-	NM_146555	129159638	129160598	1
chr10	129175029	129175971	Olfr806	942	-	NM_146553	129175029	129175971	1
chr10	129191568	129192504	Olfr807	936	-	NM_146929	129191568	129192504	1
chr10	129204553	129205492	Olfr808	939	+	NM_146928	129204553	129205492	1
chr10	129212926	129213913	Olfr809	987	+	NM_146324	129212926	129213913	1
chr10	129227704	129228643	Olfr810	939	-	NM_146550	129227704	129228643	1
chr10	129238619	129239579	Olfr811	960	-	NM_146552	129238619	129239579	1
chr10	129279163	129280096	Olfr812	933	-	NM_146795	129279163	129280096	1
chr10	129293575	129294508	Olfr813	933	+	NM_207147	129293575	129294508	1
chr10	129310878	129311811	Olfr814	933	-	NM_207159	129310878	129311811	1
chr10	129338831	129339782	Olfr815	951	-	NM_146670	129338831	129339782	1
chr10	129348393	129349332	Olfr816	939	-	NM_146672	129348393	129349332	1
chr10	129382159	129383116	Olfr818	957	-	NM_146777	129382159	129383116	1
chr10	129402791	129403754	Olfr819	963	-	NM_001165944	129402791	129403754	1
chr10	129411660	129412605	Olfr247	945	-	NM_146269	129411660	129412605	1
chr10	129454418	129455357	Olfr820	939	+	NM_146675	129454418	129455357	1
chr10	129470683	129471616	Olfr821	933	+	NM_146776	129470683	129471616	1
chr10	129511467	129512406	Olfr822	939	+	NM_146671	129511467	129512406	1
chr10	129548896	129549844	Olfr823	948	-	NM_146673	129548896	129549844	1
chr10	129563163	129564111	Olfr824	948	-	NM_146674	129563163	129564111	1
chr10	129599417	129600380	Olfr825	963	-	NM_146677	129599417	129600380	1
chr10	129616992	129617934	Olfr826	942	-	NM_146676	129616992	129617934	1
chr10	129647215	129648184	Olfr827	969	-	NM_146300	129647215	129648184	1
chr10	129705207	129717296	Neurod4	12089	-	NM_007501	129707466	129708459	2
chr10	129759907	129799698	Tespa1	39791	+	NM_183264	129784243	129799543	9
chr10	129822855	129831297	Vmn2r84	8442	-	NM_001081448	129822855	129831297	6
chr10	129855316	129866668	Vmn2r85	11352	-	NM_001102602	129855316	129866668	6
chr10	129883254	129892950	Vmn2r86	9696	-	NM_001103365	129883254	129892950	6
chr10	129908876	129934435	Vmn2r87	25559	-	NM_001103366	129908876	129934435	6
chr11	3024023	3031947	Pisd-ps1	7924	+	NR_003517	3031947	3031947	7
chr11	3024029	3031945	Pisd-ps3	7916	+	NR_003518	3031945	3031945	7
chr11	3031852	3093466	Sfi1	61614	-	NM_030207	3032029	3088966	33
chr11	3102355	3144591	Eif4enif1	42236	+	NM_001166548	3103660	3144092	18
chr11	3149924	3166389	Drg1	16465	-	NM_007879	3150268	3166313	9
chr11	3189133	3209086	Patz1	19953	+	NR_045108	3209086	3209086	6
chr11	3209002	3220725	Gm11944	11723	+	NR_045708	3220725	3220725	6
chr11	3230733	3242974	Pik3ip1	12241	+	NM_178149	3230937	3241730	6
chr11	3243299	3309241	Limk2	65942	-	NM_010718	3245742	3309064	16
chr11	3315975	3352959	Rnf185	36984	-	NM_145355	3317992	3338270	8
chr11	3352439	3379834	8430429K09Rik	27395	+	NR_028317	3379834	3379834	4
chr11	3388229	3394169	Pla2g3	5940	+	NM_172791	3388354	3393186	7
chr11	3394274	3404824	Inpp5j	10550	-	NM_172439	3394662	3404751	13
chr11	3414704	3417354	Selm	2650	+	NM_053267	3414947	3417163	5
chr11	3417524	3439295	Smtn	21771	-	NM_001159284	3420774	3437376	22
chr11	3539787	3548817	Tug1	9030	-	NR_002321	3548817	3548817	4
chr11	3549496	3590373	Morc2a	40877	+	NM_001159288	3550382	3589106	27
chr11	3603733	3763906	Osbp2	160173	-	NM_152818	3605067	3763870	14
chr11	3786090	3795129	4921536K21Rik	9039	-	NM_026150	3788162	3795090	3
chr11	3795242	3801299	Dusp18	6057	+	NM_173745	3797014	3797581	2
chr11	3807024	3814667	Slc35e4	7643	-	NM_153142	3807553	3813190	2
chr11	3817082	3832081	Tcn2	14999	-	NM_001130458	3817650	3831459	10
chr11	3863977	3880007	Pes1	16030	+	NM_022889	3864039	3878913	15
chr11	3883638	3899331	Gal3st1	15693	+	NM_016922	3896923	3899069	4
chr11	3931784	3948012	Sec14l4	16228	+	NM_146013	3931848	3946346	12
chr11	3964855	3978993	Sec14l3	14138	+	NM_001029937	3964954	3976370	12
chr11	3991483	3995434	Mtfp1	3951	-	NM_026443	3992229	3995285	4
chr11	3997042	4018732	Sec14l2	21690	-	NM_144520	3998307	4018681	12
chr11	4035162	4041195	Rnf215	6033	+	NM_027859	4035275	4040512	9
chr11	4039366	4039449	Mir3060	83	+	NR_037220	4039449	4039449	1
chr11	4041126	4060296	Ccdc157	19170	-	NM_177616	4043691	4050047	13
chr11	4060356	4082544	Sf3a1	22188	+	NM_026175	4060490	4080138	16
chr11	4086835	4115508	Tbc1d10a	28673	+	NM_134023	4086893	4115156	9
chr11	4118253	4122412	Gatsl3	4159	+	NM_028022	4118316	4121923	9
chr11	4136787	4141029	Osm	4242	+	NM_001013365	4136885	4140012	3
chr11	4157570	4172517	Lif	14947	+	NM_008501	4166601	4169337	4
chr11	4246385	4341085	Hormad2	94700	-	NM_029458	4246564	4335055	11
chr11	4380870	4494818	Mtmr3	113948	-	NM_028860	4382770	4431227	18
chr11	4520277	4527769	Gm11961	7492	-	NR_027798	4527769	4527769	3
chr11	4537795	4583388	Ascc2	45593	+	NM_029291	4540402	4583081	20
chr11	4601970	4604347	Uqcr10	2377	-	NM_197979	4602178	4604309	2
chr11	4604680	4637669	Zmat5	32989	+	NM_026015	4622387	4637464	6
chr11	4638823	4646781	Cabp7	7958	-	NM_138948	4638823	4646730	5
chr11	4665847	4749547	Nf2	83700	-	NM_001252250	4680589	4748988	17
chr11	4774005	4794203	Nipsnap1	20198	+	NM_008698	4774008	4793187	10
chr11	4791347	4791405	Mir6918	58	+	NR_105883	4791405	4791405	1
chr11	4795345	4828868	Thoc5	33523	+	NM_172438	4799813	4828741	20
chr11	4818518	4818921	AA413626	403	+	NR_102683	4818921	4818921	1
chr11	4838758	4848067	Nefh	9309	-	NM_010904	4839347	4847937	4
chr11	4847523	4942797	Ap1b1	95274	+	NM_001243043	4909558	4941795	23
chr11	4954133	4965330	Gas2l1	11197	-	NM_030228	4956667	4964461	7
chr11	4958130	4960386	Rasl10a	2256	+	NM_145216	4958308	4960068	3
chr11	4969689	4999091	Ewsr1	29402	-	NM_007968	4970066	4999024	17
chr11	4999275	5006103	Rhbdd3	6828	+	NM_001290491	5003204	5005980	9
chr11	5006268	5052225	Emid1	45957	-	NM_080595	5006844	5052225	15
chr11	5091555	5161613	Kremen1	70058	-	NM_032396	5094955	5161528	9
chr11	5176331	5344850	Znrf3	168519	-	NM_001080924	5179726	5344681	9
chr11	5420643	5425996	Xbp1	5353	+	NM_001271730	5420997	5425245	6
chr11	5428890	5442220	Ccdc117	13330	-	NM_134033	5431298	5442061	5
chr11	5469686	5589340	Ankrd36	119654	+	NM_023816	5469929	5589340	27
chr11	5603985	5607702	Mrps24	3717	-	NM_026080	5604451	5607665	4
chr11	5613419	5662379	Urgcp	48960	-	NM_001077661	5615687	5623147	6
chr11	5662152	5684713	Ube2d-ps	22561	+	NR_015577	5684713	5684713	7
chr11	5688485	5700983	Dbnl	12498	+	NM_001146309	5688562	5700002	13
chr11	5701639	5703799	Pgam2	2160	-	NM_018870	5701675	5703691	3
chr11	5727862	5738019	Polm	10157	-	NM_017401	5729031	5737754	11
chr11	5761868	5772251	Aebp1	10383	+	NM_001291857	5762154	5771852	21
chr11	5772182	5778259	Pold2	6077	-	NM_008894	5772260	5776935	11
chr11	5796639	5798785	Myl7	2146	-	NM_022879	5796682	5798766	7
chr11	5800825	5850084	Gck	49259	-	NM_010292	5801672	5849602	10
chr11	5855760	5867783	Ykt6	12023	+	NM_019661	5855903	5866047	7
chr11	5869668	5965751	Camk2b	96083	-	NM_001174054	5872220	5965541	21
chr11	6005694	6100454	Nudcd3	94760	-	NM_173748	6008247	6100137	6
chr11	6072510	6073334	Rps15a-ps6	824	-	NR_029471	6073334	6073334	1
chr11	6111013	6130248	Npc1l1	19235	-	NM_207242	6111460	6130126	19
chr11	6157547	6167732	Ddx56	10185	-	NM_026538	6159183	6167722	14
chr11	6170716	6174840	Tmed4	4124	-	NM_134020	6171653	6174836	5
chr11	6191599	6259097	Ogdh	67498	+	NM_001252283	6196980	6255677	24
chr11	6295127	6306165	Zmiz2	11038	+	NM_028601	6295631	6305100	19
chr11	6301632	6301696	Mir7651	64	+	NR_106109	6301696	6301696	1
chr11	6315872	6319813	Ppia	3941	+	NM_008907	6315913	6319613	5
chr11	6327228	6344446	H2afv	17218	-	NM_029938	6328373	6344342	5
chr11	6367601	6376079	Purb	8478	-	NM_011221	6374914	6375889	1
chr11	6406550	6420961	Myo1g	14411	-	NM_178440	6406678	6420857	22
chr11	6425593	6428763	Gm11974	3170	-	NR_045893	6428763	6428763	4
chr11	6446889	6496764	Ccm2	49875	+	NM_146014	6447002	6496364	10
chr11	6497825	6506057	Nacad	8232	-	NM_001081652	6497897	6505751	8
chr11	6515600	6526070	Tbrg4	10470	-	NM_001130457	6516615	6524223	13
chr11	6520321	6520422	Snora5c	101	-	NR_034042	6520422	6520422	1
chr11	6535485	6538652	Wap	3167	-	NM_011709	6535615	6538625	4
chr11	6550150	6560239	Gm11978	10089	-	NR_028586	6560239	6560239	6
chr11	6558535	6577478	Ramp3	18943	+	NM_019511	6558575	6576741	3
chr11	6616003	6620040	Gm11981	4037	-	NR_046025	6620040	6620040	5
chr11	6963491	7078508	Adcy1	115017	+	NM_009622	6963602	7069718	20
chr11	7083159	7088572	Gm11985	5413	-	NR_045101	7088572	7088572	4
chr11	7097789	7102549	Igfbp1	4760	+	NM_008341	7097961	7102020	4
chr11	7106095	7113926	Igfbp3	7831	-	NM_008343	7108385	7113793	5
chr11	8331654	8564538	Tns3	232884	-	NM_001083587	8334496	8449084	31
chr11	8893139	8911194	Hus1	18055	-	NR_130178	8911194	8911194	9
chr11	8916056	8948994	Sun3	32938	-	NM_177576	8916239	8930266	9
chr11	8948594	8969357	Gm11992	20763	+	NM_001037928	8949148	8968387	7
chr11	9018010	9036173	Upp1	18163	+	NM_001159401	9025654	9036103	9
chr11	9091944	9584262	Abca13	492318	+	NM_178259	9091968	9583380	62
chr11	11014018	11163529	Vwc2	149511	+	NM_177033	11015916	11161523	4
chr11	11180042	11362422	Zpbp	182380	-	NM_001185153	11182605	11362367	8
chr11	11389268	11415193	4930415F15Rik	25925	+	NM_028669	11390223	11415103	6
chr11	11489225	11527841	4930512M02Rik	38616	-	NM_001305143	11489269	11527813	4
chr11	11585927	11672929	Ikzf1	87002	+	NM_001301868	11600221	11669584	8
chr11	11700290	11708965	Fignl1	8675	-	NM_021891	11701004	11703056	3
chr11	11714103	11798147	Ddc	84044	-	NM_001190448	11715230	11780645	15
chr11	11768125	11785324	1700042O10Rik	17199	+	NR_045178	11785324	11785324	4
chr11	11830501	11937423	Grb10	106922	-	NM_010345	11833465	11870619	17
chr11	12136678	12364963	Cobl	228285	-	NM_172496	12138044	12364725	15
chr11	13972105	14079044	4930554G24Rik	106939	-	NR_131011	14079044	14079044	4
chr11	14460338	14499228	1700046C09Rik	38890	-	NR_045918	14499228	14499228	4
chr11	14499242	14500319	Pom121l12	1077	+	NM_001164166	14499298	14500135	1
chr11	16157726	16184554	Vstm2a	26828	+	NM_145967	16158010	16181920	5
chr11	16401640	16408487	Sec61g	6847	-	NM_011343	16401800	16408196	4
chr11	16652205	16813910	Egfr	161705	+	NM_207655	16652485	16811858	28
chr11	16834711	16851285	Eldr	16574	-	NR_110421	16851285	16851285	6
chr11	16851412	16854775	Fbxo48	3363	+	NM_176982	16853378	16854338	4
chr11	16871208	16908721	Plek	37513	-	NM_019549	16874152	16908601	10
chr11	16951936	16979375	Cnrip1	27439	+	NM_029861	16952172	16978567	3
chr11	17059300	17100383	Ppp3r1	41083	+	NM_024459	17059542	17098309	6
chr11	17103202	17111592	Pno1	8390	-	NM_025443	17103936	17111510	7
chr11	17111895	17135203	Wdr92	23308	+	NM_178909	17111966	17132917	8
chr11	17157620	17169179	C1d	11559	+	NM_020558	17162659	17166698	5
chr11	17838751	17853878	Etaa1	15127	-	NM_026576	17840228	17853797	6
chr11	17853972	17859584	Etaa1os	5612	+	NR_131915	17859584	17859584	3
chr11	17995988	18003388	Gm12018	7400	+	NR_131129	18003388	18003388	3
chr11	18780430	18918972	Meis1	138542	-	NM_001193271	18784026	18918235	13
chr11	18965277	18975743	4933406G16Rik	10466	+	NR_046037	18975743	18975743	5
chr11	19824444	19922600	Spred2	98156	+	NM_033523	19824933	19921450	6
chr11	19962306	20012954	Actr2	50648	-	NM_146243	19964691	20012855	9
chr11	20101604	20126859	Rab1a	25255	+	NM_008996	20101632	20124848	6
chr11	20127039	20149427	Cep68	22388	-	NM_172260	20130430	20142200	7
chr11	20202182	20232716	Slc1a4	30534	-	NM_018861	20204268	20232475	8
chr11	20443255	20553026	Sertad2	109771	+	NM_021372	20547808	20548738	2
chr11	20585087	20641559	Aftph	56472	-	NM_001290545	20586053	20627610	10
chr11	20723357	20731111	Lgalsl	7754	-	NM_173752	20726374	20731012	5
chr11	20991326	21050330	Peli1	59004	+	NM_023324	21036117	21048526	7
chr11	21139034	21221136	Vps54	82102	+	NM_001290628	21163221	21219861	23
chr11	21221128	21271270	Ugp2	50142	-	NM_001290634	21222024	21254395	10
chr11	21244590	21244678	Mir1933	88	-	NR_035454	21244678	21244678	1
chr11	21394732	21411183	4932414J04Rik	16451	-	NR_028259	21411183	21411183	9
chr11	21456694	21471937	Mdh1	15243	-	NM_008618	21457445	21471735	9
chr11	21472283	21798689	Wdpcp	326406	+	NM_145425	21552252	21798529	18
chr11	21894766	21901654	Otx1	6888	-	NM_011023	21896242	21899479	5
chr11	21905828	22186798	Ehbp1	280970	-	NM_001252515	21906783	22185594	25
chr11	22412285	22419234	Tmem17	6949	+	NM_153596	22412486	22418662	4
chr11	22734738	22760336	B3gnt2	25598	-	NM_001169114	22735992	22737186	2
chr11	22799727	22882284	Commd1	82557	-	NM_144514	22799949	22882255	3
chr11	22872004	22876496	Zrsr1	4492	+	NM_011663	22873227	22874514	1
chr11	22890592	22903336	Cct4	12744	+	NM_009837	22890753	22903151	14
chr11	22913386	22923741	Fam161a	10355	+	NM_028672	22915708	22923547	4
chr11	23052139	23066375	1700061J23Rik	14236	+	NR_131065	23066375	23066375	3
chr11	23156040	23197597	Xpo1	41557	+	NM_134014	23161840	23196107	26
chr11	23206894	23390560	Usp34	183666	+	NM_001190401	23206973	23389188	80
chr11	23387881	23398039	Ahsa2	10158	-	NM_172391	23390397	23397854	9
chr11	23416202	23419942	1700093K21Rik	3740	-	NM_001110133	23416439	23418929	5
chr11	23458059	23458842	Gm12060	783	-	NR_004857	23458842	23458842	1
chr11	23473775	23533631	0610010F05Rik	59856	-	NM_027860	23475480	23529022	22
chr11	23546478	23565935	Pex13	19457	-	NM_023651	23549291	23565844	4
chr11	23565673	23632876	Pus10	67203	+	NM_028956	23567288	23631359	18
chr11	23641728	23670970	Rel	29242	-	NM_009044	23642264	23670689	10
chr11	23762645	23795270	Papolg	32625	-	NM_172555	23763957	23795038	22
chr11	23978055	24073558	Bcl11a	95503	+	NM_016707	23978390	24072790	5
chr11	24381908	24469951	4933430M04Rik	88043	+	NR_045857	24469951	24469951	4
chr11	24621005	24630722	Gm10466	9717	-	NR_033491	24630722	24630722	3
chr11	25226106	25267137	4933427E13Rik	41031	+	NR_045853	25267137	25267137	8
chr11	25516845	26110576	5730522E02Rik	593731	-	NR_027973	26110576	26110576	6
chr11	26102239	26102348	Mir6372	109	+	NR_105791	26102348	26102348	1
chr11	26287083	26371883	Fancl	84800	+	NM_025923	26287214	26371360	14
chr11	26371401	26493920	Vrk2	122519	-	NM_027260	26371444	26491722	13
chr11	26685107	26687859	Gm12070	2752	+	NR_002890	26687859	26687859	2
chr11	28285683	28484324	Ccdc85a	198641	-	NM_181577	28288858	28483542	5
chr11	28581563	28593276	2810471M01Rik	11713	+	NR_045906	28593276	28593276	3
chr11	28646190	28646276	Mir216b	86	+	NR_030419	28646276	28646276	1
chr11	28646197	28646266	Mir216c	69	-	NR_106152	28646266	28646266	1
chr11	28657011	28657083	Mir216a	72	+	NR_029797	28657083	28657083	1
chr11	28663727	28663835	Mir217	108	+	NR_029828	28663835	28663835	1
chr11	28753204	28826743	Efemp1	73539	+	NM_146015	28754473	28826318	11
chr11	29030750	29061828	Pnpt1	31078	+	NM_027869	29030757	29061483	28
chr11	29072906	29120797	Smek2	47891	+	NM_134034	29073305	29118551	16
chr11	29121535	29147272	Cfap36	25737	-	NM_025740	29121883	29147129	10
chr11	29274171	29410808	Ccdc88a	136637	+	NM_176841	29274347	29407189	32
chr11	29411756	29415033	Prorsd1	3277	-	NM_001163454	29413662	29415000	3
chr11	29426396	29445447	Mtif2	19051	+	NM_001282120	29433332	29445085	14
chr11	29445841	29448040	Rps27a	2199	-	NM_024277	29445879	29447728	6
chr11	29447949	29478352	Clhc1	30403	+	NM_001163521	29453585	29478231	12
chr11	29592897	29644414	Rtn4	51517	+	NM_194054	29593188	29642029	9
chr11	29643050	29926033	Eml6	282983	-	NM_146016	29644585	29924576	42
chr11	29722394	29725668	4931440F15Rik	3274	-	NM_176829	29723490	29725455	1
chr11	29999394	30119772	Sptbn1	120378	-	NM_175836	30000495	30119726	35
chr11	30326005	30371829	4930505A04Rik	45824	-	NM_001100394	30326163	30371764	5
chr11	30405991	30549396	Acyp2	143405	-	NM_029344	30406324	30549379	4
chr11	30671774	30780361	Psme4	108587	+	NM_134013	30671982	30778513	47
chr11	30785357	30793725	Gpr75	8368	+	NM_175490	30791096	30792719	2
chr11	30829783	30854131	Erlec1	24348	-	NM_025745	30831776	30854075	14
chr11	30854397	31002704	Asb3	148307	+	NM_023906	30898325	31001242	10
chr11	30876706	30886365	Chac2	9659	-	NM_026527	30877380	30886246	3
chr11	31259440	31270061	Stc2	10621	-	NM_011491	31260143	31269862	4
chr11	31565149	31571862	Bod1	6713	-	NM_001024919	31566737	31571701	4
chr11	31700687	31724547	D630024D03Rik	23860	-	NR_102312	31724547	31724547	5
chr11	31770939	31835635	Cpeb4	64696	+	NM_026252	31772287	31831532	10
chr11	31865632	31879651	4930524B15Rik	14019	+	NM_026262	31865659	31876806	5
chr11	31900418	31959211	Nsg2	58793	+	NM_008741	31901751	31957634	5
chr11	31995258	32001228	Gm12108	5970	-	NR_130637	32001228	32001228	2
chr11	32088996	32100279	Il9r	11283	-	NM_001134458	32090611	32100218	9
chr11	32105414	32108995	Snrnp25	3581	+	NM_030093	32105621	32108742	5
chr11	32109584	32122293	Rhbdf1	12709	-	NM_010117	32109803	32116258	18
chr11	32126504	32132702	Mpg	6198	+	NM_010822	32126540	32131995	4
chr11	32131962	32167707	Nprl3	35745	-	NM_001284359	32132950	32167540	14
chr11	32176599	32178115	Hba-x	1516	+	NM_010405	32176663	32178008	3
chr11	32183671	32184486	Hba-a1	815	+	NM_008218	32183706	32184391	3
chr11	32183674	32184493	Hba-a2	819	+	NM_001083955	32183706	32184391	3
chr11	32186963	32187912	Hbq1b	949	+	NM_001033981	32187012	32187642	3
chr11	32200068	32200873	Hbq1a	805	+	NM_175000	32200117	32200756	3
chr11	32247810	32328183	Sh3pxd2b	80373	+	NM_177364	32247893	32323561	13
chr11	32355371	32418709	Ubtd2	63338	+	NM_173784	32355476	32416487	3
chr11	32422732	32427574	Efcab9	4842	-	NM_027031	32422794	32427520	4
chr11	32433265	32524595	Stk10	91330	+	NM_009288	32433403	32522561	19
chr11	32542554	32646814	Fbxw11	104260	+	NM_134015	32542890	32642620	14
chr11	32720375	32724594	Smim23	4219	-	NM_027050	32720493	32724517	4
chr11	33016977	33047400	Fgf18	30423	-	NM_008005	33017764	33047273	5
chr11	33052497	33063206	Npm1	10709	-	NM_001252260	33052813	33062979	11
chr11	33100751	33103588	Tlx3	2837	-	NM_019916	33101278	33103459	3
chr11	33111793	33413746	Ranbp17	301953	-	NR_110973	33413746	33413746	29
chr11	33450780	33478957	Gabrp	28177	-	NM_146017	33452539	33473370	10
chr11	33529340	33893193	Kcnip1	363853	-	NM_001190886	33530550	33892836	8
chr11	33863012	33873638	Kcnmb1	10626	+	NM_031169	33864700	33870364	4
chr11	33947200	33992280	Lcp2	45080	+	NM_010696	33947353	33990687	21
chr11	34104340	34108089	Foxi1	3749	-	NM_023907	34105509	34108023	2
chr11	34126820	34597407	Dock2	470587	-	NM_033374	34127667	34597325	52
chr11	34214821	34322640	Fam196b	107819	+	NM_001025382	34301959	34319905	4
chr11	34622686	34647143	Spdl1	24457	-	NM_027411	34623196	34644382	12
chr11	34934957	35522009	Slit3	587052	+	NM_011412	34935016	35521644	36
chr11	35430317	35430427	Mir218-2	110	+	NR_029799	35430427	35430427	1
chr11	35582996	35604787	Pank3	21791	+	NM_145962	35583421	35598960	7
chr11	35595897	35595983	Mir103-1	86	+	NR_029754	35595983	35595983	1
chr11	35610881	35612386	Fbll1	1505	-	NM_001004147	35610991	35611936	1
chr11	35621882	35648030	Rars	26148	-	NM_025936	35621983	35647983	15
chr11	35652679	35793591	Wwc1	140912	-	NM_170779	35652679	35793591	23
chr11	35820157	36757743	Tenm2	937586	-	NM_011856	35821536	36757668	29
chr11	37472490	37486668	Gm12128	14178	+	NR_131154	37486668	37486668	4
chr11	38305049	38333547	Gm12130	28498	-	NR_040295	38333547	38333547	3
chr11	39121204	39203727	4930553C11Rik	82523	-	NR_126439	39203727	39203727	3
chr11	40492815	40508705	Mat2b	15890	-	NM_001199274	40493525	40508334	7
chr11	40514889	40546939	Hmmr	32050	-	NM_013552	40516340	40546861	18
chr11	40547162	40553548	Nudcd2	6386	+	NM_001290697	40547467	40552744	4
chr11	40562053	40568788	Ccng1	6735	-	NM_009831	40564369	40567570	6
chr11	41723691	41814216	Gabrg2	90525	-	NM_008073	41725817	41813832	10
chr11	41944440	41996432	Gabra1	51992	-	NM_010250	41946980	41993135	10
chr11	42119938	42134574	Gabra6	14636	-	NM_008068	42120761	42134270	9
chr11	42233258	42446093	Gabrb2	212835	+	NM_008070	42234851	42440393	10
chr11	42963378	43075787	Atp10b	112409	+	NM_176999	42965116	43073403	23
chr11	43187898	43187963	Mir146	65	-	NR_029558	43187963	43187963	1
chr11	43233749	43239750	Pttg1	6001	-	NM_001131054	43233830	43239172	6
chr11	43247232	43261483	Slu7	14251	+	NM_148673	43250862	43259693	17
chr11	43287807	43305027	C1qtnf2	17220	+	NM_026979	43294453	43304839	4
chr11	43342250	43400501	Ccnjl	58251	+	NM_001045530	43342898	43399217	6
chr11	43409541	43415064	Fabp6	5523	-	NM_008375	43409613	43415013	4
chr11	43495499	43536135	Pwwp2a	40636	+	NM_001164231	43495594	43533736	4
chr11	43543507	43561475	Ttc1	17968	-	NM_133795	43543975	43558916	8
chr11	43588106	43714739	Adra1b	126633	-	NM_001284381	43589362	43649590	5
chr11	44213564	44228179	Il12b	14615	+	NM_001303244	44217538	44226738	8
chr11	44268072	44284050	Ublcp1	15978	-	NM_024475	44269089	44280470	11
chr11	44332465	44379022	Rnf145	46557	+	NM_028862	44338461	44377787	11
chr11	44399818	44404731	4930597A21Rik	4913	+	NR_126460	44404731	44404731	4
chr11	44431601	44821598	Ebf1	389997	+	NM_001290711	44435466	44818250	16
chr11	44916367	44930430	Gm12159	14063	-	NR_045100	44930430	44930430	3
chr11	45621584	45656380	F630206G17Rik	34796	+	NR_045876	45656380	45656380	4
chr11	45665465	45724127	Clint1	58662	+	NM_001045520	45665653	45722789	12
chr11	45741770	45758437	Lsm11	16667	-	NM_028185	45747114	45758414	4
chr11	45758808	45769005	Thg1l	10197	-	NM_001080969	45761668	45768967	6
chr11	45793811	45831494	Sox30	37683	+	NM_173384	45793821	45830858	5
chr11	45868003	45960849	Adam19	92846	+	NM_001291890	45868008	45957347	23
chr11	45915771	45915892	Mir8100	121	+	NR_106177	45915892	45915892	1
chr11	45961656	45979861	Nipal4	18205	-	NM_172524	45963647	45979778	6
chr11	45983588	45983645	Mir7239	57	+	NR_106098	45983645	45983645	1
chr11	46007350	46126361	Cyfip2	119011	-	NM_001252459	46009801	46105131	31
chr11	46049058	46053373	Fndc9	4315	+	NM_177075	46051157	46051838	2
chr11	46138649	46203017	Itk	64368	-	NM_010583	46140958	46202912	17
chr11	46218229	46221487	Fam71b	3258	+	NM_001013783	46218304	46221370	2
chr11	46250448	46256223	Med7	5775	+	NM_001104530	46254081	46254783	3
chr11	46268432	46294756	Havcr2	26324	+	NM_134250	46268502	46292948	7
chr11	46337752	46351658	Gm12169	13906	+	NM_001163357	46339758	46351507	7
chr11	46361914	46369570	Gm12171	7656	+	NM_001163353	46361914	46369570	4
chr11	46385014	46402734	BC053393	17720	+	NM_001025435	46388082	46401462	6
chr11	46420511	46442776	Dppa1	22265	-	NM_178247	46422365	46439118	7
chr11	46450007	46458508	Gm4926	8501	-	NR_028066	46458508	46458508	5
chr11	46482461	46520606	Timd2	38145	-	NM_134249	46484399	46503031	9
chr11	46553724	46593080	Havcr1	39356	+	NM_001166632	46564678	46592115	8
chr11	46624300	46657835	Timd4	33535	+	NM_178759	46624313	46656705	9
chr11	46792284	47192804	Sgcd	400520	-	NM_011891	46792764	47168875	8
chr11	48613861	48619743	Gnb2l1	5882	+	NM_008143	48613965	48619547	8
chr11	48615534	48615611	Snord96a	77	+	NR_028563	48615611	48615611	1
chr11	48616640	48616708	Snord95	68	+	NR_028564	48616708	48616708	1
chr11	48619905	48630893	Trim41	10988	-	NM_145377	48620746	48630157	6
chr11	48639639	48663697	Trim7	24058	+	NM_053166	48658943	48663491	7
chr11	48678750	48684848	Irgm1	6098	-	NM_008326	48679302	48682090	3
chr11	48700923	48715654	Gm5431	14731	-	NM_001024230	48701894	48708214	5
chr11	48718157	48740684	Gm12185	22527	-	NM_001045540	48720658	48729864	3
chr11	48758850	48759912	Psme2b	1062	-	NM_001281472	48758900	48759620	1
chr11	48759651	48792883	9930111J21Rik1	33232	-	NM_001114679	48760725	48781454	4
chr11	48798830	48805748	Tgtp1	6918	-	NM_011579	48800130	48801378	2
chr11	48851161	48864744	9930111J21Rik2	13583	-	NM_173434	48851893	48853297	3
chr11	48864234	48948889	Olfr56	84655	+	NM_010999	48947791	48948643	6
chr11	48870697	48877714	Tgtp2	7017	-	NM_001145164	48871997	48873245	2
chr11	48890088	48910489	Ifi47	20401	+	NM_001271677	48908909	48910172	3
chr11	48926278	48927259	Olfr1396	981	-	NM_146337	48926278	48927226	1
chr11	48961760	48962714	Olfr1395	954	+	NM_146877	48961760	48962714	1
chr11	48973517	48974456	Olfr1394	939	+	NM_146276	48973517	48974456	1
chr11	48981826	49000591	Btnl9	18765	-	NM_172793	48982555	48996573	10
chr11	49017001	49032318	Zfp62	15317	+	NM_001024846	49028585	49031309	5
chr11	49057692	49076526	Mgat1	18834	+	NM_001110148	49074193	49075537	4
chr11	49093651	49094587	Olfr1393	936	+	NM_146471	49093651	49094587	1
chr11	49106798	49107824	Olfr1392	1026	+	NM_146470	49106824	49107760	1
chr11	49131049	49131985	Olfr10	936	+	NM_206822	49131049	49131985	1
chr11	49140914	49141850	Olfr1391	936	+	NM_146468	49140914	49141850	1
chr11	49154035	49154971	Olfr1390	936	+	NM_147065	49154035	49154971	1
chr11	49243928	49245001	Olfr1389	1073	+	NM_147066	49243979	49244915	1
chr11	49257354	49258290	Olfr1388	936	+	NM_146467	49257354	49258290	1
chr11	49273182	49274118	Olfr1387	936	+	NM_146473	49273182	49274118	1
chr11	49283555	49284683	Olfr1386	1128	+	NM_001011741	49283654	49284584	1
chr11	49308036	49308966	Olfr1385	930	+	NM_001011805	49308036	49308966	1
chr11	49327119	49328153	Olfr1384	1034	+	NM_146472	49327141	49328098	1
chr11	49337226	49338162	Olfr1383	936	+	NM_207574	49337226	49338162	1
chr11	49348688	49349624	Olfr1382	936	+	NM_001011790	49348688	49349624	1
chr11	49365250	49366186	Olfr1381	936	+	NM_146469	49365250	49366186	1
chr11	49377424	49378360	Olfr1380	936	+	NM_207573	49377424	49378360	1
chr11	49423180	49466241	Flt4	43061	+	NM_008029	49423271	49464585	30
chr11	49477096	49478620	Scgb3a1	1524	+	NM_170727	49477600	49478493	4
chr11	49484998	49526224	Cnot6	41226	-	NM_212484	49488694	49516154	12
chr11	49607656	49652122	Gfpt2	44466	+	NM_013529	49607738	49651267	19
chr11	49660252	49699923	Mapk9	39671	+	NM_001163672	49667762	49696660	12
chr11	49715336	49793725	Rasgef1c	78389	+	NM_029004	49770541	49793021	14
chr11	49838832	49939221	Rnf130	100389	+	NM_001290750	49838902	49932656	8
chr11	49883203	49883301	Mir340	98	+	NR_029769	49883301	49883301	1
chr11	49944861	49986287	Tbc1d9b	41426	+	NM_001290760	49944940	49984909	22
chr11	49988352	50013617	3010026O09Rik	25265	+	NM_026543	49988387	50013520	7
chr11	50013653	50024322	Sqstm1	10669	-	NM_011018	50014291	50024259	8
chr11	50038836	50048605	Mgat4b	9769	+	NM_145926	50039144	50048131	15
chr11	50045746	50045808	Mir6919	62	+	NR_105884	50045808	50045808	1
chr11	50049962	50052034	Ltc4s	2072	-	NM_008521	50050072	50051937	5
chr11	50069136	50105838	Maml1	36702	-	NM_175334	50071350	50105563	5
chr11	50107458	50139175	Canx	31717	-	NM_001110500	50109783	50125279	15
chr11	50171286	50171381	Mir804	95	-	NR_030529	50171381	50171381	1
chr11	50191220	50200030	Hnrnph1	8810	+	NM_021510	50191832	50198692	14
chr11	50202804	50244613	Rufy1	41809	-	NM_172557	50203316	50244607	18
chr11	50415586	50621075	Adamts2	205489	+	NM_175643	50415665	50617531	22
chr11	50624586	50641233	Zfp354c	16647	-	NM_013922	50628065	50639960	5
chr11	50645533	50655054	Zfp879	9521	-	NM_173387	50646037	50654060	5
chr11	50664186	50679710	Grm6	15524	+	NM_173372	50664643	50678160	11
chr11	50686224	50700945	Zfp454	14721	-	NM_172794	50686494	50699903	6
chr11	50712213	50729678	Zfp2	17465	-	NM_178447	50713336	50714716	7
chr11	50735287	50745137	Zfp354b	9850	-	NM_013744	50735792	50744435	5
chr11	50764307	50767134	Prop1	2827	-	NM_008936	50764407	50766906	3
chr11	50782521	50783469	Olfr1378	948	+	NM_146910	50782521	50783469	1
chr11	50798204	50799128	Olfr1377	924	+	NM_146911	50798204	50799128	1
chr11	50820475	50821399	Olfr51	924	+	NM_146909	50820475	50821399	1
chr11	50840505	50841447	Olfr54	942	+	NM_010997	50840505	50841447	1
chr11	50861610	50862552	Olfr1375	942	+	NM_146516	50861610	50862552	1
chr11	50872758	50886301	Zfp354a	13543	+	NM_009329	50873623	50884187	5
chr11	50898588	50905337	9230009I02Rik	6749	+	NR_045865	50905337	50905337	3
chr11	51003334	51033920	Platr20	30586	-	NR_110444	51033920	51033920	5
chr11	51067152	51076453	BC049762	9301	-	NM_177567	51067294	51068092	3
chr11	51076615	51095272	Clk4	18657	+	NM_007714	51080672	51094919	13
chr11	51103421	51397427	Col23a1	294006	+	NM_153393	51103628	51393568	29
chr11	51398258	51416771	Phykpl	18513	+	NM_028398	51398322	51416343	13
chr11	51413601	51420383	Hnrnpab	6782	-	NM_001048061	51414909	51420065	8
chr11	51433274	51437216	Nhp2	3942	+	NM_026631	51433319	51436719	4
chr11	51437174	51449398	Rmnd5b	12224	-	NM_025346	51437584	51443116	10
chr11	51456590	51464575	N4bp3	7985	-	NM_145974	51457122	51459746	5
chr11	51464455	51471183	D930048N14Rik	6728	+	NR_027958	51471183	51471183	4
chr11	51498886	51502136	0610009B22Rik	3250	-	NM_025319	51499148	51499571	2
chr11	51505764	51570336	Sec24a	64572	-	NM_175255	51508628	51569675	23
chr11	51577164	51605455	Sar1b	28291	+	NM_025535	51591005	51604945	7
chr11	51626957	51670983	Jade2	44026	-	NM_199299	51630396	51662553	12
chr11	51781132	51790838	Cdkn2aipnl	9706	+	NM_029976	51781220	51789413	3
chr11	51798647	51813968	Ube2b	15321	-	NM_009458	51800183	51813838	6
chr11	51817722	51898169	Cdkl3	80447	+	NM_001166654	51818429	51854095	14
chr11	51912325	51936251	Ppp2ca	23926	+	NM_019411	51912550	51935476	7
chr11	51940247	51940338	Mir3061	91	+	NR_037221	51940338	51940338	1
chr11	51958094	51959030	Olfr1373	936	-	NM_207227	51958094	51959030	1
chr11	51968377	51971409	Olfr1372-ps1	3032	-	NR_034155	51971409	51971409	2
chr11	52026553	52027489	Olfr1371	936	-	NM_207253	52026553	52027489	1
chr11	52045496	52060360	Skp1a	14864	+	NM_011543	52050338	52059522	6
chr11	52065784	52096516	Tcf7	30732	-	NM_001313981	52067384	52095719	11
chr11	52174363	52202899	Vdac1	28536	+	NM_011694	52187803	52202025	9
chr11	52209929	52222225	9530068E07Rik	12296	+	NM_153117	52209969	52220578	3
chr11	52578207	53000849	Fstl4	422642	+	NM_177059	52587346	53000445	16
chr11	52924952	52933558	Gm11186	8606	-	NR_046047	52933558	52933558	4
chr11	53073315	53113981	Hspa4	40666	-	NM_008300	53075113	53113668	19
chr11	53138190	53146803	Zcchc10	8613	+	NM_026479	53138202	53146095	4
chr11	53164268	53235332	Aff4	71064	+	NM_033565	53182165	53229017	21
chr11	53222698	53222769	Mir6920	71	+	NR_105885	53222769	53222769	1
chr11	53235682	53236638	Leap2	956	-	NM_153069	53235914	53236604	3
chr11	53242449	53244333	Uqcrq	1884	-	NM_025352	53242557	53244191	2
chr11	53246787	53251404	Gdf9	4617	+	NM_008110	53246907	53251046	2
chr11	53270706	53281268	Shroom1	10562	+	NM_027917	53276756	53280597	8
chr11	53290079	53293697	Sowaha	3618	-	NM_183173	53291762	53293409	1
chr11	53333237	53357598	Sept8	24361	+	NM_033144	53333511	53354538	10
chr11	53380870	53417748	Kif3a	36878	+	NM_008443	53381027	53414561	18
chr11	53425962	53432167	Il4	6205	-	NM_021283	53426065	53432108	4
chr11	53444824	53448204	Il13	3380	-	NM_008355	53445566	53448136	4
chr11	53463020	53520821	Rad50	57801	-	NM_009012	53463970	53520557	25
chr11	53534295	53538605	Il5	4310	+	NM_010558	53534338	53537516	4
chr11	53577098	53577156	Mir7671	58	-	NR_106131	53577156	53577156	1
chr11	53583515	53591876	Irf1	8361	+	NM_001159393	53584790	53590932	10
chr11	53598990	53672758	Gm12216	73768	-	NR_033332	53672758	53672758	4
chr11	53678043	53705205	Slc22a5	27162	-	NM_011396	53679310	53705041	10
chr11	53764325	53793529	Slc22a21	29204	-	NM_019723	53764757	53793359	10
chr11	53796627	53841592	Slc22a4	44965	-	NM_019687	53797111	53841478	10
chr11	53868429	53882519	Pdlim4	14090	-	NM_019417	53868536	53882434	7
chr11	53914425	53945169	P4ha2	30744	+	NM_001136076	53923728	53944762	16
chr11	53991273	54026790	4933405E24Rik	35517	-	NR_045506	54026790	54026790	3
chr11	54060771	54063401	Csf2	2630	-	NM_009969	54061089	54063112	4
chr11	54078586	54080781	Il3	2195	-	NM_010556	54078905	54080752	5
chr11	54117325	54175041	Acsl6	57716	+	NM_001033598	54133679	54174699	21
chr11	54184153	54240292	Meikin	56139	+	NM_029105	54184170	54240181	14
chr11	54251680	54331743	Fnip1	80063	+	NM_173753	54251798	54329078	18
chr11	54336346	54512788	Rapgef6	176442	+	NM_001252496	54336551	54509607	29
chr11	54530916	54601205	Cdc42se2	70289	-	NM_178626	54533760	54553793	6
chr11	54633420	54638469	Lyrm7os	5049	+	NR_040284	54638469	54638469	3
chr11	54652790	54674093	Lyrm7	21303	-	NM_029327	54654633	54674071	5
chr11	54679939	54683998	Hint1	4059	+	NM_008248	54679991	54683855	3
chr11	54716355	54723884	Gpx3	7529	+	NM_008161	54716467	54723160	5
chr11	54724288	54776442	Tnip1	52154	-	NM_001199275	54725038	54754348	19
chr11	54792463	54846973	Anxa6	54510	-	NM_013472	54792963	54835056	26
chr11	54863239	54891633	Ccdc69	28394	-	NM_177471	54863978	54891562	7
chr11	54911486	54926530	Gm2a	15044	+	NM_010299	54911665	54923035	4
chr11	54938324	54965208	Slc36a3	26884	-	NM_172258	54938394	54964823	11
chr11	54971969	54998579	Slc36a2	26610	-	NM_153170	54972845	54998461	10
chr11	55005220	55011184	Slc36a1os	5964	-	NR_046034	55011184	55011184	3
chr11	55017841	55049832	Slc36a1	31991	+	NM_153139	55027436	55046140	11
chr11	55064111	55125759	Fat2	61648	-	NM_001029988	55065467	55125748	23
chr11	55207660	55233582	Sparc	25922	-	NM_009242	55209086	55223486	10
chr11	55260144	55274640	Atox1	14496	-	NM_009720	55264002	55274595	4
chr11	55283253	55314389	G3bp1	31136	+	NM_013716	55299145	55313170	12
chr11	55296207	55296331	Gm12238	124	+	NR_028480	55296331	55296331	1
chr11	55327740	55421700	Glra1	93960	-	NM_020492	55328314	55421235	9
chr11	55838491	55854489	Nmur2	15998	-	NM_153079	55840475	55854385	4
chr11	56825119	57143746	Gria1	318627	+	NM_001113325	56825535	57141148	16
chr11	57296491	57332146	Fam114a2	35655	-	NM_026342	57297519	57327776	14
chr11	57332166	57347319	Mfap3	15153	+	NM_180599	57341517	57343746	3
chr11	57458943	57601002	Galnt10	142059	+	NM_134189	57459060	57598230	12
chr11	57609000	57614969	2010001A14Rik	5969	-	NR_131042	57614969	57614969	4
chr11	57615138	57624117	Sap30l	8979	+	NM_001081168	57615593	57623572	4
chr11	57642214	57645649	Hand1	3435	-	NM_008213	57643100	57645288	2
chr11	57822565	57875534	Larp1	52969	+	NM_028451	57822694	57872267	19
chr11	57917654	57932096	Cnot8	14442	+	NM_026949	57923151	57931090	7
chr11	57933502	57982041	Gemin5	48539	-	NM_001166670	57935118	57981955	28
chr11	57985155	57993082	Mrpl22	7927	+	NM_175001	57985187	57992991	7
chr11	57997344	58003700	Gm12250	6356	+	NM_001135115	58001260	58002514	2
chr11	58013057	58021094	Igtp	8037	+	NM_018738	58015180	58020778	3
chr11	58028478	58036285	Irgm2	7807	+	NM_019440	58032986	58034174	2
chr11	58120570	58128115	Zfp692	7545	+	NM_001040686	58121087	58128024	12
chr11	58128615	58143841	Zfp672	15226	-	NM_001256520	58129588	58130995	3
chr11	58144208	58161230	Sh3bp5l	17022	+	NM_024480	58145182	58159899	7
chr11	58192533	58204043	Lypd8	11510	+	NM_001083884	58195834	58203883	7
chr11	58234612	58239525	1810065E05Rik	4913	+	NM_027239	58235199	58239405	6
chr11	58246060	58255124	Gm12253	9064	+	NM_001045542	58248005	58254558	7
chr11	58259644	58266468	4930504O13Rik	6824	-	NM_207527	58259709	58265968	4
chr11	58268416	58269482	Olfr30	1066	-	NM_146878	58268501	58269449	1
chr11	58303220	58306001	Olfr332	2781	-	NM_001011770	58303220	58304255	2
chr11	58315099	58316074	Olfr331	975	-	NM_001011861	58315099	58316074	1
chr11	58342430	58348327	Olfr330	5897	-	NM_146879	58342538	58343486	2
chr11	58355948	58356985	Olfr329-ps	1037	-	NM_001011531	58356019	58356976	1
chr11	58364806	58365739	Olfr328	933	-	NM_146502	58364806	58365739	1
chr11	58379900	58380845	Olfr224	945	-	NM_207695	58379900	58380845	1
chr11	58394338	58395379	Olfr325	1041	+	NM_207153	58394347	58395328	1
chr11	58410846	58411968	Olfr324	1122	+	NM_001011743	58410893	58411895	1
chr11	58421707	58426994	2210407C18Rik	5287	-	NM_144544	58421829	58426380	6
chr11	58438574	58439546	Olfr323	972	-	NM_146376	58438574	58439546	1
chr11	58453966	58465906	Trim58	11940	+	NM_001039047	58453969	58465175	6
chr11	58479062	58480046	Olfr322	984	+	NM_207693	58479062	58480046	1
chr11	58497376	58498297	Olfr320	921	+	NM_207230	58497376	58498297	1
chr11	58515204	58516125	Olfr319	921	+	NM_146500	58515204	58516125	1
chr11	58533570	58534596	Olfr318	1026	-	NM_146501	58533627	58534548	1
chr11	58545597	58546725	Olfr317	1128	-	NM_001011769	58545681	58546665	1
chr11	58571168	58572089	Olfr316	921	+	NM_001011818	58571168	58572089	1
chr11	58591590	58592588	Olfr315	998	+	NM_146538	58591630	58592560	1
chr11	58599640	58600771	Olfr314	1131	+	NM_001011760	58599737	58600730	1
chr11	58606303	58615462	Fam183b	9159	-	NM_029283	58606390	58615401	4
chr11	58630429	58631503	Olfr313	1074	+	NM_146536	58630511	58631438	1
chr11	58644657	58645584	Olfr312	927	+	NM_001011819	58644657	58645584	1
chr11	58654617	58655544	Olfr311	927	+	NM_146537	58654617	58655544	1
chr11	58680741	58697840	2810021J22Rik	17099	+	NM_172403	58682493	58694815	5
chr11	58701654	58717727	Zfp39	16073	-	NM_011758	58703279	58717619	5
chr11	58731558	58740467	Btnl10	8909	+	NM_138678	58732371	58740405	5
chr11	58745789	58752408	Rnf187	6619	-	NM_022423	58746895	58752286	4
chr11	58762412	58762874	Hist3h2ba	462	+	NM_030082	58762441	58762822	1
chr11	58767549	58768014	Hist3h2bb-ps	465	-	NM_206882	58767549	58768014	1
chr11	58768186	58768694	Hist3h2a	508	+	NM_178218	58768239	58768632	1
chr11	58775212	58775775	Gm12260	563	+	NM_001318003	58775313	58775724	1
chr11	58777282	58785231	Trim17	7949	+	NM_031172	58778620	58785079	7
chr11	58791594	58804964	Trim11	13370	+	NM_001290988	58791741	58804236	7
chr11	58807758	58949877	Obscn	142119	-	NM_001171512	58807833	58949877	104
chr11	58968870	58977247	Iba57	8377	-	NM_173785	58971766	58977193	3
chr11	58989065	58996715	Gjc2	7650	-	NM_080454	58989833	58991156	2
chr11	58997356	59005454	Guk1	8098	-	NM_008193	58997653	59005313	8
chr11	59011294	59015933	2610507I01Rik	4639	-	NR_037964	59015933	59015933	3
chr11	59015987	59019637	Mrpl55	3650	+	NM_026035	59017734	59019309	4
chr11	59021862	59024236	2310033P09Rik	2374	+	NM_024210	59021930	59023846	7
chr11	59024913	59041769	Arf1	16856	-	NM_007476	59026035	59026989	5
chr11	59061543	59104253	Wnt3a	42710	-	NM_009522	59063131	59104149	4
chr11	59120431	59147054	Wnt9a	26623	+	NM_139298	59120474	59144877	4
chr11	59186170	59189155	Prss38	2985	-	NM_001045521	59186417	59189132	5
chr11	59220651	59263458	Snap47	42807	-	NM_144521	59221165	59251976	5
chr11	59263546	59272069	Jmjd4	8523	+	NM_178659	59263746	59269108	6
chr11	59274698	59285976	Zfp867	11278	-	NM_178417	59276581	59285869	4
chr11	59299022	59320142	Zkscan17	21120	-	NM_001291014	59300567	59316524	10
chr11	59319186	59324569	4933439C10Rik	5383	+	NR_015585	59324569	59324569	5
chr11	59356187	59380458	Nlrp3	24271	+	NM_145827	59356614	59379765	10
chr11	59384283	59385240	Olfr222	957	-	NM_001011789	59384283	59385240	1
chr11	59402629	59403589	Olfr223	960	-	NM_146429	59402629	59403589	1
chr11	59426467	59427727	Olfr225	1260	+	NM_001011740	59426467	59427727	1
chr11	59475996	59594362	Mprip	118366	+	NM_012027	59476327	59585686	24
chr11	59539418	59553656	1700007J10Rik	14238	-	NR_045476	59553656	59553656	6
chr11	59597394	59601159	Pld6	3765	-	NM_001290283	59598479	59601137	2
chr11	59604909	59623541	Flcn	18632	-	NM_146018	59606111	59618271	13
chr11	59623581	59631864	Gm16062	8283	+	NR_045686	59631864	59631864	2
chr11	59631305	59653269	Cops3	21964	-	NM_011991	59631556	59653226	12
chr11	59661574	59690035	Nt5m	28461	+	NM_134029	59661631	59689449	5
chr11	59735000	59735391	1810063I02Rik	391	+	NR_130986	59735391	59735391	2
chr11	59760393	59761649	Med9os	1256	-	NR_045273	59761649	59761649	2
chr11	59761715	59776808	Med9	15093	+	NM_138675	59761768	59774277	2
chr11	59776684	59778446	Rasd1	1762	-	NM_009026	59777311	59778307	2
chr11	59784115	59859991	Pemt	75876	-	NM_001290011	59784319	59859937	7
chr11	59918514	60012697	Rai1	94183	+	NM_009021	59998613	60011547	6
chr11	60012585	60034129	Srebf1	21544	-	NM_011480	60013423	60034045	19
chr11	60014039	60014119	Mir6921	80	-	NR_105886	60014119	60014119	1
chr11	60015763	60015829	Mir6922	66	-	NR_105887	60015829	60015829	1
chr11	60040215	60166407	Tom1l2	126192	-	NM_153080	60043594	60166310	15
chr11	60166881	60207835	Lrrc48	40954	+	NM_029044	60172158	60207740	14
chr11	60214125	60230601	Atpaf2	16476	-	NM_145427	60214902	60230412	8
chr11	60230646	60258779	Gid4	28133	+	NM_025757	60231157	60255544	6
chr11	60268118	60282207	Drg2	14089	+	NM_021354	60268181	60281652	13
chr11	60282840	60341870	Myo15	59030	+	NM_010862	60289917	60340927	65
chr11	60351184	60372014	Alkbh5	20830	+	NM_172943	60351924	60367917	4
chr11	60513191	60527690	Llgl1	14499	+	NM_001159405	60513362	60526712	22
chr11	60527648	60540765	Flii	13117	-	NM_001302207	60527814	60540691	30
chr11	60541899	60546453	Mief2	4554	+	NM_001009927	60543790	60545472	4
chr11	60542164	60542228	Mir5100	64	+	NR_039559	60542228	60542228	1
chr11	60553560	60590867	Top3a	37307	-	NM_009410	60554024	60590603	19
chr11	60591026	60601789	Smcr8	10763	+	NM_001085440	60591529	60597709	2
chr11	60602398	60624767	Shmt1	22369	-	NM_009171	60602645	60620525	12
chr11	60644132	60671925	Dhrs7b	27793	+	NM_001172112	60657673	60671425	7
chr11	60677953	60692540	Tmem11	14587	-	NM_001168507	60678333	60689275	3
chr11	60715747	60727294	Natd1	11547	-	NM_025294	60719506	60727227	3
chr11	60734442	60745369	Map2k3os	10927	-	NR_027800	60745369	60745369	2
chr11	60745558	60766305	Map2k3	20747	+	NM_008928	60745724	60765349	12
chr11	60836065	60886769	Kcnj12	50704	+	NM_001267593	60882685	60883969	2
chr11	60954336	60961144	Tnfrsf13b	6808	+	NM_021349	60954336	60961144	4
chr11	60965282	60988561	Usp22	23279	-	NM_001004143	60967972	60988387	13
chr11	61022243	61031918	Aldh3a1	9675	+	NM_001112725	61025733	61031730	11
chr11	61058253	61080688	Aldh3a2	22435	-	NM_007437	61059811	61080508	10
chr11	61115132	61156362	Slc47a2	41230	-	NM_001033542	61115705	61156280	17
chr11	61156901	61191577	Slc47a1	34676	-	NM_026183	61157803	61191549	17
chr11	61261918	61267494	Rnf112	5576	-	NM_009548	61262908	61267351	15
chr11	61298945	61302206	Mfap4	3261	+	NM_029568	61298981	61301503	6
chr11	61302313	61307768	Mapk7	5455	-	NM_001291036	61302618	61305169	7
chr11	61318673	61326429	B9d1	7756	+	NM_013717	61318710	61326296	7
chr11	61330750	61393189	Epn2	62439	-	NM_001252188	61332919	61360246	11
chr11	61466822	61486279	Grap	19457	+	NM_027817	61466848	61485360	5
chr11	61486283	61534301	Slc5a10	48018	-	NM_001033227	61486506	61533454	16
chr11	61497911	61523452	Fam83g	25541	+	NM_178618	61498035	61521229	5
chr11	61543151	61575590	Prpsap2	32439	-	NM_144806	61543645	61569815	12
chr11	61589099	61668594	Ulk2	79495	-	NM_013881	61591282	61668078	27
chr11	61684808	61743759	Akap10	58951	-	NM_019921	61686517	61743578	15
chr11	61770264	62036515	Specc1	266251	+	NM_001281818	61842777	62032876	15
chr11	62062485	62079954	Adora2b	17469	+	NM_007413	62062603	62079227	2
chr11	62080725	62094897	Zswim7	14172	-	NM_027198	62080955	62094834	5
chr11	62094974	62129943	Ttc19	34969	+	NM_029704	62095014	62127645	9
chr11	62129927	62252017	Ncor1	122090	-	NM_001252313	62131344	62251947	45
chr11	62271961	62327402	Pigl	55441	+	NM_001039536	62271961	62326504	7
chr11	62338445	62352763	Cenpv	14318	-	NM_028448	62338664	62352707	5
chr11	62364672	62366715	Ubb	2043	+	NM_011664	62365647	62366565	2
chr11	62387987	62413807	Trpv2	25820	+	NM_011706	62391909	62413699	16
chr11	62416378	62418308	2410006H16Rik	1930	+	NR_030738	62418308	62418308	5
chr11	62416587	62416650	Snord49b	63	+	NR_028526	62416650	62416650	1
chr11	62416961	62417023	Snord49a	62	+	NR_028550	62417023	62417023	1
chr11	62418031	62418088	Snord65	57	+	NR_028541	62418088	62418088	1
chr11	62418385	62462025	Lrrc75a	43640	-	NM_198861	62419216	62461892	4
chr11	62462165	62479861	Mmgt2	17696	+	NM_175002	62478329	62478701	2
chr11	62524987	62542595	Zfp287	17608	-	NM_133208	62527301	62542168	5
chr11	62591888	62602919	Zfp286	11031	-	NM_138949	62593187	62602486	6
chr11	62633754	62656450	Trim16	22696	+	NM_053169	62634006	62654477	6
chr11	62660624	62690964	Fbxw10	30340	+	NM_001033669	62660783	62690919	13
chr11	62692991	62708686	Tvp23b	15695	+	NM_026210	62693085	62707650	7
chr11	62764694	62806597	Cdrt4	41903	+	NM_025496	62764795	62806515	2
chr11	62803954	62817636	Cdrt4os1	13682	-	NR_126547	62817636	62817636	3
chr11	62875160	62908462	Tekt3	33302	+	NM_027660	62883508	62908344	8
chr11	62942483	62973049	Pmp22	30566	+	NM_001302258	62946668	62971917	5
chr11	63698194	63735786	Hs3st3b1	37592	-	NM_018805	63702628	63735389	2
chr11	63776128	63892974	Cox10	116846	-	NM_178379	63777623	63892880	7
chr11	63777727	63781542	9630013K17Rik	3815	+	NR_131111	63781542	63781542	4
chr11	63892985	63896761	2810001G20Rik	3776	+	NR_033780	63896761	63896761	2
chr11	64246636	64250176	F930015N05Rik	3540	-	NR_028445	64250176	64250176	1
chr11	64248833	64336337	Hs3st3a1	87504	+	NM_178870	64249568	64334321	2
chr11	64792536	64815578	Elac2	23042	+	NM_023479	64792612	64815369	25
chr11	64815540	64976463	Arhgap44	160923	-	NM_175003	64818999	64976140	21
chr11	64990071	65083491	Myocd	93420	-	NM_145136	64991946	65083200	14
chr11	65091155	65101335	Gm12295	10180	-	NR_040280	65101335	65101335	5
chr11	65501745	65601861	Map2k4	100116	-	NM_001316367	65504192	65601746	12
chr11	65548234	65548334	Mir744	100	-	NR_030417	65548334	65548334	1
chr11	65620676	65642741	Zkscan6	22065	+	NM_026107	65627966	65642328	8
chr11	65644825	65982053	Dnah9	337228	-	NM_001099633	65645060	65981969	69
chr11	66025226	66339628	Shisa6	314402	-	NM_001034874	66030973	66339466	5
chr11	66719133	66760588	Gm12298	41455	-	NR_033539	66760588	66760588	4
chr11	66725492	66742202	Pirt	16710	+	NM_178656	66739366	66739774	2
chr11	66770139	66778516	9130409J20Rik	8377	+	NR_130315	66778516	66778516	3
chr11	66838655	66848814	Tmem220	10159	+	NM_177392	66838680	66847746	7
chr11	66851381	66866120	Adprm	14739	-	NM_025510	66851642	66855583	5
chr11	66866171	66880942	Sco1	14771	+	NM_001040026	66866196	66877542	6
chr11	66891801	66915793	Myh3	23992	+	NM_001099635	66893500	66915668	41
chr11	66913305	66913377	Mir6923	72	+	NR_105888	66913377	66913377	1
chr11	66925962	66933582	2310065F04Rik	7620	-	NR_038055	66933582	66933582	5
chr11	66984528	67011019	Myh2	26491	+	NM_001039545	66986617	67010890	40
chr11	67013615	67038077	Myh1	24462	+	NM_030679	67015383	67037971	40
chr11	67051313	67073949	Myh4	22636	+	NM_010855	67054125	67073842	40
chr11	67090625	67122135	Myh8	31510	+	NM_177369	67092358	67121985	40
chr11	67140604	67185004	Myh13	44400	+	NM_001081250	67140604	67185004	39
chr11	67346499	67502494	Gas7	155995	+	NM_008088	67346603	67496953	14
chr11	67508827	67516857	Rcvrn	8030	+	NM_009038	67508918	67516495	3
chr11	67519931	67584655	Glp2r	64724	-	NM_175681	67522984	67584374	13
chr11	67611772	67629504	Dhrs7c	17732	+	NM_001013013	67612127	67629455	7
chr11	67668024	67735655	Usp43	67631	-	NM_001291049	67668982	67735550	15
chr11	67738307	67779144	Cfap52	40837	-	NM_027963	67738594	67779093	14
chr11	67779984	68020650	Stx8	240666	+	NM_018768	67780002	68017275	8
chr11	68022865	68200328	Ntn1	177463	-	NM_008744	68026507	68199622	7
chr11	68034393	68034513	Mir6406	120	+	NR_105833	68034513	68034513	1
chr11	68245626	68311348	Pik3r5	65722	+	NM_177320	68287309	68309752	19
chr11	68316520	68366197	Pik3r6	49677	+	NM_001004435	68333776	68365546	20
chr11	68369687	68371747	Mfsd6l	2060	+	NM_146004	68369826	68371587	1
chr11	68400538	68411453	Ccdc42	10915	+	NM_177779	68400716	68411229	7
chr11	68505416	68630126	Myh10	124710	+	NM_175260	68512742	68628573	41
chr11	68634948	68666633	Ndel1	31685	-	NM_023668	68636073	68658914	9
chr11	68702054	68708517	Rnf222	6463	+	NM_177060	68706110	68706746	3
chr11	68715067	68718036	Rpl26	2969	+	NM_009080	68715776	68717995	4
chr11	68715090	68718036	Gm15772	2946	+	NR_003373	68718036	68718036	4
chr11	68735336	68740583	Odf4	5247	-	NM_145746	68735459	68740469	5
chr11	68756655	68770360	Arhgef15	13705	-	NM_177566	68758179	68768526	16
chr11	68781632	68786017	Slc25a35	4385	+	NM_028048	68782164	68785625	5
chr11	68785985	68788687	Rangrf	2702	-	NM_001285441	68786122	68788670	5
chr11	68799202	68821962	Pfas	22760	-	NM_001159519	68801464	68817339	28
chr11	68804075	68804180	Mir3062	105	-	NR_037222	68804180	68804180	1
chr11	68829412	68849975	Ctc1	20563	+	NM_001013256	68829634	68849669	23
chr11	68859138	68865166	Aurkb	6028	+	NM_011496	68859462	68864563	8
chr11	68873276	68875078	Borcs6	1802	+	NM_028005	68873299	68874382	1
chr11	68884310	68886795	Tmem107	2485	+	NM_025838	68884448	68886317	5
chr11	68902029	68905883	Vamp2	3854	+	NM_009497	68902127	68904168	5
chr11	68912457	68923459	Per1	11002	+	NM_011065	68914143	68922861	23
chr11	68933954	68936761	Hes7	2807	+	NM_033041	68933975	68936496	4
chr11	68939878	68962617	Aloxe3	22739	+	NM_011786	68939904	68962241	15
chr11	68970573	68983293	Alox12b	12720	+	NM_009659	68970748	68983227	15
chr11	68997386	69011345	Alox8	13959	-	NM_009661	68998591	69011311	14
chr11	69031618	69050524	Gucy2e	18906	-	NM_008192	69036536	69050147	19
chr11	69112997	69137375	Cntrob	24378	-	NM_172560	69113372	69136464	19
chr11	69137487	69139295	Trappc1	1808	+	NM_001024206	69137659	69139069	5
chr11	69139759	69146543	Kcnab3	6784	+	NM_010599	69140183	69145645	14
chr11	69154270	69156149	Chd3os	1879	+	NR_027827	69156149	69156149	2
chr11	69156774	69182928	Chd3	26154	-	NM_146019	69157852	69182893	40
chr11	69207113	69208848	Cyb5d1	1735	-	NM_001045525	69207139	69208795	4
chr11	69209292	69210173	Naa38	881	+	NM_030083	69209393	69210134	3
chr11	69210017	69211736	Tmem88	1719	-	NM_025915	69211113	69211727	2
chr11	69212019	69227177	Kdm6b	15158	-	NM_001017426	69213327	69221664	23
chr11	69234310	69362610	Dnah2	128300	-	NM_001081330	69234494	69358044	86
chr11	69367593	69373739	Efnb3	6146	-	NM_007911	69369361	69373315	5
chr11	69375255	69392826	Wrap53	17571	-	NM_144824	69375280	69392554	10
chr11	69393860	69405375	Trp53	11515	+	NM_011640	69400392	69404933	11
chr11	69413251	69419462	Atp1b2	6211	-	NM_013415	69414749	69418874	7
chr11	69428317	69431407	Shbg	3090	-	NM_011367	69428469	69431364	8
chr11	69435610	69437371	Sat2	1761	+	NM_026991	69435768	69437160	6
chr11	69446472	69466799	Fxr2	20327	+	NM_011814	69446819	69466201	17
chr11	69448901	69449021	Mir467f	120	-	NR_035420	69449021	69449021	1
chr11	69468538	69470229	Sox15	1691	+	NM_009235	69468874	69470123	2
chr11	69470200	69476151	Mpdu1	5951	-	NM_011900	69470704	69476073	7
chr11	69476544	69476627	Mir1934	83	+	NR_035455	69476627	69476627	1
chr11	69477714	69479672	Cd68	1958	-	NM_001291058	69477872	69479564	6
chr11	69480437	69485925	Eif4a1	5488	-	NM_144958	69480974	69485803	11
chr11	69486611	69495586	Senp3	8975	-	NM_001163571	69487027	69494341	11
chr11	69496078	69499056	Tnfsf13	2978	-	NM_001159505	69496736	69498761	6
chr11	69496078	69509600	Tnfsfm13	13522	-	NM_001159503	69496736	69509256	13
chr11	69499741	69509600	Tnfsf12	9859	-	NM_011614	69500341	69509256	7
chr11	69547500	69572135	Polr2a	24635	-	NM_001291068	69547911	69571725	29
chr11	69573386	69575346	Slc35g3	1960	-	NM_019871	69573636	69575186	2
chr11	69579413	69597528	Zbtb4	18115	+	NM_029348	69589372	69592903	4
chr11	69597537	69609439	Chrnb1	11902	-	NM_009601	69598122	69609381	11
chr11	69609569	69615218	Fgf11	5649	-	NM_010198	69611703	69615127	6
chr11	69617096	69619126	Tmem102	2030	-	NM_001033433	69617116	69618735	2
chr11	69617170	69619540	G630025P09Rik	2370	+	NR_027913	69619540	69619540	1
chr11	69630067	69631942	4933402P03Rik	1875	-	NM_175368	69630127	69631899	3
chr11	69634372	69635667	Spem1	1295	-	NM_028855	69634405	69635602	3
chr11	69636624	69648351	Nlgn2	11727	-	NM_198862	69638704	69647940	7
chr11	69652026	69653060	Tmem256	1034	+	NM_026982	69652066	69653011	4
chr11	69659873	69665560	Plscr3	5687	+	NM_001168497	69660570	69663902	8
chr11	69664064	69672232	Tnk1	8168	-	NM_031880	69665103	69670576	14
chr11	69690185	69691520	Tmem95	1335	-	NM_001195710	69690185	69691520	7
chr11	69691765	69694487	Kctd11	2722	-	NM_153143	69693013	69693712	1
chr11	69695068	69709041	Acap1	13973	-	NM_153788	69695126	69708840	22
chr11	69695533	69695596	Mir6924	63	-	NR_105889	69695596	69695596	1
chr11	69710859	69714488	2810408A11Rik	3629	-	NM_027419	69710990	69714253	9
chr11	69715317	69727326	Neurl4	12009	+	NM_001013414	69715399	69726833	29
chr11	69727693	69730093	Gps2	2400	+	NM_019726	69727841	69730005	10
chr11	69730213	69735460	Eif5a	5247	-	NM_001166593	69730940	69732817	7
chr11	69749400	69755101	Ybx2	5701	+	NM_016875	69749476	69754598	9
chr11	69755787	69761692	Slc2a4	5905	-	NM_009204	69756870	69761483	11
chr11	69778280	69781388	Cldn7	3108	+	NM_001193619	69779428	69781219	5
chr11	69781726	69794737	Elp5	13011	-	NM_018740	69781927	69793761	9
chr11	69794669	69804102	Ctdnep1	9433	+	NM_026017	69794985	69803539	8
chr11	69804871	69808451	Gabarap	3580	+	NM_019749	69805214	69808026	4
chr11	69809267	69813513	Phf23	4246	+	NM_030064	69809521	69812954	5
chr11	69814127	69823611	Dvl2	9484	+	NM_007888	69814334	69823094	15
chr11	69823684	69828930	Acadvl	5246	-	NM_017366	69823797	69828826	20
chr11	69825544	69825633	Mir324	89	+	NR_029758	69825633	69825633	1
chr11	69832106	69859033	Dlg4	26927	+	NM_001109752	69832421	69858197	20
chr11	69867625	69871397	Asgr1	3772	+	NM_001291131	69868401	69871145	9
chr11	69906145	69919688	Asgr2	13543	+	NM_001313926	69906571	69919383	9
chr11	69943858	69951044	Mgl2	7186	+	NM_145137	69947656	69950615	10
chr11	69980124	69984338	Clec10a	4214	+	NM_001204252	69981445	69984076	10
chr11	70027411	70029916	Slc16a11	2505	+	NM_153081	70028012	70029868	5
chr11	70030293	70034496	Slc16a13	4203	-	NM_172371	70031217	70034179	4
chr11	70037628	70043300	Bcl6b	5672	-	NM_007528	70039528	70042661	9
chr11	70048193	70048318	Mir497b	125	-	NR_106178	70048318	70048318	1
chr11	70048218	70048302	Mir497	84	+	NR_030444	70048302	70048302	1
chr11	70048543	70048637	Mir195a	94	+	NR_029581	70048637	70048637	1
chr11	70048705	70051416	0610010K14Rik	2711	-	NM_001177601	70048905	70051306	6
chr11	70051624	70053354	Rnasek	1730	-	NM_173742	70051830	70053235	3
chr11	70054956	70068843	Alox12	13887	-	NM_007440	70055886	70068774	14
chr11	70129114	70136020	Alox12e	6906	-	NM_145684	70129372	70135958	14
chr11	70157648	70165533	Alox15	7885	-	NM_009660	70158044	70165507	14
chr11	70206382	70223533	Pelp1	17151	-	NM_029231	70206431	70223514	17
chr11	70246081	70254330	Arrb2	8249	+	NM_001271360	70246232	70253759	16
chr11	70251756	70251820	Mir7115	64	+	NR_106064	70251820	70251820	1
chr11	70265432	70267228	Med11	1796	+	NM_025397	70265480	70266741	3
chr11	70267735	70273486	Cxcl16	5751	-	NM_023158	70268905	70272949	5
chr11	70273123	70279701	Zmynd15	6578	+	NM_001029929	70274071	70279588	14
chr11	70318775	70324686	Tm4sf5	5911	+	NM_029360	70318832	70324358	5
chr11	70327017	70328118	Vmo1	1101	-	NM_001013607	70327069	70328104	3
chr11	70332710	70334238	Gltpd2	1528	+	NM_146020	70332719	70334010	3
chr11	70338858	70341360	Psmb6	2502	+	NM_008946	70338898	70341081	6
chr11	70353773	70371612	Pld2	17839	+	NM_008876	70354347	70371065	25
chr11	70376382	70427984	Mink1	51602	+	NM_001045964	70376571	70427214	33
chr11	70428384	70432696	Chrne	4312	-	NM_009603	70428474	70432677	12
chr11	70429395	70430392	4930544D05Rik	997	+	NM_001145537	70429440	70430300	4
chr11	70452623	70455557	Gp1ba	2934	+	NM_010326	70452911	70455116	2
chr11	70457528	70460541	Slc25a11	3013	-	NM_024211	70458267	70460364	8
chr11	70460788	70464916	Rnf167	4128	+	NM_001316728	70463018	70464716	10
chr11	70465348	70468152	Pfn1	2804	-	NM_011072	70465625	70467982	3
chr11	70470677	70476015	Eno3	5338	+	NM_007933	70471375	70475934	12
chr11	70477270	70482918	Spag7	5648	-	NM_001167669	70477612	70482783	7
chr11	70482964	70501607	Camta2	18643	-	NM_001190376	70483700	70499879	23
chr11	70501862	70513657	Inca1	11795	-	NM_001252485	70502107	70503993	8
chr11	70514049	70545472	Kif1c	31423	+	NM_153103	70516301	70542381	23
chr11	70519491	70519561	Mir6925	70	+	NR_105890	70519561	70519561	1
chr11	70577948	70586431	Zfp3	8483	+	NM_177565	70584718	70586212	2
chr11	70604433	70626063	Scimp	21630	-	NM_001045526	70604937	70614303	5
chr11	70658262	70756607	Rabep1	98345	+	NM_001291143	70698355	70753985	19
chr11	70756559	70783475	Nup88	26916	-	NM_001276406	70756760	70783453	17
chr11	70783701	70791435	Rpain	7734	+	NM_027186	70784008	70791189	7
chr11	70791347	70796528	C1qbp	5181	-	NM_007573	70791596	70796452	6
chr11	70797592	70817934	Dhx33	20342	-	NM_178367	70800620	70817880	12
chr11	70820941	70833343	Derl2	12402	-	NM_001291146	70823822	70829239	7
chr11	70833112	70840636	Mis12	7524	+	NM_025993	70838644	70839265	3
chr11	70845442	70847119	6330403K07Rik	1677	-	NM_134022	70846538	70846904	2
chr11	70904698	70958206	Nlrp1a	53508	-	NM_001004142	70905737	70955868	14
chr11	70966603	71044235	Nlrp1b	77632	-	NM_001040696	70969501	71041969	15
chr11	71055931	71098734	Nlrp1c-ps	42803	-	NR_027858	71098734	71098734	13
chr11	71564204	71603148	Wscd1	38944	+	NM_177618	71573350	71602523	9
chr11	71741972	71753624	4930401O10Rik	11652	-	NR_045942	71753624	71753624	5
chr11	71842223	71851011	Aipl1	8788	-	NM_053245	71842755	71850960	6
chr11	71856003	71860872	Fam64a	4869	+	NM_144526	71856551	71859875	6
chr11	71861029	71949391	Pitpnm3	88362	-	NM_001024927	71864556	71949177	20
chr11	71967598	72016873	4933427D14Rik	49275	-	NM_028963	71968822	72016006	19
chr11	72021055	72023989	Txndc17	2934	+	NM_026559	72021125	72022985	4
chr11	72025225	72029094	Med31	3869	-	NM_026068	72025386	72028490	4
chr11	72028639	72031952	4930563E22Rik	3313	+	NM_001163728	72028832	72029222	1
chr11	72055495	72080106	Slc13a5	24611	-	NM_001004148	72057006	72080067	12
chr11	72080345	72082058	1700051A21Rik	1713	+	NR_045922	72082058	72082058	2
chr11	72115130	72127235	Xaf1	12105	+	NM_001037713	72115179	72125508	6
chr11	72127945	72132921	Fbxo39	4976	+	NM_001099688	72130325	72132713	4
chr11	72158218	72175944	Tekt1	17726	-	NM_001282006	72158265	72173370	8
chr11	72202257	72202366	Mir6338	109	+	NR_105756	72202366	72202366	1
chr11	72203615	72225215	Smtnl2	21600	-	NM_177776	72204788	72225135	8
chr11	72249027	72251906	Ggt6	2879	+	NM_027819	72249120	72251671	4
chr11	72254879	72265052	Mybbp1a	10173	+	NM_016776	72254885	72264976	26
chr11	72265139	72303422	Spns2	38283	-	NM_153060	72267059	72303297	13
chr11	72311657	72363748	Spns3	52091	-	NM_029932	72311893	72363710	12
chr11	72420762	72499983	Ube2g1	79221	+	NM_025985	72421091	72492957	6
chr11	72503503	72585648	Ankfy1	82145	+	NM_009671	72503526	72581147	25
chr11	72590733	72609341	Cyb5d2	18608	-	NM_001024926	72592240	72609264	4
chr11	72609727	72740622	Zzef1	130895	+	NM_001045536	72609798	72738219	55
chr11	72774670	72806545	Atp2a3	31875	+	NM_016745	72774855	72805254	22
chr11	72812646	72828699	P2rx1	16053	+	NM_008771	72812816	72827628	12
chr11	72832509	72855567	Camkk1	23058	+	NM_018883	72839079	72853795	16
chr11	72861368	72897081	Ncbp3	35713	+	NM_025818	72861401	72892678	13
chr11	72904096	72960951	Itgae	56855	+	NM_008399	72904119	72960642	31
chr11	72948985	72951796	Gsg2	2811	-	NM_010353	72949498	72951763	1
chr11	72974031	72986189	P2rx5	12158	+	NM_033321	72974098	72985336	13
chr11	72989004	72990544	Emc6	1540	-	NM_025318	72989872	72990205	2
chr11	72990584	72995548	Tax1bp3	4964	+	NM_029564	72990805	72994727	4
chr11	72996634	73012521	Ctns	15887	-	NM_031251	72998419	73010200	11
chr11	73012983	73038008	Shpk	25025	+	NM_029031	73013020	73036695	7
chr11	73047650	73074824	Trpv1	27174	+	NM_001001445	73051760	73074009	16
chr11	73081121	73110702	Trpv3	29581	+	NM_145099	73083163	73110702	18
chr11	73118489	73138139	Aspa	19650	-	NM_023113	73118937	73137989	6
chr11	73143242	73159546	Spata22	16304	+	NM_001045531	73144653	73159448	9
chr11	73164360	73168201	Olfr20	3841	+	NM_146923	73167256	73168201	2
chr11	73184747	73189206	Olfr376	4459	+	NM_001172686	73185556	73189206	3
chr11	73208577	73212997	Olfr1	4420	-	NM_146921	73208577	73209522	3
chr11	73218951	73223360	Olfr75-ps1	4409	-	NR_033528	73223360	73223360	3
chr11	73238538	73241979	Olfr378	3441	-	NM_147024	73238538	73239483	2
chr11	73266776	73267712	Olfr380	936	-	NM_147025	73266776	73267712	1
chr11	73299388	73300324	Olfr381	936	-	NM_147022	73299388	73300324	1
chr11	73329760	73330699	Olfr382	939	-	NM_146443	73329760	73330699	1
chr11	73402299	73403238	Olfr385	939	-	NM_147023	73402299	73403238	1
chr11	73416083	73417022	Olfr384	939	+	NM_207224	73416083	73417022	1
chr11	73502279	73527310	Zfp735	25031	+	NM_001126489	73502458	73525938	4
chr11	73589888	73594091	Olfr389	4203	-	NM_147009	73589888	73590827	3
chr11	73600441	73601377	Olfr390	936	+	NM_146347	73600441	73601377	1
chr11	73612254	73616486	Olfr391-ps	4232	-	NM_001159775	73612318	73613257	2
chr11	73627643	73630379	Olfr392	2736	-	NM_147006	73627643	73628582	2
chr11	73660686	73661625	Olfr393	939	-	NM_147008	73660686	73661625	1
chr11	73700939	73701872	Olfr394	933	-	NM_147007	73700939	73701872	1
chr11	73720053	73720992	Olfr395	939	-	NM_147005	73720053	73720992	1
chr11	73753749	73754727	Olfr23	978	+	NM_010970	73753749	73754727	1
chr11	73778111	73779059	Olfr397	948	+	NM_146346	73778111	73779059	1
chr11	73797163	73798108	Olfr398	945	-	NM_146710	73797163	73798108	1
chr11	73857826	73858774	Olfr139	948	-	NM_147003	73857826	73858774	1
chr11	73867277	73868280	Olfr399	1003	-	NM_147004	73867323	73868259	1
chr11	73883671	73900803	Zfp616	17132	+	NM_001177570	73896408	73899372	4
chr11	73934792	73935740	Olfr401	948	+	NM_146706	73934792	73935740	1
chr11	73968657	73969605	Olfr402	948	+	NM_146708	73968657	73969605	1
chr11	74009006	74009948	Olfr403	942	+	NM_207622	74009006	74009948	1
chr11	74019699	74020791	Olfr43	1092	-	NM_146711	74019774	74020716	1
chr11	74082892	74083864	Olfr406	972	+	NM_001011863	74082892	74083864	1
chr11	74097310	74103148	Olfr59	5838	+	NM_011002	74102149	74103121	2
chr11	74147783	74148731	Olfr410	948	-	NM_146707	74147783	74148731	1
chr11	74160125	74161174	Olfr411	1049	-	NM_146709	74160136	74161084	1
chr11	74178172	74179111	Olfr412	939	+	NM_001011851	74178172	74179111	1
chr11	74196984	74403660	Rap1gap2	206676	-	NM_001015046	74201850	74380740	25
chr11	74433106	74455018	E130309D14Rik	21912	+	NM_001013784	74433263	74452073	4
chr11	74462996	74484349	Cluh	21353	+	NM_001081158	74463096	74483112	26
chr11	74487450	74537886	Pafah1b1	50436	-	NM_013625	74491170	74512844	11
chr11	74584364	74632194	Mettl16	47830	+	NM_026197	74587023	74631260	10
chr11	74644425	74659227	Mnt	14802	+	NM_010813	74644830	74656822	6
chr11	74662765	74710582	Sgsm2	47817	-	NM_197943	74664308	74710383	23
chr11	74681628	74681696	Mir6926	68	-	NR_105891	74681696	74681696	1
chr11	74711581	74722842	Tsr1	11261	+	NM_177325	74711620	74721908	15
chr11	74718947	74719007	Snord91a	60	+	NR_028562	74719007	74719007	1
chr11	74719860	74739300	Srr	19440	-	NM_013761	74722129	74726631	9
chr11	74739373	74977950	Smg6	238577	+	NM_001002764	74739417	74976452	19
chr11	74978066	74983757	Hic1	5691	-	NM_010430	74978881	74983021	2
chr11	74986889	74986980	Mir212	91	+	NR_029794	74986980	74986980	1
chr11	74987183	74987249	Mir132	66	+	NR_029546	74987249	74987249	1
chr11	74989444	74992310	Ovca2	2866	-	NM_027136	74991395	74992297	2
chr11	74991144	75003985	Dph1	12841	-	NM_144491	74992443	75003961	13
chr11	75007494	75081264	Rtn4rl1	73770	+	NM_177708	75007783	75079583	2
chr11	75113760	75161885	Rpa1	48125	-	NM_001164223	75114806	75161760	18
chr11	75161934	75219207	Smyd4	57273	+	NM_001102611	75163182	75218421	11
chr11	75223530	75236125	Serpinf1	12595	-	NM_011340	75223635	75231491	8
chr11	75245237	75253003	Serpinf2	7766	-	NM_008878	75245904	75251956	10
chr11	75254444	75268219	Wdr81	13775	-	NM_138950	75255270	75267941	10
chr11	75275040	75280192	Mir22hg	5152	+	NR_030711	75280192	75280192	3
chr11	75277217	75277312	Mir22	95	+	NR_029739	75277312	75277312	1
chr11	75281551	75284401	Tlcd2	2850	+	NM_001291156	75281706	75283982	5
chr11	75300278	75322949	Prpf8	22671	+	NM_138659	75300593	75322791	42
chr11	75323595	75326668	Rilp	3073	+	NM_001029938	75323649	75326345	8
chr11	75327042	75340082	Scarf1	13040	+	NM_001004157	75327079	75339698	11
chr11	75345195	75391074	Slc43a2	45879	+	NM_001199284	75346130	75385978	14
chr11	75364930	75365013	Mir3971	83	+	NR_039553	75365013	75365013	1
chr11	75401580	75442306	Pitpna	40726	+	NM_008850	75401834	75439011	12
chr11	75413145	75413733	Gm12338	588	-	NR_110477	75413733	75413733	1
chr11	75444521	75462367	Inpp5k	17846	+	NM_008916	75444601	75461213	12
chr11	75465010	75488136	Myo1c	23126	+	NM_008659	75471023	75486138	32
chr11	75492760	75521930	Crk	29170	+	NM_133656	75492925	75517005	3
chr11	75546388	75579343	Ywhae	32955	+	NM_009536	75546529	75578174	6
chr11	75581773	75609562	Doc2b	27789	-	NM_007873	75585433	75609395	9
chr11	75644493	75724561	Rph3al	80068	-	NM_029548	75645681	75724528	8
chr11	75813413	75817071	1700016K19Rik	3658	+	NM_198637	75813563	75816987	2
chr11	75832696	75841284	Fam101b	8588	-	NM_029658	75835411	75841139	3
chr11	75859727	75993132	Vps53	133405	-	NM_026664	75859913	75993001	22
chr11	76015557	76021759	Fam57a	6202	+	NM_027773	76015635	76021681	5
chr11	76024072	76031074	Gemin4	7002	-	NM_177367	76024258	76030989	2
chr11	76031114	76032167	Dbil5	1053	+	NM_021294	76031773	76032037	2
chr11	76033896	76057201	Glod4	23305	-	NM_026029	76035467	76057146	9
chr11	76057237	76064124	Rnmtl1	6887	+	NM_183263	76057274	76063926	4
chr11	76070727	76212643	Nxn	141916	-	NM_008750	76072066	76212562	8
chr11	76220426	76229815	Timm22	9389	+	NM_001291161	76220566	76227624	4
chr11	76230233	76391241	Abr	161008	-	NM_198894	76232605	76322497	23
chr11	76485971	76487178	Bhlha9	1207	+	NM_177182	76486050	76486746	1
chr11	76493374	76512166	Tusc5	18792	+	NM_177709	76493661	76509738	3
chr11	76540103	76577057	Gosr1	36954	-	NM_016810	76543610	76577052	9
chr11	76590709	76660510	Cpd	69801	-	NM_007754	76595685	76660468	21
chr11	76718046	76730088	Tmigd1	12042	+	NM_025655	76718069	76729531	6
chr11	76759157	76800891	Blmh	41734	+	NM_178645	76759382	76800129	12
chr11	76812098	76845845	Slc6a4	33747	+	NM_010484	76823942	76845179	14
chr11	76857793	76891939	Nsrp1	34146	-	NM_001012309	76859241	76891900	7
chr11	76891565	76891674	Mir423	109	-	NR_030756	76891674	76891674	1
chr11	76903416	77002470	Efcab5	99054	-	NM_176965	76903799	77002420	18
chr11	77029926	77273721	Ssh2	243795	+	NM_177710	77029954	77268982	15
chr11	77277414	77283003	Coro6	5589	+	NM_139130	77277414	77283003	10
chr11	77283988	77303180	Ankrd13b	19192	-	NM_172945	77285107	77303054	16
chr11	77306913	77321276	Git1	14363	+	NM_001004144	77307084	77320110	20
chr11	77321600	77326775	Trp53i13	5175	-	NM_001024920	77321766	77326733	7
chr11	77328618	77334130	Abhd15	5512	+	NM_026185	77328700	77332343	2
chr11	77342663	77421317	Taok1	78654	-	NM_144825	77351368	77398906	20
chr11	77499640	77531468	Nufip2	31828	+	NM_001024205	77499729	77523237	4
chr11	77532115	77538795	Cryba1	6680	-	NM_009965	77532256	77538783	6
chr11	77590736	77679490	Myo18a	88754	+	NM_001291212	77590817	77678337	41
chr11	77694116	77707374	Pipox	13258	-	NM_008952	77694625	77707282	8
chr11	77725628	77742790	Gm11190	17162	-	NR_033549	77742790	77742790	3
chr11	77744340	77792554	Sez6	48214	+	NM_021286	77744561	77791547	17
chr11	77796317	77844037	Phf12	47720	+	NM_174852	77796813	77843153	15
chr11	77845814	77851366	Dhrs13	5552	+	NM_183286	77845873	77850812	5
chr11	77851442	77873934	Flot2	22492	+	NM_008028	77868302	77872735	12
chr11	77886506	77886572	Mir144	66	+	NR_029556	77886572	77886572	1
chr11	77886671	77886743	Mir451a	72	+	NR_029971	77886743	77886743	1
chr11	77886671	77886743	Mir451b	72	-	NR_105850	77886743	77886743	1
chr11	77886877	77893885	Eral1	7008	-	NM_022313	77887553	77893861	10
chr11	77908174	77970841	Fam222b	62667	+	NM_145430	77956634	77968805	3
chr11	77971924	77979052	Traf4	7128	-	NM_009423	77973417	77978942	7
chr11	77979607	77990168	Nek8	10561	-	NM_080849	77980250	77990108	15
chr11	77991650	77994321	Tlcd1	2671	+	NM_001291237	77992580	77993832	5
chr11	77992328	77992389	Mir7653	61	+	NR_106113	77992389	77992389	1
chr11	77994436	77997086	Rpl23a	2650	-	NM_207523	77994484	77997045	5
chr11	77994803	77994848	Snord42a	45	-	NR_037682	77994848	77994848	1
chr11	77995188	77995258	Snord4a	70	-	NR_030702	77995258	77995258	1
chr11	77996560	77996615	Snord42b	55	-	NR_037683	77996615	77996615	1
chr11	78001928	78005695	Rab34	3767	+	NM_001159482	78002838	78005343	11
chr11	78006893	78019265	Proca1	12372	+	NM_001045516	78017664	78018969	4
chr11	78020250	78059205	Supt6	38955	-	NM_009297	78021084	78047155	37
chr11	78059247	78068998	Sdf2	9751	+	NM_009143	78059497	78068640	3
chr11	78075255	78104127	2610507B11Rik	28872	+	NM_001002004	78075351	78103485	39
chr11	78104342	78110307	BC030499	5965	+	NM_001287206	78104384	78108322	12
chr11	78115092	78135956	Spag5	20864	+	NM_017407	78115161	78135701	24
chr11	78136574	78141280	Aldoc	4706	+	NM_001303423	78137903	78139856	9
chr11	78141923	78156278	Pigs	14355	+	NM_201406	78141976	78155511	12
chr11	78156996	78162666	Unc119	5670	+	NM_011676	78157068	78162145	5
chr11	78171078	78200110	Foxn1	29032	-	NM_008238	78172252	78185440	9
chr11	78207986	78219159	Slc13a2os	11173	+	NR_003282	78219159	78219159	5
chr11	78210777	78235687	Slc13a2	24910	-	NM_022411	78211189	78235669	12
chr11	78279202	78285447	Slc46a1	6245	+	NM_026740	78279279	78284930	5
chr11	78285831	78311256	Sarm1	25425	-	NM_001168521	78288404	78310960	9
chr11	78312621	78315827	Vtn	3206	+	NM_011707	78312851	78315749	8
chr11	78317014	78318584	Sebox	1570	+	NM_008759	78317051	78317908	3
chr11	78320556	78325670	Tmem199	5114	-	NM_199199	78321211	78325609	6
chr11	78325797	78336238	Poldip2	10441	+	NM_026389	78325813	78335410	11
chr11	78336351	78349762	Tnfaip1	13411	-	NM_009395	78338806	78343734	7
chr11	78349937	78354975	Ift20	5038	+	NM_018854	78352337	78354944	6
chr11	78355318	78364237	Tmem97	8919	-	NM_133706	78356038	78364155	3
chr11	78380669	78510927	Nlk	130258	-	NM_008702	78382422	78509768	11
chr11	78564007	78565231	Fam58b	1224	-	NM_197989	78564411	78565164	1
chr11	78640096	78657401	Lyrm9	17305	+	NM_001076681	78649534	78652642	4
chr11	78734288	78773728	Nos2	39440	+	NM_010927	78735769	78773254	27
chr11	78776480	78798426	Lgals9	21946	-	NM_010708	78776896	78798318	11
chr11	78828302	78959856	Ksr1	131554	-	NM_013571	78829686	78959781	18
chr11	78837098	78848507	Gm11201	11409	+	NR_045873	78848507	78848507	6
chr11	79052883	79068197	Wsb1	15314	-	NM_019653	79053804	79067894	9
chr11	79153393	79395111	Nf1	241718	+	NM_010897	79153501	79391898	58
chr11	79295224	79297533	AU040972	2309	-	NR_045305	79297533	79297533	4
chr11	79314483	79317584	Omg	3101	-	NM_019409	79315200	79317407	2
chr11	79326886	79337264	Evi2b	10378	-	NM_001077496	79328914	79330249	2
chr11	79326886	79344111	Gm21975	17225	-	NM_146023	79328914	79330249	4
chr11	79340062	79344111	Evi2a	4049	-	NM_010161	79340612	79341284	2
chr11	79404713	79507514	Rab11fip4	102801	+	NM_175543	79404777	79506341	15
chr11	79420580	79436665	Rab11fip4os1	16085	-	NR_003283	79436665	79436665	3
chr11	79483874	79488588	Rab11fip4os2	4714	-	NR_045898	79488588	79488588	3
chr11	79525470	79525536	Mir193a	66	+	NR_029579	79525536	79525536	1
chr11	79539901	79540013	Mir365-2	112	+	NR_029959	79540013	79540013	1
chr11	79747457	79775889	Utp6	28432	-	NM_144826	79749456	79775811	19
chr11	79806607	79847625	Suz12	41018	+	NM_199196	79806821	79845692	16
chr11	79859994	79894493	Crlf3	34499	-	NM_018776	79860982	79894414	8
chr11	79902901	79949293	Atad5	46392	+	NM_001029856	79903272	79947873	23
chr11	79950179	79955655	Tefm	5476	-	NM_183275	79950337	79955621	4
chr11	79967663	79992329	Adap2	24666	+	NM_172133	79967717	79991932	11
chr11	79997373	80013255	Rnf135	15882	+	NM_028019	79997418	80012595	5
chr11	80022556	80081409	Rhot1	58853	+	NM_001163355	80022749	80079361	20
chr11	80114413	80169488	Rhbdl3	55075	+	NM_139228	80114662	80167185	9
chr11	80173993	80191517	5730455P16Rik	17524	-	NM_027472	80177313	80191483	10
chr11	80196780	80219375	Zfp207	22595	+	NR_045038	80219375	80219375	17
chr11	80242116	80285635	Psmd11	43519	+	NM_178616	80242166	80285096	14
chr11	80290547	80294681	Cdk5r1	4134	+	NM_009871	80291010	80291934	1
chr11	80295628	80593527	Myo1d	297899	-	NM_177390	80297727	80593294	22
chr11	80320911	80322608	C030013C21Rik	1697	-	NR_126552	80322608	80322608	3
chr11	80623916	80635535	Tmem98	11619	+	NM_029537	80626060	80634921	7
chr11	80663882	80671802	4930507D10Rik	7920	-	NR_110449	80671802	80671802	3
chr11	80671890	80681316	Spaca3	9426	+	NM_029367	80676540	80681206	5
chr11	80693666	81781898	Asic2	1088232	-	NM_001034013	80694558	81781686	10
chr11	81386003	81387041	1700071K01Rik	1038	-	NM_001033765	81386159	81386975	1
chr11	81674178	81708084	5530401A14Rik	33906	+	NR_038010	81708084	81708084	5
chr11	81849078	81850954	Ccl2	1876	+	NM_011333	81849163	81850680	3
chr11	81859213	81861025	Ccl7	1812	+	NM_013654	81859285	81860592	3
chr11	81871333	81876457	Ccl11	5124	+	NM_011330	81871468	81875813	3
chr11	81915346	81916901	Ccl12	1555	+	NM_011331	81915401	81916735	3
chr11	81928686	81930301	Ccl8	1615	+	NM_021443	81928738	81930136	3
chr11	81990167	81993314	Ccl1	3147	-	NM_011329	81990325	81993246	3
chr11	82202401	82259863	Tmem132e	57462	+	NM_001304439	82202548	82258820	9
chr11	82446854	82449811	Gm11426	2957	+	NR_033582	82449811	82449811	3
chr11	82532749	82577823	Cct6b	45074	-	NM_009839	82532863	82577729	14
chr11	82577846	82581124	Zfp830	3278	+	NM_025884	82577873	82578965	1
chr11	82593104	82594544	Gm11423	1440	-	NR_126067	82594544	82594544	3
chr11	82594610	82617776	Lig3	23166	+	NM_010716	82596851	82615016	20
chr11	82617320	82684712	Rffl	67392	-	NM_001164569	82619509	82659350	8
chr11	82685463	82704126	Rad51d	18663	-	NM_001277939	82686054	82703921	10
chr11	82705646	82714239	Fndc8	8593	+	NM_030224	82705696	82713174	4
chr11	82714269	82721897	Nle1	7628	-	NM_145431	82714539	82721858	13
chr11	82724754	82756908	Unc45b	32154	+	NM_178680	82725181	82756253	20
chr11	82755842	82774183	Slfn5os	18341	-	NR_045932	82774183	82774183	3
chr11	82765603	82778352	Slfn5	12749	+	NM_183201	82769792	82775206	6
chr11	82793804	82805332	Slfn9	11528	-	NM_172796	82794677	82801803	5
chr11	82798504	82798567	Mir7679	63	-	NR_106144	82798567	82798567	1
chr11	82815659	82834312	Slfn8	18653	-	NM_181545	82816580	82831217	6
chr11	82841629	82854035	Slfn10-ps	12406	-	NR_073524	82854035	82854035	5
chr11	82878613	82884180	Slfn2	5567	+	NM_011408	82878795	82883835	2
chr11	82930346	82936161	Slfn1	5815	+	NM_011407	82934561	82935575	2
chr11	82988687	83003718	Slfn4	15031	+	NM_011410	82998811	83002796	8
chr11	83004831	83028656	Slfn3	23825	+	NM_011409	83026175	83028603	3
chr11	83037077	83040086	AI662270	3009	+	NR_015519	83040086	83040086	4
chr11	83088613	83100228	Slfn14	11615	-	NM_001166028	83089489	83097665	5
chr11	83105200	83108139	AA465934	2939	+	NR_028363	83108139	83108139	3
chr11	83106931	83108431	AI450353	1500	+	NR_028364	83108431	83108431	1
chr11	83107805	83107901	Snord7	96	+	NR_028362	83107901	83107901	1
chr11	83108146	83112479	Pex12	4333	-	NM_134025	83109542	83111943	4
chr11	83116198	83218535	Ap2b1	102337	+	NM_001035854	83121739	83216146	22
chr11	83223573	83234540	Rasl10b	10967	+	NM_001013386	83226120	83232332	4
chr11	83235136	83243023	Gas2l2	7887	-	NM_001013759	83235403	83242930	6
chr11	83251195	83254734	1700020L24Rik	3539	+	NM_025492	83251246	83254424	3
chr11	83255377	83276463	Mmp28	21086	-	NM_080453	83256052	83276360	8
chr11	83286609	83320242	Taf15	33633	+	NM_027427	83286701	83319959	16
chr11	83325180	83335601	Heatr9	10421	-	NM_001045543	83325263	83335538	15
chr11	83339280	83344020	Ccl5	4740	-	NM_013653	83339478	83343963	3
chr11	83386418	83392138	Ccl9	5720	-	NM_011338	83388885	83391966	4
chr11	83395562	83437195	E230016K23Rik	41633	+	NR_036453	83437195	83437195	9
chr11	83401387	83406589	Ccl6	5202	-	NM_009139	83402326	83406443	4
chr11	83461344	83462880	Ccl3	1536	-	NM_011337	83461754	83462779	3
chr11	83476085	83478185	Ccl4	2100	+	NM_013652	83476164	83477883	3
chr11	83517557	83519771	Wfdc17	2214	+	NM_001081957	83517593	83518444	3
chr11	83522505	83524862	Wfdc18	2357	+	NM_007969	83522619	83523501	3
chr11	83560441	83566148	Wfdc21	5707	+	NM_183249	83560528	83562829	3
chr11	83567138	83597256	Heatr6	30118	+	NM_145432	83567224	83595224	20
chr11	83664370	83719419	Hnf1b	55049	+	NM_001291268	83664550	83718433	9
chr11	83755591	83776588	Ddx52	20997	+	NM_030096	83755679	83775309	15
chr11	83777932	83858078	Synrg	80146	+	NM_194341	83777977	83854430	20
chr11	83861546	83881859	Dusp14	20313	-	NM_019819	83862118	83862715	3
chr11	83892421	83943070	Tada2a	50649	-	NM_172562	83893093	83940514	16
chr11	83961864	83980978	Gm11437	19114	-	NM_001037932	83962126	83980886	7
chr11	84008939	84215153	Acaca	206214	+	NM_133360	84008965	84213185	54
chr11	84236357	84327003	Aatf	90646	-	NM_019816	84236457	84326884	13
chr11	84332880	84339036	Lhx1	6156	-	NM_008498	84333050	84337677	5
chr11	84339161	84349333	Lhx1os	10172	+	NR_038057	84349333	84349333	4
chr11	84530477	84533934	1700109G15Rik	3457	-	NR_046197	84533934	84533934	3
chr11	84626562	84633017	Mrm1	6455	-	NM_145433	84627933	84632874	5
chr11	84634229	84642505	Dhrs11	8276	-	NM_177564	84634761	84642399	7
chr11	84642679	84644370	4930502E09Rik	1691	+	NR_046281	84644370	84644370	3
chr11	84645862	84684240	Ggnbp2	38378	-	NM_153144	84646511	84683471	14
chr11	84683506	84685133	Ggnbp2os	1627	+	NR_131201	84685133	84685133	2
chr11	84689814	84693787	Pigw	3973	-	NM_001077636	84690491	84692003	2
chr11	84693721	84724633	Myo19	30912	+	NM_025414	84696217	84724023	25
chr11	84724456	84729858	Znhit3	5402	-	NM_001005223	84724968	84729843	5
chr11	84771255	84779556	Car4	8301	+	NM_007607	84771388	84779307	8
chr11	84797989	84953457	Usp32	155468	-	NM_001029934	84799911	84953270	34
chr11	84984597	84994656	1700125H20Rik	10059	+	NM_028589	84984678	84994473	6
chr11	85004811	85048622	Appbp2	43811	-	NM_025825	85005147	85048311	13
chr11	85048667	85051806	Appbp2os	3139	+	NR_028329	85051806	85051806	4
chr11	85124755	85160573	Ppm1d	35818	+	NM_016910	85124974	85159695	6
chr11	85166665	85639560	Bcas3	472895	+	NM_138681	85168394	85638852	26
chr11	85515701	85533246	Bcas3os1	17545	-	NR_045875	85533246	85533246	6
chr11	85574117	85574204	Mir5110	87	-	NR_039570	85574204	85574204	1
chr11	85580334	85589182	Bcas3os2	8848	-	NR_046194	85589182	85589182	3
chr11	85605161	85645890	2610027K06Rik	40729	-	NR_077059	85645890	85645890	5
chr11	85646116	85655450	Tbx2	9334	+	NM_009324	85646608	85654516	7
chr11	85703564	85729599	Tbx4	26035	+	NM_011536	85703564	85728247	8
chr11	85816159	85837852	Gm20759	21693	-	NR_046030	85837852	85837852	5
chr11	85871637	86014695	Brip1	143058	-	NM_178309	85874930	86012466	20
chr11	86014861	86117945	Brip1os	103084	+	NR_130959	86117945	86117945	7
chr11	86024184	86071070	Ints2	46886	-	NM_027421	86026133	86069820	25
chr11	86079216	86171027	Med13	91811	-	NM_001080931	86084487	86171027	30
chr11	86298158	86312509	Rnft1	14351	+	NM_029788	86299613	86309457	9
chr11	86312512	86358309	Rps6kb1	45797	-	NM_001114334	86316226	86358208	15
chr11	86358492	86380862	Tubd1	22370	+	NM_001199046	86362332	86380647	10
chr11	86397366	86497324	Vmp1	99958	-	NM_029478	86398809	86479354	12
chr11	86397568	86397660	Mir21a	92	-	NR_029738	86397660	86397660	1
chr11	86497582	86505959	Ptrh2	8377	+	NM_001098810	86503060	86503606	2
chr11	86508154	86570994	Cltc	62840	-	NM_001003908	86509067	86570791	32
chr11	86582350	86621162	Dhx40	38812	-	NM_026191	86583623	86621051	18
chr11	86749926	86807264	Ypel2	57338	-	NM_001005341	86754100	86785427	5
chr11	86847295	86887639	Gdpd1	40344	-	NM_025638	86848674	86887479	10
chr11	86891233	86900279	Smg8	9046	-	NM_024262	86891454	86900255	4
chr11	86902657	86922216	Prr11	19559	-	NM_175563	86905298	86919638	10
chr11	86922762	86936476	Ska2	13714	+	NM_025377	86922773	86935501	4
chr11	86926505	86926591	Mir301	86	+	NR_029652	86926591	86926591	1
chr11	86940576	87034188	Trim37	93612	+	NM_197987	86940975	87031836	24
chr11	87040407	87172496	Ppm1e	132089	-	NM_177167	87044381	87172405	7
chr11	87191108	87218456	Rad51c	27348	-	NM_001291440	87192887	87218268	9
chr11	87218566	87369325	Tex14	150759	+	NM_031386	87247311	87369022	31
chr11	87391890	87404041	Sept4	12151	+	NM_001284398	87392036	87403529	11
chr11	87405718	87429798	Mtmr4	24080	+	NM_133215	87406932	87427755	19
chr11	87430665	87473044	Hsf5	42379	+	NM_001045527	87430773	87470869	6
chr11	87476588	87549041	Rnf43	72453	+	NM_172448	87478117	87547701	10
chr11	87513025	87518829	1110028F11Rik	5804	+	NR_045139	87518829	87518829	2
chr11	87551066	87557119	Supt4a	6053	+	NM_009296	87551101	87556815	5
chr11	87570342	87570457	Mir142b	115	-	NR_106176	87570457	87570457	1
chr11	87570365	87570429	Mir142	64	+	NR_029555	87570429	87570429	1
chr11	87574042	87599430	Bzrap1	25388	+	NM_172449	87574903	87596191	32
chr11	87607285	87617914	Mpo	10629	+	NM_010824	87608040	87617104	14
chr11	87619929	87639616	Lpo	19687	-	NM_080420	87620348	87635776	13
chr11	87666726	87677181	Mks1	10455	+	NM_001039684	87666751	87676527	18
chr11	87677499	87689038	Epx	11539	-	NM_007946	87678207	87688916	13
chr11	87702460	87703396	Olfr462	936	-	NM_146411	87702460	87703396	1
chr11	87706488	87707424	Olfr463	936	-	NM_146413	87706488	87707424	1
chr11	87727421	87728505	Olfr464	1084	-	NM_146412	87727464	87728406	1
chr11	87793026	87811800	Dynll2	18774	-	NM_001168471	87794934	87797505	3
chr11	87860874	87867259	Srsf1	6385	+	NM_173374	87861340	87863108	4
chr11	87881780	87898231	Vezf1	16451	+	NM_016686	87881902	87895327	6
chr11	87911559	87913609	2210416O15Rik	2050	+	NR_045499	87913609	87913609	4
chr11	87912647	88007642	Cuedc1	94995	+	NM_198013	87983334	88003624	11
chr11	88007607	88025009	Mrps23	17402	+	NM_001291270	88018703	88024265	5
chr11	88107544	88108763	Ccdc182	1219	+	NM_028859	88107597	88108056	1
chr11	88152883	88579543	Msi2	426660	-	NM_054043	88160585	88579404	14
chr11	88166274	88166366	Mir378b	92	+	NR_039545	88166366	88166366	1
chr11	88480564	88484740	0610039H22Rik	4176	+	NR_131025	88484740	88484740	3
chr11	88579956	88589886	C030037D09Rik	9930	+	NR_038058	88589886	88589886	4
chr11	88692105	88725900	Akap1	33795	-	NM_001042541	88693068	88707148	11
chr11	88712917	88742709	4930556N13Rik	29792	+	NR_126433	88742709	88742709	5
chr11	88767241	88797375	Scpep1os	30134	+	NR_045955	88797375	88797375	5
chr11	88785333	88816756	Scpep1	31423	-	NM_029023	88785975	88816683	13
chr11	88825980	88828231	Gm15698	2251	-	NR_003564	88828231	88828231	2
chr11	88833951	88834328	2210409E12Rik	377	+	NR_003492	88834328	88834328	1
chr11	88835248	88852927	Coil	17679	+	NM_016706	88835262	88852056	7
chr11	88860716	88881607	Trim25	20891	+	NM_009546	88860802	88878035	9
chr11	88898895	88922062	Dgke	23167	-	NM_019505	88902045	88921699	11
chr11	88922064	88929198	Dgkeos	7134	+	NR_110336	88929198	88929198	4
chr11	88935154	88954378	Gm525	19224	+	NM_001033266	88935264	88949986	4
chr11	89161951	89163873	Nog	1922	-	NM_008711	89162635	89163334	1
chr11	89251536	89280262	4932411E22Rik	28726	-	NM_172534	89252921	89280194	4
chr11	89282399	89399869	Ankfn1	117470	-	NM_001080933	89282399	89399869	15
chr11	89843857	89864208	Pctp	20351	-	NM_008796	89846004	89864156	6
chr11	89891661	89897819	Tmem100	6158	+	NM_026433	89896662	89897067	3
chr11	90110789	90139887	Mmd	29098	+	NM_026178	90111023	90138177	7
chr11	90197848	90252231	Hlf	54383	-	NM_172563	90202072	90251678	4
chr11	90337806	90499422	Stxbp4	161616	-	NM_011505	90341913	90483015	18
chr11	90499497	90507291	Cox11	7794	+	NM_199008	90499503	90505866	4
chr11	90507004	90548915	Tom1l1	41911	-	NM_028011	90508149	90536124	16
chr11	90666004	90756466	4930405D11Rik	90462	+	NR_045956	90756466	90756466	3
chr11	91436599	91438869	Kif2b	2270	-	NM_028547	91436762	91438769	1
chr11	92960603	93463065	Car10	502462	+	NM_028296	92961539	93461652	9
chr11	93720556	93747080	Utp18	26524	-	NM_001013375	93722126	93746971	14
chr11	93747532	93808298	Mbtd1	60766	+	NM_134012	93766518	93805207	16
chr11	93811127	93817570	Nme2	6443	-	NM_008705	93811242	93816934	5
chr11	93820238	93829835	Nme1	9597	-	NM_008704	93820709	93827247	5
chr11	93857404	93987396	Spag9	129992	+	NM_001199203	93857584	93984151	30
chr11	94072767	94076806	Tob1	4039	+	NM_009427	94074953	94076042	2
chr11	94097265	94103893	Wfikkn2	6628	-	NM_181819	94098911	94103863	2
chr11	94152452	94183225	Luc7l3	30773	-	NM_026313	94154149	94183102	11
chr11	94189314	94203161	Ankrd40	13847	+	NM_027799	94189567	94201013	5
chr11	94204608	94254290	Abcc3	49682	-	NM_029600	94204980	94254229	31
chr11	94269704	94335512	Cacna1g	65808	-	NM_009783	94270458	94334931	36
chr11	94340217	94346624	Spata20	6407	-	NM_144827	94340409	94346600	16
chr11	94350912	94361288	Epn3	10376	-	NM_027984	94352464	94357856	10
chr11	94362660	94382816	Mycbpap	20156	-	NM_170671	94362732	94382759	19
chr11	94401111	94410521	Rsad1	9410	-	NM_001013381	94403843	94410431	9
chr11	94418415	94463100	Acsf2	44685	-	NM_153807	94419620	94463084	16
chr11	94426387	94430441	Chad	4054	+	NM_007689	94426411	94429664	4
chr11	94491137	94506530	Lrrc59	15393	+	NM_133807	94491318	94504855	7
chr11	94506315	94515068	Eme1	8753	-	NM_177752	94506742	94512308	9
chr11	94515104	94521401	Mrpl27	6297	+	NM_053161	94515115	94521129	4
chr11	94525160	94538807	Xylt2	13647	-	NM_145828	94525900	94538721	11
chr11	94555811	94565813	Gm11541	10002	-	NM_001007584	94556906	94565554	2
chr11	94616449	94622496	Gm11545	6047	-	NM_001105561	94618367	94622225	5
chr11	94638530	94693316	Tmem92	54786	-	NM_001163172	94639960	94693048	5
chr11	94706144	94710907	Gm11544	4763	-	NM_001205037	94706750	94710639	5
chr11	94797537	94814356	Col1a1	16819	+	NM_007742	94797682	94812933	51
chr11	94824090	94837641	Sgca	13551	-	NM_009161	94824532	94834752	11
chr11	94828906	94829770	Hils1	864	+	NM_018792	94829194	94829707	1
chr11	94852525	94868212	Ppp1r9b	15687	+	NM_172261	94852861	94866672	10
chr11	94871192	94887401	Samd14	16209	+	NM_146025	94875677	94886047	10
chr11	94887571	94902685	Pdk2	15114	-	NM_133667	94888495	94902570	11
chr11	94905788	94938125	Itga3	32337	-	NM_001306162	94906921	94937650	26
chr11	94981430	94986605	Dlx3	5175	+	NM_010055	94981635	94985070	3
chr11	95001760	95007115	Dlx4	5355	-	NM_007867	95002537	95006795	3
chr11	95006366	95020361	Dlx4os	13995	+	NR_040279	95020361	95020361	3
chr11	95122842	95130575	Tac4	7733	+	NM_053093	95123013	95129886	4
chr11	95133166	95171560	Kat7	38394	-	NM_001195003	95137099	95171363	15
chr11	95198331	95243186	Fam117a	44855	+	NM_172543	95198379	95242273	8
chr11	95246235	95252966	Slc35b1	6731	+	NM_016752	95246323	95252854	9
chr11	95275396	95354724	Spop	79328	+	NM_025287	95331901	95353155	11
chr11	95371159	95375879	Nxph3	4720	-	NM_130858	95372141	95375527	2
chr11	95430139	95449012	Ngfr	18873	-	NM_033217	95432116	95448872	6
chr11	95528270	95542087	Phb	13817	+	NM_008831	95529377	95541220	7
chr11	95561419	95574068	Zfp652os	12649	-	NR_045780	95574068	95574068	2
chr11	95584899	95588087	B130006D01Rik	3188	+	NR_028263	95588087	95588087	1
chr11	95610380	95626027	Zfp652	15647	+	NM_201609	95610564	95625373	5
chr11	95685813	95693454	Phospho1	7641	+	NM_153104	95690044	95692623	3
chr11	95691385	95703790	Abi3	12405	-	NM_001163464	95694026	95698518	8
chr11	95703608	95707045	Gngt2	3437	+	NM_001284393	95706370	95706922	4
chr11	95720130	95722360	4833417C18Rik	2230	+	NR_045187	95722360	95722360	2
chr11	95724872	95776185	B4galnt2	51313	-	NM_008081	95727384	95776144	11
chr11	95818477	95867258	Igf2bp1	48781	-	NM_009951	95824813	95866947	15
chr11	95824605	95824697	Mir3063	92	-	NR_037223	95824697	95824697	1
chr11	95885858	95892142	Gip	6284	+	NM_008119	95886689	95892030	6
chr11	95896230	95908719	Snf8	12489	+	NM_033568	95896327	95908646	8
chr11	95908749	95926678	Ube2z	17929	-	NM_172300	95911557	95926588	7
chr11	95934106	95937008	Atp5g1	2902	-	NM_007506	95934417	95936339	5
chr11	95960229	95973276	Calcoco2	13047	-	NM_001271018	95961227	95968909	6
chr11	95995099	96026766	Ttll6	31667	+	NM_172799	95995099	96020240	15
chr11	96055674	96057913	Hoxb13	2239	+	NM_008267	96055756	96057543	2
chr11	96064767	96066794	Gm11538	2027	+	NR_108029	96066794	96066794	2
chr11	96112973	96125798	Gm53	12825	+	NR_037977	96125798	96125798	3
chr11	96126477	96126579	Mir196a-1	102	+	NR_029721	96126579	96126579	1
chr11	96132643	96137907	Hoxb9	5264	+	NM_008270	96132855	96136173	2
chr11	96143218	96146639	Hoxb8	3421	+	NM_010461	96144276	96145784	2
chr11	96147959	96151477	Hoxb7	3518	+	NM_010460	96148041	96150944	2
chr11	96152350	96168224	Hoxb5os	15874	-	NR_131758	96168224	96168224	3
chr11	96160484	96162883	Hoxb6	2399	+	NM_008269	96160490	96162242	2
chr11	96164825	96167435	Hoxb5	2610	+	NM_008268	96164927	96166451	2
chr11	96178478	96178588	Mir10a	110	+	NR_029784	96178588	96178588	1
chr11	96179580	96182952	Hoxb4	3372	+	NM_010459	96180083	96181642	2
chr11	96184439	96209244	Hoxb3	24805	+	NM_001079869	96205562	96207713	4
chr11	96212945	96215328	Hoxb2	2383	+	NM_134032	96213124	96214943	2
chr11	96227071	96229567	Hoxb1	2496	+	NM_008266	96227140	96228453	2
chr11	96308212	96325861	Gm11529	17649	-	NR_033524	96325861	96325861	3
chr11	96325904	96620936	Skap1	295032	+	NM_001033186	96326018	96615446	13
chr11	96628862	96638869	Snx11	10007	-	NM_028965	96630359	96635796	9
chr11	96650449	96669954	Cbx1	19505	+	NM_007622	96662121	96668074	6
chr11	96656645	96659470	Gm11517	2825	-	NR_033523	96659470	96659470	2
chr11	96678727	96691282	Nfe2l1	12555	-	NM_008686	96680489	96689021	5
chr11	96711189	96722516	Copz2	11327	+	NM_019877	96711208	96722224	9
chr11	96711706	96711779	Mir152	73	+	NR_029562	96711779	96711779	1
chr11	96768738	96777828	Cdk5rap3	9090	-	NM_030248	96769370	96777703	14
chr11	96790637	96796961	Prr15l	6324	+	NM_146026	96795859	96796162	3
chr11	96799129	96805333	Pnpo	6204	-	NM_134021	96800228	96805182	7
chr11	96805459	96826374	D030028A08Rik	20915	+	NR_003293	96826374	96826374	6
chr11	96814651	96839002	Sp2	24351	-	NM_001080964	96815783	96838941	7
chr11	96874882	96886052	Sp6	11170	+	NM_031183	96882776	96883907	2
chr11	96881821	96887732	Gm11532	5911	-	NR_133649	96887732	96887732	2
chr11	96891265	96895274	Scrn2	4009	+	NM_146027	96891729	96895138	8
chr11	96895915	96902683	Lrrc46	6768	-	NM_027026	96895976	96902418	8
chr11	96902899	96910527	Mrpl10	7628	+	NM_026154	96902914	96909649	5
chr11	96911941	96930218	Osbpl7	18277	+	NM_001310509	96911966	96929364	23
chr11	96925081	96925188	Mir8103	107	+	NR_106181	96925188	96925188	1
chr11	96959320	96976645	Tbx21	17325	-	NM_019507	96960085	96976451	6
chr11	96997484	97011026	Tbkbp1	13542	-	NM_198100	96998860	97010900	9
chr11	97007677	97007733	Mir7235	56	-	NR_106094	97007733	97007733	1
chr11	97021023	97049206	Kpnb1	28183	-	NM_008379	97023994	97048899	22
chr11	97067170	97141890	Npepps	74720	-	NM_008942	97068429	97141772	23
chr11	97177029	97191234	Mrpl45	14205	+	NM_025927	97177187	97189882	8
chr11	97193422	97213387	Gpr179	19965	-	NM_001081220	97195759	97213330	11
chr11	97223864	97259856	Socs7	35992	+	NM_138657	97223955	97251000	10
chr11	97311473	97363714	Arhgap23	52241	+	NM_021493	97312840	97362439	19
chr11	97352096	97361654	4933428G20Rik	9558	-	NM_001289118	97352322	97354088	3
chr11	97370653	97436440	Srcin1	65787	-	NM_018873	97373827	97436303	20
chr11	97459824	97484207	2410003L11Rik	24383	+	NR_045496	97484207	97484207	4
chr11	97488700	97491030	E130012A19Rik	2330	-	NM_175332	97489485	97490595	1
chr11	97524725	97546772	Mllt6	22047	+	NM_139311	97524885	97542901	20
chr11	97538373	97538444	Mir6927	71	+	NR_105892	97538444	97538444	1
chr11	97547265	97549939	Cisd3	2674	+	NM_001085500	97547415	97549761	3
chr11	97550136	97561811	Pcgf2	11675	-	NM_009545	97551300	97554841	13
chr11	97564747	97574814	Psmb3	10067	+	NM_011971	97564801	97574755	6
chr11	97576470	97606018	Pip4k2b	29548	-	NM_054051	97580172	97605918	10
chr11	97606210	97606349	Mir8102	139	+	NR_106180	97606349	97606349	1
chr11	97606783	97627927	Cwc25	21144	-	NM_026186	97608668	97627756	10
chr11	97632794	97637232	1700001P01Rik	4438	-	NM_028156	97632890	97637172	3
chr11	97638839	97643753	Rpl23	4914	-	NM_022891	97639395	97643670	5
chr11	97642952	97643080	Snora21	128	-	NR_028078	97643080	97643080	1
chr11	97660985	97700078	Lasp1	39093	+	NM_010688	97661107	97697559	7
chr11	97702093	97704357	B230217C12Rik	2264	+	NM_001080935	97702093	97703588	3
chr11	97715620	97745468	Fbxo47	29848	-	NM_001081435	97715689	97740878	11
chr11	97784550	97847760	Plxdc1	63210	-	NM_001163608	97785801	97847630	14
chr11	97850893	97857487	Arl5c	6594	-	NM_207231	97851604	97857177	6
chr11	97862821	97883941	Cacnb1	21120	-	NM_001282977	97864214	97883739	14
chr11	97888023	97891807	Rpl19	3784	+	NM_001159483	97889137	97891708	6
chr11	97897937	97914776	Stac2	16839	-	NM_146028	97899279	97914296	11
chr11	97943867	98010930	Fbxl20	67063	-	NM_028149	97950904	98010671	15
chr11	98013468	98054607	Med1	41139	-	NM_134027	98014408	98054397	18
chr11	98064618	98114854	Cdk12	50236	+	NM_001109628	98064681	98111703	14
chr11	98123919	98123976	Mir5119	57	+	NR_039579	98123976	98123976	1
chr11	98186730	98190959	Neurod2	4229	-	NM_010895	98188498	98189650	2
chr11	98209719	98219110	Ppp1r1b	9391	+	NM_144828	98210407	98218384	7
chr11	98212031	98219597	1700003D09Rik	7566	-	NR_045477	98219597	98219597	3
chr11	98219681	98242426	Stard3	22745	+	NM_021547	98233434	98241876	15
chr11	98245124	98246267	Tcap	1143	+	NM_011540	98245160	98245859	2
chr11	98247945	98249411	Pnmt	1466	+	NM_008890	98247945	98249411	3
chr11	98249985	98261804	Pgap3	11819	-	NM_001033537	98251351	98261709	8
chr11	98273797	98299030	Erbb2	25233	+	NM_001003817	98273976	98297982	27
chr11	98299021	98300302	Mien1	1281	-	NM_025559	98299375	98300260	4
chr11	98308147	98316687	Grb7	8540	+	NM_010346	98312084	98316319	15
chr11	98326006	98407345	Ikzf3	81339	-	NM_011771	98328299	98407064	8
chr11	98412410	98419979	Zpbp2	7569	+	NM_001166495	98413818	98419618	8
chr11	98442607	98448559	Ormdl3	5952	-	NM_025661	98444025	98445429	4
chr11	98459604	98460900	Lrrc3c	1296	+	NM_001195544	98460132	98460900	2
chr11	98487673	98499403	Gsdma3	11730	+	NM_001007461	98490665	98499403	11
chr11	98508072	98519271	Gsdma2	11199	+	NM_029727	98510367	98519069	11
chr11	98525664	98539022	Gsdma	13358	+	NM_021347	98527374	98537730	12
chr11	98543867	98557292	Psmd3	13425	+	NM_009439	98544043	98556914	12
chr11	98562626	98564943	Csf3	2317	+	NM_009971	98562693	98564274	5
chr11	98565904	98590749	Med24	24845	-	NM_011869	98566213	98590228	26
chr11	98603098	98630320	Thra	27222	+	NM_001313983	98614899	98629839	10
chr11	98629245	98636691	Nr1d1	7446	-	NM_145434	98629533	98636062	8
chr11	98657082	98669173	Msl1	12091	+	NM_028722	98657144	98666746	9
chr11	98659622	98671403	Gm12359	11781	-	NR_033551	98671403	98671403	3
chr11	98671121	98695121	Casc3	24000	+	NM_138660	98671177	98692880	14
chr11	98698098	98714319	Rapgefl1	16221	+	NM_001080925	98698467	98712514	15
chr11	98724911	98766892	Wipf2	41981	+	NM_197940	98746355	98760999	8
chr11	98769202	98785256	Cdc6	16054	+	NM_001025779	98769963	98782519	12
chr11	98799009	98836256	Rara	37247	+	NM_009024	98811931	98834951	9
chr11	98843493	98844330	Gjd3	837	-	NM_178596	98843493	98844330	1
chr11	98854260	98885503	Top2a	31243	-	NM_011623	98855117	98885380	36
chr11	98902573	98913957	Igfbp4	11384	+	NM_010517	98902810	98912893	4
chr11	98926991	98950620	Tns4	23629	-	NM_172564	98929494	98947407	13
chr11	99005512	99016391	Ccr7	10879	-	NM_007719	99006271	99016312	3
chr11	99070361	99092331	Smarce1	21970	-	NM_020618	99071382	99089817	11
chr11	99094411	99105381	Krt222	10970	-	NM_172946	99096232	99105352	6
chr11	99141406	99146552	Krt24	5146	-	NM_029393	99141525	99146521	8
chr11	99177157	99184255	Krt25	7098	-	NM_133730	99177417	99184205	8
chr11	99189797	99199279	Krt26	9482	-	NM_001033397	99190947	99199218	8
chr11	99206878	99212432	Krt27	5554	-	NM_010666	99207050	99212387	8
chr11	99226320	99236217	Krt28	9897	-	NM_027574	99226356	99236153	8
chr11	99246568	99250678	Krt10	4110	-	NM_010660	99246943	99250646	8
chr11	99276977	99283573	Krt12	6596	-	NM_010661	99277324	99283530	8
chr11	99289700	99299467	Krt20	9767	-	NM_023256	99290294	99299411	8
chr11	99339286	99354424	Krt23	15138	-	NM_033373	99339510	99354378	8
chr11	99375937	99382572	Krt39	6635	-	NM_213730	99375937	99382572	7
chr11	99398798	99404472	Krt40	5674	-	NM_001039666	99398798	99404472	7
chr11	99411445	99412177	Krtap3-3	732	-	NM_025524	99411823	99412123	1
chr11	99417136	99418167	Krtap3-2	1031	-	NM_025720	99417814	99418114	1
chr11	99427340	99427944	Krtap3-1	604	-	NM_023511	99427600	99427897	1
chr11	99441290	99442330	Krtap1-5	1040	-	NM_027157	99441910	99442279	1
chr11	99443862	99444991	Krtap1-4	1129	-	NM_001039502	99444375	99444942	1
chr11	99451775	99452691	Krtap1-3	916	-	NM_001085526	99452111	99452633	1
chr11	99458661	99459420	Krtap9-3	759	-	NM_029351	99458957	99459368	1
chr11	99463959	99464622	Gm11938	663	-	NM_001127354	99464185	99464581	1
chr11	99471107	99471503	Gm11937	396	-	NM_001099346	99471107	99471503	1
chr11	99475330	99476160	Krtap2-4	830	-	NM_027800	99475701	99476097	1
chr11	99480911	99481718	Gm11562	807	-	NM_001177537	99481275	99481686	1
chr11	99488542	99489553	Krtap4-1	1011	-	NM_001048196	99488986	99489496	1
chr11	99495427	99496398	Krtap4-2	971	-	NM_026807	99495834	99496338	1
chr11	99504425	99505403	Krtap4-7	978	-	NM_029613	99504842	99505349	1
chr11	99519255	99520273	Gm11563	1018	-	NM_001126320	99519733	99520240	1
chr11	99526356	99527274	Krtap4-6	918	-	NM_026834	99526625	99527213	1
chr11	99633027	99634227	Gm11595	1200	-	NM_001126322	99633296	99634166	1
chr11	99641327	99641957	Krtap4-8	630	-	NM_001085547	99641327	99641957	1
chr11	99646513	99647571	Krtap4-9	1058	+	NM_001085548	99646568	99647303	1
chr11	99653988	99654606	Gm11596	618	-	NM_001099311	99653988	99654606	1
chr11	99659386	99665764	Krtap4-13	6378	-	NM_027087	99659642	99665699	4
chr11	99659499	99671206	Gm11554	11707	-	NM_001099313	99659642	99671145	2
chr11	99664861	99665760	Gm11569	899	-	NM_001099312	99665126	99665699	2
chr11	99676289	99676980	Gm11564	691	-	NM_001100614	99676310	99676916	1
chr11	99698461	99699380	2300003K06Rik	919	-	NM_001195383	99698540	99699329	1
chr11	99711968	99712919	Krtap4-16	951	-	NM_001013823	99712277	99712886	1
chr11	99719230	99720374	Gm11568	1144	+	NM_001205030	99719284	99719920	1
chr11	99725789	99726885	Gm11559	1096	+	NM_001177484	99725840	99726416	1
chr11	99734702	99735314	Krtap9-1	612	+	NM_015741	99734753	99735314	1
chr11	99740500	99741543	Gm11567	1043	+	NM_001101613	99740551	99741139	1
chr11	99769233	99770204	Krtap31-1	971	+	NM_027568	99769286	99769820	1
chr11	99776064	99776985	Gm11565	921	+	NM_001126323	99776097	99776568	1
chr11	99797604	99798539	Krtap31-2	935	+	NM_001025244	99797657	99798191	1
chr11	99809788	99810865	Krtap9-5	1077	+	NM_001085527	99809788	99810865	1
chr11	99846016	99847907	Krtap16-1	1891	-	NM_001256057	99846381	99847890	1
chr11	99854545	99855308	Krtap17-1	763	-	NM_001099774	99854923	99855253	1
chr11	99872512	99877526	Krt33a	5014	-	NM_027983	99872911	99877461	7
chr11	99884947	99891182	Krt33b	6235	-	NM_013570	99885270	99891139	7
chr11	99898660	99902868	Krt34	4208	-	NM_027563	99899032	99902810	7
chr11	99907959	99911865	Krt31	3906	-	NM_010659	99908220	99911796	7
chr11	99942161	99949540	Krt32	7379	-	NM_001159374	99942472	99949540	7
chr11	99953505	99957538	Krt35	4033	-	NM_016880	99953821	99957500	7
chr11	99963326	99966940	Krt36	3614	-	NM_001174099	99963539	99966910	7
chr11	99978640	99982880	Krt13	4240	-	NM_010662	99978909	99982809	8
chr11	99993072	99997263	Krt15	4191	-	NM_008469	99993330	99997172	8
chr11	100002125	100007240	Krt19	5115	-	NM_008471	100002226	100007173	6
chr11	100048094	100054560	Krt9	6466	-	NM_201255	100048399	100054517	8
chr11	100064475	100068824	Krt14	4349	-	NM_016958	100064625	100068769	8
chr11	100107405	100110216	Krt16	2811	-	NM_008470	100107547	100110204	8
chr11	100117528	100122343	Krt17	4815	-	NM_010663	100117715	100122279	8
chr11	100124195	100131185	Krt42	6990	-	NM_212483	100124383	100131185	8
chr11	100181309	100183410	Eif1	2101	+	NM_011508	100181443	100182675	4
chr11	100195720	100198311	Gast	2591	+	NM_010257	100197796	100198213	3
chr11	100208640	100217455	Hap1	8815	-	NM_177981	100210018	100217391	13
chr11	100230169	100259104	Jup	28935	-	NM_010593	100233623	100247694	14
chr11	100259429	100265179	Gm12348	5750	+	NR_132425	100265179	100265179	4
chr11	100270063	100276133	P3h4	6070	-	NM_176830	100270435	100275970	8
chr11	100277007	100286154	Fkbp10	9147	+	NM_010221	100277097	100285387	10
chr11	100283634	100302403	Nt5c3b	18769	-	NM_026561	100284241	100302369	9
chr11	100303237	100318338	Klhl10	15101	+	NM_025727	100303344	100318260	5
chr11	100323925	100334096	Klhl11	10171	-	NM_172565	100324177	100334042	2
chr11	100337665	100389314	Acly	51649	-	NM_001199296	100338557	100384912	29
chr11	100339724	100339794	Mir7116	70	-	NR_130343	100339794	100339794	1
chr11	100406945	100433880	Ttc25	26935	+	NM_028918	100407114	100433106	12
chr11	100436252	100443053	Cnp	6801	+	NM_009923	100436379	100442110	4
chr11	100444149	100481482	Dnajc7	37333	-	NM_019795	100444412	100480918	14
chr11	100484268	100488916	Nkiras2	4648	+	NM_028024	100485519	100487547	4
chr11	100487532	100512007	Zfp385c	24475	-	NM_177790	100490145	100511820	8
chr11	100556197	100565585	Dhx58	9388	-	NM_030150	100556470	100565382	13
chr11	100566059	100573781	Kat2a	7722	-	NM_001038010	100566551	100573718	18
chr11	100575163	100575889	Hspb9	726	+	NM_029307	100575163	100575763	1
chr11	100576316	100599529	Rab5c	23213	-	NM_024456	100577360	100581394	6
chr11	100601691	100621092	Kcnh4	19401	-	NM_001081194	100602916	100620919	17
chr11	100623006	100624245	Hcrt	1239	-	NM_010410	100623107	100624155	2
chr11	100627645	100632271	Ghdc	4626	-	NM_031871	100628116	100631651	9
chr11	100642044	100711899	Stat5b	69855	-	NM_001113563	100644409	100669837	19
chr11	100720664	100746483	Stat5a	25819	+	NM_011488	100722651	100745310	20
chr11	100748119	100800854	Stat3	52735	-	NM_011486	100750829	100772675	24
chr11	100818050	100831931	Ptrf	13881	-	NM_008986	100819937	100831780	2
chr11	100870765	100925031	Atp6v0a1	54266	+	NM_016920	100873134	100923719	22
chr11	100891653	100891723	Mir6928	70	+	NR_105893	100891723	100891723	1
chr11	100931407	100938985	Naglu	7578	+	NM_013792	100931438	100938759	6
chr11	100939724	100941819	Hsd17b1	2095	+	NM_010475	100939755	100941568	6
chr11	100943878	100947933	Coasy	4055	+	NM_001305982	100944323	100947624	10
chr11	100948603	100953521	Mlx	4918	+	NM_011550	100948639	100952479	8
chr11	100953454	100956749	Psmc3ip	3295	-	NM_008949	100953713	100956690	8
chr11	100957635	100981157	Fam134c	23522	-	NM_028933	100959476	100963365	8
chr11	100981444	100987733	Tubg1	6289	+	NM_134024	100981507	100987543	11
chr11	101017197	101023101	Tubg2	5904	+	NM_134028	101017433	101022916	11
chr11	101023992	101032616	Plekhh3	8624	-	NM_146030	101024192	101032200	13
chr11	101034311	101036757	Ccr10	2446	-	NM_007721	101034927	101036737	2
chr11	101037430	101052034	Cntnap1	14604	+	NM_016782	101037571	101050973	24
chr11	101052428	101087777	Ezh1	35349	-	NM_007970	101054252	101079972	21
chr11	101107647	101109564	Ramp2	1917	+	NM_019444	101107765	101109380	4
chr11	101115020	101120861	Vps25	5841	+	NM_001284412	101115068	101120184	6
chr11	101121880	101138723	Wnk4	16843	+	NM_175638	101121985	101138349	19
chr11	101139283	101140262	Coa3	979	-	NM_026618	101139653	101140241	2
chr11	101140516	101150015	Cntd1	9499	+	NM_026562	101140619	101148895	7
chr11	101149580	101163581	Becn1	14001	-	NM_019584	101150126	101163168	12
chr11	101177564	101184844	Psme3	7280	+	NM_011192	101177760	101183186	11
chr11	101186376	101191008	Aoc2	4632	+	NM_178932	101186406	101190777	4
chr11	101191919	101200744	Aoc3	8825	+	NM_009675	101192253	101198980	4
chr11	101229029	101239217	G6pc	10188	+	NM_008061	101229110	101238113	5
chr11	101268153	101278747	Aarsd1	10594	-	NM_144829	101268202	101278702	12
chr11	101280127	101286647	Ptges3l	6520	-	NM_026865	101280482	101285937	6
chr11	101280500	101280567	Mir6929	67	-	NR_105894	101280567	101280567	1
chr11	101286398	101296979	Rundc1	10581	+	NM_172566	101286417	101295631	5
chr11	101303558	101306910	Rpl27	3352	+	NM_011289	101304038	101306801	5
chr11	101309725	101320015	Ifi35	10290	+	NM_027320	101309915	101319706	7
chr11	101320061	101327513	Vat1	7452	-	NM_012037	101321506	101327447	6
chr11	101329651	101332620	Rnd2	2969	+	NM_009708	101329651	101332620	5
chr11	101350077	101413269	Brca1	63192	-	NM_009764	101351080	101410408	23
chr11	101413420	101443265	Nbr1	29845	+	NM_001252220	101417503	101442072	24
chr11	101443555	101453099	Tmem106a	9544	+	NM_144830	101444890	101451767	9
chr11	101472013	101477270	LOC666331	5257	+	NM_001256318	101472099	101477250	3
chr11	101489262	101497395	Rdm1	8133	+	NM_025654	101489282	101497163	7
chr11	101526854	101529146	Arl4d	2292	+	NM_025404	101527963	101528569	2
chr11	101594269	101628671	Dhx8	34402	+	NM_144831	101594354	101628173	23
chr11	101631061	101646624	Etv4	15563	-	NM_001316365	101631679	101645890	13
chr11	101738823	101755668	Meox1	16845	-	NM_010791	101739920	101755319	3
chr11	101813734	101821888	4930417O22Rik	8154	+	NR_045806	101821888	101821888	4
chr11	101823771	101828329	Sost	4558	-	NM_024449	101825159	101828287	2
chr11	101832457	101846105	Dusp3	13648	-	NM_028207	101836047	101846050	3
chr11	101848369	101853578	1700006E09Rik	5209	+	NM_029287	101848427	101852826	6
chr11	101860966	101888269	Mpp3	27303	-	NM_007863	101861866	101887070	19
chr11	101902824	101916931	Cd300lg	14107	+	NM_001160712	101902904	101915527	8
chr11	101918330	101949829	Mpp2	31499	-	NM_016695	101920630	101946644	13
chr11	101961244	101962614	Ppy	1370	-	NM_008918	101961485	101962025	4
chr11	101967990	101969090	Pyy	1100	-	NM_145435	101968155	101968666	4
chr11	102006826	102010842	Nags	4016	+	NM_145829	102006900	102010385	7
chr11	102013860	102017721	Tmem101	3861	-	NM_029649	102014599	102017658	4
chr11	102024802	102046570	Lsm12	21768	-	NM_172947	102025388	102046520	5
chr11	102051012	102055396	G6pc3	4384	+	NM_175935	102051239	102055120	6
chr11	102057060	102091486	Hdac5	34426	-	NM_001284248	102057261	102079880	29
chr11	102091353	102091464	Mir8101	111	-	NR_106179	102091464	102091464	1
chr11	102110195	102126497	BC030867	16302	+	NM_153544	102110403	102126010	10
chr11	102130136	102139375	Asb16	9239	+	NM_148953	102130136	102139375	5
chr11	102146133	102150741	Tmub2	4608	+	NM_001302506	102146133	102149750	3
chr11	102150613	102157943	Atxn7l3	7330	-	NM_001098837	102152968	102156313	13
chr11	102165876	102180410	Ubtf	14534	-	NM_011551	102167954	102177720	21
chr11	102210133	102226595	Slc4a1	16462	-	NM_011403	102211600	102222709	20
chr11	102236864	102238334	Bloodlinc	1470	-	NR_131196	102238334	102238334	3
chr11	102254716	102264253	Rundc3a	9537	+	NM_001252347	102254989	102262722	11
chr11	102264294	102268831	Slc25a39	4537	-	NM_026542	102264733	102267953	12
chr11	102266233	102266301	Mir6930	68	-	NR_105895	102266301	102266301	1
chr11	102291635	102298123	Grn	6488	+	NM_008175	102291822	102297786	13
chr11	102298295	102308977	Fam171a2	10682	-	NM_199200	102298776	102308829	8
chr11	102314610	102331197	Itga2b	16587	-	NM_010575	102314774	102331026	30
chr11	102337229	102417472	Gpatch8	80243	-	NM_001159492	102339506	102417438	8
chr11	102437712	102440433	Gm11627	2721	-	NR_040286	102440433	102440433	3
chr11	102465744	102469372	Fzd2	3628	+	NM_020510	102466045	102467758	1
chr11	102480820	102485730	2810433D01Rik	4910	-	NR_033474	102485730	102485730	4
chr11	102526898	102543552	Meioc	16654	+	NM_001127576	102527078	102542053	8
chr11	102546001	102559039	Ccdc43	13038	-	NM_025918	102547622	102559022	5
chr11	102622752	102641576	Adam11	18824	+	NM_009613	102622934	102639460	27
chr11	102660791	102681000	Gjc1	20209	-	NM_001159383	102661298	102662489	3
chr11	102697609	102699353	Higd1b	1744	+	NM_080846	102697976	102699283	3
chr11	102699785	102742289	Eftud2	42504	-	NM_001109995	102700114	102739028	28
chr11	102742557	102746529	Ccdc103	3972	+	NM_028492	102743867	102745604	5
chr11	102746482	102748045	Fam187a	1563	+	NM_025766	102746685	102747939	1
chr11	102748649	102758514	Gfap	9865	-	NM_010277	102749990	102758431	9
chr11	102766832	102786438	Kif18b	19606	-	NM_197959	102767513	102777821	16
chr11	102800577	102807775	C1ql1	7198	-	NM_011795	102801046	102807775	2
chr11	102819613	102825468	2410004I01Rik	5855	-	NR_037963	102825468	102825468	3
chr11	102855369	102878461	Dcakd	23092	-	NM_026551	102856194	102861575	5
chr11	102861161	102861235	Mir6931	74	-	NR_105896	102861235	102861235	1
chr11	102889875	102927419	Nmt1	37544	+	NM_008707	102889885	102927082	12
chr11	102931609	102962972	Plcd3	31363	-	NM_152813	102932154	102962844	15
chr11	102963001	102973513	Acbd4	10512	+	NM_025988	102964876	102972975	10
chr11	102977638	102981038	Hexim1	3400	+	NM_138753	102978235	102979306	1
chr11	102994652	103001222	Hexim2	6570	+	NM_001130516	102995392	103000379	3
chr11	103032451	103060214	Fmnl1	27763	+	NM_019679	103032626	103059540	27
chr11	103060257	103069862	1700023F06Rik	9605	-	NM_001254724	103060274	103069829	10
chr11	103069440	103079746	Spata32	10306	-	NM_177801	103069469	103079668	5
chr11	103081077	103128715	Map3k14	47638	-	NM_016896	103082338	103103684	16
chr11	103192797	103225006	Arhgap27	32209	-	NM_001205236	103194176	103222214	18
chr11	103206066	103211440	Arhgap27os3	5374	+	NR_045346	103211440	103211440	4
chr11	103226405	103273978	Plekhm1	47573	-	NM_183034	103228195	103265183	12
chr11	103395890	103476053	Gm884	80163	-	NM_001033434	103395935	103475926	14
chr11	103492388	103500188	Lyzl6	7800	-	NM_027083	103492635	103498210	5
chr11	103500249	103510327	1700072I22Rik	10078	+	NR_131109	103510327	103510327	3
chr11	103510822	103511894	Rprml	1072	+	NM_001033212	103511094	103511448	1
chr11	103538162	103559024	Gosr2	20862	-	NM_019650	103540549	103558972	6
chr11	103559037	103586887	C130046K22Rik	27850	+	NR_102388	103586887	103586887	3
chr11	103588676	103611135	Wnt9b	22459	-	NM_011719	103592063	103611083	4
chr11	103635488	103679335	Wnt3	43847	+	NM_009521	103635582	103674074	5
chr11	103683096	103815370	Nsf	132274	-	NM_008740	103684551	103815295	21
chr11	103828038	103846664	Arf2	18626	+	NM_001304574	103830411	103845063	5
chr11	103994094	104036837	Crhr1	42743	+	NM_001313929	104031495	104035842	14
chr11	104047640	104052480	Sppl2c	4840	+	NM_001082535	104047689	104052055	2
chr11	104092749	104193403	Mapt	100654	+	NM_001038609	104143694	104189501	12
chr11	104194542	104303605	Kansl1	109063	-	NM_001081045	104196291	104286524	14
chr11	104363840	104411934	Cdc27	48094	-	NM_001285989	104366911	104411703	19
chr11	104411976	104448533	Myl4	36557	+	NM_010858	104438765	104447069	9
chr11	104418102	104423512	Gm11665	5410	-	NR_130177	104423512	104423512	6
chr11	104469313	104531785	Itgb3	62472	+	NM_016780	104469402	104528459	15
chr11	104953532	104978851	Efcab3	25319	+	NM_001081046	104954898	104978708	10
chr11	104987738	105002460	Mettl2	14722	+	NM_172567	104987810	105001083	9
chr11	105040120	105145273	Tlk2	105153	+	NM_001294331	105045527	105142572	22
chr11	105040334	105042747	1700052K11Rik	2413	-	NR_027956	105042747	105042747	1
chr11	105153959	105212459	Mrc2	58500	+	NM_008626	105154100	105211239	30
chr11	105222111	105318049	March10	95938	-	NM_172568	105222457	105312479	12
chr11	105451299	105790617	Tanc2	339318	+	NM_181071	105486371	105785030	26
chr11	105795017	105805461	Cyb561	10444	-	NM_007805	105796688	105799141	6
chr11	105826920	105847008	Gm11651	20088	-	NR_104047	105847008	105847008	3
chr11	105829258	105851278	Ace	22020	+	NM_207624	105829295	105850348	25
chr11	105855988	105866757	Ace3	10769	+	NM_001101453	105855988	105866757	14
chr11	105869516	105895378	Kcnh6	25862	+	NM_001037712	105869516	105895378	13
chr11	105898185	105920637	Dcaf7	22452	+	NM_027946	105898437	105916169	7
chr11	105927420	105934926	Taco1	7506	+	NM_027346	105927561	105934615	5
chr11	105946215	106016748	Map3k3	70533	+	NM_011947	105946243	106015508	16
chr11	106017569	106021456	Limd2	3887	-	NM_172397	106019987	106020703	5
chr11	106024287	106054917	Strada	30630	-	NM_001252448	106025352	106048450	13
chr11	106060669	106077681	Ccdc47	17012	-	NM_026009	106062249	106074658	13
chr11	106078239	106110454	Ddx42	32215	+	NM_028074	106085411	106109480	18
chr11	106110457	106117116	Ftsj3	6659	-	NM_025310	106110737	106116965	21
chr11	106117498	106124426	Psmc5	6928	+	NM_008950	106117504	106124376	11
chr11	106124484	106134286	Smarcd2	9802	-	NM_001130187	106125379	106134022	13
chr11	106137985	106149457	Tcam1	11472	+	NM_029467	106143237	106148343	8
chr11	106161574	106163210	Gh	1636	-	NM_008117	106161679	106163063	5
chr11	106172654	106175876	Cd79b	3222	-	NM_008339	106173120	106175798	6
chr11	106179906	106210704	Scn4a	30798	-	NM_133199	106180977	106210703	24
chr11	106236139	106238428	Prr29	2289	+	NM_029345	106236171	106238235	6
chr11	106238969	106243955	Icam2	4986	-	NM_010494	106239120	106243798	4
chr11	106258933	106349110	Ern1	90177	-	NM_023913	106259855	106348990	22
chr11	106362304	106362377	Snord104	73	+	NR_030703	106362377	106362377	1
chr11	106363452	106474244	Tex2	110792	-	NM_198292	106364909	106429916	12
chr11	106515526	106576595	Pecam1	61069	-	NM_001305157	106516446	106576366	16
chr11	106612539	106630108	Milr1	17569	+	NR_073165	106630108	106630108	10
chr11	106629517	106640851	Polg2	11334	-	NM_015810	106629619	106640756	8
chr11	106641669	106649808	Ddx5	8139	-	NM_007840	106643163	106649630	13
chr11	106644006	106644073	Mir3064	67	-	NR_037224	106644073	106644073	1
chr11	106650565	106680175	Cep95	29610	+	NM_177088	106650672	106680039	20
chr11	106681377	106782029	Smurf2	100652	-	NM_025481	106683978	106781546	19
chr11	106849942	106860839	Kpna2	10897	-	NM_010655	106850200	106858626	11
chr11	106889536	106891756	1810010H24Rik	2220	+	NM_001163473	106889723	106891089	3
chr11	106894394	106993236	Bptf	98842	-	NM_176850	106897116	106993236	28
chr11	107018721	107028439	Gm11715	9718	+	NM_001308498	107018735	107028107	3
chr11	107027974	107050695	Nol11	22721	-	NM_001161329	107028838	107050571	18
chr11	107069205	107332034	Pitpnc1	262829	-	NM_145823	107073966	107331252	10
chr11	107340841	107359350	Psmd12	18509	+	NM_025894	107340890	107359047	11
chr11	107409273	107548257	Helz	138984	+	NM_198298	107436269	107548033	32
chr11	107499035	107499093	Mir6932	58	+	NR_105897	107499093	107499093	1
chr11	107564531	107577790	Cacng1	13259	-	NM_007582	107564977	107577705	4
chr11	107596093	107655778	Cacng4	59685	-	NM_019431	107596093	107655778	4
chr11	107735918	107776369	Cacng5	40451	-	NM_001199301	107738665	107745855	6
chr11	107794700	108205202	Prkca	410502	-	NM_011101	107800829	108204981	17
chr11	107858161	107858230	Mir7223	69	+	NR_106082	107858230	107858230	1
chr11	108256610	108275710	Apoh	19100	+	NM_013475	108256657	108275609	8
chr11	108286579	108721929	Cep112	435350	+	NM_029606	108295447	108721509	28
chr11	108781662	108812095	Axin2	30433	+	NM_015732	108784601	108810709	11
chr11	109000604	109005683	E030025P04Rik	5079	-	NR_037978	109005683	109005683	3
chr11	109086668	109159495	Rgs9	72827	-	NM_011268	109086939	109159308	19
chr11	109208180	109214965	1700096J18Rik	6785	+	NR_027883	109214965	109214965	2
chr11	109216091	109224968	Gm11696	8877	-	NR_038097	109224968	109224968	2
chr11	109224107	109262683	Gna13	38576	+	NM_010303	109224287	109257800	4
chr11	109287259	109299462	Amz2	12203	+	NM_025275	109288399	109298029	9
chr11	109301391	109314673	LOC100503496	13282	+	NR_040680	109314673	109314673	2
chr11	109312169	109334910	Slc16a6	22741	-	NM_001029842	109314457	109334806	6
chr11	109334687	109434643	Arsg	99956	+	NM_028710	109351746	109433807	14
chr11	109434834	109472703	Wipi1	37869	-	NM_145940	109435233	109472626	13
chr11	109510718	109530977	Prkar1a	20259	+	NM_001313973	109515098	109528916	12
chr11	109534239	109583570	Fam20a	49331	-	NM_153782	109534613	109583029	11
chr11	109649604	109689360	1700012B07Rik	39756	-	NM_001162428	109650027	109689219	6
chr11	109707191	109709790	1700023C21Rik	2599	+	NR_045909	109709790	109709790	3
chr11	109794719	109857130	Abca8b	62411	-	NM_013851	109795823	109843087	39
chr11	109886947	109957251	Abca8a	70304	-	NM_153145	109887622	109952928	39
chr11	109962135	110029467	Abca9	67332	-	NM_147220	109963278	110027306	39
chr11	110038135	110113090	Abca6	74955	-	NM_147218	110038282	110111807	39
chr11	110130682	110199030	Abca5	68348	-	NM_147219	110133772	110190552	39
chr11	110260435	110374951	Map2k6	114516	+	NM_011943	110260723	110374180	12
chr11	110829346	110889281	Kcnj16	59935	+	NM_001252207	110885827	110887087	3
chr11	110927477	110938139	Kcnj2	10662	+	NM_008425	110933097	110934384	2
chr11	112525240	112572670	BC006965	47430	-	NR_024085	112572670	112572670	6
chr11	112643523	112649071	Sox9	5548	+	NM_011448	112643898	112646824	3
chr11	112654045	112660322	Gm11681	6277	-	NR_126070	112660322	112660322	3
chr11	112684278	112686442	1700012H19Rik	2164	-	NR_130164	112686442	112686442	2
chr11	112905219	113063152	2610035D17Rik	157933	-	NR_015556	113063152	113063152	3
chr11	113064628	113070983	4732490B19Rik	6355	-	NR_040276	113070983	113070983	4
chr11	113106168	113427129	Slc39a11	320961	-	NM_001166503	113107730	113423427	10
chr11	113480794	113487209	Sstr2	6415	+	NM_009217	113485570	113486950	3
chr11	113510842	113523715	Cog1	12873	+	NM_013581	113510874	113523661	14
chr11	113522632	113545465	Fam104a	22833	-	NM_138598	113524623	113545399	3
chr11	113545725	113555961	D11Wsu47e	10236	+	NM_177777	113549094	113555848	5
chr11	113559484	113571331	Cpsf4l	11847	-	NM_029794	113559898	113567881	7
chr11	113588163	113613129	Cdc42ep4	24966	-	NM_001163346	113589827	113590877	2
chr11	113642103	113927265	Sdk2	285162	-	NM_172800	113642103	113927192	45
chr11	114059571	114060513	1700092K14Rik	942	+	NR_045930	114060513	114060513	3
chr11	114274718	114310174	4932435O22Rik	35456	-	NR_027643	114310174	114310174	3
chr11	114529856	114533645	Rpl38	3789	+	NM_023372	114530125	114533604	5
chr11	114536781	114582298	Ttyh2	45517	+	NM_053273	114536857	114580517	14
chr11	114588725	114619200	Dnaic2	30475	+	NM_001034878	114594226	114618585	13
chr11	114626702	114651889	Kif19a	25187	+	NM_001102615	114626827	114651575	20
chr11	114651982	114657206	Btbd17	5224	-	NM_028055	114652761	114657162	3
chr11	114660237	114668059	Gpr142	7822	+	NM_181749	114660237	114668059	3
chr11	114712845	114733931	Gprc5c	21086	+	NM_001110337	114724812	114731667	5
chr11	114751354	114765965	Cd300a	14611	+	NM_170758	114751678	114762604	7
chr11	114784094	114795700	Cd300lb	11606	-	NM_199221	114786206	114795700	4
chr11	114817591	114821731	Cd300c	4140	-	NM_199225	114817591	114821731	4
chr11	114843760	114851200	Cd300ld	7440	-	NM_145437	114845454	114851124	4
chr11	114858082	114863194	AF251705	5112	-	NM_134158	114858201	114862861	4
chr11	114882002	114888247	Gm11710	6245	-	NM_001101656	114882041	114888212	4
chr11	114882002	114888247	Gm11711	6245	-	NM_001101657	114882041	114888212	4
chr11	114903444	114909609	Cd300lh	6165	-	NM_199201	114903444	114909609	4
chr11	114913230	114923352	Cd300e	10122	-	NM_172050	114914574	114923338	4
chr11	114952744	115023554	Rab37	70810	+	NM_001163753	114953174	115022054	9
chr11	114977527	114995306	Cd300lf	17779	-	NM_145634	114978287	114995195	7
chr11	115024654	115042492	Slc9a3r1	17838	+	NM_012030	115024839	115041823	6
chr11	115044145	115048630	Nat9	4485	-	NM_025400	115044339	115048139	7
chr11	115048800	115108339	Tmem104	59539	+	NM_001033393	115049591	115105444	10
chr11	115110482	115128557	Grin2c	18075	-	NM_010350	115110884	115122446	15
chr11	115129338	115138283	Fdxr	8945	-	NM_007997	115129637	115138201	12
chr11	115144679	115158860	Fads6	14181	-	NM_178035	115144819	115158790	6
chr11	115168476	115193617	Otop2	25141	+	NM_172801	115184732	115193299	8
chr11	115176505	115183232	Ush1g	6727	-	NM_176847	115178240	115183170	3
chr11	115196047	115208240	Otop3	12193	+	NM_027132	115196197	115207759	7
chr11	115209022	115229033	Hid1	20011	-	NM_175454	115209782	115228923	19
chr11	115243229	115257446	Cdr2l	14217	+	NM_001080929	115243636	115255551	5
chr11	115265079	115272227	Ict1	7148	+	NM_026729	115265088	115272036	6
chr11	115277010	115281233	Atp5h	4223	-	NM_027862	115277061	115279821	6
chr11	115281439	115292588	Kctd2	11149	+	NM_183285	115281481	115291656	6
chr11	115301858	115309582	Trim80	7724	+	NM_001033775	115301867	115309534	8
chr11	115309274	115309374	Mir3968	100	-	NR_039549	115309374	115309374	1
chr11	115323786	115335712	Slc16a5	11926	+	NM_001080934	115323922	115334235	4
chr11	115336990	115351780	Armc7	14790	+	NM_177778	115337250	115350388	3
chr11	115351739	115353128	Nt5c	1389	-	NM_015807	115351912	115353100	5
chr11	115358666	115375684	Hn1	17018	-	NM_008258	115359464	115375589	5
chr11	115384422	115397544	Sumo2	13122	-	NM_133354	115385020	115397432	4
chr11	115425757	115445238	Nup85	19481	+	NM_001002929	115425843	115445136	19
chr11	115445568	115465230	Gga3	19662	-	NM_173048	115447043	115465181	17
chr11	115465464	115468938	Mrps7	3474	+	NM_025305	115465474	115468353	5
chr11	115469232	115474283	Mif4gd	5051	-	NM_001243587	115469699	115473298	6
chr11	115475494	115489609	Slc25a19	14115	-	NM_001252395	115476722	115484743	8
chr11	115505358	115569911	Grb2	64553	-	NM_008163	115507082	115560543	6
chr11	115626746	115660347	Tmem94	33601	+	NM_028014	115638667	115659661	32
chr11	115657137	115657200	Mir5621	63	+	NR_049194	115657200	115657200	1
chr11	115660665	115674906	Caskin2	14241	-	NM_080643	115661300	115673294	20
chr11	115676052	115684416	Tsen54	8364	+	NM_029557	115676077	115684047	11
chr11	115685371	115717094	Llgl2	31723	+	NM_001252532	115696141	115716787	26
chr11	115753908	115794806	Recql5	40898	-	NM_130454	115754371	115794232	19
chr11	115761452	115767583	Smim5	6131	+	NM_183259	115766489	115767105	3
chr11	115773330	115775231	Smim6	1901	+	NM_001162998	115774702	115774873	2
chr11	115794972	115826848	Sap30bp	31876	+	NM_020483	115794989	115825706	11
chr11	115836038	115869725	Itgb4	33687	+	NM_001005608	115839109	115869414	40
chr11	115869670	115874033	Galk1	4363	-	NM_016905	115869956	115873992	8
chr11	115883274	115885818	H3f3b	2544	-	NM_008211	115884720	115885323	4
chr11	115891629	115922528	Unk	30899	+	NM_001286006	115891701	115921292	16
chr11	115923409	115939275	Unc13d	15866	-	NM_001009573	115924007	115938875	33
chr11	115939886	115948278	Wbp2	8392	-	NM_016852	115940856	115948239	8
chr11	115967063	115971549	Trim47	4486	-	NM_001205081	115967314	115971534	6
chr11	115986021	115992442	Trim65	6421	-	NM_178802	115987379	115992319	6
chr11	115993130	116000182	Mrpl38	7052	-	NM_024177	115993307	116000091	9
chr11	116003598	116029492	Fbf1	25894	-	NM_172571	116004696	116027196	31
chr11	116033196	116060359	Acox1	27163	-	NM_001271898	116034861	116060018	14
chr11	116060168	116076632	Ten1	16464	+	NM_027107	116066204	116076391	4
chr11	116077315	116081601	Cdk3-ps	4286	+	NR_004853	116081601	116081601	7
chr11	116081872	116099405	Evpl	17533	-	NM_025276	116082068	116099311	22
chr11	116106479	116135531	Srp68	29052	-	NM_146032	116107016	116135420	16
chr11	116142252	116145252	Galr2	3000	+	NM_010254	116142799	116144975	2
chr11	116149311	116168052	Exoc7	18741	-	NM_016857	116150496	116167987	20
chr11	116192017	116196668	Foxj1	4651	-	NM_008240	116193023	116195853	3
chr11	116197658	116274346	Rnf157	76688	-	NM_027258	116200019	116274098	19
chr11	116295407	116300391	Ubald2	4984	+	NM_176902	116295622	116299619	3
chr11	116295526	116300345	Gm7367	4819	+	NR_003376	116300345	116300345	4
chr11	116302638	116315661	Qrich2	13023	-	NM_001033267	116302668	116314897	14
chr11	116332129	116351660	Prpsap1	19531	-	NM_026364	116332710	116351531	10
chr11	116393224	116397989	Sphk1	4765	+	NM_001172475	116395477	116397700	6
chr11	116399066	116442761	Ube2o	43695	-	NM_173755	116400357	116442727	18
chr11	116455000	116458994	Aanat	3994	+	NR_033223	116458994	116458994	5
chr11	116459478	116488333	Rhbdf2	28855	-	NM_172572	116460332	116468685	19
chr11	116506908	116515627	Cygb	8719	-	NM_030206	116508272	116515233	4
chr11	116518421	116529703	Gm11744	11282	+	NM_001163318	116518550	116520633	5
chr11	116532973	116537112	1810032O08Rik	4139	+	NR_027819	116537112	116537112	6
chr11	116533818	116533896	Snord1c	78	+	NR_028569	116533896	116533896	1
chr11	116535460	116535537	Snord1b	77	+	NR_028567	116535537	116535537	1
chr11	116535910	116535986	Snord1a	76	+	NR_028570	116535986	116535986	1
chr11	116538018	116555974	St6galnac2	17956	-	NM_009180	116538827	116555872	9
chr11	116613480	116619197	BC018473	5717	+	NR_003364	116619197	116619197	4
chr11	116626338	116636821	St6galnac1	10483	-	NM_011371	116627044	116636716	9
chr11	116664713	116689360	Mxra7	24647	-	NM_026280	116665853	116689312	4
chr11	116698745	116704763	Jmjd6	6018	-	NM_033398	116698945	116704507	6
chr11	116704828	116711054	Mettl23	6226	+	NM_028865	116704920	116710869	5
chr11	116711210	116714408	Srsf2	3198	-	NM_011358	116713341	116714243	3
chr11	116715328	116736951	Mfsd11	21623	+	NM_178620	116715391	116735259	13
chr11	116780176	116848258	Mgat5b	68082	+	NM_172948	116780789	116846996	17
chr11	116938096	116940269	Snhg20	2173	+	NR_027059	116940269	116940269	2
chr11	116938661	116938771	Mir6516	110	+	NR_105853	116938771	116938771	1
chr11	116976485	117020582	Sec14l1	44097	+	NM_001166507	116978503	117018579	17
chr11	117060974	117223639	Sept9	162665	+	NM_001113486	117061068	117221869	12
chr11	117275702	117276682	Gm11729	980	+	NR_132097	117276682	117276682	3
chr11	117345681	117350328	Gm11733	4647	+	NR_130966	117350328	117350328	3
chr11	117472560	117474731	2900041M22Rik	2171	+	NR_015489	117474731	117474731	2
chr11	117515602	117624753	Tnrc6c	109151	+	NM_198022	117562075	117622165	22
chr11	117627298	117641997	Tmc6	14699	-	NM_145439	117627556	117640532	20
chr11	117643610	117654451	Tmc8	10841	+	NM_001195089	117644423	117654106	16
chr11	117658973	117668622	6030468B19Rik	9649	+	NM_029964	117659080	117668410	6
chr11	117670980	117675600	Syngr2	4620	+	NM_009304	117671018	117674789	4
chr11	117676832	117687328	Tk1	10496	-	NM_009387	117677264	117687093	7
chr11	117687232	117701222	Afmid	13990	+	NM_027827	117687263	117699839	11
chr11	117710550	117717057	Birc5	6507	+	NM_009689	117710664	117716622	4
chr11	117722065	117726857	Tmem235	4792	+	NM_001085535	117722065	117725673	4
chr11	117729262	117734840	Tha1	5578	-	NM_027919	117729772	117734713	7
chr11	117827400	117830680	Socs3	3280	-	NM_007707	117828866	117829544	2
chr11	117848170	117885325	Pgs1	37155	+	NM_133757	117848193	117881040	10
chr11	117863583	117863664	Mir6933	81	+	NR_105898	117863664	117863664	1
chr11	117883036	117990533	Dnah17	107497	-	NM_001167746	117884563	117990533	81
chr11	118025479	118109906	Cyth1	84427	-	NM_011180	118027329	118109774	13
chr11	118120966	118151558	Usp36	30592	-	NM_001033528	118123312	118147304	21
chr11	118162374	118216725	Timp2	54351	-	NM_011594	118165012	118216404	5
chr11	118193673	118203848	BC100451	10175	-	NM_021440	118193728	118195330	3
chr11	118254065	118263245	Lgals3bp	9180	-	NM_011150	118254331	118261093	6
chr11	118267602	118280432	Cant1	12830	-	NM_001267592	118269037	118272803	6
chr11	118289770	118313096	C1qtnf1	23326	+	NM_001204129	118305009	118309665	4
chr11	118305513	118316309	Gm11747	10796	-	NR_045902	118316309	118316309	3
chr11	118338273	118350512	Engase	12239	+	NM_172573	118338299	118348821	14
chr11	118351073	118772911	Rbfox3	421838	-	NM_001285437	118352552	118374685	14
chr11	118849501	118854155	Enpp7	4654	+	NM_001030291	118849530	118854155	6
chr11	118884334	118892589	Cbx2	8255	+	NM_007623	118884422	118890484	5
chr11	118899749	118902227	Cbx8	2478	-	NM_013926	118899990	118902164	5
chr11	118938884	118947551	Cbx4	8667	-	NM_007625	118942205	118947331	5
chr11	119004356	119089813	Tbc1d16	85457	-	NM_172443	119008881	119071996	12
chr11	119015389	119015451	Mir6934	62	-	NR_105899	119015451	119015451	1
chr11	119089885	119126526	Ccdc40	36641	+	NM_175430	119092897	119125828	19
chr11	119129276	119146772	Gaa	17496	+	NM_001159324	119131446	119146378	20
chr11	119149676	119161357	Eif4a3	11681	-	NM_138669	119149856	119161310	12
chr11	119176100	119206689	Card14	30589	+	NM_130886	119178419	119206055	22
chr11	119204802	119216824	Sgsh	12022	-	NM_018822	119207591	119216798	8
chr11	119216870	119242390	Slc26a11	25520	+	NM_178743	119218164	119241602	17
chr11	119251785	119251875	Mir1932	90	+	NR_035453	119251875	119251875	1
chr11	119352660	119372779	Endov	20119	+	NM_001164636	119352717	119368741	9
chr11	119400032	119409134	Nptx1	9102	-	NM_008730	119403786	119408903	5
chr11	119409943	119430360	Gm11762	20417	+	NR_045099	119430360	119430360	4
chr11	119464218	119760905	Rptor	296687	+	NM_028898	119465123	119758796	34
chr11	119682124	119695679	Rptoros	13555	-	NR_045312	119695679	119695679	4
chr11	119775123	119780866	Chmp6	5743	+	NM_001085498	119775188	119779973	8
chr11	119804405	119868096	Baiap2	63691	+	NM_001037755	119804508	119867742	14
chr11	119868631	119908459	Aatk	39828	-	NM_007377	119869717	119882760	14
chr11	119876078	119876176	Mir338	98	-	NR_029767	119876176	119876176	1
chr11	119876080	119876167	Mir3065	87	+	NR_037225	119876167	119876167	1
chr11	119925743	119948141	Cep131	22398	-	NM_009734	119925948	119945286	26
chr11	119951835	119960045	Enthd2	8210	-	NM_183137	119952834	119959987	13
chr11	119960247	119961738	1810043H04Rik	1491	+	NM_001110242	119960295	119961517	3
chr11	119965264	120012665	Slc38a10	47401	-	NM_001164798	119966310	120012392	17
chr11	120047963	120051170	2810410L24Rik	3207	-	NR_030682	120051170	120051170	3
chr11	120094260	120153611	Bahcc1	59351	+	NM_198423	120098393	120151197	28
chr11	120207000	120209809	Actg1	2809	-	NM_001313923	120207703	120208660	7
chr11	120208663	120208727	Mir6935	64	-	NR_105900	120208727	120208727	1
chr11	120209991	120212504	0610009L18Rik	2513	+	NR_038126	120212504	120212504	2
chr11	120222847	120229487	Fscn2	6640	+	NM_172802	120223022	120229423	5
chr11	120230875	120240060	Faap100	9185	-	NM_027980	120231601	120240020	10
chr11	120241111	120299014	Nploc4	57903	-	NM_001195023	120243782	120298827	17
chr11	120303944	120308635	Tspan10	4691	+	NM_145363	120304092	120307718	3
chr11	120308920	120314814	Pde6g	5894	-	NM_012065	120309412	120311926	4
chr11	120317917	120319377	Oxld1	1460	-	NM_025560	120318077	120319333	2
chr11	120319442	120325667	Ccdc137	6225	+	NM_152807	120319458	120323797	6
chr11	120325639	120328914	Arl16	3275	-	NM_197995	120326963	120328737	5
chr11	120328948	120345298	Hgs	16350	+	NM_008244	120329040	120344813	22
chr11	120345982	120350068	Mrpl12	4086	+	NM_027204	120346005	120349748	5
chr11	120353150	120362475	Slc25a10	9325	+	NM_013770	120353300	120359489	11
chr11	120392040	120400298	Gcgr	8258	+	NM_008101	120396070	120400011	14
chr11	120404201	120411041	Fam195b	6840	-	NM_001033231	120404997	120406198	5
chr11	120411288	120412446	Ppp1r27	1158	-	NM_026814	120411519	120412367	3
chr11	120421617	120434250	P4hb	12633	-	NM_011032	120422496	120434121	11
chr11	120438548	120442934	Arhgdia	4386	-	NM_133796	120440544	120441685	6
chr11	120455829	120459679	Alyref	3850	-	NM_011568	120456166	120459652	6
chr11	120459734	120469512	Anapc11	9778	+	NM_025389	120460573	120466740	3
chr11	120469790	120470414	Npb	624	+	NM_153288	120469822	120470257	2
chr11	120471400	120479204	Pcyt2	7804	-	NM_024229	120471982	120479166	14
chr11	120479685	120486316	Sirt7	6631	-	NM_153056	120480161	120486286	10
chr11	120486136	120486190	Mir6936	54	-	NR_105901	120486190	120486190	1
chr11	120489666	120494861	Mafg	5195	-	NM_010756	120490597	120491167	3
chr11	120497025	120504984	Pycr1	7959	-	NM_144795	120501529	120504539	8
chr11	120507344	120509651	Myadml2	2307	-	NM_001204820	120507662	120509321	2
chr11	120515102	120522151	Notum	7049	-	NM_175263	120515533	120521652	12
chr11	120534286	120570760	Aspscr1	36474	+	NM_026877	120534382	120570671	16
chr11	120572254	120575081	Stra13	2827	-	NM_016665	120572605	120575033	5
chr11	120575266	120582441	Lrrc45	7175	+	NM_153545	120575622	120582128	18
chr11	120582781	120585283	Rac3	2502	+	NM_133223	120582920	120584923	6
chr11	120586686	120588595	Dcxr	1909	-	NM_026428	120586817	120588543	8
chr11	120590798	120593335	Cbr2	2537	-	NM_007621	120591035	120593286	8
chr11	120642058	120645518	Rfng	3460	-	NM_009053	120643135	120645476	8
chr11	120645585	120650416	Gps1	4831	+	NM_001177874	120645623	120650058	14
chr11	120650515	120657709	Dus1l	7194	-	NM_026824	120650733	120657027	14
chr11	120667271	120685861	Fasn	18590	-	NM_007988	120669167	120684157	43
chr11	120687855	120794186	Ccdc57	106331	-	NM_027745	120688029	120783240	19
chr11	120809797	120820314	Slc16a3	10517	+	NM_030696	120816560	120819446	6
chr11	120823054	120852647	Csnk1d	29593	-	NM_027874	120826291	120852324	10
chr11	120898062	120900792	Cd7	2730	-	NM_009854	120898356	120900679	4
chr11	120914736	120924883	Sectm1b	10147	-	NM_026907	120916188	120917611	5
chr11	120928716	120942453	Sectm1a	13737	-	NM_145373	120930035	120936970	6
chr11	120977528	120979991	Tex19.2	2463	-	NM_027622	120977980	120978934	3
chr11	121007456	121009627	Tex19.1	2171	+	NM_028602	121008131	121009187	3
chr11	121021584	121023287	Uts2r	1703	+	NM_145440	121021625	121022783	1
chr11	121038906	121065962	Ogfod3	27056	-	NM_025402	121039115	121065876	9
chr11	121065746	121083970	Hexdc	18224	+	NM_001001333	121069005	121083734	13
chr11	121083902	121090623	BC017643	6721	-	NM_001252549	121085425	121089726	7
chr11	121098549	121117170	Narf	18621	+	NM_026272	121098638	121114236	11
chr11	121121300	121171210	Foxk2	49910	+	NM_001080932	121121444	121168278	9
chr11	121188516	121215761	Wdr45b	27245	-	NM_025793	121189671	121215607	10
chr11	121217434	121249565	Rab40b	32131	-	NM_139147	121218350	121249456	6
chr11	121248458	121248518	Mir7236	60	-	NR_106095	121248518	121248518	1
chr11	121282686	121292082	Fn3krp	9396	+	NM_181420	121282776	121291074	6
chr11	121296266	121311804	Fn3k	15538	+	NM_022014	121296302	121311764	6
chr11	121313262	121478484	Tbcd	165222	+	NM_029878	121313358	121478259	39
chr11	121372289	121380656	Zfp750	8367	-	NM_178763	121373122	121375361	3
chr11	121477521	121534465	B3gntl1	56944	-	NM_178664	121480961	121534346	13
chr11	121563740	121578703	Metrnl	14963	+	NM_144797	121563939	121577370	4
chr11	121691531	121704750	Ptchd3	13219	+	NM_029049	121691616	121704320	4
chr12	3235790	3250374	Rab10os	14584	+	NR_015551	3250374	3250374	7
chr12	3247427	3309969	Rab10	62542	-	NM_016676	3249786	3309418	6
chr12	3365131	3406494	Kif3c	41363	+	NM_008445	3365980	3402885	8
chr12	3403882	3426747	1110002L01Rik	22865	-	NR_030694	3426747	3426747	3
chr12	3426856	3506849	Asxl2	79993	+	NM_001270988	3427155	3502372	12
chr12	3572390	3781398	Dtnb	209008	+	NR_027869	3781398	3781398	21
chr12	3806979	3914443	Dnmt3a	107464	+	NM_007872	3835197	3907747	23
chr12	3859292	3862244	Dnmt3aos	2952	-	NR_045884	3862244	3862244	4
chr12	3954944	3960643	Pomc	5699	+	NM_001278583	3958128	3960468	4
chr12	3962553	4038915	Efr3b	76362	-	NM_001082483	3966441	4038710	23
chr12	4082573	4110612	Dnajc27	28039	+	NM_153082	4082786	4106934	7
chr12	4133396	4213524	Adcy3	80128	+	NM_001159537	4134325	4212787	22
chr12	4211671	4234294	Cenpo	22623	-	NM_134046	4214493	4233576	7
chr12	4234026	4240123	Ptrhd1	6097	+	NM_001204912	4234026	4236533	2
chr12	4247361	4484060	Ncoa1	236699	-	NM_010881	4249845	4344485	23
chr12	4599813	4720758	Itsn2	120945	+	NM_001198968	4620080	4720003	40
chr12	4720610	4745189	Fam228a	24579	-	NM_029107	4722354	4744577	8
chr12	4753021	4776073	Fam228b	23052	-	NM_175431	4754822	4775303	7
chr12	4776100	4785072	Pfn4	8972	+	NM_028376	4776958	4785014	4
chr12	4824413	4834465	Sf3b6	10052	+	NM_025323	4824595	4833909	4
chr12	4839979	4848401	Fkbp1b	8422	-	NM_016863	4840472	4848241	4
chr12	4850108	4863773	BC068281	13665	+	NM_001170858	4856951	4863731	4
chr12	4869243	4881165	Mfsd2b	11922	-	NM_001033488	4870860	4881142	14
chr12	4885837	4914326	Ubxn2a	28489	-	NM_145441	4887387	4909066	7
chr12	4924158	5054216	Atad2b	130058	+	NM_001099628	4924514	5050853	31
chr12	5084273	5382488	Klhl29	298215	-	NM_001164493	5087956	5217022	14
chr12	5383307	5422938	2810032G03Rik	39631	+	NR_015579	5422938	5422938	2
chr12	7378844	7387136	1700101O22Rik	8292	-	NR_045045	7387136	7387136	3
chr12	7984482	8023645	Apob	39163	+	NM_009693	7984584	8023356	29
chr12	8214912	8292565	Ldah	77653	+	NM_172401	8227407	8290897	7
chr12	8304723	8308760	Gdf7	4037	-	NM_013527	8304739	8308739	2
chr12	8320238	8350630	Hs1bp3	30392	+	NM_021429	8320271	8348893	7
chr12	8504564	8506791	Rhob	2227	-	NM_007483	8505847	8506438	1
chr12	8535288	8605872	Slc7a15	70584	-	NM_177802	8536150	8542599	7
chr12	8680939	8759389	Pum2	78450	+	NM_001160221	8704914	8756526	21
chr12	8778201	8800493	Sdc1	22292	+	NM_011519	8778441	8798613	5
chr12	8928112	8945547	Laptm4a	17435	+	NM_008640	8928764	8944997	7
chr12	8954734	8978834	Matn3	24100	+	NM_010770	8954849	8977381	8
chr12	8980806	9035653	Wdr35	54847	+	NM_172470	8980961	9034962	28
chr12	9036802	9043200	Ttc32	6398	+	NM_029321	9036862	9042707	3
chr12	9572041	9577391	1700022H16Rik	5350	-	NR_045488	9577391	9577391	4
chr12	9581247	9588306	Osr1	7059	+	NM_011859	9585934	9587431	3
chr12	10376776	10396980	Nt5c1b	20204	+	NM_027588	10376868	10396939	9
chr12	10397585	10402368	Rdh14	4783	+	NM_023697	10397645	10401961	2
chr12	10453193	10538109	Gm38407	84916	+	NR_110487	10538109	10538109	12
chr12	11054618	11085547	7420701I03Rik	30929	+	NR_045860	11085547	11085547	3
chr12	11097007	11157648	Kcns3	60641	-	NM_001168564	11098026	11099502	3
chr12	11192798	11211308	9530020I12Rik	18510	-	NR_131084	11211308	11211308	5
chr12	11215187	11215754	Msgn1	567	-	NM_019544	11215187	11215754	1
chr12	11247731	11272593	Gen1	24862	-	NM_177331	11248060	11269373	14
chr12	11272691	11326591	Smc6	53900	+	NM_025695	11278539	11324690	27
chr12	11306692	11306750	Mir7675	58	+	NR_106136	11306750	11306750	1
chr12	11332050	11443455	Vsnl1	111405	-	NM_012038	11333112	11393782	4
chr12	11445038	11451618	4930511A02Rik	6580	+	NR_045966	11451618	11451618	4
chr12	11462884	11469734	Rad51ap2	6850	+	NM_001111118	11462884	11469490	3
chr12	11889001	11889705	Tubb2a-ps2	704	-	NR_003964	11889705	11889705	1
chr12	12268944	12383167	Fam49a	114223	+	NM_029758	12347494	12379616	13
chr12	12358327	12399281	4921511I17Rik	40954	-	NR_045829	12399281	12399281	5
chr12	12942898	12948642	Mycn	5744	-	NM_008709	12943811	12947199	3
chr12	13226112	13255980	Ddx1	29868	-	NM_134040	13226303	13255925	26
chr12	13275932	13590617	Nbas	314685	+	NM_027706	13275956	13590472	52
chr12	14154403	14158844	Fam84a	4441	-	NM_029007	14156651	14157530	2
chr12	14268339	14292490	Gm16497	24151	+	NR_045003	14292490	14292490	3
chr12	15003194	15057195	4930448C13Rik	54001	-	NR_045960	15057195	15057195	8
chr12	15798532	15823591	Trib2	25059	-	NM_144551	15800413	15822306	3
chr12	15807799	15807907	Mir6387	108	-	NR_105809	15807907	15807907	1
chr12	16542474	16596576	Lpin1	54102	-	NM_001130412	16545218	16587701	21
chr12	16660275	16667042	Ntsr2	6767	+	NM_008747	16660305	16666776	4
chr12	16677420	16807692	Greb1	130272	-	NM_015764	16679185	16746851	35
chr12	16817770	16833558	E2f6	15788	+	NR_027677	16833558	16833558	8
chr12	16901783	16995080	Rock2	93297	+	NM_009072	16901995	16991447	33
chr12	16995453	17006924	Pqlc3	11471	-	NM_172574	16996609	17006761	7
chr12	17011763	17018533	2410004P03Rik	6770	-	NM_001201332	17013850	17018151	5
chr12	17178905	17183694	Kcnf1	4789	-	NM_201531	17181506	17183024	1
chr12	17273400	17291576	Pdia6	18176	+	NM_027959	17273423	17290812	13
chr12	17291526	17331536	Atp6v1c2	40010	-	NM_001159632	17291664	17330272	15
chr12	17355298	17436901	Nol10	81603	+	NM_001008421	17355359	17436040	21
chr12	17362197	17362280	Mir3066	83	+	NR_037226	17362280	17362280	1
chr12	17551678	17558308	Odc1	6630	+	NM_013614	17554104	17557557	12
chr12	17697619	17798732	Hpcal1	101113	+	NM_016677	17792976	17798010	4
chr12	18521315	18542060	5730507C01Rik	20745	+	NM_001033157	18521543	18540997	4
chr12	20810252	20821640	1700030C10Rik	11388	-	NR_015521	20821640	20821640	2
chr12	21117616	21276032	Asap2	158416	+	NM_001135192	21117904	21273653	29
chr12	21275666	21292098	Itgb1bp1	16432	-	NM_008403	21276746	21285332	7
chr12	21292157	21320917	Cpsf3	28760	+	NM_018813	21292355	21320610	18
chr12	21322252	21329468	Iah1	7216	+	NM_026347	21322292	21329332	6
chr12	21329369	21379493	Adam17	50124	-	NM_001277266	21331136	21379293	20
chr12	21396189	21423297	Ywhaq	27108	-	NM_011739	21397216	21422952	5
chr12	22990696	23046943	2410018L13Rik	56247	+	NR_015504	23046943	23046943	4
chr12	24728066	24782134	9030624G23Rik	54068	-	NM_001256489	24729565	24781833	4
chr12	25183445	25243436	Taf1b	59991	+	NM_020614	25183496	25243229	15
chr12	25257151	25302256	Grhl1	45105	+	NM_001161406	25257303	25300797	16
chr12	25336235	25347647	Klf11	11412	+	NM_178357	25336389	25345328	4
chr12	25350702	25366660	Cys1	15958	-	NM_001161807	25351991	25365773	5
chr12	25393118	25399011	Rrm2	5893	+	NM_009104	25393211	25398097	10
chr12	25516463	25645164	Mboat2	128701	+	NM_026037	25516564	25644025	13
chr12	25659796	25744562	Kidins220	84766	+	NM_001081378	25667134	25742706	32
chr12	25778663	25780957	Id2	2294	-	NM_010496	25780182	25780875	3
chr12	25814038	25817139	Gm17746	3101	+	NR_045844	25817139	25817139	3
chr12	26776826	26895370	Gm29687	118544	-	NR_131149	26895370	26895370	5
chr12	26896131	26925572	4930480M12Rik	29441	+	NR_046278	26925572	26925572	3
chr12	26991658	27100127	Rnf144a	108469	-	NM_001081977	26995522	27024305	10
chr12	27031574	27056613	4930549C15Rik	25039	+	NR_130981	27056613	27056613	5
chr12	27099765	27099875	Mir6538	110	-	NR_105856	27099875	27099875	1
chr12	27127607	27141317	Rsad2	13710	-	NM_021384	27130270	27141284	6
chr12	27154079	27164702	Cmpk2	10623	+	NM_020557	27154216	27162994	5
chr12	27775101	27799860	Gm20187	24759	-	NR_045052	27799860	27799860	3
chr12	27825660	27845381	Gm9866	19721	-	NR_045868	27845381	27845381	4
chr12	28019132	28027583	Sox11	8451	-	NM_009234	28026085	28027273	1
chr12	29122659	29233202	Dcdc2c	110543	-	NM_001177964	29123312	29220357	9
chr12	29238619	29267348	Allc	28729	-	NM_053156	29238702	29258131	12
chr12	29279036	29308195	Colec11	29159	-	NM_027866	29279521	29302403	7
chr12	29315711	29320818	Rps7	5107	-	NM_011300	29315980	29320519	7
chr12	29334466	29344456	Rnaseh1	9990	+	NM_001286865	29334631	29343944	8
chr12	29360071	29367039	Adi1	6968	+	NM_134052	29360117	29365950	4
chr12	29364189	29364254	Mir6937	65	+	NR_105902	29364254	29364254	1
chr12	29375492	29435318	Trappc12	59826	-	NM_178811	29376179	29432396	12
chr12	29436692	29552356	Tssc1	115664	+	NM_201357	29436827	29551960	9
chr12	30213248	30608074	Myt1l	394826	+	NM_001093775	30468485	30605346	25
chr12	30360494	30371310	C630031E19Rik	10816	-	NR_046080	30371310	30371310	4
chr12	30622900	30702523	Pxdn	79623	+	NM_181395	30622998	30700435	23
chr12	30739525	30817489	Tpo	77964	-	NM_009417	30739989	30816759	17
chr12	30859421	31058240	Sntg2	198819	-	NM_172951	30859992	31058094	17
chr12	31095423	31152223	2310016D03Rik	56800	-	NR_045491	31152223	31152223	3
chr12	31269307	31276084	Tmem18	6777	+	NM_172049	31269370	31273612	5
chr12	31569188	31578719	Fam150b	9531	+	NM_001159743	31569648	31574962	5
chr12	31578190	31596477	Acp1	18287	-	NM_021330	31580740	31596397	6
chr12	31596533	31645025	Sh3yl1	48492	+	NR_110343	31645025	31645025	11
chr12	31758832	31764805	Fam110c	5973	+	NM_027828	31758905	31760171	2
chr12	31853726	31870787	6030469F06Rik	17061	+	NR_102715	31870787	31870787	4
chr12	31950158	32014504	Lamb1	64346	+	NM_008482	31950285	32014358	33
chr12	32016426	32036336	Dld	19910	-	NM_007861	32017041	32036204	14
chr12	32123083	32158784	Slc26a3	35701	+	NM_021353	32131963	32158360	21
chr12	32169693	32184481	Cbll1	14788	-	NM_001253848	32172143	32184400	7
chr12	32204683	32244834	Slc26a4	40151	-	NM_011867	32205208	32244188	21
chr12	32280218	32319523	Bcap29	39305	-	NM_001164090	32281206	32319219	8
chr12	32324919	32339691	Dus4l	14772	-	NM_028002	32325540	32337271	7
chr12	32339733	32622495	Cog5	282762	+	NM_001163126	32339754	32610624	23
chr12	32391731	32398791	Gpr22	7060	-	NM_175191	32393576	32396521	3
chr12	32611319	32635400	Hbp1	24081	-	NM_153198	32612354	32635075	11
chr12	32643343	32746144	Prkar2b	102801	-	NM_011158	32645253	32745947	11
chr12	32858261	32893514	Pik3cg	35253	-	NM_001146200	32861442	32890851	11
chr12	33063653	33067808	Ccdc71l	4155	+	NM_001162903	33063848	33064505	1
chr12	33505199	33538234	Nampt	33035	+	NM_021524	33505434	33535398	11
chr12	33508980	33511773	Gdap10	2793	+	NR_045032	33511773	33511773	1
chr12	33604248	33638654	4933406C10Rik	34406	-	NR_044986	33638654	33638654	6
chr12	33638809	33664367	Sypl	25558	+	NM_013635	33638832	33660589	6
chr12	33718660	33777740	Cdhr3	59080	-	NM_001024478	33719784	33777639	20
chr12	33796575	33832451	F730043M19Rik	35876	-	NR_015602	33832451	33832451	6
chr12	33832550	33936022	Atxn7l1	103472	+	NM_028139	33832599	33934801	4
chr12	34043116	34079625	Atxn7l1os2	36509	-	NR_131031	34079625	34079625	4
chr12	34079718	34086134	Efcab10	6416	+	NM_029152	34079954	34086094	4
chr12	34114488	34124245	Twistnb	9757	+	NM_172253	34114519	34122945	4
chr12	34613289	34614174	Ferd3l	885	+	NM_033522	34613354	34613861	1
chr12	34642535	34644696	Twist1	2161	+	NM_011658	34642842	34643463	2
chr12	34732446	35601767	Hdac9	869321	-	NM_001271386	34737165	35512523	28
chr12	35669432	35671108	Prps1l1	1676	+	NM_029294	35669559	35670516	1
chr12	35731860	35832149	Snx13	100289	+	NM_001014973	35732068	35829008	26
chr12	35879482	35879569	Mir680-3	87	-	NR_030449	35879569	35879569	1
chr12	36182650	36219661	Ahr	37011	-	NM_013464	36185360	36219295	11
chr12	36356962	36379790	9130015A21Rik	22828	-	NR_045050	36379790	36379790	5
chr12	36652207	36676317	Agr3	24110	+	NM_207531	36654876	36676133	8
chr12	36719511	36730668	Agr2	11157	+	NM_011783	36722103	36730488	8
chr12	36741141	36769065	Tspan13	27924	-	NM_025359	36742284	36768900	6
chr12	36816965	36818416	Gm5434	1451	+	NR_003649	36818416	36818416	1
chr12	36818421	36883412	Bzw2	64991	-	NM_025840	36818867	36861535	12
chr12	36883710	36923878	Ankmy2	40168	+	NM_146033	36883943	36922988	10
chr12	36936149	36979985	Lrrc72	43836	-	NM_001177877	36936273	36948117	8
chr12	37040755	37045039	Sostdc1	4284	+	NM_025312	37040880	37044034	2
chr12	37108036	37416090	Ispd	308054	+	NM_178629	37108360	37414940	10
chr12	37542791	37542865	Mir5099	74	+	NR_039558	37542865	37542865	1
chr12	37835132	37906115	Meox2	70983	+	NM_008584	37835417	37904964	3
chr12	37968225	38308519	Agmo	340294	+	NM_178767	37968628	38308111	13
chr12	38607291	39359997	Dgkb	752706	+	NM_178681	38708527	39357277	25
chr12	39279395	39341108	4930428E07Rik	61713	-	NR_045943	39341108	39341108	9
chr12	39506844	39594802	Etv1	87958	+	NM_007960	39507521	39592356	13
chr12	40759877	40764574	Arl4a	4697	-	NM_001039515	40762730	40763333	2
chr12	40786357	40860815	Scin	74458	-	NM_001146196	40787086	40860695	16
chr12	40902972	40925902	Lsmem1	22930	-	NM_001033437	40903684	40912002	4
chr12	40929715	40949776	Ifrd1	20061	-	NM_013562	40929948	40949543	12
chr12	40949298	40949398	Mir1938	100	-	NR_035459	40949398	40949398	1
chr12	40949950	40955770	Gm7008	5820	+	NR_045157	40955770	40955770	3
chr12	41041632	41172377	Zfp277	130745	-	NM_172575	41042303	41172346	13
chr12	41172639	41573075	Dock4	400436	+	NM_172803	41172944	41571252	53
chr12	41750676	43056575	Immp2l	1305899	+	NM_053122	41794898	43056087	7
chr12	42178254	42212644	Lrrn3	34390	-	NM_001271708	42178779	42180903	3
chr12	45306883	45311055	Dnajb9	4172	-	NM_013760	45307940	45309290	3
chr12	45311299	45311360	Mir5627	61	+	NR_049203	45311360	45311360	1
chr12	45322342	45325367	Gm2027	3025	+	NR_045113	45325367	45325367	1
chr12	45370140	45414422	Pnpla8	44282	+	NM_026164	45383653	45412586	10
chr12	45429871	45702833	Nrcam	272962	+	NM_176930	45633540	45699574	31
chr12	45953472	46175470	Stxbp6	221998	-	NM_144552	45956840	46120607	6
chr12	47795503	47919762	Nova1	124259	-	NM_021361	47800955	47919738	5
chr12	50483869	50487854	Foxg1	3985	+	NM_001160112	50485472	50486918	1
chr12	50490638	50508333	3110039M20Rik	17695	+	NR_026733	50508333	50508333	3
chr12	50577979	50581849	1810007C17Rik	3870	-	NR_045472	50581849	50581849	3
chr12	51442218	51750210	Prkd1	307992	-	NM_008858	51442988	51749960	19
chr12	52106142	52163530	1700008C04Rik	57388	+	NR_126468	52163530	52163530	5
chr12	52449216	52477973	G2e3	28757	+	NM_001167963	52452395	52473709	16
chr12	52478499	52551089	Scfd1	72590	+	NM_029825	52478571	52550917	25
chr12	52694327	52706760	Coch	12433	+	NM_001198835	52694610	52706019	12
chr12	52709527	52792901	Strn3	83374	-	NM_052973	52711089	52792690	18
chr12	52791952	52839926	Ap4s1	47974	+	NM_021710	52817999	52839668	6
chr12	52844708	52930523	Hectd1	85815	-	NM_144788	52845507	52928478	43
chr12	52976859	53072308	Heatr5a	95449	-	NM_177171	52978298	53062545	36
chr12	53098493	53107488	Dtd2	8995	-	NM_029545	53100534	53107472	3
chr12	53123990	53129050	Gpr33	5060	-	NM_008159	53124221	53125241	2
chr12	53198732	53411946	Nubpl	213214	+	NM_029760	53198770	53411751	11
chr12	53617063	53668838	Arhgap5	51775	+	NM_009706	53617234	53668325	6
chr12	53700970	53703309	1700031P21Rik	2339	-	NR_045910	53703309	53703309	3
chr12	53800369	54252002	Akap6	451633	+	NM_198111	53896857	54243715	14
chr12	54349663	55173162	Npas3	823499	+	NM_013780	54349663	55170061	12
chr12	55279967	55304861	Egln3	24894	-	NM_028133	55281610	55304548	5
chr12	55334601	55343307	1700104L18Rik	8706	+	NR_108033	55343307	55343307	3
chr12	55488719	55492305	Gm7550	3586	-	NR_033689	55492305	55492305	2
chr12	55746360	55757559	Sptssa	11199	-	NM_134054	55747418	55757470	2
chr12	55746919	55746999	Mir1892	80	-	NR_035439	55746999	55746999	1
chr12	55774453	55796852	Eapp	22399	-	NM_025456	55774569	55796771	6
chr12	55847343	55896649	Snx6	49306	-	NM_026998	55847992	55896640	14
chr12	55959805	55963864	Cfl2	4059	-	NM_007688	55962111	55963733	4
chr12	55993975	56087323	Baz1a	93348	-	NM_013815	55995291	56086765	27
chr12	56146647	56181097	2700097O09Rik	34450	-	NM_028314	56146813	56181064	8
chr12	56225514	56243069	1700047I17Rik2	17555	+	NM_001100116	56225628	56239966	5
chr12	56225514	56243069	Fam177a	17555	+	NM_028527	56225628	56239966	5
chr12	56256090	56290200	Srp54b	34110	+	NM_001100109	56265248	56288938	16
chr12	56256326	56365681	Srp54a	109355	+	NM_011899	56265248	56363205	16
chr12	56331464	56364007	Srp54c	32543	+	NM_001100110	56340312	56363205	16
chr12	56381800	56403987	Ppp2r3c	22187	-	NM_021529	56382603	56403638	14
chr12	56403623	56483478	1110008L16Rik	79855	+	NM_025373	56404894	56483387	7
chr12	56485208	56519446	Psma6	34238	+	NM_001310583	56485295	56519281	7
chr12	56590395	56593634	Nfkbia	3239	-	NM_010907	56590908	56593513	6
chr12	56666191	56667883	Aldoart2	1692	+	NM_001277340	56666278	56667373	1
chr12	56699903	56703004	Insm2	3101	+	NM_020287	56700459	56701941	1
chr12	56703876	56922503	Ralgapa1	218627	-	NM_001286263	56713082	56921754	42
chr12	56937352	56970722	Brms1l	33370	+	NM_001037756	56937490	56969266	10
chr12	57354229	57367368	Gm19990	13139	+	NR_045048	57367368	57367368	4
chr12	57429293	57446881	Mbip	17588	-	NM_145442	57429681	57446787	9
chr12	57591414	57630407	E030019B13Rik	38993	-	NR_045082	57630407	57630407	7
chr12	57632923	57637895	Nkx2-1	4972	-	NM_009385	57634021	57636047	3
chr12	57692045	57695541	C87198	3496	+	NR_046003	57695541	57695541	5
chr12	57712383	57714271	Nkx2-9	1888	-	NM_008701	57712706	57714046	2
chr12	57796457	57813809	Pax9	17352	+	NM_011041	57796847	57810894	4
chr12	57813620	58298459	Slc25a21	484839	-	NM_172577	57814799	58297926	10
chr12	58331398	58343155	Prps1l3	11757	+	NM_001037746	58339412	58340369	2
chr12	58331411	58558228	Mipol1	226817	+	NM_001164370	58404404	58558174	10
chr12	58641618	58647108	Foxa1	5490	-	NM_008259	58643012	58646722	2
chr12	58665101	58838891	Ttc6	173790	+	NM_001312644	58676803	58838707	32
chr12	58686961	58719589	4921518K17Rik	32628	-	NR_131110	58719589	58719589	5
chr12	58762444	58763898	BC042761	1454	-	NR_131112	58763898	58763898	3
chr12	59312790	59317023	Sstr1	4233	+	NM_009216	59313579	59314755	2
chr12	59365706	59370245	Clec14a	4539	-	NM_025809	59368441	59369821	1
chr12	60059370	60113004	Sec23a	53634	-	NM_009147	60060983	60108197	20
chr12	60114377	60129457	Gemin2	15080	+	NM_025656	60114463	60128763	10
chr12	60144078	60162459	Trappc6b	18381	-	NM_001306218	60144631	60152662	7
chr12	60167905	60175004	Pnn	7099	+	NM_008891	60167989	60173800	9
chr12	60196786	60210117	Mia2	13331	+	NM_177321	60196786	60210043	4
chr12	60230732	60291207	Ctage5	60475	+	NM_146034	60230856	60290786	25
chr12	60301641	60320470	Fbxo33	18829	-	NM_001033156	60303394	60320466	4
chr12	61837949	61837970	Mir6380	21	+	NR_105801	61837970	61837970	1
chr12	62600646	62622807	Gm20063	22161	-	NR_045049	62622807	62622807	3
chr12	62624153	62958916	Lrfn5	334763	+	NM_001310586	62940414	62958538	6
chr12	63788773	63789323	Spanxn4	550	+	NR_131949	63789323	63789323	1
chr12	65572319	65575885	Fscb	3566	-	NM_001163271	65572488	65575677	1
chr12	66018897	66025578	Gm527	6681	+	NM_001025605	66021792	66025330	5
chr12	66043426	66066523	Klhl28	23097	-	NM_025707	66044436	66058724	5
chr12	66066728	66123560	Fam179b	56832	+	NM_177805	66066963	66122692	20
chr12	66137320	66164373	Prpf39	27053	+	NM_177806	66143476	66162467	14
chr12	66163418	66174925	Fkbp3	11507	-	NM_013902	66163672	66174909	7
chr12	66176592	66233045	Fancm	56453	+	NM_178912	66176692	66231436	23
chr12	66233720	66273567	Mis18bp1	39847	-	NM_172578	66234517	66262924	14
chr12	66326503	66329441	Wdr20rt	2938	+	NM_027614	66326751	66328455	2
chr12	67384365	67385388	Rpl10l	1023	-	NM_001162933	67384699	67385344	1
chr12	67567045	68323536	Mdga2	756491	-	NM_001193266	67572501	68322029	17
chr12	68757728	68770258	Gm17821	12530	-	NR_033146	68770258	68770258	1
chr12	70258708	70260173	Rps29	1465	-	NM_009093	70258799	70260045	3
chr12	70269800	70279997	Lrr1	10197	+	NM_001081406	70269842	70279807	4
chr12	70283720	70285054	Rpl36al	1334	-	NM_025589	70283802	70284123	2
chr12	70285144	70287760	Mgat2	2616	+	NM_146035	70285640	70286969	1
chr12	70290073	70299416	Dnaaf2	9343	-	NM_027269	70290874	70299272	3
chr12	70298197	70300855	9330151L19Rik	2658	+	NR_033222	70300855	70300855	2
chr12	70302765	70329177	Pole2	26412	-	NM_011133	70302850	70329151	19
chr12	70342818	70384948	Klhdc1	42130	+	NM_178253	70342904	70384306	13
chr12	70397667	70411674	Klhdc2	14007	+	NM_027117	70397981	70411263	13
chr12	70412529	70458163	Nemf	45634	-	NM_025441	70412989	70458096	33
chr12	70473136	70476967	Arf6	3831	+	NM_007481	70473780	70474308	2
chr12	70565773	70576537	5830428M24Rik	10764	-	NR_038061	70576537	70576537	5
chr12	70678614	70684015	Vcpkmt	5401	-	NM_001033236	70678912	70683973	6
chr12	70684747	70782839	Sos2	98092	-	NM_001135559	70686109	70782588	23
chr12	70791422	70825861	L2hgdh	34439	-	NM_145443	70793287	70825783	10
chr12	70825948	70845645	Atp5s	19697	+	NM_026536	70838941	70844820	5
chr12	70847834	70891694	Cdkl1	43860	-	NM_183294	70848289	70891141	10
chr12	70864821	70864931	Mir681	110	-	NR_030450	70864931	70864931	1
chr12	70891330	70942867	4930512B01Rik	51537	+	NR_033573	70942867	70942867	8
chr12	70904743	70994150	Map4k5	89407	-	NM_201519	70906250	70993747	31
chr12	70944672	70954658	4931403G20Rik	9986	+	NR_038172	70954658	70954658	4
chr12	70994091	71065072	Atl1	70981	+	NM_178628	71008945	71064325	15
chr12	71064395	71070731	Gm3086	6336	+	NR_036607	71070731	71070731	3
chr12	71065998	71087989	Sav1	21991	-	NM_022028	71067126	71087754	5
chr12	71119726	71213022	Nin	93296	-	NR_104397	71213022	71213022	31
chr12	71255157	71284193	Abhd12b	29036	+	NM_001195033	71255157	71284193	13
chr12	71291801	71328670	Pygl	36869	-	NM_133198	71291969	71328570	20
chr12	71328827	71335152	F730035M05Rik	6325	+	NR_045174	71335152	71335152	5
chr12	71345520	71448601	Trim9	103081	-	NM_001286388	71347375	71448155	14
chr12	71554140	71568611	Tmx1	14471	+	NM_028339	71554155	71567143	8
chr12	71926500	72003221	Frmd6	76721	+	NM_028127	71965030	72000655	14
chr12	72038843	72065704	Actr10	26861	+	NM_019785	72038941	72063035	13
chr12	72075609	72096864	Psma3	21255	+	NM_011184	72075733	72095382	11
chr12	72092601	72116810	3110056K07Rik	24209	-	NR_045055	72116810	72116810	4
chr12	72116953	72200338	Arid4a	83385	+	NM_001081195	72118129	72198591	24
chr12	72212414	72224209	Tomm20l	11795	+	NM_029227	72212431	72224089	5
chr12	72224158	72237662	Timm9	13504	-	NM_013896	72224538	72227358	6
chr12	72237834	72344290	2700049A03Rik	106456	+	NM_001163378	72238826	72344082	30
chr12	72410870	72421094	Dact1	10224	+	NM_021532	72410970	72419881	4
chr12	72641593	72657120	4930404H11Rik	15527	+	NR_045941	72657120	72657120	3
chr12	72932054	73093363	Daam1	161309	+	NM_172464	72996750	73090875	26
chr12	73170604	73171978	Gpr135	1374	-	NM_181752	73170604	73171978	1
chr12	73174414	73186300	L3hypdh	11886	-	NM_026038	73174897	73186143	5
chr12	73186825	73202514	Jkamp	15689	+	NM_001205067	73187166	73201815	7
chr12	73202278	73286016	Ccdc175	83738	-	NM_028687	73202393	73285970	21
chr12	73312735	73510041	Rtn1	197306	-	NM_153457	73313521	73509538	9
chr12	73542852	73611552	Lrrc9	68700	+	NM_001142728	73550339	73611520	32
chr12	73637343	73681200	Pcnxl4	43857	+	NM_026327	73642406	73680542	11
chr12	73751339	73765815	Dhrs7	14476	-	NM_025522	73751559	73765748	7
chr12	73862197	73895927	Ppm1a	33730	+	NM_008910	73884689	73894728	6
chr12	73982095	74018752	4930447C04Rik	36657	-	NM_029444	73982214	74017858	18
chr12	74040868	74045886	Six6	5018	+	NM_011384	74041042	74042782	2
chr12	74142813	74147699	Six1	4886	-	NM_009189	74144521	74147413	2
chr12	74201245	74214232	Six4	12987	-	NM_011382	74204428	74214171	3
chr12	74224703	74374975	Mnat1	150272	+	NM_008612	74224824	74373521	8
chr12	74381396	74387698	Trmt5	6302	-	NM_029580	74381536	74387675	5
chr12	74387834	74455032	Slc38a6	67198	+	NM_001037717	74387911	74453524	16
chr12	74465061	74510550	D830013O20Rik	45489	-	NR_046013	74510550	74510550	4
chr12	74644100	74647382	Tmem30b	3282	-	NM_178715	74646264	74647326	1
chr12	74649469	74652973	2210039B01Rik	3504	+	NR_044985	74652973	74652973	4
chr12	74685782	74879171	Prkch	193389	+	NM_001313977	74695127	74878045	15
chr12	75002310	75048517	Hif1a	46207	+	NM_001313920	75027544	75046690	15
chr12	75065516	75085807	Snapc1	20291	+	NM_178392	75065548	75084884	10
chr12	75098747	75368903	Syt16	270156	+	NM_172804	75098837	75367938	7
chr12	75385262	75396937	1700086L19Rik	11675	+	NR_030734	75396937	75396937	5
chr12	75398460	75401455	Dbpht2	2995	+	NM_198866	75399789	75400176	1
chr12	75998203	76278319	Kcnh5	280116	-	NM_172805	75998493	76277515	11
chr12	76409299	76502442	Rhoj	93143	+	NM_023275	76409810	76501240	5
chr12	76512706	76517768	Gphb5	5062	-	NM_175644	76513813	76516800	3
chr12	76551867	76697187	Ppp2r5e	145320	-	NM_012024	76554700	76694312	14
chr12	76731580	76770524	Wdr89	38944	-	NM_028203	76733304	76734465	2
chr12	76731911	76732736	Rplp2-ps1	825	-	NR_038063	76732736	76732736	1
chr12	76815234	76836716	Sgpp1	21482	-	NM_030750	76817099	76836550	3
chr12	76919304	77211915	Syne2	292611	+	NM_001005510	76955055	77211031	116
chr12	77010089	77010172	Mir5101	83	+	NR_039560	77010172	77010172	1
chr12	77221405	77278246	Esr2	56841	-	NM_207707	77222716	77268662	10
chr12	77299676	77347733	Tex21	48057	-	NM_019784	77299779	77346132	10
chr12	77356218	77420807	Mthfd1	64589	+	NM_138745	77356490	77418683	28
chr12	77425877	77435138	Akap5	9261	+	NM_001101471	77428803	77431041	2
chr12	77449886	77470547	Zbtb25	20661	-	NM_028356	77450113	77457048	3
chr12	77471252	77489734	Zbtb1	18482	+	NM_178744	77486228	77488370	2
chr12	77505162	77507923	Hspa2	2761	+	NM_001002012	77505520	77507422	2
chr12	77518585	77540478	Ppp1r36	21893	+	NM_001163103	77518616	77540292	11
chr12	77545483	77549685	Gm10451	4202	+	NR_028520	77549685	77549685	2
chr12	77634120	77634199	Mir5135	79	-	NR_039597	77634199	77634199	1
chr12	77634546	77680026	Plekhg3	45480	+	NM_153804	77661154	77679395	19
chr12	77647958	77648912	AI463170	954	-	NR_046044	77648912	77648912	3
chr12	77681474	77811534	Sptb	130060	-	NM_013675	77684211	77750911	36
chr12	77866559	77884165	Churc1	17606	+	NM_206534	77866586	77883892	4
chr12	77893321	77896541	Gpx2	3220	-	NM_030677	77893636	77896362	2
chr12	77898949	77923511	Rab15	24562	-	NM_134050	77901229	77923304	7
chr12	77938453	78022399	Fntb	83946	+	NM_145927	77938494	78021194	12
chr12	78038255	78063235	Max	24980	-	NM_008558	78039554	78063012	5
chr12	78339090	78576983	Fut8	237893	+	NM_001252614	78433113	78576303	13
chr12	79327641	79785756	Gphn	458115	+	NM_172952	79327764	79784898	24
chr12	79792521	79835506	Fam71d	42985	+	NM_029069	79811257	79835376	9
chr12	79849933	79941700	Mpp5	91767	+	NM_019579	79898010	79938621	15
chr12	79943968	79962625	Atp6v1d	18657	-	NM_023721	79944455	79962446	9
chr12	79963058	79987997	Eif2s1	24939	+	NM_026114	79967513	79985903	8
chr12	79989683	80007925	Plek2	18242	-	NM_013738	79990166	80007919	9
chr12	80062781	80108264	Tmem229b	45483	-	NM_178745	80065638	80066142	3
chr12	80130149	80182642	Plekhh1	52493	+	NM_181073	80141526	80180580	29
chr12	80181657	80190657	Pigh	9000	-	NM_029988	80183390	80190606	4
chr12	80189691	80204926	9230116L04Rik	15235	-	NR_110486	80204926	80204926	3
chr12	80231774	80257288	Arg2	25514	+	NM_009705	80231856	80257018	8
chr12	80257003	80273445	Vti1b	16442	-	NM_016800	80257461	80273321	6
chr12	80276537	80292806	Rdh11	16269	-	NM_021557	80277131	80292777	7
chr12	80309899	80323651	Rdh12	13752	+	NM_030017	80310027	80323052	7
chr12	80333333	80397269	Zfyve26	63936	-	NM_001008550	80334952	80396657	42
chr12	80398268	80915677	Rad51b	517409	+	NM_009014	80401550	80914945	11
chr12	81018005	81037251	9430078K24Rik	19246	-	NR_131074	81037251	81037251	4
chr12	81208746	81214000	Zfp36l1	5254	-	NM_007564	81210575	81213862	2
chr12	81221532	81233831	2310015A10Rik	12299	-	NR_033514	81233831	81233831	3
chr12	81268528	81361358	Actn1	92830	-	NM_134156	81269308	81361078	21
chr12	81436833	81537588	Dcaf5	100755	-	NM_177267	81439496	81537385	9
chr12	81492599	81492664	Mir1843a	65	-	NR_037207	81492664	81492664	1
chr12	81492600	81492724	Scarna3b	124	-	NR_028544	81492724	81492724	1
chr12	81564081	81599122	Exd2	35041	+	NM_133798	81576755	81597984	9
chr12	81608192	81618941	2310002D06Rik	10749	+	NR_045490	81618941	81618941	3
chr12	81619976	81704883	Galnt16	84907	+	NM_001081421	81620155	81702819	15
chr12	81735009	81744848	Erh	9839	-	NM_007951	81735411	81744753	4
chr12	81745201	81784329	Slc39a9	39128	+	NM_026244	81745867	81780692	7
chr12	81787361	81793453	Plekhd1os	6092	-	NR_037995	81793453	81793453	2
chr12	81793587	81825203	Plekhd1	31616	+	NM_001177503	81793865	81823472	13
chr12	81856433	81861702	Ccdc177	5269	-	NM_001008423	81858364	81860485	2
chr12	81891518	81981820	Susd6	90302	+	NM_001242419	81929109	81978108	7
chr12	82024418	82025434	1700052I22Rik	1016	-	NR_033786	82025434	82025434	2
chr12	82043638	82046386	Gm20337	2748	-	NR_045057	82046386	82046386	3
chr12	82046490	82051494	Srsf5	5004	+	NM_009159	82047581	82050965	8
chr12	82054171	82069066	Slc10a1	14895	-	NM_001177561	82054621	82068931	5
chr12	82127794	82287401	Smoc1	159607	+	NM_022316	82128049	82285552	13
chr12	82267137	82267221	Mir3067	84	+	NR_037227	82267221	82267221	1
chr12	82298901	82434167	Slc8a3	135266	-	NM_080440	82300477	82417030	8
chr12	82459839	82586124	Cox16	126285	-	NM_001309810	82475452	82585952	5
chr12	82459839	82633898	Synj2bp-cox16	174059	-	NM_001309848	82460301	82633766	6
chr12	82477977	82480473	Gm4787	2496	-	NM_001038995	82478122	82480369	1
chr12	82520429	82523026	Adam4	2597	-	NM_009620	82520540	82522832	1
chr12	82593180	82633898	Synj2bp	40718	-	NM_025292	82603012	82633766	4
chr12	82659570	82669461	Adam21	9891	-	NM_020330	82659783	82661973	2
chr12	82674550	82695945	Med6	21395	-	NM_027213	82674816	82692269	8
chr12	82732235	82768546	Ttc9	36311	+	NM_001033149	82732391	82764582	3
chr12	82815936	82882157	Map3k9	66221	-	NM_001174107	82823025	82881861	11
chr12	82961016	83101911	Pcnx	140895	+	NM_018814	82961358	83097149	36
chr12	83271002	83552771	Sipa1l1	281769	+	NM_001167983	83441988	83550925	24
chr12	83717911	84263043	Rgs6	545132	+	NM_001310478	83752815	84258958	18
chr12	84033506	84040142	1700085C21Rik	6636	-	NR_046045	84040142	84040142	3
chr12	84314737	84828686	Dpf3	513949	-	NM_001267625	84316727	84828658	11
chr12	84861415	84882942	Dcaf4	21527	+	NM_030246	84867101	84882577	14
chr12	84887890	84938097	Zfyve1	50207	-	NM_183154	84888832	84935830	12
chr12	84973183	85024073	Rbm25	50890	+	NM_027349	84983593	85022545	19
chr12	85029512	85076149	Psen1	46637	+	NM_008943	85040514	85075021	12
chr12	85104583	85133334	Papln	28751	+	NM_001205343	85107107	85132957	28
chr12	85134983	85262884	Numb	127901	-	NR_073564	85262884	85262884	13
chr12	85291557	85293903	2410016O06Rik	2346	+	NM_023633	85291641	85293453	1
chr12	85328810	85334825	Acot2	6015	+	NM_134188	85328851	85334030	3
chr12	85350451	85358619	Acot1	8168	+	NM_012006	85350459	85358329	3
chr12	85379328	85385673	Acot4	6345	+	NM_134247	85379460	85384746	3
chr12	85393100	85400514	Acot3	7414	+	NM_134246	85394401	85399976	4
chr12	85410274	85416969	Acot5	6695	+	NM_145444	85410416	85416859	3
chr12	85441603	85450733	Acot6	9130	+	NM_172580	85441921	85450489	3
chr12	85455277	85484460	Dnal1	29183	+	NM_028821	85455346	85479344	8
chr12	85487080	85489439	Pnma1	2359	-	NM_027438	85487815	85488877	1
chr12	85490122	85559831	Elmsan1	69709	-	NM_001163501	85493351	85515128	13
chr12	85626245	85656782	Ptgr2	30537	+	NM_001252626	85637297	85654963	11
chr12	85657808	85685389	Zfp410	27581	+	NR_045615	85685389	85685389	10
chr12	85686266	85702771	Fam161b	16505	-	NM_172581	85687777	85702695	8
chr12	85702917	85714746	Coq6	11829	+	NM_172582	85703000	85714658	12
chr12	85714825	85749979	Entpd5	35154	-	NM_001026214	85718243	85737842	16
chr12	85750017	85774730	Bbof1	24713	+	NM_028377	85750131	85774256	12
chr12	85758149	85759528	Rnf113a2	1379	+	NM_025525	85758285	85759299	1
chr12	85771670	85791974	Aldh6a1	20304	-	NM_134042	85773393	85791889	12
chr12	85792457	85872483	Lin52	80026	+	NM_173756	85792462	85870695	6
chr12	85910777	85936407	Vsx2	25630	+	NM_007701	85910892	85934404	5
chr12	85943480	85958416	Abcd4	14936	-	NM_008992	85944040	85958270	19
chr12	85981968	85992405	Vrtn	10437	+	NM_001168589	85989427	85991650	2
chr12	86018227	86039757	Syndig1l	21530	-	NM_001033334	86019666	86021738	4
chr12	86095508	86114062	Npc2	18554	-	NM_023409	86098075	86113817	4
chr12	86114219	86116039	Isca2	1820	+	NM_028863	86114250	86115667	4
chr12	86124161	86217445	Ltbp2	93284	-	NM_013589	86125199	86217241	35
chr12	86216751	86220705	D030025P21Rik	3954	+	NR_028577	86220705	86220705	1
chr12	86259098	86311836	Arel1	52738	-	NM_178065	86261427	86284297	20
chr12	86311879	86324253	Fcf1	12374	+	NM_028632	86311912	86324167	8
chr12	86337270	86411465	Ylpm1	74195	+	NM_178363	86337439	86410715	21
chr12	86427763	86447381	Prox2	19618	-	NM_175198	86428318	86436377	5
chr12	86451782	86475041	Dlst	23259	+	NM_030225	86451846	86473703	15
chr12	86476545	86492214	Rps6kl1	15669	-	NM_146244	86477322	86490838	11
chr12	86507588	86518263	Pgf	10675	-	NM_008827	86508360	86517913	7
chr12	86560430	86567578	Eif2b2	7148	+	NM_145445	86560511	86567110	8
chr12	86575415	86611549	Mlh3	36134	-	NM_175337	86576571	86610360	12
chr12	86586872	86586935	Mir6938	63	-	NR_105903	86586935	86586935	1
chr12	86613347	86621385	Acyp1	8038	-	NM_025421	86613561	86621024	3
chr12	86629540	86640308	Zc2hc1c	10768	+	NM_172414	86630520	86637624	3
chr12	86640463	86680312	Nek9	39849	-	NM_145138	86642753	86680171	22
chr12	86681563	86715667	Tmed10	34104	-	NM_026775	86684377	86715615	5
chr12	86814850	86818219	Fos	3369	+	NM_010234	86814989	86817408	4
chr12	86940054	86980828	Jdp2	40774	+	NM_001205052	86949114	86979908	4
chr12	87027669	87050037	Batf	22368	+	NM_016767	87027860	87049702	3
chr12	87087488	87154535	Mfsd7c	67047	+	NM_145447	87087801	87153069	10
chr12	87156404	87165495	0610007P14Rik	9091	-	NM_021446	87157063	87163170	5
chr12	87165899	87394710	Ttll5	228811	+	NM_001081423	87167500	87365291	34
chr12	87397692	87419991	Tgfb3	22299	-	NM_009368	87398729	87418882	7
chr12	87423510	87503409	Ift43	79899	+	NM_001199843	87423536	87503247	9
chr12	87510290	87536052	Gm805	25762	+	NR_046081	87536052	87536052	5
chr12	87582827	87632318	Gpatch2l	49491	+	NM_027405	87584994	87629925	10
chr12	87702066	87862578	Esrrb	160512	+	NM_001159500	87702486	87860015	7
chr12	88019649	88036631	Vash1	16982	+	NM_177354	88020937	88032858	7
chr12	88041451	88067410	Angel1	25959	-	NM_144524	88043230	88067343	10
chr12	88075318	88104745	Lrrc74a	29427	+	NM_001195767	88075604	88103830	15
chr12	88221652	88225764	Irf2bpl	4112	-	NM_145836	88222519	88224847	1
chr12	88287990	88306316	Cipc	18326	+	NM_001289431	88301256	88303617	5
chr12	88324330	88329626	Zdhhc22	5296	-	NM_001080943	88324330	88329626	2
chr12	88367513	88430989	Tmem63c	63476	+	NM_172583	88397403	88430370	25
chr12	88438480	88443489	Ngb	5009	-	NM_022414	88439361	88443210	4
chr12	88447810	88488852	Pomt2	41042	-	NM_153415	88450137	88488578	21
chr12	88488114	88505673	Gstz1	17559	+	NM_001252555	88500619	88504780	10
chr12	88507191	88541179	Tmed8	33988	-	NM_001033475	88513363	88541153	6
chr12	88541492	88554488	Samd15	12996	+	NM_001290288	88541492	88554323	4
chr12	88562072	88579551	Noxred1	17479	-	NM_027744	88562204	88574506	8
chr12	88579824	88607236	Vipas39	27412	-	NM_001142580	88580765	88604947	20
chr12	88607677	88614902	Ahsa1	7225	+	NM_146036	88607791	88614713	9
chr12	88619587	88640655	Ism2	21068	-	NM_001290302	88620631	88640655	6
chr12	88646007	88729305	Sptlc2	83298	-	NM_011479	88650850	88729121	12
chr12	88769027	88784789	Alkbh1	15762	-	NM_001102565	88769790	88784774	6
chr12	88778628	88778707	Mir3068	79	-	NR_037228	88778707	88778707	1
chr12	88783797	88784967	Nrp	1170	-	NM_001013372	88784460	88784868	1
chr12	88784845	88790874	Slirp	6029	+	NM_026958	88784879	88790828	4
chr12	88790859	88813249	Snw1	22390	-	NM_025507	88791467	88813211	14
chr12	88855265	88859215	Gm8300	3950	+	NM_001177565	88857846	88858281	2
chr12	88959858	88963093	Gm4027	3235	+	NM_001177564	88962549	88962984	2
chr12	89055024	89059124	BB287469	4100	+	NM_001177573	89057768	89058203	2
chr12	89080291	89085164	Gm16381	4873	-	NM_001166062	89080412	89080634	2
chr12	89099797	89104138	Gm1995	4341	+	NR_033562	89104138	89104138	1
chr12	89112519	89116307	Gm2016	3788	+	NM_001122662	89115032	89115467	2
chr12	89131277	89135166	Gm2022	3889	+	NM_001177574	89133813	89134248	2
chr12	89192923	89199120	Oog1	6197	+	NM_178657	89192996	89198849	4
chr12	89192923	89199126	Gm2042	6203	+	NM_001270793	89192996	89198314	4
chr12	89320164	89569046	Gm21319	248882	+	NM_001270722	89322140	89322575	3
chr12	89414032	89420338	Gm10436	6306	-	NM_001105254	89414312	89420288	4
chr12	89509079	89512941	Gm5662	3862	-	NM_001013824	89509997	89510432	2
chr12	89521310	89525514	Gm7104	4204	-	NR_033570	89525514	89525514	1
chr12	89558565	89560206	Gm5039	1641	-	NR_003647	89560206	89560206	1
chr12	89598957	89700170	Adck1	101213	+	NM_001277296	89606789	89699636	11
chr12	89603757	89615767	3200001D21Rik	12010	-	NR_045888	89615767	89615767	3
chr12	90032947	91573373	Nrxn3	1540426	+	NM_001198587	90033628	91570850	20
chr12	91962991	91976878	Dio2	13887	-	NM_010050	91967851	91976724	2
chr12	92236931	92622849	Cep128	385918	-	NM_181815	92237962	92604929	26
chr12	92284287	92295075	5430427M07Rik	10788	+	NR_045858	92295075	92295075	4
chr12	92439828	92786285	Bc1	346457	-	NR_038088	92786285	92786285	3
chr12	92639432	92778949	Tshr	139517	+	NM_011648	92639524	92777024	10
chr12	92793701	92828927	Gtf2a1	35226	-	NM_175335	92798183	92825154	9
chr12	92871448	93024876	Ston2	153428	-	NM_175367	92878161	92982133	7
chr12	93044482	93087597	Sel1l	43115	-	NM_001039089	93048283	93087471	21
chr12	94654896	94683263	4930559C10Rik	28367	-	NR_126436	94683263	94683263	4
chr12	96930435	97023423	Flrt2	92988	+	NM_201518	97017099	97019082	2
chr12	97284830	97285432	1700019M22Rik	602	-	NR_103800	97285432	97285432	1
chr12	99440509	99497669	Galc	57160	-	NM_008079	99442150	99497539	17
chr12	99506844	99514932	Gpr65	8088	+	NM_008152	99513299	99514313	2
chr12	99667646	99816423	Kcnk10	148777	-	NM_029911	99673016	99816038	7
chr12	99866351	99908029	Spata7	41678	+	NM_001289574	99886638	99907881	12
chr12	99914950	99975615	Ptpn21	60665	-	NM_001146199	99916759	99971863	19
chr12	99985177	100025984	Zc3h14	40807	+	NM_029334	99985332	100024791	17
chr12	100024813	100139694	Eml5	114881	-	NM_001081191	100028559	100139238	44
chr12	100158783	100221448	Ttc8	62665	+	NM_029553	100158879	100220784	14
chr12	100399486	100401018	4930474N09Rik	1532	-	NR_038130	100401018	100401018	2
chr12	100433303	100688284	Foxn3	254981	-	NM_183186	100434476	100627113	6
chr12	100864262	100866184	1700064M15Rik	1922	-	NR_045288	100866184	100866184	2
chr12	100955740	101121652	Efcab11	165912	-	NM_030172	100957234	101121566	6
chr12	101122724	101193426	Tdp1	70702	+	NM_028354	101129393	101193246	16
chr12	101202708	101300892	Kcnk13	98184	+	NM_001164427	101204156	101300095	3
chr12	101350540	101361574	Psmc1	11034	+	NM_008947	101350540	101361402	10
chr12	101363659	101397863	Nrde2	34204	-	NM_001290303	101363815	101397813	14
chr12	101426177	101431748	Gm10433	5571	+	NR_045282	101431748	101431748	3
chr12	101437644	101448034	Calm1	10390	+	NM_009790	101437923	101444638	6
chr12	101514818	101539118	Gm10432	24300	+	NR_045741	101539118	101539118	4
chr12	101538979	101759032	Ttc7b	220053	-	NM_001033213	101539758	101758901	20
chr12	101787987	101963238	Rps6ka5	175251	-	NM_153587	101789653	101963090	18
chr12	102017332	102110820	9030617O03Rik	93488	+	NM_145448	102067838	102109663	13
chr12	102114891	102146408	Gpr68	31517	-	NM_001177673	102116395	102117493	3
chr12	102150909	102267193	Ccdc88c	116284	-	NM_026681	102151019	102267041	30
chr12	102259882	102259978	Mir1190	96	-	NR_035421	102259978	102259978	1
chr12	102277618	102321912	Smek1	44294	-	NM_001160214	102278878	102321080	15
chr12	102320660	102327137	D130020L05Rik	6477	+	NR_038047	102327137	102327137	4
chr12	102383818	102387483	Kif4-ps	3665	+	NR_033653	102387483	102387483	1
chr12	102642882	102864219	Catsperb	221337	+	NM_173023	102647538	102863952	27
chr12	102883655	102956733	Tc2n	73078	-	NM_001082976	102887304	102947700	12
chr12	102984774	103057329	Fbln5	72555	-	NM_011812	102988951	103056960	11
chr12	103075581	103151381	Trip11	75800	-	NM_028446	103075755	103151038	21
chr12	103157110	103196453	Atxn3	39343	-	NM_029705	103161316	103196367	11
chr12	103214183	103244203	Cpsf2	30020	+	NM_016856	103220156	103241431	15
chr12	103367628	103504959	Slc24a4	137331	+	NM_172152	103367650	103504707	17
chr12	103521283	103629064	Rin3	107781	+	NM_177620	103521495	103628354	10
chr12	103632307	103677907	Lgmn	45600	-	NM_011175	103632779	103661938	14
chr12	103707343	103736117	Golga5	28774	+	NM_001199004	103710237	103735737	13
chr12	103793150	103803237	Chga	10087	+	NM_007693	103793334	103802903	8
chr12	103806792	103943079	Itpk1	136287	-	NM_172584	103808335	103943026	10
chr12	103923137	103923230	Mir1936	93	-	NR_035457	103923230	103923230	1
chr12	103978039	103981871	Moap1	3832	-	NM_001142937	103980439	103981498	2
chr12	103978039	103996020	Gm20604	17981	-	NM_001142939	103981581	103995955	2
chr12	103981969	103983607	Tmem251	1638	+	NM_177140	103982296	103983221	2
chr12	103991484	103996020	AK010878	4536	-	NM_001142938	103992284	103995955	2
chr12	103996184	104015911	Ubr7	19727	+	NM_025666	103996238	104013996	11
chr12	104022857	104116616	Btbd7	93759	-	NM_172806	104023320	104078391	12
chr12	104137515	104138744	Cox8c	1229	+	NM_001039049	104137575	104138547	2
chr12	104187068	104422207	Unc79	235139	+	NM_001081017	104187763	104421823	49
chr12	104435117	104480356	Prima1	45239	-	NM_133364	104435458	104479642	5
chr12	104553168	104555275	Fam181a	2107	+	NM_001195726	104554047	104554926	2
chr12	104559351	104594211	Asb2	34860	-	NM_023049	104559747	104584071	10
chr12	104615103	104644560	Otub2	29457	+	NR_033587	104644560	104644560	6
chr12	104646185	104664077	Ddx24	17892	-	NM_020494	104646421	104662802	9
chr12	104672082	104681890	Ifi27l2a	9808	-	NM_001281830	104672445	104681843	4
chr12	104672398	104678455	Ifi27	6057	+	NM_026790	104673665	104678381	7
chr12	104689107	104695433	Ifi27l2b	6326	-	NM_145449	104689284	104695369	7
chr12	104770774	104852042	Ppp4r4	81268	+	NM_028980	104770829	104851042	25
chr12	104854884	104869654	Serpina10	14770	-	NM_144834	104855046	104867168	5
chr12	104884840	104895428	Serpina6	10588	-	NM_007618	104885055	104892698	5
chr12	104907017	104914972	Serpina16	7955	-	NM_001310472	104907106	104913674	6
chr12	104926253	104933739	Serpina1f	7486	-	NM_026687	104927941	104932231	6
chr12	104966365	104976399	Serpina1b	10034	-	NM_009244	104966451	104970798	5
chr12	105001796	105011843	Serpina1d	10047	-	NM_009246	105001889	105006253	5
chr12	105091504	105101829	Serpina1a	10325	-	NM_001252569	105091884	105098688	6
chr12	105133135	105143160	Serpina1c	10025	-	NM_009245	105133221	105137595	5
chr12	105185141	105195107	Serpina1e	9966	-	NM_009247	105185227	105189618	5
chr12	105218452	105228167	Serpina11	9715	-	NM_001166350	105218566	105224719	5
chr12	105234829	105251862	Serpina9	17033	-	NM_027997	105235200	105247102	5
chr12	105266978	105282653	Serpina12	15675	-	NM_026535	105269228	105276581	5
chr12	105316168	105325130	Serpina4-ps1	8962	+	NR_002861	105325130	105325130	4
chr12	105339322	105344347	Serpina5	5025	+	NM_172953	105339891	105343563	5
chr12	105350933	105360106	Serpina3a	9173	+	NM_001167705	105354179	105359728	5
chr12	105366205	105377755	Serpina3b	11550	+	NM_173024	105368671	105377039	5
chr12	105385116	105392082	Serpina3c	6966	-	NM_008458	105385441	105390287	5
chr12	105452753	105459339	Serpina3f	6586	+	NM_001168294	105455090	105458724	6
chr12	105452753	105480144	Serpina3g	27391	+	NM_009251	105455090	105479536	6
chr12	105486105	105492615	Serpina3h	6510	+	NR_033450	105492615	105492615	5
chr12	105501331	105507575	Serpina3i	6244	+	NM_001199940	105503315	105506848	6
chr12	105552779	105558796	Serpina3j	6017	+	NM_001101472	105552779	105558060	4
chr12	105576695	105583949	Serpina3k	7254	+	NM_011458	105578720	105583631	5
chr12	105625373	105632467	Serpina3m	7094	+	NM_009253	105627285	105632137	5
chr12	105644917	105652539	Serpina3n	7622	+	NM_009252	105646880	105651816	5
chr12	105709418	105711446	Gsc	2028	-	NM_010351	105709700	105711325	3
chr12	105925951	105990162	Dicer1	64211	-	NM_148948	105929802	105970123	27
chr12	106001323	106103286	Clmn	101963	-	NR_104435	106103286	106103286	15
chr12	106168142	106248019	Syne3	79877	-	NM_172500	106170374	106214003	17
chr12	106268826	106270489	Snhg10	1663	-	NR_003145	106270489	106270489	2
chr12	106269286	106269351	Mir3069	65	-	NR_037229	106269351	106269351	1
chr12	106269286	106269559	Scarna13	273	-	NR_028576	106269559	106269559	1
chr12	106270827	106279121	Glrx5	8294	+	NM_028419	106270909	106278660	2
chr12	106385242	106393435	Tcl1b2	8193	+	NM_013775	106385299	106392311	4
chr12	106397913	106404835	Tcl1b1	6922	+	NM_013773	106397970	106403724	4
chr12	106414567	106419355	Tcl1b5	4788	+	NM_013776	106414624	106418245	4
chr12	106429254	106433609	Tcl1b3	4355	+	NM_013772	106429310	106432710	4
chr12	106440631	106445203	Tcl1b4	4572	+	NM_013774	106440688	106444106	4
chr12	106454964	106460947	Tcl1	5983	-	NR_110339	106460947	106460947	4
chr12	106574803	106622142	Tunar	47339	+	NR_045047	106622142	106622142	3
chr12	106633065	106641970	Gm2721	8905	-	NR_045085	106641970	106641970	3
chr12	106692065	106731305	D430019H16Rik	39240	+	NM_001252508	106692333	106726039	2
chr12	106751642	106753458	AU015791	1816	+	NR_102381	106753458	106753458	5
chr12	106801381	106831281	Bdkrb2	29900	+	NM_009747	106826439	106830890	3
chr12	106842300	106843638	Bdkrb1	1338	+	NM_007539	106842386	106843391	1
chr12	106851748	106923451	Atg2b	71703	-	NM_029654	106855282	106923040	42
chr12	106923561	106941267	Gskip	17706	+	NM_178613	106923654	106939009	3
chr12	106944191	107020657	Ak7	76466	+	NM_030187	106944374	107019919	18
chr12	107022911	107077153	Papola	54242	+	NM_011112	107023116	107075070	22
chr12	107248472	107315620	Vrk1	67148	+	NM_011705	107274754	107313248	15
chr12	107680861	107685876	1700121N20Rik	5015	-	NR_036593	107685876	107685876	4
chr12	107923816	107954534	4933406K04Rik	30718	-	NR_015512	107954534	107954534	8
chr12	108961952	108973698	4930465M20Rik	11746	-	NR_045973	108973698	108973698	3
chr12	109148612	109241624	Bcl11b	93012	-	NM_001079883	109153609	109241353	4
chr12	109344640	109417494	Setd3	72854	-	NM_028262	109345441	109403375	13
chr12	109417947	109441569	Ccnk	23622	+	NM_009832	109424635	109440911	12
chr12	109444554	109513627	Ccdc85c	69073	-	NM_001159910	109444554	109513343	6
chr12	109544479	109566510	Hhipl1	22031	+	NM_001044380	109544620	109566422	9
chr12	109572590	109600444	Cyp46a1	27854	+	NM_010010	109572655	109599894	15
chr12	109609362	109777774	Eml1	168412	+	NM_001286346	109609534	109776438	22
chr12	109774611	109793828	Gm16596	19217	-	NR_045751	109793828	109793828	5
chr12	109792929	109926725	Evl	133796	+	NM_001163394	109793418	109926276	14
chr12	109896829	109896928	Mir342	99	+	NR_029771	109896928	109896928	1
chr12	109925001	109940516	Degs2	15515	-	NM_001171002	109927261	109940452	3
chr12	110031520	110054842	Yy1	23322	+	NM_009537	110031622	110053865	5
chr12	110064087	110074086	Slc25a29	9999	-	NM_181328	110064939	110073895	4
chr12	110075182	110075278	Mir345	96	+	NR_029773	110075278	110075278	1
chr12	110089338	110095025	Slc25a47	5687	+	NM_001012310	110089389	110094429	6
chr12	110098239	110132384	Wars	34145	-	NM_001164314	110099474	110126696	10
chr12	110132481	110266662	Wdr25	134181	+	NM_177602	110136140	110265677	7
chr12	110270391	110306427	Begain	36036	-	NM_001163175	110271193	110306377	7
chr12	110691032	110701546	Dlk1	10514	+	NR_033813	110701546	110701546	6
chr12	110779205	110809939	Meg3	30734	+	NR_027652	110809939	110809939	10
chr12	110801901	110801995	Mir770	94	+	NR_030427	110801995	110801995	1
chr12	110810199	110810290	Mir673	91	+	NR_030438	110810290	110810290	1
chr12	110818442	110818525	Mir493	83	+	NR_030573	110818525	110818525	1
chr12	110823998	110824095	Mir337	97	+	NR_029765	110824095	110824095	1
chr12	110824022	110824083	Mir3544	61	-	NR_049184	110824083	110824083	1
chr12	110824289	110824356	Mir540	67	+	NR_030260	110824356	110824356	1
chr12	110824523	110824617	Mir665	94	+	NR_030425	110824617	110824617	1
chr12	110826152	110826241	Mir3070a	89	+	NR_037230	110826241	110826241	1
chr12	110826801	110826890	Mir3070b	89	+	NR_037231	110826890	110826890	1
chr12	110828378	110833613	Rtl1	5235	-	NM_184109	110828378	110833613	1
chr12	110828656	110828747	Mir431	91	+	NR_029951	110828747	110828747	1
chr12	110829746	110831061	6430411K18Rik	1315	+	NR_002848	110831061	110831061	1
chr12	110829924	110830048	Mir433	124	+	NR_029952	110830048	110830048	1
chr12	110831055	110831125	Mir127	70	+	NR_029542	110831125	110831125	1
chr12	110832715	110832809	Mir434	94	+	NR_029953	110832809	110832809	1
chr12	110833165	110833240	Mir432	75	+	NR_035526	110833240	110833240	1
chr12	110833527	110833607	Mir3071	80	-	NR_037232	110833607	110833607	1
chr12	110833536	110833598	Mir136	62	+	NR_029550	110833598	110833598	1
chr12	110842154	110899921	Rian	57767	+	NR_028261	110899921	110899921	21
chr12	110849709	110849805	Mir341	96	+	NR_029770	110849805	110849805	1
chr12	110850031	110850151	Mir1188	120	+	NR_035419	110850151	110850151	1
chr12	110856467	110856546	Mir370	79	+	NR_029918	110856546	110856546	1
chr12	110874221	110874290	AF357425	69	+	NR_046302	110874290	110874290	1
chr12	110881047	110881114	AF357426	67	+	NR_046303	110881114	110881114	1
chr12	110887826	110887897	DQ267100	71	+	NR_046304	110887897	110887897	1
chr12	110888918	110888948	AF357359	30	+	NR_028434	110888948	110888948	1
chr12	110889633	110889705	DQ267101	72	+	NR_046305	110889705	110889705	1
chr12	110892836	110892907	AF357355	71	+	NR_028433	110892907	110892907	1
chr12	110894554	110894625	DQ267102	71	+	NR_046306	110894625	110894625	1
chr12	110920406	110920483	Mir882	77	+	NR_030540	110920483	110920483	1
chr12	110947269	110947335	Mir379	66	+	NR_029880	110947335	110947335	1
chr12	110948384	110948466	Mir411	82	+	NR_029916	110948466	110948466	1
chr12	110948847	110948910	Mir299a	63	+	NR_029650	110948910	110948910	1
chr12	110948854	110948903	Mir299b	49	-	NR_049185	110948903	110948903	1
chr12	110950012	110950073	Mir380	61	+	NR_029881	110950073	110950073	1
chr12	110950526	110950646	Mir1197	120	+	NR_035429	110950646	110950646	1
chr12	110950717	110950803	Mir323	86	+	NR_029757	110950803	110950803	1
chr12	110951019	110951100	Mir758	81	+	NR_030421	110951100	110951100	1
chr12	110951690	110951787	Mir329	97	+	NR_029762	110951787	110951787	1
chr12	110953527	110953612	Mir494	85	+	NR_030269	110953612	110953612	1
chr12	110953786	110953860	Mir679	74	+	NR_030445	110953860	110953860	1
chr12	110953880	110954001	Mir1193	121	+	NR_035424	110954001	110954001	1
chr12	110955294	110955393	Mir666	99	+	NR_030435	110955393	110955393	1
chr12	110955467	110955543	Mir543	76	+	NR_030261	110955543	110955543	1
chr12	110956963	110957026	Mir495	63	+	NR_030446	110957026	110957026	1
chr12	110958215	110958307	Mir667	92	+	NR_030426	110958307	110958307	1
chr12	110960927	110961012	Mir376c	85	+	NR_030270	110961012	110961012	1
chr12	110961427	110961511	Mir654	84	+	NR_030578	110961511	110961511	1
chr12	110961667	110961749	Mir376b	82	+	NR_029915	110961749	110961749	1
chr12	110961990	110962058	Mir376a	68	+	NR_029877	110962058	110962058	1
chr12	110962522	110962601	Mir300	79	+	NR_029651	110962601	110962601	1
chr12	110965031	110965106	Mir381	75	+	NR_029882	110965106	110965106	1
chr12	110965542	110965624	Mir487b	82	+	NR_030271	110965624	110965624	1
chr12	110966338	110966412	Mir539	74	+	NR_030262	110966412	110966412	1
chr12	110967534	110967612	Mir544	78	+	NR_030610	110967612	110967612	1
chr12	110971980	110972056	Mir382	76	+	NR_029883	110972056	110972056	1
chr12	110972348	110972419	Mir134	71	+	NR_029548	110972419	110972419	1
chr12	110972941	110973007	Mir668	66	+	NR_030424	110973007	110973007	1
chr12	110973111	110973184	Mir485	73	+	NR_030253	110973184	110973184	1
chr12	110973190	110987667	Mirg	14477	+	NR_028265	110987667	110987667	8
chr12	110973828	110973910	Mir453	82	+	NR_030559	110973910	110973910	1
chr12	110976642	110976708	Mir154	66	+	NR_029564	110976708	110976708	1
chr12	110977328	110977407	Mir496a	79	+	NR_030437	110977407	110977407	1
chr12	110978719	110978787	Mir377	68	+	NR_029878	110978787	110978787	1
chr12	110980618	110980708	Mir541	90	+	NR_030263	110980708	110980708	1
chr12	110981367	110981446	Mir409	79	+	NR_029913	110981446	110981446	1
chr12	110981498	110981578	Mir412	80	+	NR_029917	110981578	110981578	1
chr12	110981627	110981706	Mir369	79	+	NR_030272	110981706	110981706	1
chr12	110981924	110982005	Mir410	81	+	NR_029914	110982005	110982005	1
chr12	110986087	110986170	Mir3072	83	+	NR_037233	110986170	110986170	1
chr12	111389863	111396283	3110009F21Rik	6420	-	NR_045466	111396283	111396283	3
chr12	111513594	111516278	Dio3os	2684	-	NR_002866	111516278	111516278	4
chr12	111516257	111516339	Mir1247	82	-	NR_037204	111516339	111516339	1
chr12	111517439	111519307	Dio3	1868	+	NM_172119	111517441	111518356	1
chr12	111685388	111809900	Ppp2r5c	124512	+	NM_001135001	111685568	111809011	14
chr12	111829583	111830889	B930059L03Rik	1306	+	NR_033340	111830889	111830889	1
chr12	111839604	111905154	Dync1h1	65550	+	NM_030238	111839814	111904901	77
chr12	111905898	111920829	1700001K19Rik	14931	-	NM_025488	111906016	111909027	6
chr12	111929245	111934605	Hsp90aa1	5360	-	NM_010480	111929749	111933890	11
chr12	111976158	112033238	Wdr20	57080	+	NM_027149	111976238	112032601	3
chr12	112046007	112079149	Mok	33142	-	NM_011973	112046250	112078962	12
chr12	112088488	112108208	Zfp839	19720	+	NM_028365	112088527	112107288	8
chr12	112110819	112127355	Cinp	16536	-	NM_027223	112112136	112127282	6
chr12	112127473	112210606	Tecpr2	83133	+	NM_175336	112169626	112207230	21
chr12	112213562	112217231	Ankrd9	3669	-	NM_175207	112214728	112215709	3
chr12	112232607	112252082	6030440G07Rik	19475	+	NR_036598	112252082	112252082	3
chr12	112278008	112351597	Rcor1	73589	+	NM_198023	112278183	112350126	12
chr12	112398060	112422702	4930595D18Rik	24642	-	NR_130987	112422702	112422702	4
chr12	112404580	112505366	Traf3	100786	+	NM_011632	112475789	112500271	12
chr12	112509306	112514637	Amn	5331	+	NM_033603	112509332	112514340	12
chr12	112531182	112615929	Cdc42bpb	84747	-	NM_183016	112532311	112615482	37
chr12	112645019	112650288	A230065H16Rik	5269	+	NM_001101503	112646756	112650056	4
chr12	112655640	112669891	Exoc3l4	14251	+	NM_001289487	112660289	112669063	14
chr12	112680871	112693229	Tnfaip2	12358	+	NM_009396	112683154	112691773	12
chr12	112722819	112724034	Gm266	1215	-	NM_001033248	112723378	112723981	1
chr12	112776311	112784964	Eif5	8653	+	NM_173363	112777826	112782829	12
chr12	112779156	112779277	Snora28	121	+	NR_033168	112779277	112779277	1
chr12	112810527	112812613	2810029C07Rik	2086	-	NR_045295	112812613	112812613	2
chr12	112812720	112894438	Mark3	81718	+	NM_021516	112813261	112893826	17
chr12	112907565	112910549	Ckb	2984	-	NM_021273	112907773	112910169	8
chr12	112916315	112922113	Trmt61a	5798	+	NM_001099793	112916842	112921080	4
chr12	112947703	112951467	Bag5	3764	-	NM_027404	112948254	112949598	2
chr12	112951479	112993266	Apopt1	41787	+	NM_001163388	112951503	112993191	6
chr12	112997078	113046055	Klc1	48977	+	NM_001025362	113010530	113044278	15
chr12	113041402	113052090	Xrcc3	10688	-	NM_028875	113042654	113050326	8
chr12	113052380	113066599	Zfyve21	14219	+	NM_026752	113052450	113066064	7
chr12	113066668	113146266	Ppp1r13b	79598	-	NM_011625	113067552	113146081	17
chr12	113180201	113182693	5033406O09Rik	2492	-	NR_029464	113182693	113182693	3
chr12	113199586	113205188	2010107E04Rik	5602	-	NM_027360	113199720	113201564	4
chr12	113209769	113307065	Tdrd9	97296	+	NM_029056	113209852	113306491	36
chr12	113217533	113218962	Rd3l	1429	-	NM_001127685	113217660	113218551	3
chr12	113344893	113365784	Aspg	20891	+	NM_001081169	113345102	113364956	15
chr12	113347448	113347533	Mir3073a	85	+	NR_037234	113347533	113347533	1
chr12	113347460	113347520	Mir3073b	60	-	NR_049197	113347520	113347520	1
chr12	113369090	113369166	Mir203	76	+	NR_029590	113369166	113369166	1
chr12	113384418	113419958	Kif26a	35540	+	NM_001097621	113384575	113418843	16
chr12	113649233	113661409	A730018C14Rik	12176	-	NR_036459	113661409	113661409	4
chr12	113666494	113673549	B020018J22Rik	7055	-	NR_045950	113673549	113673549	3
chr12	113727658	113738138	A530016L24Rik	10480	+	NM_177039	113733214	113736274	5
chr12	113738394	113749371	Tmem179	10977	-	NM_178915	113739953	113749259	4
chr12	113826994	113853768	Inf2	26774	+	NM_198411	113838213	113850814	23
chr12	113858257	113879566	Adssl1	21309	+	NM_007421	113858329	113879221	13
chr12	113883038	113887363	Siva1	4325	+	NM_013929	113883177	113887248	4
chr12	113892031	113912487	Akt1	20456	-	NM_001165894	113892834	113909772	14
chr12	113897487	113897562	Mir6939	75	-	NR_105904	113897562	113897562	1
chr12	113917050	113920958	Zbtb42	3908	+	NM_001100460	113917603	113918866	2
chr12	113960384	113984802	Cep170b	24418	+	NM_001024602	113962861	113983123	19
chr12	113971532	113971602	Mir6940	70	+	NR_105905	113971602	113971602	1
chr12	113998865	114007197	Pld4	8332	+	NM_178911	113998967	114006833	11
chr12	114047185	114054456	BC022687	7271	+	NM_145450	114047599	114053921	5
chr12	114058445	114067600	Cdca4	9155	-	NM_028023	114059603	114060317	2
chr12	114089086	114099127	Gpr132	10041	-	NM_019925	114090266	114094053	3
chr12	114146800	114167706	Jag2	20906	-	NM_010588	114147099	114167695	26
chr12	114158693	114158752	Mir6941	59	-	NR_105906	114158752	114158752	1
chr12	114172501	114180353	Nudt14	7852	-	NM_001316724	114173020	114180282	5
chr12	114198072	114238832	Brf1	40760	-	NM_028193	114198531	114238567	18
chr12	114214692	114217151	Btbd6	2459	+	NM_001145900	114214969	114216747	5
chr12	114252718	114312612	Pacs2	59894	+	NM_001081170	114252774	114309867	24
chr12	114312712	114327125	Tex22	14413	+	NM_029381	114313491	114327104	3
chr12	114336488	114375417	Mta1	38929	+	NM_054081	114336628	114374879	20
chr12	114378446	114383717	Crip2	5271	+	NM_024223	114378782	114383241	7
chr12	114390222	114392090	Crip1	1868	+	NM_007763	114390324	114391869	5
chr12	114394631	114403669	4930427A07Rik	9038	+	NM_134041	114394647	114401593	8
chr12	114424113	114427733	Tmem121	3620	+	NM_153776	114426374	114427331	2
chr12	114727775	114730046	Adam6b	2271	+	NM_001009545	114727775	114730046	1
chr12	114782118	114784625	Adam6a	2507	+	NM_174885	114782219	114784484	1
chr12	115707617	115707677	Mir7094-1	60	-	NR_106062	115707677	115707677	1
chr12	115751845	115751905	Mir7094-2	60	-	NR_106063	115751905	115751905	1
chr12	116933930	116934005	Mir6388	75	-	NR_105810	116934005	116934005	1
chr12	117285934	117301675	Zfp386	15741	+	NM_019565	117286068	117299012	3
chr12	117316195	117384734	Vipr2	68539	+	NM_009511	117316315	117382783	13
chr12	117445522	117501498	Wdr60	55976	-	NM_146039	117446087	117501338	22
chr12	117519694	117611571	Esyt2	91877	+	NM_028731	117519815	117608689	22
chr12	117640419	117643634	D430020J02Rik	3215	-	NR_028421	117643634	117643634	2
chr12	117643874	117702004	Ncapg2	58130	+	NM_133762	117645705	117699088	29
chr12	117724192	118516640	Ptprn2	792448	+	NM_011215	117724337	118515103	23
chr12	118382995	118389742	Gm10421	6747	-	NR_033538	118389742	118389742	3
chr12	118472993	118575485	Gm5441	102492	-	NR_044987	118575485	118575485	3
chr12	118489289	118489358	Mir153	69	+	NR_029563	118489358	118489358	1
chr12	118754951	118995451	Rapgef5	240500	+	NM_175930	118765701	118994554	28
chr12	119082333	119117179	Cdca7l	34846	+	NM_146040	119082406	119115958	10
chr12	119116454	119437516	Dnah11	321062	-	NM_010060	119116848	119437305	82
chr12	119470158	119539913	Sp4	69755	-	NM_001166385	119476619	119539706	6
chr12	119756769	119768666	D230030E09Rik	11897	-	NR_045947	119768666	119768666	4
chr12	120084801	120091051	Sp8	6250	+	NM_177082	120086884	120088345	3
chr12	120106296	120204894	Abcb5	98598	-	NM_029961	120106320	120203787	28
chr12	120401275	120476749	Itgb8	75474	-	NM_177290	120401589	120476271	14
chr12	120681882	120705405	Macc1	23523	+	NM_001163136	120681882	120704145	4
chr12	121184434	121257530	Tmem196	73096	+	NM_001294154	121184946	121256989	5
chr13	3148720	3188924	Speer6-ps1	40204	+	NR_001581	3188924	3188924	5
chr13	3477548	3491644	2810429I04Rik	14096	+	NR_015522	3491644	3491644	5
chr13	3497295	3500639	1700024F13Rik	3344	+	NR_045363	3500639	3500639	3
chr13	3537320	3565507	Gdi2	28187	+	NM_008112	3537544	3564388	11
chr13	3565280	3610354	Fam208b	45074	-	NM_134063	3565909	3599210	20
chr13	3633277	3651025	Asb13	17748	+	NM_178283	3633378	3649553	6
chr13	3802138	3803564	Calml3	1426	-	NM_027416	3802999	3803449	1
chr13	3837002	3837917	Calm4	915	+	NM_020036	3837141	3837588	1
chr13	3853418	3854007	Calm5	589	+	NM_001008706	3853513	3853976	2
chr13	3881263	3917466	Net1	36203	-	NM_019671	3883315	3917311	12
chr13	3923940	3934523	Tubal3	10583	+	NM_001033879	3923980	3932808	4
chr13	3939933	3944595	Ucn3	4662	-	NM_031250	3940401	3940896	2
chr13	4058836	4089668	Akr1c14	30832	+	NM_134072	4058877	4088236	9
chr13	4131872	4149877	Akr1c18	18005	-	NM_134066	4132039	4149844	9
chr13	4190432	4204849	Akr1c13	14417	+	NM_013778	4190472	4204629	9
chr13	4232985	4247605	Akr1c19	14620	+	NM_001013785	4233016	4247366	9
chr13	4247980	4249023	Marcksl1-ps4	1043	+	NR_028405	4249023	4249023	1
chr13	4267417	4278645	Akr1c12	11228	-	NM_013777	4267633	4278602	9
chr13	4433588	4456776	Akr1c6	23188	+	NM_030611	4433636	4456437	9
chr13	4486101	4522590	Akr1c20	36489	-	NM_001311132	4486428	4522560	9
chr13	4573320	4585789	Akr1c21	12469	+	NM_029901	4573394	4585626	9
chr13	4591735	4608410	Akr1e1	16675	-	NM_018859	4592501	4608369	10
chr13	5854754	5857338	1700016G22Rik	2584	-	NR_045891	5857338	5857338	3
chr13	5860734	5869639	Klf6	8905	+	NM_011803	5860884	5866529	4
chr13	6547402	6579395	Pitrm1	31993	+	NM_145131	6547419	6578989	27
chr13	6579119	6648017	Pfkp	68898	-	NM_019703	6580705	6647925	22
chr13	8202111	8768008	Adarb2	565897	+	NR_110345	8768008	8768008	11
chr13	8802211	8870982	Wdr37	68771	-	NM_001039388	8805060	8860471	14
chr13	8884851	8891642	Idi1	6791	+	NM_145360	8885105	8889881	5
chr13	8952108	8960181	Idi2	8073	+	NM_177197	8956056	8958678	5
chr13	8971723	8995258	Gtpbp4	23535	-	NM_027000	8972367	8995242	17
chr13	9093126	9173697	Larp4b	80571	+	NM_172585	9121391	9170188	18
chr13	9275770	9668172	Dip2c	392402	+	NM_001081426	9276227	9665276	37
chr13	9684081	9764560	Zmynd11	80479	-	NM_001199141	9686107	9734693	15
chr13	9875858	10360049	Chrm3	484191	-	NM_033269	9876474	9878244	5
chr13	11614318	11617949	Zp4-ps	3631	+	NR_027813	11617949	11617949	7
chr13	11645369	12199212	Ryr2	553843	-	NM_023868	11646782	12198713	105
chr13	12274983	12278755	Gm10336	3772	-	NR_045170	12278755	12278755	1
chr13	12278806	12350380	Mtr	71574	-	NM_001081128	12279271	12346240	33
chr13	12361693	12432999	Actn2	71306	-	NM_033268	12361760	12432767	21
chr13	12487641	12531160	Heatr1	43519	+	NM_144835	12488038	12530944	45
chr13	12531668	12554005	Lgals8	22337	-	NM_001291060	12533111	12547064	9
chr13	12563475	12612717	Edaradd	49242	-	NM_133643	12570449	12612215	6
chr13	12658149	12701795	Ero1lb	43646	+	NM_026184	12658343	12699154	16
chr13	12706332	12742662	Gpr137b-ps	36330	-	NR_003568	12742662	12742662	7
chr13	12883082	12892325	Prl2c4	9243	-	NM_011954	12883197	12892279	5
chr13	12883087	12892346	Prl2c3	9259	-	NM_011118	12883197	12892279	5
chr13	13088390	13097597	Prl2c2	9207	-	NM_031191	13088501	13097593	5
chr13	13274982	13284192	Prl2c5	9210	+	NM_001311129	13275271	13284082	6
chr13	13449887	13485891	Gpr137b	36004	-	NM_031999	13451578	13485760	7
chr13	13529868	13604542	Nid1	74674	+	NM_010917	13529968	13602334	20
chr13	13682675	13869707	Lyst	187032	+	NM_010748	13708820	13869446	53
chr13	13876325	13920162	Gng4	43837	+	NM_001302997	13898338	13917642	4
chr13	14046940	14091335	B3galnt2	44395	+	NM_178640	14047071	14089300	12
chr13	14090217	14131905	Tbce	41688	-	NM_178337	14090355	14121642	17
chr13	14144713	14155668	Ggps1	10955	-	NM_010282	14145960	14150132	4
chr13	14156050	14291870	Arid4b	135820	+	NM_194262	14157140	14290000	24
chr13	14318704	14615493	Hecw1	296789	-	NM_001081348	14322915	14526727	29
chr13	14702567	14705304	Mrpl32	2737	-	NM_029271	14702752	14705285	3
chr13	14705508	14717940	Psma2	12432	+	NM_008944	14705541	14717732	8
chr13	14722511	14730469	AW209491	7958	+	NM_001104646	14728830	14730096	2
chr13	15555555	15821858	Gli3	266303	+	NM_008130	15569873	15818614	15
chr13	15873496	15894463	4933412O06Rik	20967	-	NR_045507	15894463	15894463	3
chr13	15899075	15919370	A530046M15Rik	20295	+	NR_046131	15919370	15919370	5
chr13	16106307	16119044	Inhba	12737	+	NM_008380	16109128	16118962	3
chr13	16949309	17786599	Sugct	837290	-	NM_138654	16949688	17786566	14
chr13	17787246	17790939	Mplkip	3693	+	NM_025479	17787318	17788876	2
chr13	17807795	17896931	Cdk13	89136	-	NM_027118	17809894	17896485	14
chr13	17839306	17839427	Mir466i	121	+	NR_035412	17839427	17839427	1
chr13	17972408	18036051	Rala	63643	-	NM_019491	17974212	17988900	5
chr13	18078473	18085185	Yae1d1	6712	-	NM_025904	18081213	18085140	3
chr13	18176780	18192036	4930448F12Rik	15256	-	NR_046032	18192036	18192036	6
chr13	18216793	18473873	Pou6f2	257080	-	NM_175006	18216995	18473873	8
chr13	18809160	18958680	Vps41	149520	+	NM_172120	18809184	18958069	29
chr13	19040219	19242788	Amph	202569	+	NM_001289546	19040301	19241712	21
chr13	19449544	19487682	Stard3nl	38138	-	NM_024270	19450861	19468472	9
chr13	19554715	19596236	9330199G10Rik	41521	-	NR_131038	19596236	19596236	4
chr13	19683576	19711699	Epdr1	28123	-	NM_134065	19685020	19711431	3
chr13	19715043	19724692	Sfrp4	9649	+	NM_016687	19715301	19724248	6
chr13	19736947	19789629	Nme8	52682	-	NM_181591	19742622	19788905	17
chr13	19819285	19824820	A530099J19Rik	5535	-	NM_175688	19820849	19821749	2
chr13	19841550	19916126	Gpr141	74576	-	NM_181754	19843554	19844472	5
chr13	20182375	20700222	Elmo1	517847	+	NM_080288	20277295	20697168	22
chr13	20885981	21116123	Aoah	230142	+	NM_012054	20886262	21115206	21
chr13	21164217	21165168	Olfr1370	951	-	NM_146535	21164217	21165168	1
chr13	21224645	21225599	Olfr263	954	+	NM_010984	21224645	21225599	1
chr13	21233979	21234924	Olfr1368	945	-	NM_146534	21233979	21234924	1
chr13	21271799	21286592	Trim27	14793	+	NM_009054	21272363	21284494	8
chr13	21378297	21384555	Gpx5	6258	-	NM_010343	21379234	21384529	5
chr13	21404071	21411493	Gpx6	7422	+	NM_145451	21404126	21410952	5
chr13	21438798	21439749	Olfr1367	951	+	NM_146533	21438798	21439749	1
chr13	21454688	21464171	Zscan12	9483	+	NM_016684	21455518	21461382	4
chr13	21478872	21494624	Zkscan3	15752	-	NM_001145778	21479667	21488385	6
chr13	21488446	21488507	Mir6942	61	-	NR_105907	21488507	21488507	1
chr13	21513143	21532922	Pgbd1	19779	-	NM_001162920	21514643	21526354	5
chr13	21534043	21545596	Zscan26	11553	-	NM_001013786	21536799	21541324	4
chr13	21537028	21537109	Mir1896	81	+	NR_035441	21537109	21537109	1
chr13	21558915	21560370	Nkapl	1455	-	NM_025719	21559122	21560310	1
chr13	21570717	21577374	Zkscan4	6657	+	NM_001039115	21570961	21576605	3
chr13	21596184	21598393	Zfp389	2209	-	NR_026798	21598393	21598393	2
chr13	21605089	21622983	Zkscan8	17894	-	NM_139141	21611869	21618807	6
chr13	21628842	21629896	Olfr1366	1054	-	NM_146283	21628885	21629872	1
chr13	21646908	21647889	Olfr1535	981	-	NM_207572	21646908	21647889	1
chr13	21665378	21666323	Olfr1364	945	-	NM_146540	21665378	21666323	1
chr13	21702888	21703873	Olfr1362	985	-	NM_146744	21702909	21703836	1
chr13	21730448	21731390	Olfr11	942	-	NM_146542	21730448	21731390	1
chr13	21750236	21751190	Olfr1361	954	-	NM_146541	21750236	21751190	1
chr13	21765869	21766811	Olfr1359	942	-	NM_001011820	21765869	21766811	1
chr13	21765869	21766849	Olfr1360	980	-	NM_146543	21765869	21766811	1
chr13	21807581	21808012	Hist1h2bl	431	-	NM_178199	21807631	21808012	1
chr13	21808280	21808728	Hist1h2ai	448	+	NM_178182	21808290	21808683	1
chr13	21809496	21809984	Hist1h3h	488	+	NM_178206	21809527	21809938	1
chr13	21813912	21814395	Hist1h2bm	483	+	NM_178200	21813966	21814347	1
chr13	21826902	21827325	Hist1h4j	423	+	NM_178210	21826964	21827276	1
chr13	21842013	21842422	Hist1h4k	409	-	NM_178211	21842062	21842374	1
chr13	21845245	21845781	Hist1h2ak	536	-	NM_178183	21845303	21845696	1
chr13	21845991	21846422	Hist1h2bn	431	+	NM_178201	21845991	21846372	1
chr13	21871700	21872494	Hist1h1b	794	-	NM_020034	21871751	21872423	1
chr13	21874783	21875266	Hist1h3i	483	-	NM_178207	21874828	21875239	1
chr13	21878640	21879087	Hist1h2an	447	-	NM_178184	21878694	21879087	1
chr13	21879356	21881082	Hist1h2bp	1726	+	NM_178202	21879383	21880932	2
chr13	21903614	21904019	Hist1h4m	405	+	NM_001195421	21903652	21903964	1
chr13	21923661	21924027	Hist1h4n	366	-	NM_175657	21923715	21924027	1
chr13	21924892	21925344	Hist1h2ap	452	-	NM_178185	21924951	21925344	1
chr13	21924892	21925444	Hist1h2ao	552	-	NM_001177544	21924951	21925344	1
chr13	21925611	21929399	Hist1h2bq	3788	+	NM_001097979	21925639	21927711	2
chr13	21925611	21929399	Hist1h2br	3788	+	NM_001110555	21925639	21927711	2
chr13	21988786	21988918	Mir1983	132	-	NR_035500	21988918	21988918	1
chr13	22036962	22052354	Zfp184	15392	+	NM_183014	22037661	22052208	6
chr13	22073062	22080603	Pom121l2	7541	+	NM_001162929	22073429	22080437	2
chr13	22094044	22101610	Prss16	7566	-	NM_019429	22094622	22101566	12
chr13	22126990	22127512	Hist1h2ah	522	-	NM_175659	22127034	22127421	1
chr13	22127689	22128189	Hist1h2bk	500	+	NM_175665	22127755	22128136	1
chr13	22132828	22133231	Hist1h4i	403	-	NM_175656	22132880	22133192	1
chr13	22134346	22134818	Hist1h2ag	472	-	NM_178186	22134403	22134796	1
chr13	22135098	22135527	Hist1h2bj	429	+	NM_178198	22135098	22135479	1
chr13	22179746	22180673	Vmn1r188	927	+	NM_145850	22179746	22180673	1
chr13	22193595	22194534	Vmn1r189	939	-	NM_145844	22193595	22194534	1
chr13	22270554	22271451	Vmn1r191	897	-	NM_145849	22270554	22271451	1
chr13	22279014	22279917	Vmn1r192	903	-	NM_145845	22279014	22279917	1
chr13	22310729	22311689	Vmn1r193	960	-	NM_134225	22310729	22311689	1
chr13	22336083	22336974	Vmn1r194	891	+	NM_001080972	22336083	22336974	1
chr13	22370185	22371273	Vmn1r195	1088	+	NM_134223	22370230	22371181	1
chr13	22385061	22385967	Vmn1r196	906	+	NM_001167541	22385061	22385967	1
chr13	22419779	22420676	Vmn1r197	897	+	NM_134244	22419779	22420676	1
chr13	22446214	22447117	Vmn1r198	903	+	NM_134220	22446214	22447117	1
chr13	22474406	22475510	Vmn1r199	1104	+	NM_134213	22474406	22475510	1
chr13	22486897	22487836	Vmn1r200	939	+	NM_134212	22486897	22487836	1
chr13	22533140	22534112	Vmn1r-ps103	972	+	NM_134211	22533140	22534112	1
chr13	22566486	22567389	Vmn1r201	903	+	NM_134221	22566486	22567389	1
chr13	22593205	22594114	Vmn1r202	909	-	NM_134224	22593205	22594114	1
chr13	22615919	22616855	Vmn1r203	936	+	NM_134236	22615919	22616855	1
chr13	22648069	22648978	Vmn1r204	909	+	NM_001045544	22648069	22648978	1
chr13	22683848	22684799	Vmn1r205	951	-	NM_134217	22683848	22684799	1
chr13	22711965	22712904	Vmn1r206	939	-	NM_134216	22711965	22712904	1
chr13	22817552	22818491	Vmn1r207-ps	939	-	NM_001166709	22817552	22818491	1
chr13	22864267	22865194	Vmn1r208	927	-	NM_134218	22864267	22865194	1
chr13	22897448	22898387	Vmn1r209	939	-	NM_001013787	22897448	22898387	1
chr13	22919062	22919983	Vmn1r210	921	-	NM_134235	22919062	22919983	1
chr13	22943467	22944364	Vmn1r211	897	-	NM_134243	22943467	22944364	1
chr13	22974956	22976030	Vmn1r212	1074	-	NM_134241	22974956	22976030	1
chr13	23103117	23104272	Vmn1r213	1155	+	NM_134215	23103117	23104272	1
chr13	23126206	23127310	Vmn1r214	1104	+	NM_134214	23126206	23127310	1
chr13	23167660	23168563	Vmn1r215	903	+	NM_134219	23167660	23168563	1
chr13	23191017	23191914	Vmn1r216	897	+	NM_134245	23191017	23191914	1
chr13	23205702	23206599	Vmn1r217	897	-	NM_134239	23205702	23206599	1
chr13	23228353	23229250	Vmn1r218	897	+	NM_134222	23228353	23229250	1
chr13	23254511	23255450	Vmn1r219	939	+	NM_134238	23254511	23255450	1
chr13	23275496	23276393	Vmn1r220	897	-	NM_134237	23275496	23276393	1
chr13	23309241	23310180	Vmn1r221	939	+	NM_001167542	23309241	23310180	1
chr13	23323983	23324910	Vmn1r222	927	-	NM_134240	23323983	23324910	1
chr13	23341106	23342192	Vmn1r223	1086	+	NM_001083311	23341106	23342192	1
chr13	23368072	23405276	4930557F10Rik	37204	-	NR_126443	23405276	23405276	2
chr13	23370218	23374136	4933404K08Rik	3918	+	NR_046038	23374136	23374136	4
chr13	23405393	23477668	4930586N03Rik	72275	+	NR_131052	23477668	23477668	4
chr13	23444971	23461077	Zfp322a	16106	-	NM_001111107	23448206	23449439	5
chr13	23510229	23515735	Abt1	5506	-	NM_013924	23513841	23515701	3
chr13	23519844	23522886	C230035I16Rik	3042	-	NR_015492	23522886	23522886	4
chr13	23548861	23557770	Btn1a1	8909	-	NM_013483	23550571	23557049	8
chr13	23568931	23580726	Btn2a2	11795	-	NM_001289615	23570102	23579786	8
chr13	23622912	23623347	Hist1h4h	435	+	NM_153173	23622983	23623295	1
chr13	23625779	23626247	Hist1h2af	468	+	NM_175661	23625779	23626172	1
chr13	23627286	23627778	Hist1h3g	492	+	NM_145073	23627314	23627725	1
chr13	23634791	23635313	Hist1h2bh	522	-	NM_178197	23634840	23635221	1
chr13	23635920	23636823	Hist1h3f	903	+	NM_013548	23636353	23636764	1
chr13	23643154	23643512	Hist1h4f	358	-	NM_175655	23643200	23643512	1
chr13	23646900	23647676	Hist1h1d	776	+	NM_145713	23646958	23647624	1
chr13	23653764	23654234	Hist1h3e	470	-	NM_178205	23653823	23654234	1
chr13	23662531	23663089	Hist1h2ae	558	-	NM_178187	23662584	23662977	1
chr13	23663268	23663732	Hist1h2bg	464	+	NM_178196	23663301	23663682	1
chr13	23665628	23666059	Hist1h2bf	431	-	NM_178195	23665678	23666059	1
chr13	23666249	23666784	Hist1h2ad	535	+	NM_178188	23666339	23666732	1
chr13	23667631	23668135	Hist1h3d	504	+	NM_178204	23667670	23668081	1
chr13	23673470	23673838	Hist1h4d	368	+	NM_175654	23673470	23673782	1
chr13	23675538	23712993	Hist1h2be	37455	-	NM_178194	23677444	23677825	2
chr13	23713645	23714427	Hist1h1e	782	-	NM_015787	23713706	23714366	1
chr13	23775341	23775828	Hist1h2ac	487	-	NM_178189	23775393	23775786	1
chr13	23776067	23784349	Hist1h2bc	8282	+	NM_023422	23776100	23776481	2
chr13	23787679	23788414	Hist1h1t	735	+	NM_010377	23787734	23788364	1
chr13	23789952	23790327	Hist1h4c	375	-	NM_178208	23790006	23790318	1
chr13	23795709	23802680	Hfe	6971	-	NM_010424	23796254	23802583	6
chr13	23830675	23831400	Hist1h1c	725	+	NM_015786	23830717	23831356	1
chr13	23836910	23837390	Hist1h3c	480	-	NM_175653	23836955	23837366	1
chr13	23838602	23839092	Hist1h2bb	490	+	NM_175664	23838663	23839044	1
chr13	23842956	23843461	Hist1h2ab	505	+	NM_175660	23843001	23843394	1
chr13	23844248	23844709	Hist1h3b	461	+	NM_178203	23844248	23844659	1
chr13	23848805	23849255	Hist1h4b	450	+	NM_178193	23848889	23849201	1
chr13	23852663	23853118	Hist1h4a	455	-	NM_178192	23852714	23853026	1
chr13	23853753	23854255	Hist1h3a	502	-	NM_013550	23853811	23854222	1
chr13	23855536	23856281	Hist1h1a	745	+	NM_030609	23855585	23856227	1
chr13	23874409	23883397	Trim38	8988	+	NM_001029935	23874440	23883364	6
chr13	23898895	23915394	Slc17a2	16499	+	NM_144836	23902668	23914171	12
chr13	23931302	23952583	Slc17a3	21281	+	NM_134069	23934318	23949982	13
chr13	23960886	23987599	Slc17a1	26713	+	NR_121611	23987599	23987599	13
chr13	23989757	24006876	Slc17a4	17119	-	NM_177016	23990643	24000716	12
chr13	24025593	24026025	Hist1h2ba	432	-	NM_175663	24025641	24026025	1
chr13	24026330	24026782	Hist1h2aa	452	+	NM_175658	24026330	24026720	1
chr13	24045325	24083083	Scgn	37758	-	NM_145399	24045724	24082902	11
chr13	24104349	24372659	Lrrc16a	268310	-	NM_001311122	24111920	24372469	38
chr13	24419272	24569158	Cmah	149886	+	NM_001284519	24508868	24560491	18
chr13	24674057	24825675	Fam65b	151618	+	NM_001286100	24761854	24823554	23
chr13	24689993	24696636	Gm11346	6643	-	NR_024599	24696636	24696636	2
chr13	24843713	24853806	Gmnn	10093	-	NM_020567	24843937	24852079	7
chr13	24893525	24904768	BC005537	11243	+	NM_024473	24895249	24904631	5
chr13	24909823	24923358	Acot13	13535	-	NM_025790	24909903	24923175	3
chr13	24923527	24934022	Tdp2	10495	+	NM_019551	24923600	24933231	7
chr13	24936999	24993308	D130043K22Rik	56309	+	NM_001081051	24946369	24991668	21
chr13	24997468	25003649	4932702P03Rik	6181	+	NR_045182	25003649	25003649	3
chr13	24999447	25029530	Aldh5a1	30083	-	NM_172532	25003429	25029437	10
chr13	25029269	25030918	9330162012Rik	1649	+	NR_102323	25030918	25030918	2
chr13	25035020	25083805	Gpld1	48785	+	NM_008156	25035485	25081991	26
chr13	25084163	25112186	Mrs2	28023	-	NM_001013389	25084946	25112113	11
chr13	25147872	25302575	Dcdc2a	154703	+	NM_177577	25148139	25297387	10
chr13	25343907	25361865	Nrsn1	17958	-	NM_009513	25345221	25354260	4
chr13	26012902	26058185	Gm11351	45283	-	NR_045062	26058185	26058185	4
chr13	26375027	26404275	1700092E19Rik	29248	-	NR_045933	26404275	26404275	3
chr13	26860040	26862034	Hdgfl1	1994	-	NM_008232	26861105	26861957	1
chr13	27149438	27157072	Prl	7634	+	NM_011164	27149492	27156919	5
chr13	27186057	27192129	Prl3d1	6072	+	NM_001205322	27186121	27191990	5
chr13	27213572	27219351	Prl3d2	5779	+	NM_172155	27213610	27219287	5
chr13	27248667	27254389	Prl3d3	5722	+	NM_172156	27248705	27254325	5
chr13	27288528	27295618	Prl3c1	7090	+	NM_013766	27288574	27295481	5
chr13	27334298	27341609	Prl3b1	7311	+	NM_008865	27334357	27341401	5
chr13	27351357	27368529	Prl3a1	17172	+	NM_025896	27351513	27368087	5
chr13	27404495	27411121	Prl6a1	6626	+	NM_011166	27404533	27410984	5
chr13	27437541	27446084	Prl8a2	8543	+	NM_010088	27437605	27445933	6
chr13	27475213	27482715	Prl2b1	7502	-	NM_025532	27475320	27482645	5
chr13	27524549	27530557	Prl8a6	6008	-	NR_073166	27530557	27530557	6
chr13	27598836	27605086	Prl8a8	6250	-	NM_001311125	27599050	27605023	6
chr13	27649865	27656475	Prl8a9	6610	-	NM_001316721	27650019	27656415	6
chr13	27665790	27674040	Prl8a1	8250	-	NM_028477	27665870	27673979	6
chr13	27693687	27702451	Prl7b1	8764	-	NM_029355	27693796	27702391	6
chr13	27725232	27734362	Prl7a1	9130	-	NM_001164058	27725347	27734319	7
chr13	27750452	27759905	Prl7a2	9453	-	NM_011168	27750925	27759863	6
chr13	27800866	27808606	Prl7d1	7740	-	NM_011120	27801060	27808538	6
chr13	27865363	27872673	Prl7c1	7310	-	NM_026206	27865568	27872618	6
chr13	27893523	27900585	Prl2a1	7062	+	NM_019991	27893571	27900450	5
chr13	27941210	27949577	Prl2c1	8367	+	NM_001045532	27941270	27949552	5
chr13	28108091	28115415	Prl4a1	7324	+	NM_011165	28108141	28115297	5
chr13	28234352	28243464	Prl5a1	9112	+	NM_023746	28234411	28243171	5
chr13	28551902	28977291	2610307P16Rik	425389	-	NR_045053	28977291	28977291	9
chr13	28802649	28802742	Mir6368	93	-	NR_105787	28802742	28802742	1
chr13	29042598	29045551	Sox4	2953	-	NM_009238	29043567	29044890	1
chr13	29108123	29132205	A330102I10Rik	24082	+	NR_045073	29132205	29132205	6
chr13	29283614	29947542	Cdkal1	663928	-	NR_131896	29947542	29947542	17
chr13	29998443	30077932	E2f3	79489	-	NM_010093	30001771	30077537	7
chr13	30228358	30338563	Mboat1	110205	+	NM_153546	30228535	30337338	13
chr13	30428224	30474736	Agtr1a	46512	+	NM_177322	30472822	30473902	3
chr13	30632180	30637185	Uqcrfs1	5005	-	NM_025710	30632599	30637116	2
chr13	30706911	30716127	4930519D14Rik	9216	+	NR_045975	30716127	30716127	4
chr13	30751927	30803101	Dusp22	51174	+	NM_134068	30751994	30802621	8
chr13	30841126	30858796	Irf4	17670	+	NM_013674	30842448	30855536	9
chr13	30905786	31065916	Exoc2	160130	-	NM_025588	30907166	31032596	28
chr13	31038444	31039630	Hus1b	1186	-	NM_153072	31038712	31039543	1
chr13	31305278	31332955	4930401O12Rik	27677	-	NR_045957	31332955	31332955	3
chr13	31650038	31652843	Foxq1	2805	+	NM_008239	31650785	31651988	1
chr13	31657360	31674382	1700018A04Rik	17022	-	NR_029439	31674382	31674382	6
chr13	31717684	31723275	Foxf2	5591	+	NM_010225	31717948	31722514	2
chr13	31898514	31902504	Foxc1	3990	+	NM_008592	31899076	31900738	1
chr13	31911454	32430413	Gmds	518959	-	NM_146041	31911784	32430352	11
chr13	32792695	32873648	Mylk4	80953	-	NM_001166030	32800773	32873585	12
chr13	32893898	32914479	Wrnip1	20581	+	NM_030215	32894106	32914028	7
chr13	32933960	32943054	Serpinb1a	9094	-	NM_025429	32934686	32942275	7
chr13	32973265	32990009	Serpinb1c	16744	-	NM_173051	32973701	32988967	7
chr13	33057381	33070906	Serpinb6b	13525	+	NM_011454	33060378	33070222	7
chr13	33096409	33109824	Serpinb9	13415	+	NM_009256	33098411	33107717	7
chr13	33119282	33132427	Serpinb9b	13145	+	NM_011452	33121330	33131829	7
chr13	33175971	33186249	Serpinb1b	10278	+	NM_173052	33177154	33185803	7
chr13	33241143	33251623	Serpinb9c	10480	-	NM_001164524	33241846	33251576	7
chr13	33284827	33295849	Serpinb9d	11022	+	NM_011460	33286441	33294953	7
chr13	33341478	33352715	Serpinb9e	11237	+	NM_011456	33343454	33352001	7
chr13	33415945	33427235	Serpinb9f	11290	+	NM_183197	33417695	33426521	7
chr13	33576658	33587869	Serpinb9g	11211	+	NM_011455	33578399	33587151	7
chr13	33654354	33661186	Gm6093	6832	-	NR_131141	33661186	33661186	3
chr13	33753273	33763454	Serpinb6d	10181	+	NM_001076790	33755923	33763341	7
chr13	33924213	33935277	Serpinb6e	11064	-	NM_001045535	33924327	33933175	8
chr13	33971684	33997577	Serpinb6c	25893	-	NM_148942	33971799	33991298	7
chr13	34009786	34094663	Serpinb6a	84877	-	NM_001243192	34009909	34023505	8
chr13	34027900	34052050	1110046J04Rik	24150	+	NR_040707	34052050	34052050	5
chr13	34056527	34080334	Nqo2	23807	+	NM_020282	34060139	34077361	8
chr13	34094742	34127039	Ripk1	32297	+	NM_009068	34101525	34124651	11
chr13	34129509	34165943	Bphl	36434	+	NM_026512	34129531	34165632	7
chr13	34166146	34169877	Tubb2a	3731	-	NM_009450	34166336	34169798	4
chr13	34176023	34205141	4930447K03Rik	29118	-	NR_046184	34205141	34205141	5
chr13	34218876	34222223	Tubb2b	3347	-	NM_023716	34219339	34222102	4
chr13	34254832	34270041	Psmg4	15209	+	NM_001101430	34254944	34269971	3
chr13	34271026	34437051	Slc22a23	166025	-	NM_001033167	34274822	34436666	11
chr13	34719709	34744550	Pxdc1	24841	-	NM_025831	34720639	34744304	5
chr13	34744791	34758643	Gm15908	13852	+	NR_105041	34758643	34758643	4
chr13	34831510	34839491	Fam50b	7981	+	NM_138746	34838411	34839416	2
chr13	34967362	34994747	Prpf4b	27385	+	NM_013830	34967522	34993465	15
chr13	35001832	35011861	Fam217a	10029	-	NM_027967	35002110	35007585	8
chr13	35016277	35045065	4933417A18Rik	28788	+	NM_025750	35016405	35044833	5
chr13	35038482	35055678	Eci3	17196	-	NM_026947	35038797	35052347	9
chr13	35069616	35086013	Eci2	16397	-	NM_001110331	35069779	35085926	10
chr13	35273491	35279883	1700011B04Rik	6392	+	NR_045616	35279883	35279883	3
chr13	35302528	35303917	1700019C18Rik	1389	-	NR_126478	35303917	35303917	2
chr13	35751730	35965933	Cdyl	214203	+	NM_009881	35761814	35964539	10
chr13	35986972	35998216	Rpp40	11244	-	NM_145938	35988595	35998195	8
chr13	36059774	36062257	Ppp1r3g	2483	+	NM_029628	36060467	36061511	2
chr13	36070665	36209226	Lyrm4	138561	-	NM_201358	36071707	36209029	3
chr13	36209511	36629464	Fars2	419953	+	NM_024274	36296398	36629308	7
chr13	36817490	36826346	Nrn1	8856	-	NM_153529	36818496	36826159	3
chr13	36959046	37142113	F13a1	183067	-	NM_001166391	36960633	37139355	15
chr13	37437213	37510905	Ly86	73692	+	NM_010745	37437307	37510491	5
chr13	37918780	38043871	Rreb1	125091	+	NR_033615	38043871	38043871	10
chr13	38063269	38086059	Ssr1	22790	-	NM_025965	38071607	38085952	8
chr13	38097920	38128806	Cage1	30886	-	NM_027724	38097957	38124341	13
chr13	38128857	38153302	Riok1	24445	+	NM_024242	38129329	38152734	17
chr13	38243162	38290446	Dsp	47284	+	NM_023842	38243457	38289801	24
chr13	38296807	38319532	Snrnp48	22725	+	NM_026382	38296841	38318791	9
chr13	38437584	38592183	Bmp6	154599	+	NM_007556	38437801	38590937	7
chr13	38552110	38553662	4930579J19Rik	1552	-	NR_131033	38553662	38553662	4
chr13	38592139	38620693	Txndc5	28554	-	NM_001289598	38593454	38615286	10
chr13	38694574	38726978	Bloc1s5	32404	-	NM_139063	38695717	38726910	5
chr13	38737559	38750897	Eef1e1	13338	-	NM_025380	38738038	38750862	4
chr13	39024008	39052744	Slc35b3	28736	-	NM_001170431	39024634	39052526	10
chr13	39052487	39058166	5033403F01Rik	5679	+	NR_131019	39058166	39058166	3
chr13	40097250	40383380	Ofcc1	286130	-	NM_172143	40097257	40383352	19
chr13	40810671	40830289	Tfap2a	19618	-	NM_001301674	40812483	40829083	8
chr13	40823176	40830531	Gm26688	7355	+	NR_125899	40830531	40830531	3
chr13	40955136	41056261	Gcnt2	101125	+	NM_023887	40955723	41053711	3
chr13	41096378	41108402	Pak1ip1	12024	+	NM_026550	41096698	41108118	10
chr13	41111618	41117951	Tmem14c	6333	+	NM_025387	41112519	41117529	6
chr13	41120488	41175075	Mak	54587	-	NM_001145803	41121776	41165606	15
chr13	41196795	41205357	Gcm2	8562	-	NM_008104	41198125	41205323	5
chr13	41277750	41315772	Elovl2	38022	-	NM_019423	41280662	41315726	8
chr13	41345212	41371946	Smim13	26734	+	NM_001135577	41345607	41368125	2
chr13	41405284	41582729	Nedd9	177445	-	NM_001111324	41407029	41521241	8
chr13	41701584	41736726	Tmem170b	35142	+	NM_001163572	41701584	41729955	3
chr13	41744811	41752146	Gm5082	7335	+	NM_177808	41751380	41751797	5
chr13	41858516	41942985	Adtrp	84469	-	NM_001145875	41860126	41923664	7
chr13	41961283	42008461	Gm10790	47178	+	NR_033545	42008461	42008461	7
chr13	42147389	42280395	Hivep1	133006	+	NM_007772	42150871	42279882	9
chr13	42396638	42403358	Edn1	6720	+	NM_010104	42397263	42402248	5
chr13	42776167	43233881	Phactr1	457714	+	NM_001302635	42778066	43230558	14
chr13	43247108	43266870	Tbc1d7	19762	-	NM_001252640	43247262	43265282	8
chr13	43290887	43399541	Gfod1	108654	-	NM_001033399	43295693	43398866	2
chr13	43466084	43490572	Sirt5	24488	+	NM_178848	43466122	43490181	8
chr13	43493744	43498227	Nol7	4483	+	NM_023554	43493773	43497210	8
chr13	43498041	43576342	Ranbp9	78301	-	NM_019930	43498927	43576297	14
chr13	43633774	43655560	Mcur1	21786	-	NM_001081059	43637042	43655495	9
chr13	43711165	43766313	Rnf182	55148	+	NM_183204	43763343	43764087	2
chr13	43812159	43814407	Gm20751	2248	+	NR_046022	43814407	43814407	4
chr13	43880480	43898502	Cd83	18022	+	NM_009856	43880582	43897054	5
chr13	44216535	44220548	Gm5083	4013	+	NR_045285	44220548	44220548	5
chr13	44288957	44311856	A330076C08Rik	22899	-	NR_045088	44311856	44311856	4
chr13	44535095	44552936	1700029N11Rik	17841	+	NR_045489	44552936	44552936	4
chr13	44826142	45017012	Jarid2	190870	+	NM_021878	44827240	45015321	19
chr13	45017448	45097465	Dtnbp1	80017	-	NM_025772	45017575	45097341	10
chr13	45485110	45507309	Mylip	22199	+	NM_153789	45485325	45505879	7
chr13	45602812	45641755	Gmpr	38943	+	NM_025508	45603025	45641422	9
chr13	45645124	46060360	Atxn1	415236	-	NM_009124	45652423	45663786	8
chr13	46369089	46395484	Stmnd1	26395	+	NM_001005422	46369186	46395058	5
chr13	46513668	46526468	Rbm24	12800	+	NM_001081425	46514399	46524686	4
chr13	46597271	46745650	Cap2	148379	+	NM_026056	46620784	46743733	13
chr13	46764890	46771142	Fam8a1	6252	+	NM_001033192	46764954	46771025	5
chr13	46775270	46823218	Nup153	47948	-	NM_175749	46776526	46822842	22
chr13	46844456	47025087	Kif13a	180631	-	NM_010617	46845974	47024990	38
chr13	47107925	47110219	Nhlrc1	2294	-	NM_175340	47108942	47110148	1
chr13	47118911	47138586	Tpmt	19675	-	NM_016785	47120733	47136892	9
chr13	47138867	47180648	Kdm1b	41781	+	NM_172262	47143284	47178327	21
chr13	47180135	47201589	Dek	21454	-	NM_025900	47181436	47201096	11
chr13	47218088	47343360	Rnf144b	125272	+	NM_146042	47302754	47339870	8
chr13	47239308	47244039	A930002C04Rik	4731	-	NR_126083	47244039	47244039	3
chr13	48005803	48029670	G630093K05Rik	23867	+	NR_045156	48029670	48029670	3
chr13	48055698	48113977	4931429P17Rik	58279	-	NR_038004	48113977	48113977	8
chr13	48139599	48357992	A330033J07Rik	218393	-	NR_102303	48357992	48357992	3
chr13	48356795	48359405	Id4	2610	+	NM_031166	48356866	48357698	3
chr13	48367786	48369253	A330048O09Rik	1467	-	NR_045162	48369253	48369253	3
chr13	48583028	48608805	Zfp169	25777	-	NM_001164576	48584570	48602308	6
chr13	48631380	48631483	Mirlet7d	103	-	NR_029656	48631483	48631483	1
chr13	48633197	48633286	Mirlet7f-1	89	-	NR_029731	48633286	48633286	1
chr13	48633547	48633641	Mirlet7a-1	94	-	NR_029725	48633641	48633641	1
chr13	48673237	48721041	Ptpdc1	47804	-	NM_001301781	48675104	48701723	11
chr13	48758404	48761876	Barx1	3472	+	NM_007526	48758485	48761361	4
chr13	48897118	48966254	Phf2	69136	-	NM_011078	48898967	48966134	22
chr13	48974585	49063197	Fam120a	88612	-	NM_001033268	48976164	49063197	18
chr13	49063480	49065274	Fam120aos	1794	+	NR_015601	49065274	49065274	2
chr13	49131670	49243697	Wnk2	112027	-	NM_001290313	49131848	49242601	30
chr13	49282915	49291620	Ninj1	8705	+	NM_013610	49282931	49290417	4
chr13	49298319	49311395	Card19	13076	-	NM_026738	49298488	49311312	6
chr13	49326199	49344075	Susd3	17876	-	NM_028340	49326504	49343839	5
chr13	49358478	49404577	Fgd3	46099	-	NM_015759	49359152	49392140	18
chr13	49436917	49482395	Bicd2	45478	+	NM_001039180	49437261	49480345	9
chr13	49516591	49558429	Ippk	41838	+	NR_075085	49558429	49558429	14
chr13	49559427	49748100	Cenpp	188673	-	NM_025495	49559578	49748058	8
chr13	49600178	49628158	Ecm2	27980	+	NM_001012324	49610191	49626800	10
chr13	49639811	49662931	Aspn	23120	+	NM_001172481	49647032	49662000	8
chr13	49678115	49687978	Omd	9863	+	NM_012050	49684844	49687756	4
chr13	49703439	49719869	Ogn	16430	+	NM_008760	49704552	49718352	7
chr13	49748446	49774385	Nol8	25939	+	NM_001271397	49749014	49773805	17
chr13	49777498	49829636	Iars	52138	+	NM_172015	49782761	49829110	34
chr13	50340549	50345677	Gm906	5128	-	NM_001033438	50340603	50345633	4
chr13	50357183	50358238	2310081J21Rik	1055	+	NR_045474	50358238	50358238	3
chr13	50513245	50529138	Fbxw17	15893	+	NM_175401	50513266	50528775	10
chr13	50562675	50570724	Nutm2	8049	+	NM_001033400	50562769	50570472	7
chr13	50639994	50640103	Mir683-1	109	-	NR_030453	50640103	50640103	1
chr13	50639994	50640103	Mir683-2	109	-	NR_030647	50640103	50640103	1
chr13	50738596	50741207	Gm904	2611	+	NM_001033770	50738640	50740911	4
chr13	50793697	50798778	Gm8765	5081	+	NM_001244649	50793724	50798750	4
chr13	50848761	50860617	4930518P08Rik	11856	-	NR_045364	50860617	50860617	4
chr13	51193106	51196096	9430083A17Rik	2990	-	NR_029463	51196096	51196096	1
chr13	51196248	51247931	Spin1	51683	+	NM_001283028	51218605	51244530	6
chr13	51266393	51270556	Nxnl2	4163	+	NM_029173	51266691	51270162	2
chr13	51295452	51298435	Hist1h2al	2983	-	NR_132443	51298435	51298435	1
chr13	51503986	51518166	S1pr3	14180	+	NM_010101	51514153	51515290	2
chr13	51526410	51662453	Shc3	136043	-	NM_009167	51526521	51662453	12
chr13	51740600	51746031	Cks2	5431	+	NM_025415	51740781	51745758	3
chr13	51747076	51779413	Secisbp2	32337	+	NM_001308448	51749761	51778750	17
chr13	51796616	51889116	Sema4d	92500	-	NM_001281880	51797977	51820698	17
chr13	51942043	51943843	Gadd45g	1800	+	NM_011817	51942148	51943348	4
chr13	52192109	52219529	4921525O09Rik	27420	+	NR_045061	52219529	52219529	8
chr13	52599743	52626205	Diras2	26462	-	NM_001024474	52603038	52603638	2
chr13	52665248	52668594	Gm2848	3346	-	NR_046069	52668594	52668594	4
chr13	52678805	52744161	Syk	65356	+	NM_001198977	52706207	52741164	14
chr13	52824738	52852574	BB123696	27836	-	NR_027893	52852574	52852574	3
chr13	52930478	53025046	Auh	94568	-	NM_016709	52930842	53025010	10
chr13	53062577	53076408	Nfil3	13831	-	NM_017373	53062846	53064235	2
chr13	53204685	53381478	Ror2	176793	-	NM_013846	53205588	53381246	9
chr13	53428118	53472730	Sptlc1	44612	-	NM_009269	53429252	53472718	15
chr13	53489057	53550999	Gm2762	61942	+	NR_037991	53550999	53550999	8
chr13	53562249	53568149	Msx2	5900	-	NM_013601	53563537	53568079	2
chr13	53731260	53734570	9530014B07Rik	3310	-	NR_131079	53734570	53734570	3
chr13	53743953	53745450	4930555G21Rik	1497	+	NR_131010	53745450	53745450	3
chr13	54146552	54151027	Drd1	4475	-	NM_010076	54148221	54149562	2
chr13	54167213	54203714	Sfxn1	36501	+	NM_027324	54180828	54201972	11
chr13	54287497	54317801	Hrh2	30304	+	NM_001010973	54309375	54316709	3
chr13	54472712	54485278	Cplx2	12566	+	NM_009946	54480032	54481073	4
chr13	54560197	54570201	Thoc3	10004	-	NM_028597	54561434	54570168	6
chr13	54605165	54652651	Simc1	47486	+	NM_176987	54605236	54651994	10
chr13	54652578	54666743	4833439L19Rik	14165	-	NM_133797	54653972	54665573	9
chr13	54676373	54682489	Arl10	6116	+	NM_019968	54676455	54682255	4
chr13	54685551	54691435	Nop16	5884	-	NM_178605	54686641	54691328	5
chr13	54691591	54692508	Higd2a	917	+	NM_025933	54691626	54692251	2
chr13	54694299	54712633	Cltb	18334	-	NM_028870	54695231	54712625	5
chr13	54723144	54765424	Faf2	42280	+	NM_178397	54723201	54762497	11
chr13	54780759	54795321	Rnf44	14562	-	NR_027396	54795321	54795321	11
chr13	54802823	54838023	Cdhr2	35200	+	NM_001033364	54813988	54837941	32
chr13	54838031	54851235	Gprin1	13204	-	NM_012014	54839021	54841820	3
chr13	54860220	54867801	Sncb	7581	-	NM_033610	54860869	54867044	6
chr13	54885358	54889819	Eif4e1b	4461	+	NM_001286180	54885376	54888316	7
chr13	54890765	54898136	Tspan17	7371	+	NM_028841	54890955	54897583	8
chr13	55050771	55107379	Unc5a	56608	+	NM_001311128	55051022	55106332	15
chr13	55107345	55122746	Hk3	15401	-	NM_001033245	55107531	55120784	19
chr13	55129240	55201661	Uimc1	72421	-	NR_121592	55201661	55201661	14
chr13	55206669	55236432	Zfp346	29763	+	NM_012017	55206704	55233755	7
chr13	55254178	55270120	Fgfr4	15942	+	NM_008011	55256850	55269536	18
chr13	55311142	55419686	Nsd1	108544	+	NM_008739	55314581	55415089	23
chr13	55420583	55423341	Rab24	2758	-	NM_009000	55421510	55423015	8
chr13	55423415	55426633	Prelid1	3218	+	NM_025596	55423550	55426333	5
chr13	55426528	55431091	Mxd3	4563	-	NM_016662	55427143	55431028	6
chr13	55445193	55464144	Lman2	18951	-	NM_025828	55448237	55463950	8
chr13	55471092	55486048	Rgs14	14956	+	NM_016758	55471252	55485496	15
chr13	55501008	55516056	Slc34a1	15048	+	NM_011392	55501818	55514998	13
chr13	55516048	55516593	Pfn3	545	-	NM_029303	55516113	55516527	1
chr13	55519318	55528165	F12	8847	-	NM_021489	55519459	55528129	14
chr13	55546432	55562288	Grk6	15856	+	NM_001286063	55550712	55561235	16
chr13	55554466	55554532	Mir6943	66	+	NR_105908	55554532	55554532	1
chr13	55565627	55574516	Prr7	8889	+	NM_001030296	55573385	55574351	3
chr13	55574788	55589437	Dbn1	14649	-	NM_001177371	55575583	55589309	15
chr13	55579041	55579137	Mir6944	96	-	NR_105909	55579137	55579137	1
chr13	55598847	55614807	Pdlim7	15960	-	NM_001114088	55600008	55613768	13
chr13	55608985	55609053	Mir6945	68	-	NR_105910	55609053	55609053	1
chr13	55624595	55629899	Dok3	5304	-	NM_013739	55624782	55629875	5
chr13	55631770	55638019	Ddx41	6249	-	NM_134059	55631955	55637868	17
chr13	55640676	55672481	Fam193b	31805	-	NM_145382	55642985	55657457	11
chr13	55694495	55699055	Tmed9	4560	+	NM_026211	55694534	55698351	5
chr13	55701256	55711804	B4galt7	10548	+	NM_146045	55701503	55710735	6
chr13	55724365	55733777	Caml	9412	+	NM_007596	55724451	55733361	4
chr13	55736359	55782628	Ddx46	46269	+	NM_001282055	55736539	55780192	23
chr13	55794484	55804861	B230219D22Rik	10377	+	NM_181278	55800436	55801003	2
chr13	55816010	55827588	Txndc15	11578	+	NM_175150	55816138	55827224	5
chr13	55828728	55878191	Pcbd2	49463	+	NM_028281	55828733	55878061	4
chr13	55885939	55910361	Catsper3	24422	+	NM_001252487	55886022	55910280	8
chr13	55926414	55932786	Pitx1	6372	-	NM_011097	55927429	55932301	3
chr13	56174982	56236911	H2afy	61929	-	NM_001159515	56175587	56229809	9
chr13	56275063	56280246	Tifab	5183	-	NM_145976	56277545	56277989	3
chr13	56323584	56345301	4930550C17Rik	21717	-	NR_131023	56345301	56345301	5
chr13	56351859	56353524	Neurog1	1665	-	NM_010896	56352558	56353293	1
chr13	56390005	56397912	Cxcl14	7907	-	NM_019568	56391152	56397534	4
chr13	56464260	56470218	Gm10782	5958	+	NR_046061	56470218	56470218	4
chr13	56539715	56573724	Slc25a48	34009	+	NM_177809	56539850	56571833	8
chr13	56580637	56583607	Il9	2970	-	NM_008373	56580723	56583592	5
chr13	56623868	56639147	Fbxl21	15279	+	NM_178674	56628276	56638828	7
chr13	56643820	56649899	Lect2	6079	-	NM_010702	56644065	56649723	4
chr13	56710963	56740700	Tgfbi	29737	+	NM_009369	56711007	56740118	17
chr13	56804370	56843739	Smad5	39369	+	NM_008541	56824954	56838839	7
chr13	56874458	56997150	Trpc7	122692	-	NM_001302373	56875124	56923975	13
chr13	57522555	58009693	Spock1	487138	-	NM_001166464	57524450	58008948	11
chr13	58106317	58203789	Klhl3	97472	-	NM_001195075	58106536	58203789	17
chr13	58124485	58124561	Mir874	76	-	NR_030544	58124561	58124561	1
chr13	58227239	58229917	Hnrnpa0	2678	-	NM_029872	58228756	58229674	1
chr13	58248309	58250336	1700066J03Rik	2027	+	NR_126543	58250336	58250336	2
chr13	58259009	58266054	Idnk	7045	+	NM_198004	58259047	58265136	5
chr13	58277516	58317014	Ubqln1	39498	-	NM_026842	58279236	58316797	11
chr13	58334711	58375549	Gkap1	40838	-	NM_019832	58334971	58365518	12
chr13	58388876	58456223	Kif27	67347	-	NM_175214	58389153	58456223	17
chr13	58414404	58414510	Mir6369	106	-	NR_105788	58414510	58414510	1
chr13	58481406	58486586	2210016F16Rik	5180	-	NM_027335	58483140	58486515	4
chr13	58492492	58504704	Hnrnpk	12212	-	NM_001301341	58493803	58501751	18
chr13	58494139	58494247	Mir7-1	108	-	NR_029825	58494247	58494247	1
chr13	58503608	58512510	Rmi1	8902	+	NR_031761	58512510	58512510	3
chr13	58654668	58712238	Slc28a3	57570	-	NM_022317	58657050	58712168	18
chr13	58842434	58863672	4930455J16Rik	21238	-	NR_045469	58863672	58863672	3
chr13	58907929	59235331	Ntrk2	327402	+	NM_001282961	58910089	59229714	18
chr13	59550895	59658708	Agtpbp1	107813	-	NM_023328	59551497	59645779	26
chr13	59681536	59686584	A230056J06Rik	5048	-	NR_045633	59686584	59686584	2
chr13	59686693	59736142	Naa35	49449	+	NM_030153	59687518	59735838	23
chr13	59736356	59777145	Golm1	40789	-	NM_027307	59738652	59767016	11
chr13	59788762	59795462	4921517D22Rik	6700	-	NM_183290	59790820	59792990	5
chr13	59801443	59807558	Spata31d1a	6115	-	NM_028157	59801662	59807511	4
chr13	59813644	59820650	Spata31d1b	7006	+	NM_001167593	59813675	59820486	4
chr13	59827285	59833113	Spata31d1d	5828	-	NM_177711	59827336	59833081	4
chr13	59835010	59838831	4930528D03Rik	3821	+	NR_045977	59838831	59838831	3
chr13	59856775	59871150	Isca1	14375	-	NM_026921	59858215	59871065	4
chr13	59871326	59875041	Etohd2	3715	+	NR_015349	59875041	59875041	2
chr13	59873239	59924508	Zcchc6	51269	-	NM_153538	59880159	59923440	28
chr13	60131071	60218030	A530065N20Rik	86959	+	NR_046142	60218030	60218030	3
chr13	60275765	60278896	Gas1	3131	-	NM_008086	60277147	60278302	1
chr13	60306831	60317379	Gm5084	10548	+	NR_036449	60317379	60317379	4
chr13	60703307	60864552	Dapk1	161245	+	NM_001285917	60703895	60863757	27
chr13	60883247	60887725	BC051665	4478	-	NM_199148	60883515	60886506	8
chr13	60899610	60904205	Ctsll3	4595	-	NM_027344	60899860	60902776	8
chr13	60943972	60965777	4930486L24Rik	21805	-	NM_178098	60944237	60956299	8
chr13	60996711	60998808	Ctla2b	2097	-	NM_007797	60997071	60998075	5
chr13	61002655	61006208	Tpbpb	3553	-	NM_026429	61002915	61003996	5
chr13	61035515	61037986	Ctla2a	2471	-	NM_007796	61036380	61037892	5
chr13	61040052	61043296	Tpbpa	3244	-	NM_009411	61040966	61042049	5
chr13	61101638	61107272	Ctsj	5634	-	NM_012007	61101837	61105911	8
chr13	61136402	61141958	Ctsq	5556	-	NM_029636	61136655	61140913	8
chr13	61260575	61265549	Ctsr	4974	-	NM_020284	61260836	61264591	8
chr13	61296507	61304753	Cts6	8246	-	NM_021445	61296761	61303626	8
chr13	61348107	61356709	Cts8	8602	-	NM_019541	61349514	61355442	8
chr13	61382740	61390211	Cts8-ps	7471	-	NR_027871	61390211	61390211	5
chr13	61453821	61459531	Cts7	5710	-	NM_019539	61454096	61458397	8
chr13	61637803	61643199	Ctsm	5396	-	NM_022326	61637914	61641673	8
chr13	61665989	61671487	Cts3	5498	-	NM_054092	61666265	61670180	8
chr13	61872939	61888642	BC052688	15703	+	NR_028430	61888642	61888642	4
chr13	62231249	62275296	Zfp808	44047	+	NM_001039239	62231385	62274580	4
chr13	62469075	62484534	Gm3604	15459	-	NM_001162910	62470222	62484442	4
chr13	62554375	62568172	Zfp935	13797	-	NM_178875	62555682	62568069	4
chr13	62618156	62659959	Zfp934	41803	-	NM_175252	62618859	62621811	7
chr13	62704374	62725542	6720489N17Rik	21168	-	NM_173381	62706549	62725400	3
chr13	62862098	62862206	Mir713	108	+	NR_030493	62862206	62862206	1
chr13	62873559	62887168	Gm5141	13609	-	NM_001256065	62874967	62887043	4
chr13	62938244	62959730	Fbp2	21486	-	NM_007994	62938445	62959657	7
chr13	62966112	62989642	Fbp1	23530	-	NM_019395	62966335	62989403	7
chr13	63066252	63404185	2010111I01Rik	337933	+	NM_001289924	63116526	63400160	17
chr13	63390461	63398455	Gm16907	7994	-	NR_045794	63398455	63398455	3
chr13	63401791	63401865	Mir23b	74	+	NR_029530	63401865	63401865	1
chr13	63402019	63402092	Mir27b	73	+	NR_029531	63402092	63402092	1
chr13	63402506	63402591	Mir3074-1	85	-	NR_037235	63402591	63402591	1
chr13	63402515	63402583	Mir24-1	68	+	NR_029575	63402583	63402583	1
chr13	63406016	63533053	Fancc	127037	-	NM_001042673	63413973	63504314	16
chr13	63612840	63666828	Ptch1	53988	-	NM_008957	63612840	63666828	23
chr13	63777064	63835606	1700024I08Rik	58542	-	NR_126476	63835606	63835606	5
chr13	63916627	64001609	Ercc6l2	84982	+	NM_001013608	63916782	64000811	19
chr13	64159581	64190509	Hsd17b3	30928	-	NM_008291	64159876	64190436	11
chr13	64197617	64230638	Slc35d2	33021	-	NM_001001321	64198889	64230615	12
chr13	64234364	64254507	Zfp367	20143	-	NM_175494	64236621	64254297	5
chr13	64263173	64287845	Habp4	24672	+	NM_019986	64263293	64286637	8
chr13	64293852	64376296	Cdc14b	82444	-	NM_172587	64306610	64376058	14
chr13	64350007	64369453	1810034E14Rik	19446	+	NR_045798	64369453	64369453	3
chr13	64393143	64414018	Aaed1	20875	-	NM_025370	64393408	64413992	6
chr13	64463197	64471828	Ctsl	8631	-	NM_009984	64465405	64470461	8
chr13	64533860	64541029	Cdk20	7169	+	NM_053180	64533903	64540286	8
chr13	64582553	64599100	1190003K10Rik	16547	-	NM_001195435	64583071	64587308	3
chr13	64838898	65005196	Cntnap3	166298	-	NM_001081129	64839854	65005148	24
chr13	65018713	65024503	Spata31	5790	+	NM_030047	65018790	65024392	3
chr13	65134365	65139312	Spata31d1c	4947	+	NM_001083890	65134396	65138515	4
chr13	65166337	65214290	Hiatl1	47953	-	NM_001083901	65167920	65213925	13
chr13	65253533	65254460	Olfr466	927	+	NM_146819	65253533	65254460	1
chr13	65278418	65307024	Nlrp4f	28606	-	NM_175290	65282871	65300750	10
chr13	65380161	65399103	Zfp369	18942	+	NM_178364	65380279	65398890	8
chr13	66214388	66223772	Gm10324	9384	+	NM_001177832	66214493	66223772	4
chr13	66519049	66542054	2410141K09Rik	23005	-	NM_183119	66519180	66541958	5
chr13	67001556	67006286	Uqcrb	4730	-	NM_026219	67001684	67006247	4
chr13	67006350	67010102	Gm10767	3752	+	NM_001177750	67008880	67009192	3
chr13	67013033	67034008	Mterf3	20975	-	NM_025547	67013119	67031139	8
chr13	67033765	67099337	Ptdss1	65572	+	NM_008959	67034443	67098013	13
chr13	67097753	67133341	4933433G19Rik	35588	-	NR_045851	67133341	67133341	9
chr13	67139529	67162106	Zfp712	22577	-	NM_001166218	67141279	67162004	4
chr13	67170333	67198912	Zfp708	28579	-	NM_001012325	67171103	67198770	4
chr13	67197548	67214964	Rslcan18	17416	-	NM_001256052	67199099	67214917	7
chr13	67229163	67242723	Zfp759	13560	+	NM_172392	67229244	67241488	4
chr13	67274117	67284434	Rsl1	10317	+	NM_001013769	67274153	67283883	4
chr13	67295441	67310234	Zfp455	14793	+	NM_001048204	67295524	67308991	4
chr13	67355853	67370004	Zfp458	14151	-	NM_001001152	67357050	67369972	4
chr13	67379529	67384297	F630042J09Rik	4768	+	NR_033540	67384297	67384297	4
chr13	67393386	67407348	Zfp457	13962	-	NM_001003666	67393501	67407291	4
chr13	67413933	67433496	Zfp595	19563	-	NM_177622	67417264	67433408	5
chr13	67440244	67461508	Zfp953	21264	-	NM_001038651	67443907	67461445	4
chr13	67464519	67476699	Zfp456	12180	-	NM_001001186	67467144	67473810	4
chr13	67490264	67500703	Zfp429	10439	-	NM_001080941	67490801	67500667	4
chr13	67506649	67522354	Zfp459	15705	-	NM_177811	67509094	67514893	4
chr13	67541366	67552560	Zfp874a	11194	-	NM_177712	67543155	67552453	4
chr13	67572448	67585189	Zfp874b	12741	-	NM_001076791	67574769	67585082	4
chr13	67591102	67601458	Zfp58	10356	-	NM_001007575	67591836	67595662	4
chr13	67616717	67627167	Zfp87	10450	-	NM_133228	67617654	67627018	4
chr13	67639576	67654088	Zfp748	14512	-	NM_001035231	67641408	67653972	4
chr13	67654137	67671829	9430065F17Rik	17692	+	NR_131100	67671829	67671829	5
chr13	67690375	67710644	Zfp729b	20269	-	NM_001163246	67691943	67710515	4
chr13	67717937	67738690	Zfp729a	20753	-	NM_183146	67720123	67738619	4
chr13	67768377	67784449	Zfp738	16072	-	NM_001001187	67770425	67784375	4
chr13	67806242	67830110	Zfp65	23868	-	NM_145622	67808922	67830003	4
chr13	67830198	67857775	Zfp85os	27577	+	NR_027969	67857775	67857775	3
chr13	67848736	67856071	Zfp85	7335	-	NM_001001130	67849466	67856005	4
chr13	67880629	67890017	Zfp493	9388	+	NM_028402	67880750	67888021	4
chr13	67897530	67931922	4930525G20Rik	34392	-	NR_045194	67931922	67931922	3
chr13	67914752	67927937	Zfp273	13185	+	NM_198322	67914827	67927197	4
chr13	67932042	67944229	Gm10037	12187	+	NM_001309374	67934171	67944007	4
chr13	67964262	67964860	BC048507	598	+	NM_001001185	67964442	67964712	1
chr13	68699656	68721046	Mtrr	21390	-	NM_172480	68701164	68719556	15
chr13	68721124	68731156	Fastkd3	10032	+	NM_027123	68722438	68730906	7
chr13	68736315	68753108	1700001L19Rik	16793	+	NM_027035	68736352	68751886	3
chr13	68758919	69138419	Adcy2	379500	-	NM_153534	68759596	69138173	25
chr13	69636836	69672742	Papd7	35906	-	NM_198600	69638793	69654747	13
chr13	69712326	69750341	Srd5a1	38015	-	NM_175283	69714007	69750125	5
chr13	69750893	69774657	Nsun2	23764	+	NM_145354	69750970	69772729	19
chr13	69841709	69878775	Ube2ql1	37066	-	NM_001145162	69842919	69878218	2
chr13	69948759	69954972	Med10	6213	+	NM_138596	69948808	69954567	4
chr13	70142927	70167226	1700084F23Rik	24299	-	NR_045965	70167226	70167226	5
chr13	70160836	70258827	Gm3772	97991	+	NR_131156	70258827	70258827	3
chr13	70371699	70387000	4930520P13Rik	15301	+	NR_036596	70387000	70387000	4
chr13	70712118	70714982	1700100L14Rik	2864	+	NR_045934	70714982	70714982	3
chr13	70727566	70776512	Ice1	48946	-	NM_144837	70728478	70776475	19
chr13	70866685	70980688	Adamts16	114003	-	NM_172053	70867729	70980427	23
chr13	71021825	71023381	8030423J24Rik	1556	+	NM_029873	71022353	71023117	3
chr13	71245966	71246087	Mir466f-4	121	+	NR_130325	71246087	71246087	1
chr13	72095679	72101171	Irx1	5492	-	NM_010573	72096063	72100936	4
chr13	72760913	72766012	Gm20554	5099	-	NR_030701	72766012	72766012	1
chr13	72766244	72771644	Irx2	5400	+	NM_010574	72766509	72770086	5
chr13	72947048	72954211	D730050B12Rik	7163	-	NR_046196	72954211	72954211	4
chr13	73343538	73366548	4930555K05Rik	23010	-	NR_126459	73366548	73366548	3
chr13	73397944	73407068	Irx4	9124	+	NM_018885	73402382	73406482	6
chr13	73457323	73465930	Ndufs6	8607	-	NM_010888	73457442	73465894	4
chr13	73468456	73469626	Mrpl36	1170	+	NM_053163	73468820	73469129	2
chr13	73482112	73484832	D630045M09Rik	2720	-	NR_045293	73484832	73484832	3
chr13	73604830	73651986	Lpcat1	47156	+	NM_145376	73604830	73651986	14
chr13	73674194	73716120	Slc6a3	41926	+	NM_010020	73675963	73714681	15
chr13	73741449	73758087	Clptm1l	16638	+	NM_146047	73741685	73757565	17
chr13	73764448	73786489	Tert	22041	+	NM_009354	73764477	73786461	16
chr13	73799197	73815471	Slc6a18	16274	-	NM_001136087	73801569	73815377	12
chr13	73818604	73838143	Slc6a19	19539	-	NM_028878	73819076	73838081	12
chr13	73837273	73847304	Slc6a19os	10031	+	NM_027780	73837483	73846408	2
chr13	73901144	73954190	Slc12a7	53046	+	NM_011390	73901214	73952382	24
chr13	73956775	73985079	Nkd2	28304	-	NM_028186	73958407	73984875	10
chr13	74049909	74075215	Trip13	25306	-	NM_027182	74050691	74075029	13
chr13	74075258	74098337	Brd9	23079	+	NM_001308041	74075341	74097786	16
chr13	74101309	74130288	Zdhhc11	28979	+	NM_027704	74101368	74130090	10
chr13	74146866	74173201	Tppp	26335	+	NM_182839	74158590	74168863	4
chr13	74173942	74199733	Cep72	25791	-	NM_028959	74175610	74199710	12
chr13	74258962	74303512	Slc9a3	44550	+	NM_001081060	74258962	74303512	16
chr13	74307252	74346148	Exoc3	38896	-	NM_177333	74309520	74344528	13
chr13	74348565	74429779	Ahrr	81214	-	NM_009644	74351104	74420549	11
chr13	74440568	74454774	Pdcd6	14206	-	NM_011051	74441397	74454655	6
chr13	74459702	74487688	Sdha	27986	-	NM_023281	74460534	74487656	15
chr13	74487764	74503231	Ccdc127	15467	+	NM_001168658	74490313	74498061	4
chr13	74497029	74501448	Lrrc14b	4419	-	NM_001033042	74498201	74501407	2
chr13	74508873	74514014	Zfp72	5141	-	NM_001081680	74509097	74513917	3
chr13	74617504	74631398	Zfp825	13894	-	NM_146231	74617964	74631300	4
chr13	74777319	74829323	Erap1	52004	+	NM_030711	74783671	74828177	19
chr13	74830741	74946208	Cast	115467	-	NM_001301153	74833346	74945958	32
chr13	75227434	75269946	Pcsk1	42512	+	NM_013628	75227509	75269767	14
chr13	75782493	75782589	Mir682	96	+	NR_030451	75782589	75782589	1
chr13	75844931	75909806	Ell2	64875	+	NM_138953	75845098	75908244	12
chr13	75977333	75987599	Glrx	10266	+	NM_053108	75977416	75984734	3
chr13	76006984	76081272	Rhobtb3	74288	-	NM_028493	76009793	76080980	12
chr13	76105186	76136416	Spata9	31230	+	NM_029343	76105281	76136217	5
chr13	76138982	76156160	Rfesd	17178	-	NM_001131069	76140272	76145733	4
chr13	76192298	76194444	Gpr150	2146	-	NM_175495	76192988	76194272	1
chr13	76197869	76236108	Arsk	38239	-	NM_029847	76199703	76235956	8
chr13	76236181	76325431	Ttc37	89250	+	NM_001081352	76245641	76325122	44
chr13	76522408	77171071	Mctp1	648663	+	NM_030174	76781026	77169212	21
chr13	77182348	77274729	Slf1	92381	-	NM_134071	77182809	77265975	21
chr13	77274796	77752940	2210408I21Rik	478144	+	NM_001145676	77314114	77751905	20
chr13	77847950	78305501	Fam172a	457551	+	NM_138312	77882041	78302916	11
chr13	78164162	78165557	Pou5f2	1395	+	NM_029315	78164201	78165191	1
chr13	78328235	78338243	Nr2f1	10008	-	NM_010151	78328993	78337834	3
chr13	78337277	78375825	A830082K12Rik	38548	+	NR_045195	78375825	78375825	3
chr13	81022682	81035303	Arrdc3	12621	+	NM_001042591	81022910	81032687	8
chr13	81079663	81087858	5430425K12Rik	8195	+	NR_103550	81087858	81087858	5
chr13	81103334	81218856	9330111N05Rik	115522	+	NR_015587	81218856	81218856	2
chr13	81234066	81772143	Adgrv1	538077	-	NM_054053	81234381	81772027	90
chr13	81796804	81810889	Lysmd3	14085	+	NM_030257	81804013	81808822	3
chr13	81812835	81850012	Polr3g	37177	-	NM_001081176	81815034	81838859	8
chr13	81850415	81892274	Mblac2	41859	+	NM_028372	81850527	81889345	2
chr13	81922290	81936156	Cetn3	13866	+	NM_007684	81922339	81935696	5
chr13	82837273	82837332	Mir3961	59	-	NR_039537	82837332	82837332	1
chr13	83643032	83806684	Mef2c	163652	+	NM_001170537	83714834	83802236	11
chr13	83867710	83875274	C130071C03Rik	7564	+	NR_015561	83875274	83875274	4
chr13	83878418	83878490	Mir9-2	72	+	NR_029545	83878490	83878490	1
chr13	84030812	84068315	2810049E08Rik	37503	+	NR_036594	84068315	84068315	3
chr13	84164901	84204379	Gm17750	39478	-	NR_131220	84204379	84204379	2
chr13	84361900	84435571	Tmem161b	73671	+	NM_175187	84362036	84434485	12
chr13	85329081	85353328	Ccnh	24247	+	NM_023243	85329140	85352383	9
chr13	85354303	85429091	Rasa1	74788	-	NM_145452	85355708	85428512	25
chr13	86184402	86186400	Cox7c	1998	-	NM_007749	86185357	86186280	3
chr13	88961076	89462830	Edil3	501754	+	NM_001037987	88961586	89459425	11
chr13	89680240	89751437	Hapln1	71197	+	NM_013500	89724326	89747754	5
chr13	89794914	89882117	Vcan	87203	-	NM_001081249	89796835	89871133	15
chr13	89988518	90229213	Xrcc4	240695	-	NM_028012	89988962	90211284	8
chr13	90229271	90254526	Tmem167	25255	+	NM_025335	90229385	90244050	4
chr13	91023053	91044960	Atp6ap1l	21907	-	NM_001145879	91023155	91044897	7
chr13	91062726	91064337	Rps23	1611	+	NM_024175	91062800	91064288	4
chr13	91074953	91363592	Atg10	288639	-	NM_025770	91076207	91348027	8
chr13	91508594	91527690	A830009L08Rik	19096	-	NR_045161	91527690	91527690	3
chr13	91600701	91845780	Ssbp2	245079	+	NM_024272	91600791	91840300	17
chr13	91841269	91881477	4833422C13Rik	40208	-	NR_015501	91881477	91881477	2
chr13	91881125	91925753	Acot12	44628	+	NM_028790	91881135	91924385	15
chr13	91936137	91947301	Zcchc9	11164	-	NM_145453	91936740	91945739	6
chr13	91992991	92016490	Ckmt2	23499	-	NM_198415	91993133	92004938	10
chr13	92020011	92901449	Rasgrf2	881438	-	NM_009027	92024036	92901449	24
chr13	92981832	93124958	Msh3	143126	-	NM_001311120	92982389	93124855	24
chr13	93124737	93159008	Dhfr	34271	+	NM_010049	93125213	93154758	6
chr13	93195923	93211613	Ankrd34b	15690	+	NM_175455	93208216	93209743	5
chr13	93219574	93253986	Fam151b	34412	-	NM_001163627	93220038	93253907	6
chr13	93257703	93300765	Zfyve16	43062	-	NM_173392	93258416	93294254	18
chr13	93344586	93346187	Spz1	1601	-	NM_030237	93344784	93345921	1
chr13	93381092	93481901	Serinc5	100809	+	NM_172588	93381215	93478092	12
chr13	93521540	93564773	Thbs4	43233	-	NM_011582	93521705	93564628	22
chr13	93614741	93628185	Mtx3	13444	+	NM_001162945	93614741	93622849	9
chr13	93810669	93914679	Cmya5	104010	-	NM_023821	93811268	93914461	13
chr13	93843258	93844710	Gm4814	1452	+	NR_036451	93844710	93844710	3
chr13	93864787	93868923	A630019I02Rik	4136	+	NR_046182	93868923	93868923	4
chr13	93917354	93962238	Papd4	44884	-	NM_133905	93917545	93956394	15
chr13	94074449	94175084	Homer1	100635	+	NM_147176	94075252	94172184	10
chr13	94200051	94269763	Jmy	69712	-	NM_021310	94209396	94269261	11
chr13	94386845	94407713	Bhmt	20868	-	NM_016668	94387430	94407451	8
chr13	94426051	94444257	Bhmt2	18206	-	NM_022884	94427017	94444225	8
chr13	94444390	94522778	Dmgdh	78388	+	NM_028772	94444401	94522420	16
chr13	94476054	94489130	AW495222	13076	-	NR_045086	94489130	94489130	3
chr13	94541633	94712971	Arsb	171338	+	NM_009712	94541732	94710686	8
chr13	94560731	94560792	Mir5624	61	+	NR_049198	94560792	94560792	1
chr13	94827750	94965364	Lhfpl2	137614	+	NM_172589	94944178	94962056	4
chr13	94971387	95055236	Scamp1	83849	-	NM_029153	94973953	95055231	9
chr13	95126703	95128878	Gm9776	2175	-	NR_045619	95128878	95128878	1
chr13	95128914	95336271	Ap3b1	207357	+	NM_009680	95129058	95335713	27
chr13	95558897	95612854	Tbca	53957	+	NM_009321	95558904	95612685	4
chr13	95645581	95653636	Otp	8055	+	NM_011021	95645724	95653575	3
chr13	95746298	95793271	Wdr41	46973	+	NM_172590	95746493	95791780	13
chr13	95794059	96020259	Pde8b	226200	-	NM_172263	95796074	96020115	20
chr13	96093559	96107797	Zbed3	14238	+	NM_001302538	96106024	96106711	2
chr13	96100565	96100691	Snora47	126	+	NR_034043	96100691	96100691	1
chr13	96120637	96145312	Aggf1	24675	-	NM_025630	96121456	96145013	14
chr13	96201330	96214786	Crhbp	13456	-	NM_198408	96201891	96214635	7
chr13	96247255	96248610	S100z	1355	-	NM_001081159	96247255	96248610	2
chr13	96281683	96295195	F2rl1	13512	-	NM_007974	96283127	96295082	2
chr13	96371743	96388388	F2r	16645	-	NM_010169	96373687	96388329	2
chr13	96397131	96661877	Iqgap2	264746	-	NM_027711	96397961	96661664	36
chr13	96466874	96472723	F2rl2	5849	+	NM_010170	96467018	96471513	2
chr13	96729397	96902532	Sv2c	173135	-	NM_029210	96731234	96858754	13
chr13	97158248	97185542	Poc5	27294	+	NM_026173	97161552	97184574	13
chr13	97186088	97241115	Ankdd1b	55027	-	NM_001042714	97187793	97240903	14
chr13	97250643	97312440	Polk	61797	-	NM_012048	97252124	97289115	15
chr13	97312689	97410122	Col4a3bp	97433	+	NM_023420	97313118	97405832	18
chr13	97418918	97440891	Hmgcr	21973	-	NM_008255	97420533	97436640	20
chr13	97694643	97720869	Gcnt4	26226	+	NM_001166065	97716152	97717520	3
chr13	97791818	97805209	1700029F12Rik	13391	-	NR_104276	97805209	97805209	3
chr13	97837241	97899477	Fam169a	62236	+	NM_001146045	97861775	97896993	13
chr13	97899381	97907881	Nsa2	8500	-	NM_021552	97901115	97907712	6
chr13	97907891	97951151	Gfm2	43260	+	NM_001146043	97911902	97949006	21
chr13	97946285	97968312	Hexb	22027	-	NM_010422	97946483	97968216	14
chr13	98011059	98022995	Enc1	11936	+	NM_007930	98014938	98016708	3
chr13	98204924	98267619	Lncenc1	62695	+	NR_110432	98267619	98267619	2
chr13	98329954	98353949	Gm5086	23995	+	NR_046157	98353949	98353949	3
chr13	98668549	98976120	Arhgef28	307571	-	NM_012026	98669601	98915539	36
chr13	99016799	99032947	Utp15	16148	-	NM_178918	99019083	99030843	13
chr13	99033030	99044709	Ankra2	11679	+	NM_001271389	99036201	99043921	9
chr13	99079851	99086961	Btf3	7110	-	NM_001170540	99080109	99086253	6
chr13	99124199	99126660	Foxd1	2461	+	NM_008242	99124574	99125945	1
chr13	99194064	99205020	2310005E17Rik	10956	-	NR_045498	99205020	99205020	3
chr13	99404932	99407365	Tmem174	2433	-	NM_026685	99406362	99407275	2
chr13	99456192	99464786	Tmem171	8594	-	NM_001025606	99456275	99462595	4
chr13	99493360	99585404	Fcho2	92044	-	NM_172591	99495708	99585063	26
chr13	99612035	99696339	Tnpo1	84304	-	NM_178716	99616410	99696220	24
chr13	99754044	99754520	1700024P04Rik	476	-	NM_027064	99754099	99754471	1
chr13	99846482	99857876	2310020H05Rik	11394	-	NR_045495	99857876	99857876	6
chr13	99954777	100016987	Zfp366	62210	+	NM_001004149	99998287	100016526	5
chr13	100089603	100114633	Ptcd2	25030	-	NM_026873	100090123	100114624	10
chr13	100114740	100185516	Mrps27	70776	+	NM_173757	100114757	100184933	11
chr13	100180790	100182781	6430562O15Rik	1991	-	NR_015515	100182781	100182781	2
chr13	100191418	100286557	Map1b	95139	-	NM_008634	100195760	100286442	7
chr13	100668437	100670638	Cartpt	2201	-	NM_001081493	100668873	100670589	3
chr13	100718486	100785594	Mccc2	67108	-	NM_030026	100718793	100785469	17
chr13	100787948	100874025	Bdp1	86077	-	NM_001081061	100790233	100873793	39
chr13	100877973	100884188	Serf1	6215	+	NM_011353	100878177	100883992	3
chr13	100893159	100907653	Smn1	14494	+	NM_001252629	100898286	100905691	9
chr13	100914017	100972077	Naip2	58060	-	NM_010872	100914313	100959353	16
chr13	100981694	101017291	Naip5	35597	-	NM_010870	100982561	101016154	15
chr13	101051075	101086571	Naip6	35496	-	NM_010871	101053503	101086506	14
chr13	101053069	101087643	Naip7	34574	-	NM_021545	101053503	101086506	15
chr13	101177724	101222819	Naip1	45095	-	NM_008670	101178761	101214692	16
chr13	101238531	101262564	Gtf2h2	24033	-	NM_022011	101238861	101260086	16
chr13	101267321	101322453	Ocln	55132	-	NM_008756	101268768	101311072	9
chr13	101365911	101386926	Marveld2	21015	-	NM_001038602	101367243	101382524	7
chr13	101387118	101421016	Rad17	33898	-	NM_001283011	101387598	101403865	18
chr13	101421297	101426015	Taf9	4718	+	NM_027139	101425005	101425800	3
chr13	101421297	101436370	Ak6	15073	+	NM_027592	101421372	101435974	5
chr13	101439435	101467195	Ccdc125	27760	+	NM_183115	101447868	101466374	12
chr13	101466979	101500897	Cdk7	33918	-	NM_009874	101473432	101500794	12
chr13	101505894	101514614	Mrps36	8720	-	NM_001190264	101506210	101514523	4
chr13	101529640	101545854	Cenph	16214	-	NM_021886	101530056	101545757	9
chr13	101548693	101556441	Ccnb1	7748	-	NM_172301	101549632	101556357	9
chr13	101572602	101603382	Slc30a5	30780	-	NM_022885	101573245	101603132	16
chr13	102002081	102017506	5930438M14Rik	15425	+	NR_046158	102017506	102017506	4
chr13	102024273	102063351	4933416M06Rik	39078	+	NR_045846	102063351	102063351	6
chr13	102161825	102167535	4922502H24Rik	5710	-	NR_046187	102167535	102167535	3
chr13	102450715	102538172	Pik3r1	87457	-	NM_001077495	102454834	102527614	16
chr13	103483637	103496711	Cd180	13074	+	NM_008533	103483779	103496513	3
chr13	103522568	104124572	Mast4	602004	-	NM_175171	103525081	104124272	29
chr13	103550334	103551976	1700099I09Rik	1642	+	NR_130171	103551976	103551976	3
chr13	104531694	104554662	Srek1	22968	-	NM_172592	104533643	104554033	10
chr13	104608865	104710666	Erbb2ip	101801	-	NM_001005868	104610778	104676409	27
chr13	104813518	104899694	Nln	86176	-	NM_029447	104815025	104899536	13
chr13	104899869	104931521	Sgtb	31652	+	NM_144838	104901169	104929931	11
chr13	104932232	104968546	Trappc13	36314	-	NM_025879	104934217	104968239	13
chr13	104969177	104992128	Trim23	22951	+	NM_030731	104971132	104991490	10
chr13	104995201	105018924	Ppwd1	23723	-	NM_172807	104995583	105018881	11
chr13	105018690	105039702	Cenpk	21012	+	NR_075088	105039702	105039702	10
chr13	105077952	105284843	Adamts6	206891	+	NM_001081020	105084807	105283784	25
chr13	105421406	105607033	Cwc27	185627	-	NM_026072	105421655	105606808	14
chr13	105607318	105628739	Srek1ip1	21421	+	NM_026075	105607433	105627628	5
chr13	105635362	105653973	Fam159b	18611	-	NM_029984	105636015	105653793	3
chr13	105737232	105845010	Rgs7bp	107778	-	NM_029879	105741570	105844294	6
chr13	105872201	105911862	4933425L06Rik	39661	+	NM_025751	105872239	105911501	8
chr13	105937573	106083094	Rnf180	145521	-	NM_027934	105939431	106061119	8
chr13	106233772	106238213	Htr1a	4441	+	NM_008308	106234333	106235599	1
chr13	107584518	107726995	Ipo11	142477	-	NM_029665	107585710	107715230	30
chr13	107737208	107750304	Dimt1	13096	+	NM_025447	107737284	107748777	12
chr13	107750664	107812194	Kif2a	61530	-	NM_008442	107752218	107784005	22
chr13	107812649	107823598	3830408C21Rik	10949	+	NR_015471	107823598	107823598	4
chr13	108259901	108269268	AI197445	9367	+	NR_045083	108269268	108269268	3
chr13	108477476	108482248	1700006H21Rik	4772	+	NR_045900	108482248	108482248	3
chr13	108514696	108680258	Zswim6	165562	-	NM_145456	108516514	108680243	15
chr13	108834667	108839340	Smim15	4673	+	NM_001048250	108837655	108837880	3
chr13	108842782	108948819	Ndufaf2	106037	-	NM_001127346	108842899	108948763	4
chr13	108948931	108985175	Ercc8	36244	+	NM_028042	108948987	108984318	12
chr13	109004597	109077301	Elovl7	72704	+	NM_029001	109046928	109072875	8
chr13	109106530	109179751	Depdc1b	73221	+	NM_178683	109106615	109178896	11
chr13	109444370	110746177	Pde4d	1301807	+	NM_011056	109650359	110741552	17
chr13	110114937	110115017	Mir582	80	+	NR_030644	110115017	110115017	1
chr13	110694016	110694096	Mir1904	80	+	NR_035442	110694096	110694096	1
chr13	110844395	111070414	Rab3c	226019	-	NM_023852	110852022	111070226	5
chr13	111142822	111147380	Gapt	4558	-	NM_177713	111143861	111144335	3
chr13	111185251	111191051	Plk2	5800	+	NM_152804	111185384	111190432	14
chr13	111672618	111694054	4930526H09Rik	21436	-	NR_131194	111694054	111694054	3
chr13	111693706	111698488	Gm38397	4782	+	NR_131193	111698488	111698488	5
chr13	112001676	112019639	3110015C05Rik	17963	-	NR_045908	112019639	112019639	3
chr13	112045220	112047957	Actbl2	2737	+	NM_175497	112045340	112046471	1
chr13	112215887	112280249	Gpbp1	64362	-	NM_028487	112216700	112257121	13
chr13	112476385	112508802	Mier3	32417	+	NM_172593	112476553	112505349	13
chr13	112536642	112599191	Map3k1	62549	-	NM_011945	112539107	112599177	20
chr13	112658143	112662145	Gm15326	4002	+	NR_130345	112662145	112662145	3
chr13	113078658	113174210	Ankrd55	95552	+	NM_001168403	113108661	113173787	12
chr13	113254277	113297068	Il6st	42791	+	NM_010560	113265253	113294653	17
chr13	113313015	113370870	Il31ra	57855	-	NM_139299	113314110	113349410	17
chr13	113388540	113442518	Ddx4	53978	-	NM_001145885	113389152	113441611	22
chr13	113450973	113528960	Slc38a9	77987	+	NM_178746	113459829	113521872	15
chr13	113590984	113658102	Plpp1	67118	+	NM_008247	113591416	113657776	6
chr13	113657987	113717588	Skiv2l2	59601	-	NM_028151	113658150	113717565	27
chr13	113718000	113759395	Dhx29	41395	+	NM_172594	113718000	113759395	27
chr13	113778009	113780986	Ccno	2977	+	NM_001081062	113778105	113780265	3
chr13	113784075	113790602	Mcidas	6527	+	NM_001037914	113784079	113789392	7
chr13	113825586	113881343	Cdc20b	55757	+	NM_001281487	113825586	113881343	12
chr13	113826190	113826299	Mir449c	109	+	NR_030452	113826299	113826299	1
chr13	113827626	113827706	Mir449b	80	+	NR_030602	113827706	113827706	1
chr13	113827741	113827832	Mir449a	91	+	NR_029961	113827832	113827832	1
chr13	113832970	113836596	Gpx8	3626	-	NM_027127	113833343	113836583	3
chr13	113884034	113891189	Gzma	7155	-	NM_010370	113884099	113891159	5
chr13	113926283	113934220	1700084D21Rik	7937	+	NR_131045	113934220	113934220	3
chr13	113962081	113971105	Gzmk	9024	-	NM_008196	113962081	113971105	5
chr13	113999866	114008312	Esm1	8446	+	NM_023612	114000050	114006948	3
chr13	114236495	114293052	4921509O07Rik	56557	-	NR_045501	114293052	114293052	7
chr13	114382386	114408772	Snx18	26386	-	NM_130796	114384816	114408603	2
chr13	114453103	114453884	Hspb3	781	-	NM_019960	114453235	114453700	1
chr13	114584715	114947669	Arl15	362954	+	NM_172595	114584856	114945064	5
chr13	114914555	114941800	A430090L17Rik	27245	-	NR_045836	114941800	114941800	14
chr13	115078002	115178302	Ndufs4	100300	-	NM_010887	115078970	115178264	5
chr13	115242469	115249159	Fst	6690	-	NM_008046	115243630	115248794	6
chr13	115397435	115488030	4930544M13Rik	90595	+	NR_045976	115488030	115488030	7
chr13	115608444	115619628	Mocs2	11184	+	NM_013826	115608513	115611136	7
chr13	115626119	115722249	Itga2	96130	-	NM_008396	115626692	115722141	30
chr13	115748288	115892172	Itga1	143884	-	NM_001033228	115750297	115891739	29
chr13	115878562	115880366	Pelo	1804	-	NM_134058	115878737	115880127	2
chr13	117088477	117099896	Isl1	11419	-	NM_021459	117089687	117099630	6
chr13	117643630	117814323	Parp8	170693	-	NM_001081009	117643996	117814277	27
chr13	117918831	117924691	Gm6416	5860	+	NR_046023	117924691	117924691	4
chr13	118009379	118063222	Emb	53843	+	NM_010330	118009655	118061869	9
chr13	118391126	118769835	Hcn1	378709	+	NM_010408	118391510	118765041	8
chr13	118495570	118508818	4933413L06Rik	13248	-	NR_045508	118508818	118508818	5
chr13	119168916	119176059	Mrps30	7143	-	NM_021556	119169159	119176041	5
chr13	119344974	119377436	1700003P14Rik	32462	+	NR_045982	119377436	119377436	4
chr13	119392216	119447550	Gm10732	55334	-	NR_131153	119447550	119447550	7
chr13	119503505	119581380	Fgf10	77875	+	NM_008002	119504190	119578123	3
chr13	120123123	120197818	Nnt	74695	-	NM_008710	120125063	120193509	17
chr13	120217406	120249130	Paip1	31724	+	NM_001079849	120219037	120245888	11
chr13	120251565	120274924	4833420G17Rik	23359	+	NM_026127	120254910	120274724	14
chr13	120276063	120277191	3110070M22Rik	1128	-	NR_027974	120277191	120277191	1
chr13	120276845	120284312	Gm7120	7467	+	NM_001039244	120281441	120284277	3
chr13_random	114526	132436	Hmgcs1	17910	-	NM_145942	116308	123113	11
chr13_random	141204	142745	1700074H08Rik	1541	-	NR_045296	142745	142745	3
chr13_random	225536	251474	Zfp131	25938	+	NM_001302550	226386	250308	7
chr13_random	260753	306603	Nim1k	45850	+	NM_175538	288749	304651	4
chr13_random	362538	393978	Ccl28	31440	-	NM_020279	365830	393924	3
chr14	3049284	3076838	Gm2897	27554	+	NM_001177715	3070130	3075783	7
chr14	3224445	3234357	D830030K20Rik	9912	+	NM_177135	3225320	3233523	5
chr14	3262412	3305842	1700110I01Rik	43430	+	NR_038059	3305842	3305842	4
chr14	3500848	3668655	Gm5795	167807	+	NM_001270806	3500882	3668333	5
chr14	3920623	3936392	Gm3002	15769	+	NR_033388	3936392	3936392	5
chr14	4126976	4144402	Gm5796	17426	+	NM_001029930	4136792	4143267	6
chr14	4437801	4457726	2610042L04Rik	19925	+	NM_001309398	4451879	4456501	6
chr14	4534030	4622491	Gm3264	88461	+	NM_001242945	4534030	4622491	4
chr14	5153653	5162268	4930555G01Rik	8615	+	NM_175393	5153735	5160903	5
chr14	5266666	5273317	Gm3317	6651	+	NM_001242941	5266666	5272258	5
chr14	5266666	5273317	Gm3488	6651	+	NM_001256885	5266666	5272258	5
chr14	5468459	6240637	LOC100861615	772178	-	NM_001270812	5923711	5929286	8
chr14	5540867	5613657	Gm3383	72790	-	NM_001291094	5541995	5547570	5
chr14	5731119	5754402	Gm3500	23283	+	NM_001256886	5746792	5753267	7
chr14	6956219	6964661	Gm10413	8442	+	NM_029288	6956282	6964346	5
chr14	6973740	6991301	Gm3020	17561	+	NR_033117	6991301	6991301	6
chr14	6973740	6994984	Gm10409	21244	+	NR_033121	6994984	6994984	7
chr14	7010438	7020406	Gm10408	9968	+	NM_001256501	7010507	7019561	5
chr14	7568196	7589571	Gm3636	21375	-	NM_001309401	7569255	7573944	5
chr14	7838628	7859963	Gm10406	21335	-	NM_001164727	7839761	7845280	7
chr14	7915538	7937971	Gm3696	22433	-	NM_001024712	7916861	7923326	7
chr14	8156501	8164909	Gm5797	8408	-	NM_001025085	8156820	8164846	5
chr14	8244986	8255199	4933406F09Rik	10213	+	NR_015568	8255199	8255199	2
chr14	8377664	8401080	Gm3558	23416	-	NM_001270842	8378798	8385270	7
chr14	8650470	8784101	Flnb	133631	+	NM_001081427	8650665	8783006	46
chr14	8797703	8826696	Dnase1l3	28993	-	NM_007870	8800272	8826499	8
chr14	8835415	8889069	Abhd6	53654	+	NM_025341	8860784	8888158	9
chr14	8912826	8924360	Rpp14	11534	+	NM_025938	8916237	8922478	6
chr14	8930726	8997625	Pxk	66899	+	NM_178279	8930828	8992532	19
chr14	8998504	9005506	Pdhb	7002	-	NM_024221	8998849	9005446	10
chr14	9046594	9056083	Kctd6	9489	+	NM_027782	9052707	9055387	3
chr14	9058024	9091533	Acox2	33509	-	NM_053115	9058279	9089375	15
chr14	9128791	9142290	Fam107a	13499	-	NM_183187	9131203	9133742	4
chr14	9181461	9211277	Oit1	29816	-	NM_146050	9181790	9199560	10
chr14	9263685	9498804	4930452B06Rik	235119	-	NM_028934	9264119	9498512	16
chr14	9498903	9505892	4930455B14Rik	6989	+	NR_045968	9505892	9505892	6
chr14	10382607	11994549	Fhit	1611942	-	NM_001308285	10382906	11584200	10
chr14	10716608	10719382	Mnd1-ps	2774	+	NR_030680	10719382	10719382	1
chr14	11571066	11611515	Fhitos	40449	+	NR_131139	11611515	11611515	4
chr14	12386066	13074553	Ptprg	688487	+	NM_008981	12386761	13070387	30
chr14	13116716	13135745	3830406C13Rik	19029	+	NM_146051	13117929	13132256	6
chr14	13174405	13178379	Fezf2	3974	-	NM_080433	13175009	13177699	5
chr14	13205076	13655593	Cadps	450517	-	NM_001042617	13206127	13655252	31
chr14	13989901	14117152	Gm5087	127251	-	NR_121588	14117152	14117152	4
chr14	14117293	14447983	Synpr	330690	+	NM_028052	14117498	14446495	6
chr14	14503389	14515662	Sntn	12273	+	NM_177624	14503409	14514886	4
chr14	14781525	14793827	Thoc7	12302	-	NM_001285780	14781773	14786033	9
chr14	14845004	14939815	Atxn7	94811	+	NM_139227	14845597	14935838	12
chr14	14944698	14953418	Psmd6	8720	-	NM_025550	14944803	14953397	8
chr14	15007643	15008594	Olfr720	951	-	NM_146392	15007643	15008594	1
chr14	15160626	15161580	Olfr31	954	+	NM_147027	15160626	15161580	1
chr14	15179008	15188004	Il3ra	8996	+	NM_008369	15179644	15187940	12
chr14	15535538	15632457	Slc4a7	96919	+	NM_001033270	15535746	15628672	25
chr14	15653328	15839207	Nek10	185879	+	NM_001195229	15653328	15839207	35
chr14	16190030	16271501	Lrrc3b	81471	-	NM_146052	16190338	16191118	2
chr14	17071172	17082322	Oxsm	11150	-	NM_027695	17073181	17075281	3
chr14	17081827	17144440	Ngly1	62613	+	NM_021504	17081880	17143548	12
chr14	17197719	17263301	Top2b	65582	+	NM_009409	17198192	17262980	36
chr14	17263353	17914845	Rarb	651492	-	NM_001289760	17264584	17651381	10
chr14	18493473	18870602	Thrb	377129	+	NM_001113417	18758151	18866180	10
chr14	19036569	19071620	Nr1d2	35051	-	NM_011584	19039198	19071340	8
chr14	19100336	19103500	Rpl15	3164	-	NM_025586	19101524	19102964	4
chr14	19103649	19116514	Nkiras1	12865	+	NM_001316711	19110611	19112703	5
chr14	19115242	19164358	Ube2e1	49116	-	NM_009455	19115855	19163615	6
chr14	19406090	19726141	Ube2e2	320051	-	NM_144839	19406807	19720955	6
chr14	20413359	20421809	Gm5458	8450	-	NM_001024706	20413679	20421740	5
chr14	20570478	20631009	Nid2	60531	+	NM_008695	20570559	20630418	21
chr14	20630623	20643045	2700060E02Rik	12422	-	NM_026528	20631304	20642951	8
chr14	20658146	20663899	D14Ertd670e	5753	+	NR_105025	20663899	20663899	3
chr14	20691780	20796471	Gng2	104691	-	NM_001285909	20695028	20710594	6
chr14	20894857	20902394	Saysd1	7537	-	NM_026209	20896509	20902309	2
chr14	20959279	21001004	Kcnk5	41725	-	NM_021542	20960804	21000674	5
chr14	21081977	21088384	Kcnk16	6407	-	NM_029006	21081977	21088384	5
chr14	21113911	21136797	Nudt13	22886	+	NM_026341	21119818	21135446	9
chr14	21139080	21167343	Ecd	28263	-	NM_027475	21139945	21166037	14
chr14	21167383	21202713	Fam149b	35330	+	NM_001024512	21167569	21202206	14
chr14	21203859	21208132	Dnajc9	4273	-	NM_134081	21204583	21208005	5
chr14	21210452	21212777	Mrps16	2325	-	NM_025440	21210548	21212715	3
chr14	21213411	21271447	Cfap70	58036	-	NM_029698	21213542	21267839	29
chr14	21274482	21299355	Anxa7	24873	-	NM_001110794	21275700	21292550	13
chr14	21302085	21316123	Mss51	14038	-	NM_029104	21302282	21306883	7
chr14	21318585	21365795	Ppp3cb	47210	-	NM_008914	21320705	21365662	14
chr14	21365514	21389902	1810062O18Rik	24388	+	NR_033571	21389902	21389902	6
chr14	21368133	21437576	Usp54	69443	-	NM_030180	21369122	21426450	21
chr14	21468323	21475762	Myoz1	7439	-	NM_021508	21468599	21474570	6
chr14	21478169	21487576	Synpo2l	9407	-	NM_175132	21479522	21487417	4
chr14	21493542	21514072	Sec24c	20530	+	NM_001168273	21495207	21513013	24
chr14	21509856	21509925	Mir6946	69	+	NR_105911	21509925	21509925	1
chr14	21514189	21519419	Fut11	5230	+	NM_028428	21514224	21517580	3
chr14	21521233	21522321	6230400D17Rik	1088	-	NR_029446	21522321	21522321	1
chr14	21522248	21523647	Chchd1	1399	+	NM_025366	21522295	21523456	3
chr14	21526773	21542841	Zswim8	16068	+	NM_001252082	21527070	21542564	27
chr14	21542951	21553784	Ndst2	10833	-	NM_010811	21543456	21549392	15
chr14	21554094	21613310	Camk2g	59216	-	NM_178597	21556492	21613187	21
chr14	21655883	21662610	Plau	6727	+	NM_008873	21656300	21661672	11
chr14	21748654	21852895	Vcl	104241	+	NM_009502	21748742	21850955	21
chr14	21852963	21871664	Ap3m1	18701	-	NM_018829	21855824	21864982	9
chr14	21871795	22267791	Adk	395996	+	NM_134079	21871860	22267160	11
chr14	22318991	22491700	Kat6b	172709	+	NM_001205241	22336096	22490095	17
chr14	22495793	22533798	Dupd1	38005	-	NM_001013826	22496152	22522298	4
chr14	22552617	22567844	Dusp13	15227	-	NM_001007268	22565539	22567816	8
chr14	22569752	22617947	Samd8	48195	+	NM_026283	22569828	22612463	6
chr14	22650782	22665101	Vdac2	14319	+	NM_011695	22651097	22664459	10
chr14	22665082	22668132	Comtd1	3050	-	NM_026965	22666496	22668094	7
chr14	22803183	22808823	Zfp503	5640	-	NM_145459	22804109	22806755	3
chr14	22838933	23875310	1700112E06Rik	1036377	+	NM_028275	22839100	23875256	7
chr14	23326395	23362020	4930405A10Rik	35625	-	NR_046307	23362020	23362020	4
chr14	23857416	23913793	Gm10248	56377	-	NR_033550	23913793	23913793	4
chr14	24117915	24823427	Kcnma1	705512	-	NM_001253359	24119112	24823347	31
chr14	24824212	24825059	4930519K11Rik	847	+	NR_131107	24825059	24825059	3
chr14	24908098	24908152	Mir7210	54	+	NR_106069	24908152	24908152	1
chr14	24953174	25065142	Dlg5	111968	-	NM_001163513	24954791	25064672	32
chr14	25112585	25129181	E330034G19Rik	16596	+	NM_001033214	25112640	25128800	7
chr14	25267915	25306268	Polr3a	38353	-	NM_001081247	25268295	25306138	31
chr14	25309902	25315368	Rps24	5466	+	NM_207635	25309977	25313279	7
chr14	25959280	25962727	4930572O13Rik	3447	-	NR_045718	25962727	25962727	3
chr14	26278670	26486229	Zmiz1	207559	+	NM_183208	26391554	26482533	24
chr14	26353924	26354009	Mir3075	85	+	NR_037236	26354009	26354009	1
chr14	26406289	26410147	4931406H21Rik	3858	+	NR_033492	26410147	26410147	1
chr14	26422998	26425122	Israa	2124	+	NM_001309430	26423032	26423410	1
chr14	26513655	26519952	Ppif	6297	+	NM_134084	26513717	26519088	6
chr14	26515841	26520768	Ppifos	4927	-	NR_028021	26520768	26520768	3
chr14	26531125	26588342	Zcchc24	57217	-	NM_001101433	26534774	26588342	4
chr14	26661640	26706290	Anxa11	44650	+	NM_013469	26688357	26705556	15
chr14	26707419	26722457	Plac9b	15038	-	NM_001270503	26708001	26722368	4
chr14	26707888	26722379	Plac9a	14491	-	NM_207229	26708001	26722368	4
chr14	26742783	26747158	Tmem254a	4375	-	NM_026679	26744272	26746870	4
chr14	26743482	26747142	Tmem254b	3660	-	NM_001270495	26744272	26746870	4
chr14	26743483	26747158	Tmem254c	3675	-	NM_001270498	26744272	26746870	4
chr14	26942094	26949271	Duxbl2	7177	+	NM_001177538	26942603	26948499	5
chr14	26942094	26949271	Duxbl3	7177	+	NM_001177539	26942603	26948499	5
chr14	27041389	27055226	Cphx2	13837	+	NM_001270506	27041437	27054161	4
chr14	27041389	27055228	Cphx3	13839	+	NM_001310463	27041437	27054161	4
chr14	27041393	27055221	Cphx1	13828	+	NM_175342	27041437	27054161	4
chr14	27081743	27088586	Duxbl1	6843	+	NM_183389	27082252	27088148	5
chr14	27177032	27219942	4933413J09Rik	42910	+	NR_038005	27219942	27219942	8
chr14	27232653	27354110	Slmap	121457	-	NM_032008	27235694	27353011	23
chr14	27393343	27453808	Dennd6a	60465	+	NM_001285467	27424221	27449045	20
chr14	27457682	27476744	Arf4	19062	+	NM_007479	27457905	27475468	6
chr14	27483602	27489332	Pde12	5730	-	NM_178668	27485010	27489038	3
chr14	27489032	27489094	Mir7672	62	-	NR_106132	27489094	27489094	1
chr14	27707789	27728443	Asb14	20654	+	NM_001170748	27707849	27728336	10
chr14	27732173	27783737	Appl1	51564	-	NM_145221	27736913	27783640	22
chr14	27813547	27815511	Hesx1	1964	+	NM_010420	27813905	27815290	4
chr14	27852186	27920472	Il17rd	68286	+	NM_134437	27852289	27914572	13
chr14	27957178	28217097	Arhgef3	259919	+	NM_001289686	27966197	28215165	13
chr14	28242032	28296740	Fam208a	54708	+	NM_028945	28242254	28293883	24
chr14	28295595	28321646	Ccdc66	26051	-	NM_177111	28295701	28321618	18
chr14	28435627	29291723	Erc2	856096	+	NM_177814	28466012	29288962	16
chr14	29318658	29338701	Wnt5a	20043	+	NM_009524	29319294	29336126	5
chr14	29718128	30535050	Cacna2d3	816922	-	NM_009785	29718450	30534953	38
chr14	29831393	29846828	Lrtm1	15435	+	NM_176920	29831752	29840940	3
chr14	30781565	30788260	Selk	6695	+	NM_019979	30781703	30787665	5
chr14	30791522	30806407	Actr8	14885	+	NM_027493	30791651	30806290	13
chr14	30802073	30802138	Mir6947	65	+	NR_105912	30802138	30802138	1
chr14	30809353	30822082	Il17rb	12729	-	NM_019583	30809809	30821977	11
chr14	30822185	30853652	Chdh	31467	+	NM_001136240	30844321	30850076	8
chr14	30853129	31304342	Cacna1d	451213	-	NM_028981	30855258	31304287	47
chr14	31271221	31276468	4831407H17Rik	5247	+	NR_131095	31276468	31276468	4
chr14	31292750	31340242	Dcp1a	47492	+	NM_133761	31292807	31336492	10
chr14	31362316	31387911	Tkt	25595	+	NM_009388	31362459	31386698	14
chr14	31385334	31385394	Mir3076	60	+	NR_037237	31385394	31385394	1
chr14	31408539	31439394	Prkcd	30855	-	NM_011103	31409052	31423488	18
chr14	31467560	31504499	Rft1	36939	+	NM_177815	31467598	31503795	13
chr14	31528034	31635907	Sfmbt1	107873	+	NM_019460	31579259	31631034	21
chr14	31638779	31690396	Tmem110	51617	+	NM_028839	31638916	31687662	8
chr14	31692442	31694796	Mustn1	2354	+	NM_181390	31692792	31694216	3
chr14	31699661	31715172	Itih4	15511	+	NM_001159299	31699714	31714890	23
chr14	31721759	31736773	Itih3	15014	-	NM_008407	31721868	31736735	21
chr14	31742365	31756475	Itih1	14110	-	NM_001306078	31742695	31756452	22
chr14	31764562	31802011	Nek4	37449	+	NM_011849	31764811	31800390	15
chr14	31813011	31814852	Spcs1	1841	-	NM_026911	31813282	31814603	4
chr14	31814578	31825627	Glt8d1	11049	+	NM_001165930	31819682	31824861	10
chr14	31825618	31832317	Gnl3	6699	-	NM_153547	31825737	31832127	15
chr14	31827478	31827537	Snord69	59	-	NR_028531	31827537	31827537	1
chr14	31829404	31829458	Snord19	54	-	NR_028523	31829458	31829458	1
chr14	31832323	31934778	Pbrm1	102455	+	NM_001081251	31838698	31932087	33
chr14	31901314	31942116	Smim4	40802	-	NM_001308466	31936939	31941969	4
chr14	31948038	31952310	Nt5dc2	4272	+	NM_027289	31948532	31952228	13
chr14	31952202	31981827	Stab1	29625	-	NM_138672	31952332	31981678	69
chr14	31984113	32020012	Nisch	35899	-	NM_022656	31984753	32019848	21
chr14	32021497	32024897	Tnnc1	3400	+	NM_009393	32021540	32024723	6
chr14	32031058	32042697	Sema3g	11639	+	NM_001025379	32031096	32041392	16
chr14	32050881	32064404	Phf7	13523	-	NM_027949	32051541	32062834	11
chr14	32064674	32073115	Bap1	8441	+	NM_027088	32064803	32072025	17
chr14	32073560	32137082	Dnah1	63522	-	NM_001033668	32073611	32133198	78
chr14	32149909	32185169	Capn7	35260	+	NM_009796	32150067	32184208	21
chr14	32187149	32249219	Sh3bp5	62070	-	NM_011894	32188169	32249143	9
chr14	32291983	32308163	Mettl6	16180	-	NM_025907	32292820	32307007	6
chr14	32308264	32323044	Eaf1	14780	+	NM_028932	32308454	32319803	6
chr14	32336269	32390569	Colq	54300	-	NM_009937	32337595	32390434	17
chr14	32420411	32454151	Hacl1	33740	-	NM_019975	32421196	32454064	17
chr14	32454242	32481383	Btd	27141	+	NM_025295	32454310	32481099	4
chr14	32513200	32643601	Ankrd28	130401	-	NM_001024604	32515205	32643539	28
chr14	32842288	32871512	Galnt15	29224	+	NM_030166	32842678	32871478	10
chr14	32893702	32898878	Dph3	5176	-	NM_001284346	32896366	32898703	4
chr14	32898913	32916389	Oxnad1	17476	+	NM_145460	32904829	32915597	8
chr14	32955208	32971512	Msmb	16304	+	NM_020597	32955257	32971382	4
chr14	32973072	32993041	Ncoa4	19969	+	NM_001033988	32983947	32991014	10
chr14	32993351	33015077	Timm23	21726	-	NM_016897	32993740	33014934	7
chr14	33015156	33110735	Parg	95579	+	NM_011960	33015431	33109506	18
chr14	33135204	33161006	Ogdhl	25802	+	NM_001081130	33138980	33160815	24
chr14	33189687	33201559	1700024G13Rik	11872	-	NM_001034037	33189782	33201538	3
chr14	33221388	33279095	Chat	57707	-	NM_009891	33221930	33271859	16
chr14	33275622	33278036	Slc18a3	2414	-	NM_021712	33276017	33277610	1
chr14	33326706	33394175	Ercc6	67469	+	NM_001081221	33330142	33390288	21
chr14	33413112	33462432	Prrxl1	49320	+	NM_001001796	33413216	33460363	7
chr14	33472304	33498458	3425401B19Rik	26154	-	NM_001195097	33472953	33477192	4
chr14	33599148	33631154	1810011H11Rik	32006	+	NM_001163616	33599236	33630057	5
chr14	33647147	33649974	Fam170b	2827	+	NM_001164485	33647261	33649532	2
chr14	33669941	33752675	Vstm4	82734	+	NM_178791	33670097	33751048	8
chr14	33772732	33998252	Wdfy4	225520	-	NM_001146022	33773123	33976129	59
chr14	33804567	33828478	Lrrc18	23911	+	NM_026253	33821691	33827035	4
chr14	34030008	34183122	Arhgap22	153114	+	NM_153800	34030245	34182764	11
chr14	34191083	34260344	Mapk8	69261	-	NM_016700	34195493	34224163	12
chr14	34402455	34453940	Ptpn20	51485	+	NM_008978	34418236	34452349	12
chr14	34621257	34624469	4930503F20Rik	3212	-	NR_131113	34624469	34624469	4
chr14	34736772	34748468	Gdf10	11696	+	NM_145741	34737081	34747699	3
chr14	34754224	34760384	Gdf2	6160	+	NM_019506	34754336	34758795	2
chr14	34767207	34777402	Rbp3	10195	+	NM_015745	34767282	34775906	4
chr14	34780255	34791950	Zfp488	11695	-	NM_001013777	34783376	34784390	2
chr14	34854263	34860167	Gm5460	5904	+	NM_001034880	34855150	34859212	5
chr14	34864315	34915940	A630023A22Rik	51625	-	NM_001251843	34864732	34868115	5
chr14	34866655	34889185	Antxrl	22530	+	NM_172808	34866851	34889181	17
chr14	34899164	34913754	Anxa8	14590	+	NM_013473	34899241	34912936	12
chr14	34958831	34965605	Npy4r	6774	-	NM_008919	34959387	34960515	2
chr14	35007626	35014819	Gprin2	7193	-	NM_183209	35007629	35008997	2
chr14	35033231	35043607	Syt15	10376	+	NM_181529	35033359	35041367	8
chr14	35050220	35123689	Fam35a	73469	-	NM_029389	35050533	35082133	11
chr14	35123912	35158219	Glud1	34307	+	NM_008133	35124083	35156909	13
chr14	35158240	35158844	Gm3219	604	+	NR_027380	35158844	35158844	1
chr14	35165067	35168579	Fam25c	3512	-	NM_183278	35165129	35168544	3
chr14	35183459	35187855	Sncg	4396	-	NM_011430	35183730	35187766	5
chr14	35188689	35217472	Mmrn2	28783	+	NM_153127	35188800	35216481	7
chr14	35224253	35315732	Bmpr1a	91479	-	NM_009758	35227729	35261024	13
chr14	35324806	35335987	9230112D13Rik	11181	-	NM_030062	35325104	35335921	3
chr14	35339884	35401867	Ldb3	61983	-	NM_001039073	35342645	35401655	15
chr14	35403803	35413328	Opn4	9525	-	NM_001128599	35404477	35413144	10
chr14	35487113	35561169	Wapl	74056	+	NM_001004436	35490161	35558876	19
chr14	35633321	36394301	Grid1	760980	+	NM_008166	35633413	36393995	16
chr14	35707794	35707892	Mir346	98	+	NR_029774	35707892	35707892	1
chr14	36622671	36625164	4930596D02Rik	2493	-	NM_001033766	36623151	36625133	3
chr14	36908150	36910041	4930474N05Rik	1891	+	NM_175008	36908180	36909889	3
chr14	37688121	37781950	Ccser2	93829	-	NM_027045	37692853	37754411	11
chr14	37848094	37862200	Rgr	14106	-	NM_021340	37851421	37862113	7
chr14	37868015	37878124	Lrit1	10109	+	NM_146245	37868110	37875777	4
chr14	37881234	37886921	Lrit2	5687	+	NM_173418	37881260	37885816	3
chr14	37891034	37911497	Cdhr1	20463	-	NM_130878	37892590	37911329	17
chr14	37915325	37923287	2610528A11Rik	7962	-	NM_001206684	37915791	37923234	3
chr14	37933631	37948508	Ghitm	14877	-	NM_078478	37935327	37946950	9
chr14	39182136	40286376	Nrg3	1104240	-	NM_008734	39183718	40286088	10
chr14	39711589	39772082	Nrg3os	60493	+	NR_045713	39772082	39772082	5
chr14	40285716	40289543	LOC432842	3827	+	NR_131973	40289543	40289543	1
chr14	40468950	40498581	1700109I08Rik	29631	+	NR_045936	40498581	40498581	4
chr14	41629156	41706254	Sh2d4b	77098	-	NM_177816	41629156	41706254	8
chr14	41719715	41780185	Tspan14	60470	-	NM_145928	41721346	41747557	9
chr14	41807023	41827122	Fam213a	20099	-	NM_001316734	41807812	41817507	6
chr14	41862497	41882363	Dydc2	19866	-	NM_027717	41862589	41875784	4
chr14	41886199	41905486	Dydc1	19287	+	NM_027094	41891327	41904580	8
chr14	41918321	41937717	Mat1a	19396	+	NM_133653	41918879	41935894	10
chr14	41945076	41949662	Sftpa1	4586	+	NM_023134	41945746	41947735	6
chr14	41964744	41972248	Mbl1	7504	+	NM_010775	41966879	41972165	5
chr14	41985500	41998487	Sftpd	12987	-	NM_009160	41985624	41996421	8
chr14	42668556	42674084	1700091H14Rik	5528	-	NR_073362	42674084	42674084	5
chr14	42833465	42838855	Gm17026	5390	-	NR_105055	42838855	42838855	5
chr14	43688720	43694109	Gm10377	5389	-	NM_001244671	43689005	43694101	5
chr14	44020916	44026344	1700001F09Rik	5428	-	NM_027940	44021199	44026299	5
chr14	44180291	44185678	Gm10375	5387	-	NM_001098269	44180609	44185670	5
chr14	44396430	44397304	Ear1	874	-	NM_007894	44396606	44397074	2
chr14	44500562	44501033	Ear10	471	-	NM_053112	44500562	44501033	1
chr14	44534733	44540745	Ang3	6012	+	NM_001123394	44540145	44540583	3
chr14	44534733	44540745	Ang5	6012	+	NM_007448	44540145	44540583	2
chr14	44579328	44584083	Ang6	4755	-	NM_001011876	44579490	44579934	2
chr14	44680318	44681196	Ear2	878	+	NM_007895	44680551	44681022	2
chr14	44680551	44681022	Ear3	471	+	NM_017388	44680551	44681022	1
chr14	44680551	44681022	Ear12	471	+	NM_001012766	44680551	44681022	1
chr14	44740831	44749036	4930503E14Rik	8205	-	NM_029131	44741518	44748968	4
chr14	44769271	44790902	1700047E10Rik	21631	-	NR_073363	44790902	44790902	3
chr14	45119792	45126016	BC061237	6224	+	NM_198677	45119852	45125732	5
chr14	45336841	45344662	Gm8267	7821	-	NM_001162954	45337440	45344636	4
chr14	45470909	45479050	Ptgdr	8141	-	NM_008962	45472900	45478928	2
chr14	45567117	45567186	Mir327	69	-	NR_030556	45567186	45567186	1
chr14	45574574	45580982	4930431P03Rik	6408	-	NR_045059	45580982	45580982	6
chr14	45607785	45623495	Ptger2	15710	+	NM_008964	45608639	45621670	2
chr14	45754122	45839100	Txndc16	84978	-	NM_172597	45755382	45833123	21
chr14	45839391	45900651	Gpr137c	61260	+	NM_027518	45839667	45899755	7
chr14	45902761	45938247	Ero1l	35486	-	NM_015774	45905702	45938165	16
chr14	45949498	45968746	Psmc6	19248	+	NM_025959	45949522	45968376	14
chr14	45970860	45996559	Styx	25699	+	NM_019637	45971147	45993260	11
chr14	45996095	46008471	Gnpnat1	12376	-	NM_019425	45998013	46004409	6
chr14	46078466	46149740	Fermt2	71274	-	NM_146054	46079524	46149256	15
chr14	46163384	46182551	4930527F14Rik	19167	+	NR_045809	46182551	46182551	7
chr14	46212845	46277818	Ddhd1	64973	-	NM_001284399	46215157	46240468	15
chr14	46277635	46277728	Mir5131	93	-	NR_039593	46277728	46277728	1
chr14	46703701	46704632	Gm1821	931	+	NR_002875	46704632	46704632	2
chr14	46999198	47003281	Gm15217	4083	+	NR_037981	47003281	47003281	4
chr14	47003199	47010344	Bmp4	7145	-	NM_007554	47003533	47005762	4
chr14	47188005	47195526	Rubie	7521	-	NR_046459	47195526	47195526	5
chr14	47222480	47257098	4933425B07Rik	34618	-	NR_046460	47257098	47257098	5
chr14	47265491	47293450	D330046F09Rik	27959	-	NR_131909	47293450	47293450	4
chr14	47380215	47391200	Cdkn3	10985	+	NM_028222	47380314	47391162	8
chr14	47395241	47408032	Cnih1	12791	-	NM_009919	47396196	47407938	5
chr14	47427823	47441917	Gmfb	14094	-	NM_022023	47431426	47441778	7
chr14	47451918	47473865	Cgrrf1	21947	+	NM_026832	47451950	47473694	6
chr14	47502639	47725492	Samd4	222853	+	NM_001037221	47504495	47721134	13
chr14	47574504	47574603	Mir378c	99	-	NR_105813	47574603	47574603	1
chr14	47717353	47735836	Gm10371	18483	-	NR_126579	47735836	47735836	4
chr14	47773569	47809077	Gch1	35508	-	NM_008102	47775472	47808942	6
chr14	47860618	47896532	Wdhd1	35914	-	NM_172598	47861286	47896272	25
chr14	47896817	47911266	Socs4	14449	+	NM_080843	47909284	47910595	2
chr14	47917988	47942766	Mapk1ip1l	24778	+	NM_178684	47928245	47939098	4
chr14	47993534	48005842	Lgals3	12308	+	NM_010705	47999201	48005355	6
chr14	48007453	48038082	Dlgap5	30629	-	NM_144553	48007690	48036245	19
chr14	48092235	48151637	Fbxo34	59402	+	NR_027414	48151637	48151637	6
chr14	48160567	48188109	Atg14	27542	-	NM_172599	48162511	48188081	10
chr14	48268985	48356239	Ktn1	87254	+	NM_001293635	48283461	48353934	41
chr14	48518538	48563864	4930447J18Rik	45326	+	NR_045959	48563864	48563864	4
chr14	48740543	48880558	Peli2	140015	+	NM_033602	48740831	48876257	6
chr14	48818390	48848088	Gm6498	29698	+	NR_003630	48848088	48848088	3
chr14	49065797	49134805	Tmem260	69008	+	NM_001310584	49092122	49131832	17
chr14	49277351	49287319	Otx2	9968	-	NM_001286482	49278380	49282215	5
chr14	49288962	49413023	Otx2os1	124061	+	NR_029384	49413023	49413023	5
chr14	49498547	49506787	4933429O19Rik	8240	+	NR_033783	49506787	49506787	4
chr14	49631818	49686342	Exoc5	54524	-	NM_207214	49633835	49685827	18
chr14	49686169	49707398	Ap5m1	21229	+	NM_144535	49686465	49706002	8
chr14	49791920	49810563	Naa30	18643	+	NM_027492	49792291	49807362	5
chr14	49846033	49865103	1700011H14Rik	19070	-	NM_025956	49846240	49864932	7
chr14	49918194	50145512	Slc35f4	227318	-	NM_029238	49918393	50145288	8
chr14	50301693	50403042	3632451O06Rik	101349	-	NM_026142	50302022	50402951	8
chr14	50513932	50521616	Olfr722	7684	-	NM_146494	50514548	50515475	2
chr14	50548237	50549243	Olfr723	1006	-	NM_001011530	50548287	50549217	1
chr14	50579765	50580771	Olfr724	1006	-	NM_146492	50579815	50580745	1
chr14	50654065	50655175	Olfr725	1110	-	NM_146317	50654110	50655076	1
chr14	50703388	50704354	Olfr726	966	-	NM_146316	50703388	50704354	1
chr14	50746227	50747262	Olfr727	1035	+	NM_146319	50746253	50747228	1
chr14	50759376	50760312	Olfr728	936	-	NM_001011809	50759376	50760312	1
chr14	50767575	50768547	Olfr729	972	-	NM_146278	50767575	50768547	1
chr14	50805936	50806893	Olfr730	957	-	NM_146493	50805936	50806893	1
chr14	50857577	50858558	Olfr731	981	-	NM_146363	50857577	50858558	1
chr14	50900902	50901946	Olfr732	1044	-	NM_146665	50900999	50901926	1
chr14	50918011	50919005	Olfr733	994	-	NM_146663	50918055	50918982	1
chr14	50939566	50940508	Olfr734	942	-	NM_146664	50939566	50940508	1
chr14	50965050	50966115	Olfr735	1065	-	NM_001011754	50965050	50966115	1
chr14	50977588	50983338	Tlr11	5750	+	NM_205819	50977690	50983029	2
chr14	51012432	51013371	Olfr736	939	+	NM_146666	51012432	51013371	1
chr14	51033220	51034156	Olfr738	936	+	NM_146420	51033220	51034156	1
chr14	51044195	51045125	Olfr739	930	+	NM_146668	51044195	51045125	1
chr14	51072728	51073664	Olfr740	936	+	NM_146667	51072728	51073664	1
chr14	51092731	51106070	Olfr741	13339	+	NM_207133	51105134	51106070	3
chr14	51123443	51140618	4930413M19Rik	17175	+	NR_045759	51140618	51140618	3
chr14	51134795	51135915	Olfr742	1120	+	NM_146430	51134880	51135816	1
chr14	51153088	51154024	Olfr743	936	+	NM_001177508	51153088	51154024	1
chr14	51237898	51238870	Olfr744	972	+	NM_001011738	51237898	51238870	1
chr14	51261869	51263044	Olfr745	1175	+	NM_146299	51261957	51262944	1
chr14	51272913	51273858	Olfr746	945	+	NM_146298	51272913	51273858	1
chr14	51300365	51301320	Olfr747	955	-	NM_207156	51300365	51301307	1
chr14	51330006	51330930	Olfr748	924	+	NM_001011837	51330006	51330930	1
chr14	51355893	51363999	Olfr749	8106	-	NM_020288	51355893	51356835	2
chr14	51385083	51405195	Ttc5	20112	-	NM_001080949	51385577	51405163	10
chr14	51408923	51415403	Ccnb1ip1	6480	-	NM_001111119	51409487	51413529	4
chr14	51427121	51427446	Rpph1	325	-	NR_002142	51427446	51427446	1
chr14	51427620	51440975	Parp2	13355	+	NM_009632	51427622	51440869	16
chr14	51443735	51490229	Tep1	46494	-	NM_009351	51443842	51488236	55
chr14	51511063	51512930	Klhl33	1867	-	NM_001166651	51511063	51512930	3
chr14	51535048	51544568	Osgep	9520	-	NM_133676	51535533	51544453	11
chr14	51544623	51546863	Apex1	2240	+	NM_009687	51544944	51546648	5
chr14	51546889	51550524	Tmem55b	3635	-	NM_001033271	51547568	51550450	7
chr14	51563977	51573087	Pnp	9110	+	NM_013632	51564257	51571296	6
chr14	51575815	51584424	Pnp2	8609	+	NM_001123371	51575847	51584151	6
chr14	51627425	51630433	Rnase10	3008	+	NM_001162863	51628952	51629579	2
chr14	51658133	51661542	Rnase9	3409	-	NM_183032	51658639	51659194	2
chr14	51669125	51669838	Rnase11	713	-	NM_001011877	51669191	51669770	1
chr14	51676372	51676917	Rnase12	545	-	NM_001011875	51676457	51676895	1
chr14	51689985	51691117	Olfr750	1132	-	NM_207558	51690070	51691066	1
chr14	51710751	51721684	Ang	10933	+	NM_001161731	51721078	51721516	2
chr14	51710751	51725826	Rnase4	15075	+	NM_021472	51724495	51724942	2
chr14	51736227	51737466	Eddm3b	1239	+	NM_203508	51736231	51736681	1
chr14	51748742	51750796	Rnase6	2054	+	NM_030098	51749827	51750289	2
chr14	51764676	51766442	Rnase1	1766	-	NM_011271	51765120	51765570	2
chr14	51781934	51782693	Rnase2b	759	+	NM_019398	51782138	51782606	1
chr14	51815160	51815598	Ang2	438	-	NM_007449	51815160	51815598	1
chr14	51823364	51823831	Ear4	467	+	NM_001017422	51823364	51823831	1
chr14	51823369	51823831	Ear14	462	+	NM_017389	51823369	51823831	1
chr14	51874936	51875787	Rnase2a	851	-	NM_053113	51875113	51875581	2
chr14	51937009	51965164	4930597G03Rik	28155	-	NR_045736	51965164	51965164	5
chr14	52030675	52038557	Vmn2r88	7882	+	NM_011686	52030675	52038557	6
chr14	52071636	52080968	Vmn2r89	9332	+	NM_009487	52071716	52079630	5
chr14	52172464	52282628	Gm5622	110164	+	NM_001013816	52172782	52281869	5
chr14	52331318	52336807	Gm5800	5489	-	NM_001034102	52331600	52336799	5
chr14	52383566	52393265	Ang4	9699	-	NM_177544	52383729	52384164	2
chr14	52419720	52446034	AY358078	26314	+	NM_194347	52419720	52445971	9
chr14	52473442	52474317	Ear6	875	+	NM_053111	52473672	52474140	2
chr14	52473672	52474140	Ear7	468	+	NM_017385	52473672	52474140	1
chr14	52504516	52511543	Mettl17	7027	+	NM_001029990	52504620	52511410	14
chr14	52513284	52516420	Slc39a2	3136	+	NM_001039676	52513474	52515206	4
chr14	52524945	52533163	Ndrg2	8218	-	NM_013864	52525814	52531215	16
chr14	52538435	52540375	Tppp2	1940	+	NM_001128634	52538462	52540287	3
chr14	52541834	52542448	Rnase13	614	-	NM_001011687	52541893	52542355	1
chr14	52604507	52625922	Arhgef40	21415	+	NM_198249	52604663	52624705	24
chr14	52606063	52608504	Gm16617	2441	-	NR_045728	52608504	52608504	3
chr14	52625751	52640408	Zfp219	14657	-	NM_027248	52626214	52629650	5
chr14	52636539	52639462	Tmem253	2923	+	NM_001033805	52636764	52638961	7
chr14	52654848	52655784	Olfr221	936	-	NM_001001808	52654848	52655784	1
chr14	52693054	52723703	Hnrnpc	30649	-	NM_001170984	52694754	52704030	9
chr14	52730577	52781014	Rpgrip1	50437	+	NM_001168515	52731831	52779893	25
chr14	52780093	52816914	Supt16	36821	-	NM_033618	52781351	52816825	26
chr14	52817825	52857247	Chd8	39422	-	NM_201637	52818266	52857247	37
chr14	52829460	52829559	Snord8	99	-	NR_028542	52829559	52829559	1
chr14	52881433	52899070	Rab2b	17637	-	NM_172601	52883384	52898916	8
chr14	52898820	52915184	Tox4	16364	+	NM_023434	52899325	52912936	10
chr14	52914516	52924799	Mettl3	10283	-	NM_019721	52914656	52924662	11
chr14	52930851	52948345	Sall2	17494	-	NM_015772	52932396	52947850	2
chr14	52968777	52969719	Olfr1513	942	-	NM_001012269	52968777	52969719	1
chr14	52991784	52992726	Olfr1512	942	-	NM_146432	52991784	52992726	1
chr14	53009489	53010446	Olfr1511	957	-	NM_146271	53009489	53010446	1
chr14	53029563	53030602	Olfr1510	1039	-	NM_146431	53029588	53030545	1
chr14	53070067	53071077	Olfr1509	1010	+	NM_020514	53070089	53071016	1
chr14	53082395	53087136	Olfr1508	4741	-	NM_020513	53082749	53083682	2
chr14	53109609	53115370	Olfr1507	5761	-	NM_001170918	53109695	53110637	2
chr14	54855159	54873604	Dad1	18445	-	NM_001113358	54862412	54873517	3
chr14	54873803	54888844	Abhd4	15041	+	NM_001205181	54881349	54887532	7
chr14	54901570	54902600	Olfr49	1030	-	NM_010991	54901626	54902568	1
chr14	54980524	54989353	Oxa1l	8829	+	NM_026936	54980538	54988135	10
chr14	54989125	55036539	Slc7a7	47414	-	NM_011405	54989469	55027841	12
chr14	55045745	55048587	Mrpl52	2842	+	NM_026851	55045769	55048565	5
chr14	55050440	55060095	Mmp14	9655	+	NM_008608	55050702	55059509	10
chr14	55082983	55089128	Lrp10	6145	+	NM_022993	55083411	55088686	7
chr14	55094936	55099271	Rem2	4335	+	NM_080726	55095108	55098582	5
chr14	55126018	55136307	Prmt5	10289	-	NM_013768	55126631	55136193	17
chr14	55160621	55173198	Haus4	12577	-	NM_145462	55160910	55171028	10
chr14	55186305	55196498	Ajuba	10193	-	NM_010590	55187767	55196101	8
chr14	55202499	55224745	4931414P19Rik	22246	-	NM_028890	55203117	55214553	7
chr14	55232956	55236832	Psmb5	3876	-	NM_011186	55233028	55236828	3
chr14	55235513	55235622	Mir686	109	-	NR_030457	55235622	55235622	1
chr14	55244146	55248393	Psmb11	4247	+	NM_175204	55244163	55245072	1
chr14	55250828	55260201	Cdh24	9373	-	NM_199470	55250949	55258381	12
chr14	55260997	55305768	Acin1	44771	-	NM_001085473	55261564	55305617	19
chr14	55261885	55261947	Mir6948	62	-	NR_105913	55261947	55261947	1
chr14	55269347	55273937	4930579G18Rik	4590	+	NR_038053	55273937	55273937	6
chr14	55305007	55309579	1700123O20Rik	4572	+	NM_021437	55308641	55309070	2
chr14	55329199	55331011	Cebpe	1812	-	NM_207131	55329375	55330795	2
chr14	55341051	55400723	Slc7a8	59672	-	NM_016972	55342930	55400164	11
chr14	55471573	55482995	Homez	11422	-	NM_001177705	55475529	55477086	2
chr14	55494433	55496375	Ppp1r3e	1942	-	NM_001167908	55495210	55496140	2
chr14	55502261	55507071	Bcl2l2	4810	+	NM_007537	55503218	55504370	4
chr14	55512979	55517764	Pabpn1	4785	+	NM_019402	55512992	55516893	7
chr14	55525563	55531969	Slc22a17	6406	-	NM_021551	55525907	55531092	9
chr14	55535379	55545625	Efs	10246	-	NM_010112	55535934	55544292	6
chr14	55551531	55554673	Il25	3142	+	NM_080729	55551607	55554196	3
chr14	55555306	55558114	Cmtm5	2808	+	NM_026066	55555494	55557883	5
chr14	55560757	55585444	Myh6	24687	-	NM_010856	55560817	55584297	39
chr14	55567896	55567979	Mir208a	83	-	NR_029724	55567979	55567979	1
chr14	55587623	55593186	Mhrt	5563	+	NR_033497	55593186	55593186	5
chr14	55589524	55613386	Myh7	23862	-	NM_080728	55589629	55611710	41
chr14	55594536	55594613	Mir208b	77	-	NR_030607	55594613	55594613	1
chr14	55634290	55642974	Ngdn	8684	+	NM_026890	55634413	55642845	11
chr14	55657298	55661813	Gm10364	4515	+	NR_073535	55661813	55661813	2
chr14	55680495	55710885	Zfhx2	30390	-	NM_001039198	55681440	55694072	10
chr14	55691927	55694711	Zfhx2os	2784	+	NR_004444	55694711	55694711	2
chr14	55713620	55717832	Thtpa	4212	+	NM_153083	55714296	55716344	2
chr14	55717671	55725430	Ap1g2	7759	-	NM_007455	55717896	55724965	22
chr14	55725662	55735772	Jph4	10110	-	NM_177049	55727148	55734111	6
chr14	55840843	55860277	Dhrs2	19434	+	NM_027790	55853490	55860085	11
chr14	56097594	56109177	Dhrs4	11583	+	NM_001037938	56097739	56108770	8
chr14	56109929	56127101	Lrrc16b	17172	+	NM_001024645	56110080	56126782	40
chr14	56129284	56136268	Cpne6	6984	+	NM_001146183	56130821	56135924	17
chr14	56137814	56143818	Nrl	6004	-	NM_001136074	56139391	56141305	4
chr14	56159102	56168854	Pck2	9752	+	NM_028994	56159240	56167596	10
chr14	56178865	56188902	Dcaf11	10037	+	NM_133734	56180124	56188208	15
chr14	56194510	56195789	Fitm1	1279	+	NM_026808	56194518	56195764	2
chr14	56197330	56200364	Psme1	3034	+	NM_011189	56197411	56200218	11
chr14	56200360	56204091	Emc9	3731	-	NM_033146	56200399	56203946	5
chr14	56206276	56209938	Psme2	3662	-	NM_001029855	56206321	56209882	11
chr14	56210626	56222508	Rnf31	11882	+	NM_194346	56210720	56222422	21
chr14	56222821	56228867	Irf9	6046	+	NM_001159417	56222969	56227868	10
chr14	56237002	56244232	Rec8	7230	+	NM_020002	56237439	56244198	20
chr14	56244465	56254515	Ipo4	10050	-	NM_024267	56244747	56254435	30
chr14	56254802	56262643	Tm9sf1	7841	-	NM_028780	56255055	56261775	6
chr14	56269020	56271376	Tssk4	2356	+	NM_027673	56269185	56271285	4
chr14	56276715	56279345	Mdp1	2630	-	NM_023397	56277819	56279211	6
chr14	56281103	56290743	Nedd8	9640	-	NM_008683	56281365	56290649	4
chr14	56291071	56297588	Gmpr2	6517	+	NM_177992	56291551	56297250	10
chr14	56297917	56300654	Tinf2	2737	-	NM_145705	56298174	56300418	9
chr14	56318845	56332329	Tgm1	13484	-	NM_001161715	56319039	56331586	15
chr14	56334713	56341013	Rabggta	6300	-	NM_019519	56335226	56340683	16
chr14	56357856	56364521	Dhrs1	6665	-	NM_026819	56358120	56363904	9
chr14	56364529	56374471	Nop9	9942	+	NM_026403	56364610	56372635	10
chr14	56372891	56377261	Cideb	4370	-	NM_009894	56373272	56377129	5
chr14	56380264	56382066	Ltb4r2	1802	+	NM_020490	56380760	56381843	2
chr14	56384798	56387329	Ltb4r1	2531	+	NM_008519	56386078	56387134	2
chr14	56387928	56402856	Adcy4	14928	-	NM_080435	56387977	56402515	26
chr14	56403831	56407694	Ripk3	3863	-	NM_001164108	56404033	56406942	10
chr14	56443631	56452780	Nfatc4	9149	+	NM_023699	56443873	56452461	10
chr14	56472951	56493573	Nynrin	20622	+	NM_001040072	56473065	56491797	8
chr14	56497756	56503093	Cbln3	5337	-	NM_019820	56501816	56503024	3
chr14	56503805	56515618	Khnyn	11813	+	NM_027143	56504627	56513949	8
chr14	56516121	56519069	Sdr39u1	2948	-	NM_001082975	56516439	56519042	6
chr14	56560287	56563512	Cma1	3225	-	NM_010780	56560490	56563408	5
chr14	56568645	56571208	Mcpt-ps1	2563	-	NR_028284	56571208	56571208	4
chr14	56590264	56592832	Cma2	2568	+	NM_001024714	56590300	56592662	5
chr14	56636800	56639228	Mcpt1	2428	+	NM_008570	56636835	56638976	5
chr14	56645700	56649332	Mcpt9	3632	-	NM_010782	56645732	56648105	5
chr14	56660959	56663471	Mcpt2	2512	+	NM_008571	56660990	56663266	5
chr14	56678580	56681147	Mcpt4	2567	-	NM_010779	56678793	56681111	5
chr14	56700999	56704034	Mcpt8	3035	-	NM_008572	56701084	56704024	5
chr14	56701237	56701305	Mir6949	68	-	NR_105914	56701305	56701305	1
chr14	56718721	56721411	Ctsg	2690	-	NM_007800	56718795	56721273	5
chr14	56736455	56739462	Gzme	3007	-	NM_010373	56736562	56739393	5
chr14	56748404	56751430	Gzmd	3026	-	NM_010372	56748511	56751359	5
chr14	56775417	56778416	Gzmg	2999	-	NM_010375	56775525	56778361	5
chr14	56784632	56793436	Gzmn	8804	-	NM_001305808	56784879	56787903	6
chr14	56824099	56830244	Gzmf	6145	-	NM_010374	56824211	56830194	5
chr14	56850237	56853494	Gzmc	3257	-	NM_010371	56850350	56853419	5
chr14	56877694	56881097	Gzmb	3403	-	NM_013542	56878255	56880986	5
chr14	56983904	57007388	Atp12a	23484	+	NM_138652	56984117	57006758	23
chr14	57021533	57143868	Rnf17	122335	+	NM_001033043	57021537	57143241	37
chr14	57145597	57190683	Cenpj	45086	-	NM_001014996	57145755	57183943	17
chr14	57194455	57278635	Parp4	84180	+	NM_001145978	57202996	57278267	35
chr14	57287084	57316266	Mphosph8	29182	+	NM_023773	57287188	57316009	14
chr14	57315111	57319837	Gm16973	4726	-	NR_046210	57319837	57319837	3
chr14	57341285	57397153	Pspc1	55868	-	NM_025682	57341931	57396996	9
chr14	57409421	57430553	Zmym5	21132	-	NM_001253752	57412602	57423656	8
chr14	57506631	57581416	Zmym2	74785	+	NM_029498	57521542	57578744	24
chr14	57633970	57637819	B020004C17Rik	3849	+	NM_001256060	57634093	57636256	4
chr14	57653296	57676867	Gja3	23571	-	NM_016975	57654496	57655750	2
chr14	57717438	57723539	Gjb2	6101	-	NM_008125	57718905	57719586	2
chr14	57742137	57752448	Gjb6	10311	-	NM_001271663	57742853	57743639	3
chr14	57893870	58017320	Cryl1	123450	-	NM_030004	57894285	58017285	8
chr14	58042907	58136773	Ift88	93866	+	NM_009376	58049380	58136295	26
chr14	58143665	58162003	Il17d	18338	+	NM_145837	58143743	58161477	3
chr14	58168434	58190406	N6amt2	21972	-	NM_026526	58168579	58190390	5
chr14	58201107	58283793	Xpo4	82686	-	NM_020506	58201107	58283793	23
chr14	58308498	58364960	Lats2	56462	-	NM_015771	58310124	58353053	8
chr14	58417025	58423817	Sap18	6792	+	NM_009119	58417062	58420915	4
chr14	58417054	58421167	Gm10094	4113	+	NM_001142441	58417062	58420915	4
chr14	58417260	58417324	Mir3077	64	+	NR_037238	58417324	58417324	1
chr14	58425397	58445000	Ska3	19603	-	NM_198605	58426813	58444949	9
chr14	58445075	58447582	Mrpl57	2507	+	NM_026401	58445353	58445662	2
chr14	58451538	58509099	Zdhhc20	57561	-	NM_029492	58456466	58509017	13
chr14	58535116	58618099	Micu2	82983	-	NM_028643	58536104	58618076	12
chr14	58691522	58731557	Fgf9	40035	+	NM_013518	58691892	58728415	3
chr14	59751876	59761730	1700129C05Rik	9854	-	NM_026461	59752240	59761684	5
chr14	59777339	59797586	Gm5142	20247	-	NM_001004158	59777521	59797544	2
chr14	59820064	59856102	Rcbtb1	36038	+	NM_027764	59828805	59854196	12
chr14	59863277	59879053	Gm6904	15776	-	NM_001164329	59863530	59879017	6
chr14	59895749	59916359	Phf11a	20610	-	NM_172603	59896185	59916323	8
chr14	59939800	59960167	Phf11b	20367	-	NM_001164327	59940117	59960152	9
chr14	59966243	59984327	Phf11d	18084	-	NM_199015	59967885	59984246	11
chr14	59999669	60012349	Phf11c	12680	-	NM_001164289	59999981	60012091	10
chr14	60020847	60059714	Setdb2	38867	-	NM_001081024	60021135	60056289	15
chr14	60059817	60167740	Cab39l	107923	+	NM_026908	60115670	60166002	11
chr14	60178224	60216796	Cdadc1	38572	-	NM_001168535	60179732	60216673	11
chr14	60244117	60250497	Shisa2	6380	+	NM_145463	60244903	60249025	2
chr14	60266577	60705671	Atp8a2	439094	-	NM_015803	60266663	60705519	36
chr14	60838304	60870215	Nupl1	31911	-	NM_170591	60838825	60870106	15
chr14	60847642	60847752	Mir719	110	-	NR_030458	60847752	60847752	1
chr14	60884041	60921208	Mtmr6	37167	+	NM_144843	60884174	60919358	14
chr14	60997122	60999840	Amer2	2718	+	NM_001164705	60997194	60999102	2
chr14	61253541	61383393	Spata13	129852	+	NM_001033272	61309831	61379888	13
chr14	61386970	61399706	C1qtnf9	12736	+	NM_183175	61391133	61398861	4
chr14	61403402	61524317	Mipep	120915	+	NR_040642	61524317	61524317	20
chr14	61582670	61665692	Tnfrsf19	83022	-	NM_013869	61585293	61643649	10
chr14	61757293	61859530	Sacs	102237	+	NM_172809	61766888	61859269	10
chr14	61837951	61877327	Sgcg	39376	-	NM_011892	61840439	61864787	8
chr14	61911819	61924171	1700109G14Rik	12352	-	NR_033788	61924171	61924171	3
chr14	61928589	61930773	Arl11	2184	+	NM_177337	61929579	61930110	2
chr14	61958599	61979282	Ebpl	20683	-	NM_026598	61960000	61979227	4
chr14	61984022	62058784	Kpna3	74762	-	NM_008466	61986467	62058628	17
chr14	62111524	62119219	4930556J02Rik	7695	+	NR_045714	62119219	62119219	3
chr14	62150687	62175723	Spryd7	25036	-	NM_025697	62153980	62175463	5
chr14	62217062	62224782	Trim13	7720	+	NM_001164220	62223372	62224596	3
chr14	62221672	62301210	Dleu2	79538	-	NR_028264	62301210	62301210	7
chr14	62226293	62231670	Kcnrg	5377	+	NM_001039105	62226349	62230723	2
chr14	62250716	62250809	Mir16-1	93	-	NR_029734	62250809	62250809	1
chr14	62250863	62250947	Mir15a	84	-	NR_029733	62250947	62250947	1
chr14	62895065	62911816	Dleu7	16751	-	NM_173419	62895738	62911787	2
chr14	62950941	62991829	Rnaseh2b	40888	+	NM_026001	62950952	62991310	11
chr14	63011506	63075126	Gucy1b2	63620	-	NM_001204340	63011657	63075035	17
chr14	63174573	63227322	Fam124a	52749	+	NM_001243857	63174689	63225492	4
chr14	63282503	63311080	Serpine3	28577	+	NM_001199945	63283778	63310947	9
chr14	63295164	63379949	Ints6	84785	-	NM_008715	63312417	63379495	19
chr14	63379337	63448963	4931440J10Rik	69626	+	NR_045503	63448963	63448963	7
chr14	63456526	63575723	Wdfy2	119197	+	NM_175546	63456757	63575146	12
chr14	63456557	63456694	Mir8098	137	+	NR_106174	63456694	63456694	1
chr14	63484378	63484488	Mir6541	110	+	NR_105860	63484488	63484488	1
chr14	63596360	63603347	Defb48	6987	-	NM_001037751	63596498	63603304	2
chr14	63616913	63619997	Defb47	3084	+	NM_001039125	63616938	63619903	2
chr14	63630607	63636925	Defb43	6318	+	NM_001039121	63630646	63636766	2
chr14	63652923	63656683	Defb30	3760	-	NM_001039566	63654768	63656652	3
chr14	63665827	63667443	Defb42	1616	+	NM_001034910	63666400	63667237	3
chr14	63673909	63676986	2700070H01Rik	3077	+	NR_046019	63676986	63676986	3
chr14	63741298	63764760	Ctsb	23462	+	NM_007798	63752177	63761166	10
chr14	63763987	63798415	Fdft1	34428	-	NM_010191	63765586	63796618	10
chr14	63801281	63812362	Neil2	11081	-	NM_201610	63802087	63810679	5
chr14	63817750	63864108	Gata4	46358	-	NM_008092	63819211	63859985	7
chr14	63991673	64036024	Blk	44351	-	NM_007549	63992228	64006663	13
chr14	64055230	64084339	Fam167a	29109	+	NM_177628	64071092	64081477	4
chr14	64111183	64127929	Tdh	16746	-	NM_021480	64111543	64119141	9
chr14	64142446	64162790	Mtmr9	20344	-	NM_177594	64142902	64162476	10
chr14	64225366	64439247	Xkr6	213881	+	NM_173393	64225366	64438627	3
chr14	64346025	64346104	Mir598	79	+	NR_030611	64346104	64346104	1
chr14	64479148	64538696	Pinx1	59548	+	NM_028228	64479265	64538461	7
chr14	64562542	64569569	Sox7	7027	+	NM_011446	64562592	64567496	2
chr14	64589958	64606617	4930578I06Rik	16659	-	NM_026359	64590061	64606584	4
chr14	64611267	64652343	Rp1l1	41076	+	NM_146246	64640747	64651383	4
chr14	64694279	64704226	Prss55	9947	-	NM_001081063	64694304	64704202	5
chr14	64712532	64716509	Prss51	3977	+	NM_001193631	64713844	64716503	5
chr14	64718131	64723072	4930471C04Rik	4941	-	NR_046192	64723072	64723072	4
chr14	64723159	64732588	Prss52	9429	+	NM_028525	64723198	64732570	5
chr14	64741457	65074740	Msra	333283	-	NM_026322	64742025	65059682	11
chr14	65206951	65212798	Mir124a-1hg	5847	+	NR_040709	65212798	65212798	4
chr14	65209493	65209578	Mir124a-1	85	+	NR_029813	65209578	65209578	1
chr14	65210021	65210108	Mir3078	87	+	NR_037239	65210108	65210108	1
chr14	65271367	65425133	Kif13b	153766	+	NM_001081177	65271438	65425133	40
chr14	65441054	65568684	Hmbox1	127630	-	NM_177338	65442397	65522098	10
chr14	65568881	65658672	Ints9	89791	+	NM_153414	65569108	65658286	17
chr14	65670895	65716943	Extl3	46048	-	NM_018788	65673449	65696568	7
chr14	65811277	65881300	Fzd3	70023	-	NM_021458	65821555	65871969	7
chr14	65885537	65940339	Fbxo16	54802	+	NM_015795	65889573	65940235	8
chr14	65977512	66017767	Zfp395	40255	+	NM_199029	66004254	66015167	10
chr14	66019509	66044309	Pnoc	24800	-	NM_010932	66023585	66030080	4
chr14	66149282	66211949	Elp3	62667	-	NM_028811	66150360	66211837	15
chr14	66224103	66267280	Nuggc	43177	+	NM_001195674	66224103	66267153	19
chr14	66285239	66383663	Scara5	98424	+	NM_028903	66289399	66381695	9
chr14	66424747	66436659	Pbk	11912	+	NM_023209	66428071	66436250	8
chr14	66437863	66452806	Esco2	14943	-	NM_028039	66438802	66451565	11
chr14	66456138	66485441	Ccdc25	29303	+	NM_145944	66456293	66483996	9
chr14	66538231	66572581	Scara3	34350	-	NM_172604	66539573	66572339	6
chr14	66587319	66600385	Clu	13066	+	NM_013492	66590595	66600154	9
chr14	66605623	66628047	Gulo	22424	-	NM_178747	66606402	66627884	12
chr14	66646165	66696570	Adam2	50405	-	NM_009618	66646860	66696559	21
chr14	66703208	66743359	Ephx2	40151	-	NM_007940	66703518	66743272	19
chr14	66759796	66771785	Chrna2	11989	+	NM_144803	66761050	66769913	7
chr14	66772093	66899889	Ptk2b	127796	-	NM_001162365	66772890	66832352	31
chr14	66914165	66915966	1700001G11Rik	1801	-	NR_038077	66915966	66915966	3
chr14	66915861	66930261	Trim35	14400	+	NM_029979	66915906	66928173	6
chr14	66963132	66980517	Stmn4	17385	+	NM_001310523	66973269	66977536	7
chr14	67254087	67390005	Adra1a	135918	+	NM_001271761	67256414	67389426	3
chr14	67421700	67487437	Dpysl2	65737	-	NM_009955	67424181	67487205	14
chr14	67487686	67489842	Gm5464	2156	+	NM_001034881	67487752	67488280	1
chr14	67530044	67538898	Pnma2	8854	+	NM_175498	67534965	67536063	3
chr14	67604076	67627714	Bnip3l	23638	-	NM_009761	67606563	67627621	6
chr14	67632892	67691308	Ppp2r2a	58416	-	NM_001205188	67634055	67690933	10
chr14	67852128	68049789	Ebf2	197661	+	NM_001276387	67853971	68046959	17
chr14	67923724	67933548	Gm6878	9824	-	NM_001037931	67925068	67932485	4
chr14	67950878	68016579	4930438E09Rik	65701	-	NR_045961	68016579	68016579	6
chr14	68294410	68333898	Cdca2	39488	-	NM_175384	68294916	68333062	15
chr14	68334154	68360367	Kctd9	26213	+	NM_001285933	68347438	68358469	12
chr14	68363237	68367493	Gnrh1	4256	+	NM_008145	68364402	68367348	4
chr14	68369984	68551629	Dock5	181645	-	NM_177780	68374474	68551391	52
chr14	68477692	68477802	Mir6539	110	-	NR_105857	68477802	68477802	1
chr14	68701940	68705794	Nefl	3854	+	NM_010910	68702019	68705504	4
chr14	68737601	68743061	Nefm	5460	-	NM_008691	68738093	68742870	3
chr14	68741808	68749428	A230070E04Rik	7620	+	NR_045897	68749428	68749428	3
chr14	69115393	69151746	Adam7	36353	-	NM_007402	69116477	69151732	23
chr14	69181443	69200129	Adamdec1	18686	-	NM_021475	69182425	69200103	14
chr14	69223054	69273899	Adam28	50845	-	NM_001048175	69224631	69273747	23
chr14	69647345	69659458	Stc1	12113	+	NM_009285	69647446	69656560	4
chr14	69782855	69789900	1700092C10Rik	7045	-	NR_045931	69789900	69789900	3
chr14	69789858	69793597	Nkx2-6	3739	+	NM_010920	69789858	69793311	2
chr14	69808748	69812715	Nkx3-1	3967	+	NM_010921	69808761	69810305	2
chr14	69859907	69903160	Slc25a37	43253	-	NM_026331	69862890	69902998	4
chr14	69908454	69912356	Synb	3902	-	NM_173420	69909003	69910860	3
chr14	69947763	69955194	Gm16677	7431	-	NR_045091	69955194	69955194	3
chr14	69955207	69984799	Entpd4	29592	+	NM_026174	69965643	69983796	13
chr14	70009282	70095641	Loxl2	86359	+	NM_033325	70033733	70092926	14
chr14	70092054	70092127	Mir6950	73	+	NR_105915	70092127	70092127	1
chr14	70097110	70114616	R3hcc1	17506	-	NM_001301651	70097275	70114609	8
chr14	70116785	70132377	Chmp7	15592	-	NM_134078	70118054	70132296	10
chr14	70132640	70166920	4930480K23Rik	34280	+	NR_130157	70166920	70166920	3
chr14	70167278	70184218	Tnfrsf10b	16940	+	NM_020275	70167466	70182373	8
chr14	70184796	70205352	Rhobtb2	20556	-	NM_153514	70187321	70200616	10
chr14	70240213	70459725	Pebp4	219512	+	NM_028560	70247301	70459549	7
chr14	70477251	70482420	Egr3	5169	+	NM_001289925	70477843	70479712	3
chr14	70499951	70538013	Bin3	38062	+	NM_021328	70499995	70537092	9
chr14	70537975	70553598	Ccar2	15623	-	NM_146055	70538709	70552528	21
chr14	70554211	70559309	9930012K11Rik	5098	-	NM_001112735	70554974	70559187	7
chr14	70564024	70577479	Pdlim2	13455	-	NM_145978	70564422	70575112	10
chr14	70580274	70607478	Sorbs3	27204	-	NM_011366	70580976	70607434	21
chr14	70617671	70689304	Ppp3cc	71633	-	NM_001304991	70617890	70689036	15
chr14	70703273	70751231	Slc39a14	47958	-	NM_001135151	70706472	70718732	10
chr14	70772286	70828901	Piwil2	56615	-	NM_021308	70774086	70826505	23
chr14	70838554	70843278	Polr3d	4724	-	NM_025945	70839262	70842922	9
chr14	70843316	70843398	Mir320	82	+	NR_029802	70843398	70843398	1
chr14	70857323	70868631	Phyhip	11308	+	NM_145981	70861565	70867142	5
chr14	70874361	70920067	Bmp1	45706	-	NM_009755	70874921	70919844	20
chr14	70920748	70923888	Sftpc	3140	-	NM_011359	70921132	70923850	6
chr14	70930627	70938131	Lgi3	7504	+	NM_145219	70930871	70936841	8
chr14	70945057	70948742	Reep4	3685	+	NM_180588	70945513	70948302	8
chr14	70953862	70973355	Hr	19493	+	NM_021877	70956195	70972111	20
chr14	70977653	70982378	Nudt18	4725	+	NM_153136	70977755	70979736	3
chr14	70983101	70999642	Fam160b2	16541	-	NM_194345	70984851	70999593	17
chr14	71001990	71035855	Dmtn	33865	-	NM_001252664	71004547	71018063	15
chr14	71036011	71042075	Fgf17	6064	-	NM_008004	71036536	71041564	5
chr14	71047108	71052891	Npm2	5783	-	NM_181345	71047311	71052396	9
chr14	71054052	71166435	Xpo7	112383	-	NM_023045	71065807	71166336	28
chr14	71174187	71178301	Dok2	4114	+	NM_010071	71174244	71177880	5
chr14	71252739	71273761	2410012E07Rik	21022	+	NR_045939	71273761	71273761	4
chr14	71289913	71379647	Gfra2	89734	+	NM_008115	71290661	71378303	9
chr14	71651079	71670866	Gm4251	19787	+	NR_046075	71670866	71670866	3
chr14	72256515	72320245	4930434J06Rik	63730	+	NR_046274	72320245	72320245	7
chr14	72937759	73109810	Fndc3a	172051	-	NM_207636	72939973	73083539	26
chr14	73425409	73426697	Gm9199	1288	+	NR_027860	73426697	73426697	1
chr14	73428934	73448921	Cysltr2	19987	-	NM_133720	73429145	73430075	6
chr14	73542316	73583861	Rcbtb2	41545	+	NM_001170694	73554659	73582406	15
chr14	73595308	73725598	Rb1	130290	-	NM_009029	73597017	73725448	27
chr14	73606569	73606658	Mir687	89	-	NR_030459	73606658	73606658	1
chr14	73637697	73640165	Lpar6	2468	+	NM_175116	73638407	73639442	1
chr14	73762038	73785078	Itm2b	23040	-	NM_008410	73762864	73784933	6
chr14	73909855	73918352	Med4	8497	+	NM_026119	73909867	73917873	7
chr14	73919670	73948049	Nudt15	28379	-	NM_172527	73921320	73925021	5
chr14	73952592	73995949	Sucla2	43357	+	NM_011506	73952614	73995255	11
chr14	74755333	74769548	4933402J15Rik	14215	+	NR_046059	74769548	74769548	5
chr14	75040646	75106666	Htr2a	66020	+	NM_172812	75041739	75106204	3
chr14	75132103	75150572	Esd	18469	+	NM_016903	75135773	75149532	9
chr14	75154479	75347684	Lrch1	193205	-	NM_001033439	75156839	75347467	20
chr14	75374892	75386911	Gm4278	12019	+	NR_046078	75386911	75386911	3
chr14	75415833	75452339	5031414D18Rik	36506	+	NM_198642	75431710	75451888	14
chr14	75484109	75530690	Lrrc63	46581	-	NM_027581	75484552	75529395	10
chr14	75530929	75630649	Lcp1	99720	+	NM_001247984	75597906	75629145	16
chr14	75642093	75683360	Cpb2	41267	+	NM_019775	75642161	75683222	11
chr14	75684179	75744233	Zc3h13	60054	+	NM_026083	75691384	75743571	19
chr14	75855788	75925948	Siah3	70160	+	NM_001128093	75855862	75925924	2
chr14	75982640	75992923	Spert	10283	-	NM_001164139	75982857	75992866	3
chr14	76042065	76066944	Erich6b	24879	+	NM_029230	76058482	76066826	5
chr14	76102157	76154300	Cog3	52143	-	NM_177381	76103837	76154245	23
chr14	76161805	76186844	Slc25a30	25039	-	NM_026232	76162455	76176866	10
chr14	76242724	76244771	Gm4285	2047	-	NR_045294	76244771	76244771	3
chr14	76245062	76248110	Tpt1	3048	+	NM_009429	76245235	76247908	6
chr14	76247729	76247841	Snora31	112	+	NR_028481	76247841	76247841	1
chr14	76296743	76410672	Gtf2f2	113929	-	NM_026816	76297340	76410552	8
chr14	76354809	76365024	Kctd4	10215	+	NM_026214	76362397	76363177	2
chr14	76486038	76510622	Gpalpp1	24584	-	NM_026177	76490334	76510511	8
chr14	76510697	76537186	Nufip1	26489	+	NM_013745	76510739	76534709	10
chr14	76814767	76907572	Tsc22d1	92805	+	NM_001310646	76815889	76906481	5
chr14	76914364	76920662	4930444M15Rik	6298	-	NR_045660	76920662	76920662	4
chr14	76932618	76956696	Serp2	24078	-	NR_027699	76956696	76956696	5
chr14	77077374	77086915	1700108F19Rik	9541	+	NR_015485	77086915	77086915	5
chr14	77424007	77436424	Lacc1	12417	-	NM_172488	77429335	77435161	8
chr14	77436578	77512070	Ccdc122	75492	+	NM_001310648	77491543	77511411	7
chr14	77556569	78121570	Enox1	565001	+	NM_001253759	77906684	78120751	20
chr14	77879289	77906675	Gm6994	27386	-	NR_033141	77906675	77906675	6
chr14	78193751	78198775	Gm1587	5024	-	NM_001033440	78194629	78198671	3
chr14	78226023	78274724	Dnajc15	48701	-	NM_025384	78226203	78274706	6
chr14	78304045	78402463	Epsti1	98418	+	NM_029495	78304292	78401786	12
chr14	78480830	78488814	Fam216b	7984	-	NM_177629	78482551	78486542	4
chr14	78591179	78591285	Mir1971	106	-	NR_035499	78591285	78591285	1
chr14	78677252	78707850	Tnfsf11	30598	-	NM_011613	78678382	78707696	5
chr14	78892052	78936667	Akap11	44615	-	NM_001164503	78895582	78922457	12
chr14	78969415	79124896	Dgkh	155481	-	NM_001081336	78969911	79124896	29
chr14	79248984	79602117	Vwa8	353133	+	NM_027906	79249090	79601013	45
chr14	79612161	79647174	Zfp957	35013	-	NM_001033215	79612460	79614164	3
chr14	79688556	79701442	Rgcc	12886	-	NM_025427	79688918	79701304	5
chr14	79734313	79790475	Naa16	56162	-	NM_025832	79735540	79790422	20
chr14	79797578	79823457	Mtrf1	25879	+	NM_145960	79801236	79823317	11
chr14	79826317	79830845	Kbtbd7	4528	+	NM_001024135	79826536	79828609	1
chr14	79851641	79854623	Kbtbd6	2982	+	NM_001034882	79851862	79853323	1
chr14	79859743	79881075	Wbp4	21332	-	NM_018765	79861728	79880739	10
chr14	79881000	79982298	Elf1	101298	+	NM_007920	79936157	79980577	9
chr14	79987497	80029562	Sugt1	42065	+	NM_026474	79987635	80028760	13
chr14	80037499	80061990	Lect1	24491	-	NM_010701	80037768	80061818	7
chr14	80102726	80112737	4930452G13Rik	10011	+	NR_045060	80112737	80112737	4
chr14	80138237	80138335	Mir759	98	+	NR_030436	80138335	80138335	1
chr14	80166578	80171119	Pcdh8	4541	-	NM_021543	80167177	80170928	3
chr14	80260327	80268983	Gm10845	8656	-	NR_033535	80268983	80268983	3
chr14	80400108	80421737	Olfm4	21629	+	NM_001030294	80400131	80421737	7
chr14	84843369	84936867	Pcdh17	93498	+	NM_001013753	84845901	84933364	4
chr14	84858644	84876231	9630013A20Rik	17587	-	NR_015539	84876231	84876231	6
chr14	86645776	86661849	4930529K09Rik	16073	+	NR_040457	86661849	86661849	4
chr14	87056129	87540921	Diaph3	484792	-	NM_019670	87056129	87540921	28
chr14	87816389	87945315	Tdrd3	128926	+	NM_172605	87816614	87939320	14
chr14	88864553	88871203	Pcdh20	6650	-	NM_178685	88866810	88870797	3
chr14	90296030	90299254	Gm5088	3224	+	NR_002862	90299254	90299254	1
chr14	90526697	90669567	4930474H20Rik	142870	+	NR_045712	90669567	90669567	9
chr14	93412918	94289888	Pcdh9	876970	-	NM_001271798	93414730	94287951	4
chr14	96280484	96281994	4921530L21Rik	1510	+	NM_025733	96281027	96281852	2
chr14	96504483	96918253	Klhl1	413770	-	NM_053105	96505558	96917536	11
chr14	98186064	98568984	Dach1	382920	-	NM_007826	98188800	98568528	12
chr14	99433762	99445355	Mzt1	11593	-	NM_175245	99435708	99445282	3
chr14	99445595	99473326	Bora	27731	+	NM_175265	99446534	99472930	12
chr14	99475852	99498989	Dis3	23137	-	NM_028315	99476600	99498892	21
chr14	99498642	99653713	Pibf1	155071	+	NM_029320	99500268	99653430	18
chr14	99697909	99712628	Klf5	14719	+	NM_009769	99698213	99712548	4
chr14	100269861	100549015	Klf12	279154	-	NM_010636	100274351	100548983	7
chr14	101596906	101599286	Prr30	2380	-	NM_029680	101597135	101598341	3
chr14	101841576	102008408	Tbc1d4	166832	-	NM_001081278	101843754	102007677	19
chr14	102032982	102039688	Commd6	6706	-	NM_001033132	102033558	102039653	4
chr14	102053183	102095342	Uchl3	42159	+	NM_016723	102053280	102095202	9
chr14	102129144	102333910	Lmo7	204766	+	NM_201529	102129373	102333135	31
chr14	103375797	103381854	Kctd12	6057	-	NM_177715	103380673	103381657	1
chr14	103381765	103381849	Mir5130	84	-	NR_039592	103381849	103381849	1
chr14	103386628	103433020	4933432I03Rik	46392	-	NR_045657	103433020	103433020	3
chr14	103446228	103455790	Irg1	9562	+	NM_008392	103446284	103454725	5
chr14	103469432	103476847	Cln5	7415	+	NM_001033242	103469562	103475556	4
chr14	103479455	103498726	Fbxl3	19271	-	NM_015822	103482083	103494757	5
chr14	103512627	103746017	Mycbp2	233390	-	NM_207215	103513336	103745734	85
chr14	103912557	104012563	Scel	100006	+	NM_022886	103928418	104011616	31
chr14	104049459	104104016	Slain1	54557	+	NM_198014	104049571	104103128	7
chr14	104092199	104098649	Slain1os	6450	-	NR_045148	104098649	104098649	3
chr14	104213831	104243693	Ednrb	29862	-	NM_001136061	104216282	104242693	8
chr14	104376844	104426359	4930432J09Rik	49515	-	NR_045953	104426359	104426359	3
chr14	104861540	104867216	Pou4f1	5676	-	NM_011143	104864945	104866950	3
chr14	104876750	104921883	Rnf219	45133	-	NM_026047	104877983	104921829	6
chr14	105038363	105366000	D130009I18Rik	327637	+	NR_015593	105366000	105366000	6
chr14	105505944	105513893	Gm17066	7949	-	NR_040628	105513893	105513893	3
chr14	105513735	105576544	Rbm26	62809	-	NM_134077	105514413	105576069	21
chr14	105657889	105708515	Ndfip2	50626	+	NM_029561	105657889	105704051	8
chr14	105826775	105836933	5430440P10Rik	10158	+	NR_045859	105836933	105836933	3
chr14	105898004	105904845	4930449E01Rik	6841	+	NR_045921	105904845	105904845	3
chr14	105988765	105993146	9330188P03Rik	4381	+	NR_102319	105993146	105993146	3
chr14	106022858	106022987	Mir6390	129	-	NR_105814	106022987	106022987	1
chr14	106291163	106296036	Spry2	4873	-	NM_011897	106292019	106292967	2
chr14	106505414	106535079	Trim52	29665	+	NR_073203	106535079	106535079	2
chr14	106816403	106885737	1700128A07Rik	69334	-	NR_045938	106885737	106885737	4
chr14	109309205	109313456	Slitrk1	4251	-	NM_199065	109310403	109312494	1
chr14	111147799	111154371	Slitrk6	6572	-	NM_175499	111148972	111151495	2
chr14	112074336	112082357	Slitrk5	8021	+	NM_198865	112078167	112081041	2
chr14	115231186	115260549	4930524C18Rik	29363	+	NR_045661	115260549	115260549	6
chr14	115339446	115345170	1700100I10Rik	5724	-	NR_126549	115345170	115345170	5
chr14	115442892	115442976	Mir17	84	+	NR_029785	115442976	115442976	1
chr14	115443072	115443168	Mir18	96	+	NR_029736	115443168	115443168	1
chr14	115443221	115443303	Mir19a	82	+	NR_029786	115443303	115443303	1
chr14	115443378	115443485	Mir20a	107	+	NR_029737	115443485	115443485	1
chr14	115443526	115443613	Mir19b-1	87	+	NR_029815	115443613	115443613	1
chr14	115443611	115445950	Mir17hg	2339	+	NR_029382	115445950	115445950	1
chr14	115443648	115443728	Mir92-1	80	+	NR_029816	115443728	115443728	1
chr14	115491436	116924414	Gpc5	1432978	+	NM_175500	115491847	116923659	8
chr14	115795772	115808774	4930505G20Rik	13002	-	NR_045761	115808774	115808774	4
chr14	117324518	118378751	Gpc6	1054233	+	NM_001079844	117325157	118374308	10
chr14	118352964	118353069	Mir6239	105	-	NR_105747	118353069	118353069	1
chr14	118412011	118451468	Dct	39457	-	NM_010024	118412252	118451000	8
chr14	118511132	118531987	Tgds	20855	-	NM_029578	118512293	118531951	12
chr14	118536348	118563454	Gpr180	27106	+	NM_021434	118536414	118561969	9
chr14	118632455	118636252	Sox21	3797	-	NM_177753	118634026	118634857	1
chr14	118635453	118660421	LOC105245869	24968	+	NR_131969	118660421	118660421	3
chr14	118657855	118657958	Mir6241	103	+	NR_105749	118657958	118657958	1
chr14	118666379	118666992	Gm9376	613	+	NM_001101609	118666379	118666910	1
chr14	118765099	118797387	1700044C05Rik	32288	+	NR_045624	118797387	118797387	6
chr14	118881913	119105441	Abcc4	223528	-	NM_001033336	118883554	119105331	31
chr14	118991590	118991694	Mir6391	104	-	NR_105815	118991694	118991694	1
chr14	119187092	119273747	Cldn10	86655	+	NM_001160096	119187378	119273537	5
chr14	119274741	119324692	Dzip1	49951	-	NM_025943	119276404	119322135	22
chr14	119337153	119380924	Dnajc3	43771	+	NM_008929	119337310	119377406	12
chr14	119384206	119498656	Uggt2	114450	-	NM_001081252	119386112	119498563	39
chr14	119537486	120269037	Hs6st3	731551	+	NM_015820	119537636	120268816	2
chr14	120148448	120150786	1700006F04Rik	2338	+	NR_045621	120150786	120150786	3
chr14	120418806	120441657	Oxgr1	22851	-	NM_001001490	120421001	120422015	4
chr14	120674890	120830920	Mbnl2	156030	+	NM_175341	120724460	120828171	9
chr14	120877682	120906414	Rap2a	28732	+	NM_029519	120877948	120903060	2
chr14	121310415	121347266	Ipo5	36851	+	NM_023579	121310475	121346027	26
chr14	121434795	121682948	Farp1	248153	+	NM_134082	121501233	121681613	27
chr14	121685562	121778452	Stk24	92890	-	NM_145465	121686549	121778161	11
chr14	121858842	121904476	Slc15a1	45634	-	NM_053079	121859803	121904444	23
chr14	121941260	122196956	Dock9	255696	-	NM_134074	121942724	122196837	53
chr14	122276080	122278630	1810041H14Rik	2550	-	NR_130999	122278630	122278630	2
chr14	122277827	122420257	Ubac2	142430	+	NM_026861	122277965	122419279	9
chr14	122310655	122314996	Gpr18	4341	-	NM_182806	122310837	122311833	2
chr14	122351552	122364415	Gpr183	12863	-	NM_183031	122353255	122354329	2
chr14	122433895	122437644	Timm8a2	3749	+	NM_001037744	122433908	122434202	2
chr14	122497160	122506196	A330035P11Rik	9036	-	NR_015586	122506196	122506196	4
chr14	122506303	122558825	Tm9sf2	52522	+	NM_080556	122506489	122557938	17
chr14	122580915	122801456	Clybl	220541	+	NM_029556	122580947	122801264	8
chr14	122629126	122632860	1700108J01Rik	3734	-	NR_015532	122632860	122632860	2
chr14	122764900	122850368	Gm5089	85468	-	NR_033326	122850368	122850368	4
chr14	122858381	122864880	Zic5	6499	-	NM_022987	122858554	122864539	2
chr14	122869598	122874421	2610035F20Rik	4823	-	NR_045046	122874421	122874421	5
chr14	122874605	122879550	Zic2	4945	+	NM_009574	122874897	122878465	3
chr14	122933549	123289166	Pcca	355617	+	NM_144844	122933588	123288777	24
chr14	123290081	123312387	Ggact	22306	-	NM_145466	123290573	123291023	3
chr14	123318196	123382483	Tmtc4	64287	-	NM_028651	123319216	123377454	18
chr14	123567724	123575398	AA536875	7674	+	NR_045145	123575398	123575398	5
chr14	123675862	124026366	Nalcn	350504	-	NM_177393	123677389	123999172	44
chr14	124059361	124373301	Itgbl1	313940	+	NM_145467	124059530	124372598	11
chr14	124377512	125076349	Fgf14	698837	-	NM_207667	124379567	125075939	5
chr14	124386856	124414906	1700024B18Rik	28050	+	NR_045479	124414906	124414906	4
chr15	3220766	3230508	Sepp1	9742	+	NM_001042613	3224673	3229710	5
chr15	3230626	3253526	Ccdc152	22900	-	NM_001166063	3230626	3251191	9
chr15	3267754	3533352	Ghr	265598	-	NM_010284	3269741	3407999	11
chr15	3913563	3929573	Fbxo4	16010	-	NM_134099	3915702	3929424	7
chr15	3932034	3945752	AW549877	13718	-	NM_145930	3936195	3945714	6
chr15	3946038	3965858	A630020A06	19820	+	NR_045740	3965858	3965858	3
chr15	3970110	3977406	BC037032	7296	-	NR_028266	3977406	3977406	2
chr15	3976427	4105344	Oxct1	128917	+	NM_024188	3976771	4103769	17
chr15	4325490	4525579	Plcxd3	200089	+	NM_177355	4325712	4524877	3
chr15	4677209	4754045	C6	76836	+	NM_016704	4681659	4753642	16
chr15	4848736	4912201	Mroh2b	63465	+	NM_001166066	4849186	4912167	42
chr15	4938761	5013773	C7	75012	-	NM_001243837	4938821	5013662	18
chr15	5047438	5058533	Card6	11095	-	NM_001163138	5048384	5058370	4
chr15	5066612	5069140	Rpl37	2528	+	NM_026069	5066681	5068636	4
chr15	5068420	5068480	Snord72	60	+	NR_028091	5068480	5068480	1
chr15	5093860	5131899	Prkaa1	38039	+	NM_001013367	5093868	5128932	9
chr15	5135559	5168332	Ttc33	32773	+	NM_026213	5139582	5167503	5
chr15	5183398	5194187	Ptger4	10789	-	NM_008965	5184631	5193698	3
chr15	5446317	5544983	5430437J10Rik	98666	+	NR_045274	5544983	5544983	5
chr15	6249788	6390709	Dab2	140921	+	NM_001008702	6366903	6387045	14
chr15	6395332	6448476	C9	53144	+	NM_013485	6395361	6447172	11
chr15	6529846	6615608	Fyb	85762	+	NM_011815	6529947	6613172	18
chr15	6658380	6750400	Rictor	92020	+	NM_030168	6658402	6746236	38
chr15	6763576	6824313	Osmr	60737	-	NM_011019	6765370	6810365	18
chr15	7090541	7147489	Lifr	56948	+	NM_013584	7104408	7141169	20
chr15	7156119	7348395	Egflam	192276	-	NM_001289498	7157647	7254024	23
chr15	7760047	7787580	Gdnf	27533	+	NM_001301332	7761053	7784832	3
chr15	7823054	8049209	Wdr70	226155	-	NM_001081402	7823165	8049143	18
chr15	8059312	8109859	Nup155	50547	+	NM_133227	8059445	8107764	35
chr15	8119105	8221158	2410089E03Rik	102053	+	NM_001162906	8121740	8220855	53
chr15	8239823	8394463	Nipbl	154640	-	NM_027707	8241224	8324023	47
chr15	8584123	8660807	Slc1a3	76684	-	NM_148938	8586131	8658742	10
chr15	8917948	8997082	Ranbp3l	79134	+	NM_198024	8918425	8994756	12
chr15	9001008	9040253	Nadk2	39245	+	NM_001085410	9001250	9038114	13
chr15	9041738	9085181	Skp2	43443	-	NM_001285980	9043410	9069362	10
chr15	9070325	9127206	Lmbrd2	56881	+	NM_177178	9078787	9126472	18
chr15	9209583	9244791	Ugt3a1	35208	+	NM_207216	9209708	9244240	7
chr15	9265352	9300625	Ugt3a2	35273	+	NM_144845	9265449	9300098	7
chr15	9365782	9395790	Capsl	30008	+	NM_029341	9387451	9395611	5
chr15	9435913	9459631	Il7r	23718	-	NM_008372	9437609	9459497	8
chr15	9507947	9678623	Spef2	170676	-	NM_001305042	9508016	9678524	37
chr15	10106992	10266775	Prlr	159783	+	NM_011169	10243973	10259022	10
chr15	10288287	10339908	Agxt2	51621	+	NM_001310736	10288351	10339312	14
chr15	10376517	10400271	Dnajc21	23754	-	NM_030046	10376819	10400116	12
chr15	10404533	10415692	Brix1	11159	-	NM_026396	10406081	10415648	10
chr15	10415772	10428818	Rad1	13046	+	NM_001289448	10416273	10425814	6
chr15	10433701	10488423	Ttc23l	54722	-	NM_029430	10434237	10488405	11
chr15	10498732	10644386	Rai14	145654	-	NM_001166408	10500451	10620161	18
chr15	10530047	10541406	Gm10389	11359	+	NR_033541	10541406	10541406	3
chr15	10644590	10719878	4930556M19Rik	75288	+	NR_045063	10719878	10719878	7
chr15	10758805	10762468	Gm19276	3663	+	NR_040357	10762468	10762468	3
chr15	10882086	10909917	C1qtnf3	27831	+	NM_030888	10882208	10908430	6
chr15	10911510	10926379	Amacr	14869	+	NM_008537	10911564	10925004	5
chr15	10930475	10958988	Slc45a2	28513	+	NM_053077	10930571	10957694	7
chr15	10963471	10967723	Rxfp3	4252	-	NM_178717	10965620	10967039	1
chr15	10994544	11276622	Adamts12	282078	+	NM_175501	10994785	11275432	24
chr15	11313417	11329413	Tars	15996	-	NM_033074	11313765	11329294	19
chr15	11769650	11837126	Npr3	67476	-	NM_001286395	11774931	11825551	9
chr15	11836279	11837145	Gm5144	866	+	NR_131059	11837145	11837145	2
chr15	11896816	11899838	1700047G03Rik	3022	+	NR_040447	11899838	11899838	3
chr15	11911093	11925762	Sub1	14669	-	NM_011294	11913972	11923615	5
chr15	12047605	12115205	Zfr	67600	+	NM_011767	12047665	12113893	20
chr15	12101246	12101329	Mir1898	83	+	NR_035443	12101329	12101329	1
chr15	12134848	12201995	Mtmr12	67147	+	NM_172958	12134953	12199826	16
chr15	12251250	12281022	Golph3	29772	+	NM_025673	12251486	12279547	4
chr15	12286808	12522311	Pdzd2	235503	-	NM_001081064	12291830	12522311	24
chr15	12737931	12754412	6030458C11Rik	16481	-	NM_029998	12740466	12754302	9
chr15	12754569	12865046	Drosha	110477	+	NM_026799	12757030	12864877	35
chr15	12958453	13103430	Cdh6	144977	-	NM_007666	12963954	13021632	12
chr15	16707855	16786532	Cdh9	78677	+	NM_009869	16707855	16785997	11
chr15	18007891	18299382	4921515E04Rik	291491	-	NR_045711	18299382	18299382	12
chr15	18748701	18943991	Cdh10	195290	+	NM_001316758	18829343	18943437	12
chr15	20594968	20596505	Acot10	1537	-	NM_022816	20595088	20596408	1
chr15	21041206	21519288	Cdh12	478082	+	NM_001008420	21167435	21516236	12
chr15	22643574	22644739	Gm5803	1165	-	NM_001165971	22643622	22644585	1
chr15	22966217	23404173	Cdh18	437956	+	NM_001081299	23103456	23404173	12
chr15	25293031	25343519	Basp1	50488	-	NM_027395	25293983	25294664	2
chr15	25343946	25382173	Gm5468	38227	+	NR_027376	25382173	25382173	2
chr15	25552304	25743426	Myo10	191122	+	NM_019472	25552764	25741977	41
chr15	25773052	25903451	Fam134b	130399	+	NM_001034851	25773098	25901801	9
chr15	25877981	25878042	Mir7212	61	+	NR_106071	25878042	25878042	1
chr15	25914120	25928237	Zfp622	14117	+	NM_144523	25914304	25927049	6
chr15	26238802	26339330	March11	100528	+	NM_177597	26239016	26339174	4
chr15	26470213	26825319	Fbxl7	355106	-	NM_176959	26472838	26824804	4
chr15	27175876	27246498	Mir297-1	70622	+	NR_029647	27246498	27246498	4
chr15	27396431	27524662	Ank	128231	+	NM_020332	27396758	27522972	12
chr15	27501248	27501313	Mir7117	65	+	NR_106065	27501313	27501313	1
chr15	27535675	27560448	Otulin	24773	-	NM_001013792	27536021	27560364	7
chr15	27584825	27611297	Fam105a	26472	-	NM_001242424	27586952	27611206	9
chr15	27660403	27955603	Trio	295200	-	NM_001081302	27662236	27955251	57
chr15	28133520	28401800	Dnah5	268280	+	NM_133365	28133733	28400263	79
chr15	29643085	29643159	Mir3964	74	-	NR_039542	29643159	29643159	1
chr15	30102347	30959098	Ctnnd2	856751	+	NM_008729	30102881	30957427	23
chr15	30968880	30973086	4930430F21Rik	4206	+	NR_045186	30973086	30973086	4
chr15	31154139	31204093	Dap	49954	+	NM_146057	31154283	31203065	4
chr15	31221234	31297514	Ankrd33b	76280	-	NM_027496	31226903	31297147	4
chr15	31370964	31383444	Ropn1l	12480	-	NM_145852	31371071	31383298	5
chr15	31385653	31460792	March6	75139	-	NM_172606	31388943	31460576	26
chr15	31498666	31519874	Cmbl	21208	+	NM_181588	31511613	31519618	6
chr15	31520638	31531559	Cct5	10921	-	NM_007637	31520682	31531460	11
chr15	31531870	31547290	Fam173b	15420	+	NM_026546	31531891	31546889	5
chr15	32107043	32108049	Tas2r119	1006	+	NM_020503	32107044	32108049	1
chr15	32170322	32174417	Snhg18	4095	-	NR_038186	32174417	32174417	2
chr15	32171599	32171687	Snord123	88	-	NR_028575	32171687	32171687	1
chr15	32174567	32626096	Sema5a	451529	+	NM_009154	32347140	32619170	23
chr15	32850477	32964476	Sdc2	113999	+	NM_008304	32851000	32962295	5
chr15	33012883	33524307	Cpq	511424	+	NM_018755	33142591	33524012	9
chr15	33334963	33335694	1700084J12Rik	731	-	NR_033608	33335694	33335694	1
chr15	33523635	33583191	4930592A05Rik	59556	-	NR_045070	33583191	33583191	6
chr15	33613629	33617638	Tspyl5	4009	-	NM_001085421	33616331	33617552	1
chr15	34012473	34072140	Mtdh	59667	+	NM_026002	34012790	34070517	12
chr15	34167780	34214050	Laptm4b	46270	+	NM_033521	34168078	34213135	7
chr15	34236435	34365995	Matn2	129560	+	NM_016762	34246268	34365542	19
chr15	34278805	34287627	9430069I07Rik	8822	-	NM_001256161	34278930	34286176	4
chr15	34370260	34372988	Gm12191	2728	-	NR_028101	34372988	34372988	5
chr15	34370262	34373031	Rpl30	2769	-	NM_001163485	34370309	34372800	5
chr15	34383066	34403647	Erich5	20581	+	NM_173421	34383401	34402695	3
chr15	34413776	34425001	Hrsp12	11225	-	NM_008287	34414233	34424872	6
chr15	34425065	34460408	Pop1	35343	+	NM_152894	34429045	34460260	17
chr15	34502553	34608461	Nipal2	105908	-	NM_145469	34505213	34608448	11
chr15	34604827	34608959	4930413F20Rik	4132	+	NR_045883	34608959	34608959	4
chr15	34767109	34773162	Kcns2	6053	+	NM_181317	34768247	34769681	2
chr15	34805253	35085561	Stk3	280308	-	NM_019635	34806416	35085307	11
chr15	35225866	35233060	Osr2	7194	+	NM_054049	35230054	35232648	4
chr15	35236764	35258290	BC048602	21526	-	NR_045280	35258290	35258290	3
chr15	35301300	35860984	Vps13b	559684	+	NM_177151	35301715	35859855	62
chr15	35590585	35590673	Mir599	88	-	NR_035527	35590673	35590673	1
chr15	35590724	35590802	Mir875	78	-	NR_030606	35590802	35590802	1
chr15	35861730	35868001	Cox6c	6271	-	NM_053071	35865054	35867026	4
chr15	35939231	36070155	Rgs22	130924	-	NM_001195748	35940087	36070107	28
chr15	36079814	36094639	Fbxo43	14825	-	NM_001081253	36081398	36092814	5
chr15	36103764	36106767	Polr2k	3003	+	NM_023127	36104750	36106531	4
chr15	36109284	36164932	Spag1	55648	+	NM_012031	36111452	36164653	19
chr15	36169688	36212902	Rnf19a	43214	-	NM_013923	36171123	36195704	10
chr15	36169800	36169919	Mir8097	119	-	NR_106173	36169919	36169919	1
chr15	36407422	36426546	Ankrd46	19124	-	NM_175134	36409011	36415860	5
chr15	36433816	36485327	Snx31	51511	-	NM_025712	36435135	36485268	14
chr15	36525412	36538728	Pabpc1	13316	-	NM_008774	36526317	36538261	15
chr15	36700015	36726684	Ywhaz	26669	-	NM_001253806	36702472	36720732	6
chr15	36926781	36937157	Zfp706	10376	-	NM_026521	36931605	36933575	4
chr15	37162790	37293323	Grhl2	130533	+	NM_026496	37163141	37290606	16
chr15	37295929	37722183	Ncald	426254	-	NM_134094	37298582	37327189	7
chr15	37350887	37362419	Gm15941	11532	-	NR_045283	37362419	37362419	3
chr15	37355308	37370399	4930447A16Rik	15091	+	NM_029113	37355372	37370275	4
chr15	37853707	37890810	Rrm2b	37103	-	NM_199476	37856999	37890646	9
chr15	37897082	38008609	Ubr5	111527	-	NM_001081359	37898047	38008180	59
chr15	38148957	38156490	Odf1	7533	+	NM_008757	38149184	38156359	2
chr15	38221218	38230466	Klf10	9248	-	NM_001289471	38221944	38230349	5
chr15	38417184	38449021	Azin1	31837	-	NM_001102458	38420115	38431260	13
chr15	38420227	38420302	Mir6951	75	-	NR_105916	38420302	38420302	1
chr15	38479098	38524689	2310043O21Rik	45591	-	NR_045757	38524689	38524689	3
chr15	38591658	38622199	Atp6v1c1	30541	+	NM_025494	38602643	38621462	13
chr15	38643237	38658275	Borg	15038	-	NR_131206	38658275	38658275	3
chr15	38765454	38784462	Baalc	19008	+	NM_080640	38765454	38780774	2
chr15	38837825	38869736	Fzd6	31911	+	NM_001162494	38838932	38868100	7
chr15	38908477	38918665	Cthrc1	10188	+	NM_026778	38908549	38918311	4
chr15	38925736	38944262	Slc25a32	18526	-	NM_172402	38927515	38944047	7
chr15	38944419	38978401	Dcaf13	33982	+	NM_198606	38944527	38978306	11
chr15	39029831	39515918	Rims2	486087	+	NM_001256382	39029908	39513310	27
chr15	39577475	39592484	Dcstamp	15009	+	NM_001289508	39585742	39591949	4
chr15	39600030	39689016	Dpys	88986	-	NM_022722	39616143	39688908	10
chr15	39628590	39643923	Gm16291	15333	+	NR_045788	39643923	39643923	3
chr15	39702148	39775303	Lrp12	73155	-	NM_172814	39703560	39775228	7
chr15	39794194	39799061	AU022793	4867	+	NR_045719	39799061	39799061	3
chr15	39965910	39981556	9330182O14Rik	15646	+	NM_001256056	39973733	39980235	4
chr15	40342867	40358823	Gm16294	15956	-	NR_046185	40358823	40358823	3
chr15	40486587	40936138	Zfpm2	449551	+	NM_011766	40487089	40935122	8
chr15	41209535	41423539	Mir8115	214004	-	NR_106195	41423539	41423539	5
chr15	41279027	41692593	Oxr1	413566	+	NM_001130166	41367250	41690839	17
chr15	41696838	41701266	Abra	4428	-	NM_175456	41697420	41701214	2
chr15	42256212	42508523	Angpt1	252311	-	NM_001286062	42258515	42508007	9
chr15	42852340	43002364	Rspo2	150024	-	NM_172815	42854072	43001370	6
chr15	43081585	43114282	Eif3e	32697	-	NM_008388	43081744	43114238	13
chr15	43262488	43308582	Gm10373	46094	-	NR_046064	43308582	43308582	3
chr15	43308774	43359323	Emc2	50549	+	NM_025736	43308831	43359029	11
chr15	43698240	43701575	Tmem74	3335	-	NM_175502	43698273	43699191	2
chr15	44027680	44067458	Trhr	39778	+	NM_013696	44028631	44065013	4
chr15	44206772	44259853	Nudcd1	53081	-	NM_001113554	44207939	44259322	10
chr15	44259656	44269231	Eny2	9575	+	NM_175009	44259782	44267234	5
chr15	44289098	44428681	Pkhd1l1	139583	+	NM_138674	44289098	44428681	77
chr15	44451186	44472572	Ebag9	21386	+	NM_019480	44456003	44471968	7
chr15	44503402	44619609	Sybu	116207	-	NM_176998	44504092	44619452	8
chr15	44619308	44637375	2310069G16Rik	18067	+	NR_040309	44637375	44637375	3
chr15	44712939	44716289	A930017M01Rik	3350	+	NR_033609	44716289	44716289	1
chr15	44937829	44946480	Kcnv1	8651	-	NM_026200	44940519	44946186	3
chr15	46156130	46205445	1700022A22Rik	49315	+	NR_045509	46205445	46205445	4
chr15	46267411	46327725	4930523O13Rik	60314	-	NR_040451	46327725	46327725	9
chr15	46454850	46471404	4930548G14Rik	16554	+	NR_045811	46471404	46471404	4
chr15	47412183	48623535	Csmd3	1211352	-	NM_001081391	47413996	48623450	71
chr15	50486304	50721587	Trps1	235283	-	NM_032000	50492220	50678486	6
chr15	50720570	50720660	Mir1907	90	-	NR_035444	50720660	50720660	1
chr15	51063185	51227156	Gm19303	163971	-	NR_045092	51227156	51227156	6
chr15	51618108	51697007	Eif3h	78899	-	NM_080635	51618273	51697003	8
chr15	51708986	51716168	Utp23	7182	+	NM_030132	51709068	51714083	3
chr15	51794149	51823306	Rad21	29157	-	NM_009009	51795601	51814218	14
chr15	51871652	51877269	Aard	5617	+	NM_175503	51871728	51876501	2
chr15	52127107	52167288	Slc30a8	40181	+	NM_172816	52127440	52166819	8
chr15	52543999	52561986	Med30	17987	+	NM_027212	52544064	52561717	4
chr15	52899817	53177738	Ext1	277921	-	NM_010162	52900218	53176918	11
chr15	53293355	53733991	Samd12	440636	-	NM_177225	53293748	53733936	5
chr15	53445759	53445834	Mir28c	75	-	NR_039538	53445834	53445834	1
chr15	54082173	54110039	Tnfrsf11b	27866	-	NM_008764	54083548	54109802	5
chr15	54242328	54297913	Colec10	55585	+	NM_173422	54242332	54294164	6
chr15	54402920	54434401	Mal2	31481	+	NM_178920	54403063	54432297	4
chr15	54577482	54585316	Nov	7834	+	NM_010930	54577526	54584060	5
chr15	54670455	54751701	Enpp2	81246	-	NM_001136077	54670920	54751516	26
chr15	54846683	54903707	Taf2	57024	-	NM_001081288	54847896	54903484	26
chr15	54907655	54922033	Dscc1	14378	-	NM_183089	54907711	54921980	9
chr15	54931471	54945137	Gm9920	13666	-	NR_045093	54945137	54945137	5
chr15	54943871	55090828	Deptor	146957	+	NM_145470	54944052	55083690	9
chr15	55139304	55352358	Col14a1	213054	+	NM_181277	55160747	55351567	48
chr15	55365649	55388867	Mrpl13	23218	-	NM_026759	55365870	55388839	7
chr15	55388962	55457978	Mtbp	69016	+	NM_134092	55389174	55457731	22
chr15	55470708	55738504	Sntb1	267796	-	NM_016667	55470889	55738146	7
chr15	56497181	56526101	Has2	28920	-	NM_008216	56499213	56513759	4
chr15	56521498	56526015	Has2os	4517	+	NR_002874	56526015	56526015	4
chr15	57075325	57309180	Slc22a22	233855	-	NM_172378	57075586	57095226	12
chr15	57526221	57671387	Zhx2	145166	+	NM_199449	57652791	57655302	4
chr15	57701056	57723973	Derl1	22917	-	NM_024207	57703322	57723850	8
chr15	57743753	57801623	Tbc1d31	57870	+	NM_001081396	57743869	57801412	21
chr15	57817457	57842257	Fam83a	24800	+	NM_173862	57817616	57841642	4
chr15	57853826	57865849	9130401M01Rik	12023	-	NM_029418	57853920	57865755	6
chr15	57878557	57908063	Zhx1	29506	-	NM_001042438	57883781	57886403	5
chr15	57925601	57966637	Atad2	41036	-	NM_027435	57927081	57966529	28
chr15	57972990	57990209	Wdyhv1	17219	+	NM_029734	57973047	57989572	6
chr15	58007433	58046447	Fbxo32	39014	-	NM_026346	58013020	58046166	9
chr15	58146127	58155724	Klhl38	9597	-	NM_177755	58146381	58154886	4
chr15	58173018	58220829	Anxa13	47811	-	NM_027211	58173428	58220785	9
chr15	58247022	58289356	D15Ertd621e	42334	+	NM_145959	58247260	58286487	24
chr15	58613823	58654982	Tmem65	41159	-	NM_175212	58616463	58654683	7
chr15	58704203	58708336	Trmt12	4133	+	NM_026642	58704309	58705650	1
chr15	58720783	58733945	Rnf139	13162	+	NM_175226	58720868	58731689	2
chr15	58721707	58765285	Tatdn1	43578	-	NM_175151	58722248	58765255	12
chr15	58765364	58771044	Ndufb9	5680	+	NM_023172	58765392	58770961	4
chr15	58772788	58913581	Mtss1	140793	-	NM_144800	58774984	58913082	15
chr15	59138502	59143568	Zfp572	5066	+	NR_045613	59143568	59143568	2
chr15	59146646	59162748	Sqle	16102	+	NM_009270	59147399	59162472	11
chr15	59163551	59205707	E430025E21Rik	42156	-	NM_153548	59163857	59201620	29
chr15	59205752	59433239	Nsmce2	227487	+	NM_026746	59210436	59433012	7
chr15	59480208	59488654	Trib1	8446	+	NM_144549	59480717	59486256	3
chr15	59619971	59626514	Gm19510	6543	-	NR_045076	59626514	59626514	4
chr15	59846420	59848173	4933412E24Rik	1753	-	NM_027668	59846602	59848144	1
chr15	60650550	60656635	Fam84b	6085	-	NM_001162926	60654517	60655450	2
chr15	60654519	60662955	9930014A18Rik	8436	+	NR_030696	60662955	60662955	3
chr15	60749143	60752825	A1bg	3682	-	NM_001081067	60749413	60752811	7
chr15	61530838	61606006	D030024E09Rik	75168	-	NR_040350	61606006	61606006	5
chr15	61816895	61821916	Myc	5021	+	NM_001177353	61817476	61821463	3
chr15	61869540	62091767	Pvt1	222227	+	NR_132747	62091767	62091767	5
chr15	62049095	62051006	H2afy3	1911	-	NR_003523	62051006	62051006	1
chr15	63245951	63311163	Gm20740	65212	-	NR_045279	63311163	63311163	6
chr15	63607525	63640294	Gsdmc	32769	-	NM_031378	63608231	63636147	12
chr15	63648742	63651095	1700065I16Rik	2353	+	NR_108057	63651095	63651095	4
chr15	63655900	63676731	Gsdmc2	20831	-	NM_001168274	63656432	63667498	14
chr15	63678863	63682497	Gsdmcl1	3634	+	NR_108051	63682497	63682497	5
chr15	63689279	63710113	Gsdmc3	20834	-	NM_183194	63689825	63700852	13
chr15	63712261	63720628	Gsdmcl2	8367	+	NR_108053	63720628	63720628	7
chr15	63722819	63743852	Gsdmc4	21033	-	NM_028992	63723358	63734485	12
chr15	63746015	63757008	Gsdmcl-ps	10993	+	NR_029414	63757008	63757008	11
chr15	63760648	63892010	Fam49b	131362	-	NM_144846	63763170	63788227	12
chr15	63918401	64214481	Asap1	296080	-	NM_010026	63921008	64181448	31
chr15	64530596	64753858	Adcy8	223262	-	NM_009623	64530694	64752667	18
chr15	65618602	65705374	Efr3a	86772	+	NM_133766	65618798	65702820	23
chr15	65707614	65743849	Oc90	36235	-	NM_010953	65707859	65740567	15
chr15	65754004	65808366	Hhla1	54362	-	NM_001145096	65754646	65804401	17
chr15	65826476	66117786	Kcnq3	291310	-	NM_152923	65826732	66117786	15
chr15	66211419	66332472	Lrrc6	121053	-	NM_019457	66211955	66332346	12
chr15	66357773	66392608	Tmem71	34835	-	NM_172514	66359480	66390881	10
chr15	66409133	66476817	Phf20l1	67684	+	NM_001081409	66411667	66473502	21
chr15	66502331	66682282	Tg	179951	+	NM_009375	66502353	66682169	48
chr15	66612380	66663391	Sla	51011	-	NM_009192	66614103	66633053	9
chr15	66722954	66754761	Wisp1	31807	+	NM_018865	66723127	66751016	5
chr15	66760879	66801203	Ndrg1	40324	-	NM_008681	66762428	66792096	16
chr15	66934436	67008444	St3gal1	74008	-	NM_009177	66938218	66945365	9
chr15	67058330	67208656	1700012I11Rik	150326	+	NR_045140	67208656	67208656	9
chr15	67915299	68090418	Zfat	175119	-	NM_001145888	67915883	68090248	16
chr15	68168976	68169072	Mir30b	96	-	NR_029534	68169072	68169072	1
chr15	68172769	68172851	Mir30d	82	-	NR_029718	68172851	68172851	1
chr15	68758849	68923948	Khdrbs3	165099	+	NM_010158	68759175	68923422	9
chr15	69100962	69105148	4930504C09Rik	4186	+	NR_130983	69105148	69105148	3
chr15	69754662	69908634	Gm19782	153972	+	NR_045071	69908634	69908634	6
chr15	71276107	71558268	Fam135b	282161	-	NM_177819	71276329	71452508	20
chr15	71628905	71864657	Col22a1	235752	-	NM_027174	71629762	71839930	64
chr15	72342548	72376709	Kcnk9	34161	-	NM_001033876	72342548	72376709	2
chr15	72420049	72891634	Trappc9	471585	-	NM_180662	72420424	72888935	22
chr15	72636029	72640754	Peg13	4725	-	NR_002864	72640754	72640754	1
chr15	72920841	72924505	Chrac1	3664	+	NM_053068	72920866	72924069	3
chr15	72932054	73015377	Ago2	83323	-	NM_153178	72937337	73015212	19
chr15	73035534	73253621	Ptk2	218087	-	NM_007982	73036477	73173757	32
chr15	73085244	73085312	Mir151	68	-	NR_029561	73085312	73085312	1
chr15	73342989	73402672	Dennd3	59683	+	NM_001081066	73343175	73401384	23
chr15	73410720	73455174	Slc45a4	44454	-	NM_001033219	73412194	73436115	8
chr15	73525036	73537935	Gpr20	12899	-	NM_173365	73525891	73526968	2
chr15	73553574	73589196	Ptp4a3	35622	+	NM_001166389	73582352	73587344	6
chr15	73617365	73670101	Mroh5	52736	-	NM_001033365	73618135	73649749	11
chr15	74346625	74419894	Adgrb1	73269	+	NM_174991	74359586	74419314	31
chr15	74436457	74466748	Mroh4	30291	-	NM_001177437	74436540	74459873	27
chr15	74499510	74503000	Arc	3490	-	NM_018790	74501611	74502802	3
chr15	74532841	74539752	Jrk	6911	-	NM_008415	74536190	74537864	2
chr15	74539590	74540804	4933427E11Rik	1214	+	NR_033197	74540804	74540804	1
chr15	74545268	74547495	Psca	2227	+	NM_028216	74545284	74547027	3
chr15	74551663	74554803	Them6	3140	+	NM_198607	74551724	74554000	2
chr15	74557073	74558456	Slurp1	1383	-	NM_020519	74557237	74558428	3
chr15	74562681	74564743	Lypd2	2062	-	NM_026671	74562763	74564717	3
chr15	74573268	74577117	2300005B03Rik	3849	-	NM_001081961	74573426	74577105	3
chr15	74578285	74583409	Lynx1	5124	-	NM_011838	74581660	74582336	4
chr15	74592485	74593997	Ly6d	1512	-	NM_010742	74592785	74593990	3
chr15	74601337	74609289	D730001G18Rik	7952	-	NR_027836	74609289	74609289	3
chr15	74627303	74630398	Ly6k	3095	-	NM_029627	74627393	74629906	4
chr15	74643884	74649245	Gml	5361	-	NM_001177524	74644033	74647629	4
chr15	74649505	74654866	Gml2	5361	+	NM_010416	74650996	74654719	4
chr15	74665321	74672073	Cyp11b1	6752	-	NM_001033229	74666182	74672042	9
chr15	74681439	74686748	Cyp11b2	5309	-	NM_009991	74681468	74686661	9
chr15	74708765	74712134	2010109I03Rik	3369	-	NM_025929	74710277	74712095	3
chr15	74785480	74790335	Ly6e	4855	+	NM_001164037	74788237	74789143	5
chr15	74810241	74813860	Ly6i	3619	-	NM_020498	74810343	74813489	3
chr15	74825306	74828461	Ly6a	3155	-	NM_001271446	74825691	74828034	4
chr15	74874447	74879267	Ly6c1	4820	-	NM_001252056	74874755	74878941	6
chr15	74938590	74942379	Ly6c2	3789	-	NM_001099217	74938972	74942097	4
chr15	74985690	74989558	Ly6g	3868	+	NM_001310438	74986074	74989169	4
chr15	75098850	75102664	Ly6f	3814	+	NM_008530	75099159	75102280	4
chr15	75258035	75262259	9030619P08Rik	4224	-	NR_108041	75262259	75262259	4
chr15	75395174	75397612	Ly6h	2438	-	NM_011837	75395535	75397194	4
chr15	75427087	75428643	Gpihbp1	1556	+	NM_026730	75427108	75428554	4
chr15	75447113	75455730	Zfp41	8617	+	NM_011759	75448630	75449227	3
chr15	75487462	75509220	Top1mt	21758	-	NM_028404	75487541	75509186	14
chr15	75534717	75544849	Rhpn1	10132	+	NM_001163465	75534823	75544655	15
chr15	75577272	75578352	Mafa	1080	-	NM_194350	75577272	75578352	1
chr15	75584876	75672338	Zc3h3	87462	-	NM_172121	75585348	75672325	12
chr15	75692768	75697834	Gsdmd	5066	+	NM_026960	75693838	75697669	11
chr15	75713363	75719153	Mroh6	5790	-	NM_001282443	75714566	75719153	14
chr15	75721393	75724911	Naprt	3518	-	NM_172607	75721427	75724672	13
chr15	75725225	75739986	Eef1d	14761	-	NM_001285429	75725982	75731678	8
chr15	75740164	75744965	Tigd5	4801	+	NM_178646	75740220	75742149	1
chr15	75746892	75751990	Pycrl	5098	-	NM_025412	75747326	75751896	6
chr15	75755112	75760160	Tsta3	5048	-	NM_031201	75755368	75759467	11
chr15	75771381	75779830	Zfp623	8449	+	NM_030199	75777626	75779126	2
chr15	75799614	75806295	Zfp707	6681	+	NM_001081065	75799823	75805705	4
chr15	75810301	75812715	Ccdc166	2414	-	NM_146059	75811196	75812659	2
chr15	75824198	75829583	Mapk15	5385	+	NM_177922	75824289	75829394	14
chr15	75831521	75844766	Fam83h	13245	-	NM_134087	75832286	75836977	5
chr15	75877592	75900214	Scrib	22622	-	NM_134089	75877821	75899817	38
chr15	75895257	75895318	Mir6952	61	-	NR_105917	75895318	75895318	1
chr15	75900611	75911376	Puf60	10765	-	NM_028364	75900757	75911303	12
chr15	75916023	75920443	Nrbp2	4420	-	NM_144847	75917505	75920054	12
chr15	75931917	75950625	Eppk1	18708	-	NM_144848	75932732	75943109	2
chr15	75949947	75956986	BC024139	7039	-	NM_001142968	75950175	75956734	16
chr15	76001403	76061808	Plec	60405	-	NM_001163542	76002599	76061802	34
chr15	76046040	76046103	Mir1942	63	-	NR_035463	76046103	76046103	1
chr15	76063424	76073870	Parp10	10446	-	NM_001163575	76063731	76073665	11
chr15	76077236	76080334	Grina	3098	+	NM_023168	76078303	76079796	7
chr15	76078620	76078688	Mir6953	68	+	NR_105918	76078688	76078688	1
chr15	76097216	76100269	Mirt2	3053	-	NR_045747	76100269	76100269	3
chr15	76098518	76123002	Spatc1	24484	+	NM_028852	76098601	76122923	5
chr15	76121308	76121398	Mir3079	90	-	NR_037240	76121398	76121398	1
chr15	76124863	76127326	Smpd5	2463	+	NM_001195537	76124863	76126955	7
chr15	76127032	76137675	Oplah	10643	-	NM_153122	76127064	76137075	27
chr15	76157826	76161100	Exosc4	3274	+	NM_175399	76157922	76160145	3
chr15	76161723	76165329	Gpaa1	3606	+	NM_010331	76161819	76165255	12
chr15	76173952	76176364	Cyc1	2412	+	NM_025567	76173993	76176189	7
chr15	76177469	76181540	Sharpin	4071	-	NM_025340	76177700	76181108	9
chr15	76181723	76184808	Maf1	3085	+	NM_001164607	76182899	76184298	9
chr15	76199327	76201841	Hgh1	2514	+	NM_021555	76199385	76201114	6
chr15	76202387	76205368	Tssk5	2981	-	NM_183099	76202528	76205114	8
chr15	76210942	76283469	Mroh1	72527	+	NM_175457	76222867	76283341	44
chr15	76263643	76263703	Mir6954	60	+	NR_105919	76263703	76263703	1
chr15	76283425	76307699	Bop1	24274	-	NM_013481	76283654	76307651	16
chr15	76287867	76289898	Scx	2031	+	NM_198885	76288031	76289550	2
chr15	76307874	76331402	Hsf1	23528	+	NM_008296	76308030	76331052	12
chr15	76332444	76342248	Dgat1	9804	-	NM_010046	76332665	76342211	17
chr15	76346632	76352559	Scrt1	5927	-	NM_130893	76349171	76352135	2
chr15	76366157	76369176	Fbxl6	3019	-	NM_013909	76366233	76369146	9
chr15	76369372	76372560	Slc52a2	3188	+	NM_029643	76369902	76371556	5
chr15	76406788	76426241	Adck5	19453	+	NM_172960	76406912	76426080	15
chr15	76426237	76438021	Cpsf1	11784	-	NM_053193	76426314	76437908	37
chr15	76442812	76447282	Slc39a4	4470	-	NM_028064	76442964	76447191	12
chr15	76452515	76456514	Vps28	3999	-	NM_001305668	76452662	76454595	10
chr15	76456666	76470359	Tonsl	13693	-	NM_183091	76456730	76470308	26
chr15	76473824	76490638	Cyhr1	16814	-	NM_019396	76476612	76489741	5
chr15	76491070	76498626	Kifc2	7556	+	NM_010630	76491096	76497888	18
chr15	76498653	76500378	Foxh1	1725	-	NM_007989	76498736	76500301	3
chr15	76502109	76525345	Ppp1r16a	23236	+	NM_033371	76521323	76525102	11
chr15	76527155	76530105	Gpt	2950	+	NM_182805	76527287	76529940	11
chr15	76531971	76534669	Mfsd3	2698	+	NM_027122	76532098	76533866	5
chr15	76533982	76540989	Recql4	7007	-	NM_058214	76534170	76540906	22
chr15	76541169	76545521	Lrrc14	4352	+	NM_145471	76543321	76545077	6
chr15	76545705	76552603	Lrrc24	6898	-	NM_198119	76545801	76549264	6
chr15	76551894	76554275	C030006K11Rik	2381	-	NM_145472	76552967	76554246	3
chr15	76554414	76648600	Arhgap39	94186	-	NM_001168288	76555411	76596000	12
chr15	76682573	76701865	Zfp251	19292	-	NM_001007568	76683422	76701112	4
chr15	76709705	76722824	Zfp7	13119	+	NM_145916	76711209	76722247	5
chr15	76730370	76731727	Commd5	1357	+	NM_025536	76730834	76731509	2
chr15	76734500	76736748	Rpl8	2248	+	NM_012053	76734742	76736709	6
chr15	76740799	76755878	Zfp647	15079	-	NM_001168276	76741280	76748440	6
chr15	76778973	76781161	1110038F14Rik	2188	+	NM_054099	76779238	76780818	4
chr15	76845916	76881098	Mb	35182	-	NM_013593	76846355	76853013	4
chr15	76875705	76887538	Apol6	11833	+	NM_028010	76877487	76886374	5
chr15	76909419	77137483	Rbfox2	228064	-	NM_053104	76914591	77136973	14
chr15	76914827	76926744	1700109K24Rik	11917	+	NR_108037	76926744	76926744	3
chr15	77218646	77229540	Apol7a	10894	-	NM_029419	77219433	77226672	6
chr15	77234218	77241510	Apol9a	7292	-	NM_001162883	77234662	77236093	3
chr15	77252638	77277890	Apol7b	25252	-	NM_001024848	77253613	77258178	5
chr15	77307476	77321499	Apol10a	14023	+	NM_177744	77311689	77319552	4
chr15	77338700	77347749	Apol11a	9049	+	NM_001177533	77341399	77347749	4
chr15	77355296	77363745	Apol7c	8449	-	NM_175391	77356064	77360852	5
chr15	77388669	77392322	1700025B11Rik	3653	-	NR_040310	77392322	77392322	4
chr15	77414587	77426555	Apol10b	11968	-	NM_177820	77415400	77422542	4
chr15	77449397	77457828	Gm8221	8431	+	NR_033577	77457828	77457828	1
chr15	77464380	77473716	Apol11b	9336	-	NM_001143686	77465294	77471013	4
chr15	77529318	77549718	Apol7e	20400	+	NM_001134802	77542747	77548743	5
chr15	77559501	77566812	Apol9b	7311	+	NM_173743	77564937	77566368	3
chr15	77579042	77585659	Apol8	6617	-	NM_001081970	77579784	77583704	4
chr15	77591014	77672605	Myh9	81591	-	NM_022410	77592328	77643642	41
chr15	77745480	77759424	Txn2	13944	-	NM_019913	77746173	77758384	4
chr15	77770951	77787152	Foxred2	16201	-	NM_001017983	77773589	77786518	9
chr15	77789427	77801254	Eif3d	11827	-	NM_018749	77789538	77799009	15
chr15	77824052	77949710	Cacng2	125658	-	NM_007583	77825578	77949321	4
chr15	77989892	78004538	Ift27	14646	-	NM_025931	77990039	78004232	7
chr15	78021547	78034586	Pvalb	13039	-	NM_013645	78022095	78034575	4
chr15	78075240	78093010	Ncf4	17770	+	NM_008677	78075485	78092821	10
chr15	78112937	78136151	Csf2rb2	23214	-	NM_007781	78114746	78128659	14
chr15	78115217	78115279	Mir7676-1	62	-	NR_106137	78115279	78115279	1
chr15	78115217	78115279	Mir7676-2	62	-	NR_106138	78115279	78115279	1
chr15	78156419	78181431	Csf2rb	25012	+	NM_007780	78165636	78179615	14
chr15	78208829	78226342	Tex33	17513	-	NM_028522	78208898	78220594	7
chr15	78229985	78236289	Tst	6304	-	NM_009437	78230161	78236263	2
chr15	78237141	78244445	Mpst	7304	+	NM_001162493	78240499	78244107	3
chr15	78258993	78269733	Kctd17	10740	+	NM_001289671	78259087	78268058	8
chr15	78270096	78299064	Tmprss6	28968	-	NM_027902	78270643	78295773	18
chr15	78310978	78325496	Il2rb	14518	-	NM_008368	78311905	78322279	10
chr15	78353775	78360081	C1qtnf6	6306	-	NM_001204152	78355606	78359953	4
chr15	78367444	78374775	Sstr3	7331	-	NM_009218	78369688	78370975	3
chr15	78389598	78403213	Rac2	13615	-	NM_009008	78392337	78403075	7
chr15	78427476	78452449	Cyth4	24973	+	NM_028195	78427630	78450994	13
chr15	78500436	78548543	Elfn2	48107	-	NM_183141	78502303	78504775	2
chr15	78586312	78603875	Mfng	17563	-	NM_008595	78587007	78603702	8
chr15	78605565	78633472	Card10	27907	-	NM_130859	78607022	78633414	21
chr15	78673076	78681332	Cdc42ep1	8256	+	NM_027219	78677786	78680361	3
chr15	78681289	78685959	Lgals2	4670	-	NM_025622	78681436	78685907	4
chr15	78707619	78725015	Gga1	17396	+	NM_145929	78708004	78724274	17
chr15	78722269	78722343	Mir6955	74	+	NR_105920	78722343	78722343	1
chr15	78730197	78742482	Sh3bp1	12285	+	NR_133564	78742482	78742482	19
chr15	78744348	78749947	Pdxp	5599	+	NM_020271	78744399	78748876	2
chr15	78757154	78760895	Lgals1	3741	+	NM_008495	78757225	78760574	4
chr15	78765362	78772340	Nol12	6978	+	NM_133800	78765419	78771058	6
chr15	78778153	78836299	Triobp	58146	+	NM_001039156	78781462	78835033	25
chr15	78825384	78841471	Gm10865	16087	-	NR_045746	78841471	78841471	3
chr15	78832652	78832714	Mir6956	62	+	NR_105921	78832714	78832714	1
chr15	78858641	78860930	H1f0	2289	+	NM_008197	78859151	78859736	1
chr15	78861303	78872961	Gcat	11658	+	NM_001161712	78861363	78872407	9
chr15	78872314	78873988	Galr3	1674	+	NM_015738	78872361	78873903	2
chr15	78883523	78893289	Ankrd54	9766	-	NM_144849	78884439	78893227	8
chr15	78905652	78924830	Eif3l	19178	+	NM_145139	78905689	78924669	13
chr15	78939412	78967331	Micall1	27919	+	NM_177461	78939713	78963551	16
chr15	78965084	78971681	1700088E04Rik	6597	-	NM_138581	78965580	78971413	7
chr15	78971754	78982204	Polr2f	10450	+	NM_027231	78971844	78982109	5
chr15	78985342	78994920	Sox10	9578	-	NM_011437	78986367	78994146	4
chr15	78996495	79046831	Gm10863	50336	+	NR_029470	79046831	79046831	5
chr15	79059602	79079896	Pick1	20294	+	NM_008837	79060242	79079422	13
chr15	79081445	79085178	Slc16a8	3733	-	NM_020516	79081557	79084237	6
chr15	79088624	79115939	Baiap2l2	27315	-	NM_177580	79089006	79115818	14
chr15	79116657	79158801	Pla2g6	42144	-	NM_001199023	79117180	79148399	17
chr15	79177050	79189506	Maff	12456	+	NM_001304830	79187427	79188285	3
chr15	79191113	79233733	Tmem184b	42620	-	NM_172608	79193073	79209085	9
chr15	79205657	79205730	Mir1943	73	-	NR_035464	79205730	79205730	1
chr15	79248281	79272487	Csnk1e	24206	-	NM_013767	79250365	79269277	11
chr15	79314143	79335671	Kcnj4	21528	-	NM_008427	79314869	79316207	2
chr15	79346837	79358169	Kdelr3	11332	+	NM_134090	79346979	79357542	5
chr15	79358125	79377171	Ddx17	19046	-	NM_001040187	79360441	79376674	13
chr15	79391927	79435539	Dmc1	43612	-	NM_010059	79392942	79432881	14
chr15	79440005	79489386	Fam227a	49381	-	NM_029407	79442938	79480190	18
chr15	79489656	79498090	Cby1	8434	+	NM_028634	79491876	79497498	5
chr15	79501297	79503292	Tomm22	1995	+	NM_172609	79501321	79502721	4
chr15	79504679	79518302	Josd1	13623	-	NM_028792	79506509	79517347	4
chr15	79521325	79551909	Gtpbp1	30584	+	NM_013818	79521336	79550529	12
chr15	79554497	79572966	Sun2	18469	-	NM_001205346	79555876	79570275	18
chr15	79573127	79587824	Gm16576	14697	+	NR_045069	79587824	79587824	4
chr15	79591878	79604897	Dnal4	13019	-	NM_017470	79592790	79595314	4
chr15	79616780	79635139	Nptxr	18359	-	NM_030689	79620121	79635013	5
chr15	79616780	79664763	Npcd	47983	-	NM_001013362	79620121	79664641	9
chr15	79654327	79664763	Cbx6	10436	-	NM_028763	79658409	79664641	5
chr15	79719961	79723568	D730005E14Rik	3607	-	NR_030675	79723568	79723568	1
chr15	79722837	79738859	Apobec3	16022	+	NM_001160415	79722946	79737799	9
chr15	79746236	79763076	Cbx7	16840	-	NM_144811	79748748	79762946	7
chr15	79826305	79845238	Pdgfb	18933	-	NM_011057	79828009	79844428	7
chr15	79829399	79829456	Mir7213	57	-	NR_106072	79829456	79829456	1
chr15	79908210	79913836	Rpl3	5626	-	NM_013762	79908279	79913756	10
chr15	79908932	79909009	Snord83b	77	-	NR_028282	79909009	79909009	1
chr15	79913288	79913336	Snord43	48	-	NR_028281	79913336	79913336	1
chr15	79921763	79949931	Syngr1	28168	+	NM_207708	79921823	79946506	4
chr15	79963583	79992132	Tab1	28549	+	NM_025609	79963585	79990711	11
chr15	80004150	80045949	Mgat3	41799	+	NM_010795	80041403	80043020	2
chr15	80064509	80083801	Mief1	19292	+	NM_178719	80077173	80080565	6
chr15	80085613	80087975	Atf4	2362	+	NM_001287180	80086728	80087890	4
chr15	80091043	80094736	Rps19bp1	3693	-	NM_175109	80091413	80094708	4
chr15	80117667	80228722	Cacna1i	111055	+	NM_001044308	80128844	80226089	37
chr15	80282669	80390900	Enthd1	108231	-	NM_001163189	80282804	80390782	6
chr15	80403026	80483284	Grap2	80258	+	NM_001289442	80454166	80479032	8
chr15	80476502	80476566	Mir6957	64	+	NR_105922	80476566	80476566	1
chr15	80502276	80530855	Fam83f	28579	+	NM_145986	80502346	80529420	5
chr15	80521454	80528040	A430088P11Rik	6586	-	NR_045309	80528040	80528040	4
chr15	80541742	80771516	Tnrc6b	229774	+	NM_144812	80590015	80759906	25
chr15	80770468	80770550	Mir5113	82	+	NR_039573	80770550	80770550	1
chr15	80778919	80801377	Adsl	22458	+	NM_009634	80778977	80799178	13
chr15	80808194	80842720	Sgsm3	34526	+	NM_134091	80833057	80842166	22
chr15	80842710	81021187	Mkl1	178477	-	NM_001082536	80843714	80875725	14
chr15	81021282	81023187	4930483J18Rik	1905	+	NR_015603	81023187	81023187	2
chr15	81065928	81069394	Mchr1	3466	+	NM_145132	81066203	81068542	2
chr15	81073083	81082292	8430426J06Rik	9209	-	NR_077230	81082292	81082292	2
chr15	81149350	81191195	Slc25a17	41845	-	NM_011399	81150058	81191160	9
chr15	81195473	81230124	St13	34651	-	NM_133726	81195879	81230024	12
chr15	81230617	81285318	Xpnpep3	54701	+	NM_177310	81230653	81281436	9
chr15	81237517	81238703	Dnajb7	1186	-	NM_021317	81237625	81238564	1
chr15	81296745	81306799	Rbx1	10054	+	NM_019712	81296802	81305528	5
chr15	81416643	81482507	Ep300	65864	+	NM_177821	81417058	81481412	31
chr15	81494318	81518745	L3mbtl2	24427	+	NM_001289711	81494430	81518444	18
chr15	81516596	81527717	Chadl	11121	-	NM_001164320	81522549	81527666	6
chr15	81534677	81560349	Rangap1	25672	-	NM_011241	81535618	81555027	17
chr15	81575277	81626699	Zc3h7b	51422	+	NM_001081016	81598430	81624195	23
chr15	81633102	81657293	Tef	24191	+	NM_153484	81633213	81654111	4
chr15	81678699	81688756	Tob2	10057	-	NM_020507	81681158	81682196	2
chr15	81694945	81702322	Phf5a	7377	-	NM_026737	81696232	81702294	4
chr15	81702892	81745567	Aco2	42675	+	NM_080633	81702942	81745192	18
chr15	81745459	81756643	Polr3h	11184	-	NM_030229	81747041	81756326	6
chr15	81767188	81781371	Csdc2	14183	+	NM_145473	81777183	81779698	4
chr15	81781535	81791360	Pmm1	9825	-	NM_013872	81781919	81791231	8
chr15	81810969	81811993	1700029P11Rik	1024	+	NM_025503	81810989	81811442	1
chr15	81822952	81846570	Desi1	23618	-	NM_134095	81825181	81846395	6
chr15	81846798	81870514	Xrcc6	23716	+	NM_010247	81847552	81870348	13
chr15	81871774	81878028	Nhp2l1	6254	-	NM_011482	81872535	81877919	3
chr15	81889580	81896968	4930407I10Rik	7388	+	NM_001166475	81889618	81896872	2
chr15	81900546	81957244	Mei1	56698	+	NM_028897	81900575	81957089	31
chr15	81958351	81972632	Ccdc134	14281	+	NM_172428	81960497	81971421	7
chr15	81977698	82035390	Srebf2	57692	+	NM_033218	81977832	82034347	19
chr15	82028551	82028620	Mir33	69	+	NR_029804	82028620	82028620	1
chr15	82037381	82043245	Shisa8	5864	-	NM_001207021	82037582	82042842	4
chr15	82052173	82054766	Tnfrsf13c	2593	-	NM_028075	82053527	82054742	3
chr15	82064205	82075177	Cenpm	10972	-	NM_025639	82064798	82075109	6
chr15	82082826	82091181	1500009C09Rik	8355	+	NR_037697	82091181	82091181	2
chr15	82105364	82124872	Sept3	19508	+	NM_011889	82109873	82121303	10
chr15	82129413	82144988	Wbp2nl	15575	+	NM_029066	82129436	82144773	6
chr15	82159961	82169256	Naga	9295	-	NM_008669	82160490	82168683	10
chr15	82171608	82176140	Fam109b	4532	+	NM_177391	82173711	82174491	2
chr15	82176475	82179492	Smdt1	3017	+	NM_026914	82176513	82178467	3
chr15	82180568	82184721	Ndufa6	4153	-	NM_025987	82180669	82184658	3
chr15	82200956	82210690	Cyp2d22	9734	-	NM_019823	82201976	82206411	10
chr15	82219583	82224452	Cyp2d11	4869	-	NM_001104531	82219583	82224377	9
chr15	82224348	82224408	Mir7684	60	-	NR_106153	82224408	82224408	1
chr15	82233275	82237624	Cyp2d10	4349	-	NM_010005	82233335	82237552	9
chr15	82282806	82287257	Cyp2d9	4451	+	NM_010006	82282881	82287196	9
chr15	82385527	82389843	Cyp2d12	4316	+	NM_201360	82385576	82389783	9
chr15	82446394	82451337	Cyp2d34	4943	-	NM_145474	82446451	82451287	9
chr15	82467179	82472475	Cyp2d13	5296	-	NR_003552	82472475	82472475	9
chr15	82519179	82520488	Cyp2d37-ps	1309	-	NR_033515	82520488	82520488	3
chr15	82590262	82594552	Cyp2d40	4290	-	NM_023623	82590335	82594540	6
chr15	82620536	82624675	Cyp2d26	4139	-	NM_029562	82620606	82624603	9
chr15	82639054	82742564	Tcf20	103510	-	NM_001114140	82644949	82687678	6
chr15	82720912	82728891	Tbrg3	7979	-	NR_027799	82728891	82728891	1
chr15	82729509	82736246	Gm20324	6737	+	NR_045068	82736246	82736246	4
chr15	82789647	82789726	Mir3080	79	-	NR_037241	82789726	82789726	1
chr15	82827165	82863827	Nfam1	36662	-	NM_001271412	82830165	82863622	6
chr15	82930634	82947101	Serhl	16467	+	NM_023475	82930773	82946809	12
chr15	82946276	82953231	Rrp7a	6955	-	NM_029101	82947315	82953164	7
chr15	82956407	82979766	Poldip3	23359	-	NM_178627	82958310	82979683	9
chr15	82980074	82980224	Rnu12	150	+	NR_004432	82980224	82980224	1
chr15	82983931	83002638	Cyb5r3	18707	-	NM_029787	82984979	83002562	9
chr15	83057151	83082204	A4galt	25053	-	NM_001004150	83057930	83059010	3
chr15	83130169	83180677	Arfgap3	50508	-	NM_025445	83131114	83180579	16
chr15	83184276	83197727	1700001L05Rik	13451	-	NR_027980	83197727	83197727	4
chr15	83206036	83295036	Pacsin2	89000	-	NM_001159509	83208047	83232356	11
chr15	83314198	83341337	Ttll1	27139	-	NM_178869	83314613	83335792	12
chr15	83357291	83375065	Bik	17774	+	NM_007546	83371729	83374655	5
chr15	83377226	83386141	Mcat	8915	-	NM_001030014	83377949	83386117	4
chr15	83394002	83404633	Tspo	10631	+	NM_009775	83401843	83404388	4
chr15	83405523	83425587	Ttll12	20064	-	NM_183017	83407326	83425540	14
chr15	83433012	83555469	Scube1	122457	-	NM_001271472	83437754	83555336	23
chr15	83610452	83688904	Mpped1	78452	+	NM_172610	83622464	83686796	7
chr15	83697141	83895779	Efcab6	198638	-	NM_029946	83697478	83884943	32
chr15	83906526	83936184	Sult4a1	29658	-	NM_013873	83907899	83936029	7
chr15	83943050	83953605	Pnpla5	10555	-	NM_029427	83943383	83953543	10
chr15	83998245	84019951	Pnpla3	21706	+	NM_054088	83998303	84016515	8
chr15	83998699	83998807	Mir6392	108	+	NR_105816	83998807	83998807	1
chr15	84022662	84044733	Samm50	22071	+	NM_178614	84022793	84044601	15
chr15	84062472	84146039	Parvb	83567	+	NM_133167	84062501	84143461	13
chr15	84155149	84173408	Parvg	18259	+	NM_022321	84157434	84171878	13
chr15	84209632	84277527	1810041L15Rik	67895	-	NM_001163145	84214821	84250633	5
chr15	84383827	84388253	Ldoc1l	4426	-	NM_177630	84386891	84387623	1
chr15	84511427	84534103	Prr5	22676	+	NM_146061	84511612	84533617	8
chr15	84545058	84550696	Gm20556	5638	-	NR_040347	84550696	84550696	3
chr15	84550481	84602637	Arhgap8	52156	+	NM_001205334	84563380	84602507	13
chr15	84615805	84686559	Phf21b	70754	-	NM_001081166	84617657	84686148	13
chr15	84753857	84773393	Nup50	19536	+	NM_016714	84757807	84770278	8
chr15	84776149	84818401	5031439G07Rik	42252	-	NM_001033273	84779667	84818231	10
chr15	84781955	84782053	Mir1249	98	-	NR_037206	84782053	84782053	1
chr15	84847570	84852990	Upk3a	5420	+	NM_023478	84847649	84852827	6
chr15	84867491	84893260	Fam118a	25769	+	NM_133750	84875218	84891981	9
chr15	84895118	84962387	Smc1b	67269	-	NM_080470	84895391	84962367	25
chr15	84962528	84974999	Ribc2	12471	+	NM_026357	84962696	84974649	7
chr15	84979683	84986562	Gm19277	6879	-	NR_040360	84986562	84986562	3
chr15	85036437	85116724	Fbln1	80287	+	NM_010180	85036563	85115609	17
chr15	85166810	85294266	Atxn10	127456	+	NM_016843	85166894	85293353	12
chr15	85323165	85333657	7530416G11Rik	10492	-	NM_001256072	85323711	85325162	5
chr15	85365866	85412251	Wnt7b	46385	-	NM_009528	85367818	85411880	4
chr15	85411571	85424138	AU022754	12567	+	NR_040433	85424138	85424138	5
chr15	85534202	85537954	Lncppara	3752	+	NR_110483	85537954	85537954	2
chr15	85537032	85537127	Mirlet7c-2	95	+	NR_029729	85537127	85537127	1
chr15	85537748	85537833	Mirlet7b	85	+	NR_029727	85537833	85537833	1
chr15	85565993	85637281	Ppara	71288	+	NM_001113418	85607989	85631688	8
chr15	85637401	85642127	Cdpf1	4726	-	NM_197998	85637833	85639754	5
chr15	85645105	85652163	Pkdrej	7058	-	NM_011105	85645782	85652163	1
chr15	85662733	85689252	Ttc38	26519	+	NM_001033337	85662828	85686994	14
chr15	85690136	85707003	Gtse1	16867	+	NM_001168672	85690500	85706662	12
chr15	85709756	85727823	Trmu	18067	+	NM_028063	85709806	85727607	11
chr15	85729187	85864207	Celsr1	135020	-	NM_009886	85731125	85864200	35
chr15	85888124	85968066	Gramd4	79942	+	NM_172611	85888157	85965884	19
chr15	85969530	86016571	Cerk	47041	-	NM_145475	85971987	86016078	13
chr15	86044888	86328933	Tbc1d22a	284045	+	NM_145476	86045004	86327371	13
chr15	87374728	87589794	Fam19a5	215066	+	NM_001252310	87374921	87587735	4
chr15	87626279	87626373	Mir6393	94	-	NR_105817	87626373	87626373	1
chr15	88145303	88203081	B230214G05Rik	57778	+	NR_045281	88203081	88203081	3
chr15	88430731	88432099	Zdhhc25	1368	+	NM_027306	88430893	88431733	1
chr15	88517464	88564649	Brd1	47185	-	NM_001033274	88518726	88561120	13
chr15	88582140	88614946	Zbed4	32806	+	NM_181412	88610160	88613667	3
chr15	88635672	88649748	Alg12	14076	-	NM_001142357	88636258	88646661	10
chr15	88650075	88657111	Creld2	7036	+	NM_029720	88650141	88656866	10
chr15	88692623	88696156	Pim3	3533	+	NM_145478	88693097	88695192	6
chr15	88744327	88784848	Ttll8	40521	-	NM_172818	88744461	88784505	12
chr15	88786313	88808983	Mlc1	22670	-	NM_133241	88787451	88808423	12
chr15	88813423	88885582	Mov10l1	72159	+	NM_031260	88816003	88885036	27
chr15	88890155	88901337	Panx2	11182	+	NM_001002005	88890503	88900307	3
chr15	88901627	88906284	1810021B22Rik	4657	-	NR_040417	88906284	88906284	4
chr15	88906493	88917505	Trabd	11012	+	NM_026485	88911444	88916363	10
chr15	88919536	88930770	Selo	11234	+	NM_027905	88919538	88930416	9
chr15	88929527	88953580	Tubgcp6	24053	-	NM_001163319	88930841	88953247	25
chr15	88953732	88959130	Hdac10	5398	-	NR_028447	88959130	88959130	20
chr15	88961013	88971133	Mapk12	10120	-	NM_013871	88961568	88970902	12
chr15	88972913	88980036	Mapk11	7123	-	NM_011161	88974167	88979943	12
chr15	88985975	89011218	Plxnb2	25243	-	NM_138749	88986710	88998444	38
chr15	88993277	88993338	Mir7118	61	-	NR_106066	88993338	88993338	1
chr15	89012642	89026905	Dennd6b	14263	-	NM_027081	89015416	89026826	21
chr15	89015894	89015967	Mir6958	73	-	NR_105923	89015967	89015967	1
chr15	89041989	89116692	Ppp6r2	74703	+	NM_026813	89083465	89116577	25
chr15	89118666	89145742	Sbf1	27076	-	NM_001170561	89119057	89145547	41
chr15	89136088	89136163	Mir6959	75	-	NR_105924	89136163	89136163	1
chr15	89153150	89155161	Adm2	2011	+	NM_182928	89153718	89154742	3
chr15	89164903	89167438	Miox	2535	+	NM_019977	89164933	89167279	10
chr15	89181434	89186090	Lmf2	4656	-	NM_178919	89182021	89185880	14
chr15	89186149	89203281	Ncaph2	17132	+	NM_001115132	89186266	89201882	20
chr15	89202067	89204249	Sco2	2182	-	NM_001111288	89202112	89202880	3
chr15	89202361	89207468	Tymp	5107	-	NM_138302	89203875	89207179	11
chr15	89207879	89209685	Odf3b	1806	-	NM_001013022	89208126	89209609	5
chr15	89217321	89219139	Klhdc7b	1818	+	NM_001160178	89217321	89219139	1
chr15	89220604	89240934	Syce3	20330	-	NM_001162880	89220712	89227865	3
chr15	89246835	89256293	Cpt1b	9458	-	NM_009948	89247326	89255759	19
chr15	89246835	89260358	ChkbCpt1b	13523	-	NR_004843	89260358	89260358	27
chr15	89256779	89260358	Chkb	3579	-	NR_037154	89260358	89260358	11
chr15	89284341	89292878	Mapk8ip2	8537	+	NM_021921	89284651	89292142	12
chr15	89302906	89307855	Arsa	4949	-	NM_009713	89303668	89306153	9
chr15	89306682	89315281	C230037L18Rik	8599	+	NR_077233	89315281	89315281	5
chr15	89330287	89390691	Shank3	60404	+	NM_021423	89330287	89388754	22
chr15	89398756	89405016	Acr	6260	+	NM_001205049	89398792	89404360	5
chr15	89412957	89422354	Rabl2	9397	-	NM_026817	89413780	89420810	9
chr15	89612823	89672291	Syt10	59468	-	NM_018803	89613005	89672200	7
chr15	90054741	90060985	Alg10b	6244	+	NM_001033441	90054868	90058810	3
chr15	90054790	90054843	Mir7648	53	+	NR_106106	90054843	90054843	1
chr15	90317911	90509819	Cpne8	191908	-	NM_025815	90319417	90509735	20
chr15	90721826	90728907	Spn-ps	7081	-	NR_033583	90728907	90728907	3
chr15	90763705	90880382	Kif21a	116677	-	NM_001109040	90764880	90880133	37
chr15	90976301	91022238	Abcd2	45937	-	NM_011994	90979416	91022039	10
chr15	91098121	91403692	Slc2a13	305571	-	NM_001033633	91102584	91403528	10
chr15	91503654	91646555	Lrrk2	142901	+	NM_025730	91503711	91645966	51
chr15	91668756	91764986	Muc19	96230	+	NM_207243	91668799	91764809	44
chr15	91668758	91691866	Smgc	23108	+	NM_198927	91668799	91691132	18
chr15	91881595	92172398	Cntn1	290803	+	NM_001159648	92046817	92170020	24
chr15	92227240	92602250	Pdzrn4	375010	+	NM_001164593	92227345	92601444	10
chr15	93070172	93105515	Gxylt1	35343	-	NM_001033275	93076057	93105512	8
chr15	93114263	93167366	Yaf2	53103	-	NR_028315	93167366	93167366	5
chr15	93216543	93228721	Zcrb1	12178	-	NM_026025	93216585	93227684	8
chr15	93228780	93322343	Pphln1	93563	+	NM_146062	93241142	93319599	10
chr15	93329544	93426322	Prickle1	96778	-	NM_001033217	93330877	93343012	8
chr15	93735286	93757542	9430014N10Rik	22256	-	NR_045737	93757542	93757542	4
chr15	94077632	94086037	D630010B17Rik	8405	+	NR_045629	94086037	94086037	4
chr15	94100593	94234781	Adamts20	134188	-	NM_177431	94100730	94234520	39
chr15	94353070	94373938	Pus7l	20868	-	NM_172437	94353749	94371393	9
chr15	94374090	94398747	Irak4	24657	+	NM_029926	94378273	94397477	12
chr15	94408378	94420255	Twf1	11877	-	NM_008971	94410250	94420207	9
chr15	94459615	94926528	Tmem117	466913	+	NM_178789	94468517	94925436	8
chr15	94928052	94979749	LOC100043315	51697	-	NR_015482	94979749	94979749	3
chr15	95049870	95358683	Nell2	308813	-	NM_001289653	95050534	95358295	21
chr15	95453993	95485202	Dbx2	31209	-	NM_207533	95455121	95485193	4
chr15	95577677	95582022	Gm6961	4345	-	NR_131148	95582022	95582022	3
chr15	95621273	95805903	Ano6	184630	+	NM_001253813	95621414	95803132	21
chr15	95882048	95909984	D030018L15Rik	27936	-	NR_126493	95909984	95909984	4
chr15	96013230	96033901	Gm4371	20671	+	NR_028311	96033901	96033901	2
chr15	96020904	96028405	2610037D02Rik	7501	-	NR_040423	96028405	96028405	6
chr15	96062300	96085115	4833422M21Rik	22815	-	NR_130160	96085115	96085115	3
chr15	96098994	96105706	E330033B04Rik	6712	-	NR_030690	96105706	96105706	1
chr15	96117952	96235894	Arid2	117942	+	NM_175251	96118125	96232525	21
chr15	96242128	96291274	Scaf11	49146	-	NM_028148	96245218	96277001	15
chr15	96401848	96473344	Slc38a1	71496	-	NM_001166458	96407141	96454508	16
chr15	96517822	96530129	Slc38a2	12307	-	NM_175121	96520557	96529161	16
chr15	96825253	96886387	Slc38a4	61134	-	NM_027052	96827420	96850273	16
chr15	97074504	97077718	Amigo2	3214	-	NM_001164602	97075410	97076970	2
chr15	97077537	97216122	Pced1b	138585	+	NM_172293	97214512	97215814	6
chr15	97505535	97536253	Rpap3	30718	-	NM_028003	97505724	97533785	17
chr15	97541449	97561836	Endou	20387	-	NM_001168693	97542479	97561700	10
chr15	97575200	97598097	Rapgef3	22897	-	NM_001177810	97575978	97597831	28
chr15	97614795	97623123	Slc48a1	8328	+	NM_026353	97614911	97621154	3
chr15	97623094	97674933	Hdac7	51839	-	NM_001204275	97624127	97642012	25
chr15	97684857	97738727	Vdr	53870	-	NM_009504	97687802	97715370	10
chr15	97794659	97800717	Tmem106c	6058	+	NM_201359	97795280	97800150	8
chr15	97806032	97835155	Col2a1	29123	-	NM_031163	97806470	97834924	54
chr15	97869174	97924000	Senp1	54826	-	NM_144851	97873320	97917520	18
chr15	97923019	97962878	Pfkm	39859	+	NM_001163488	97942592	97962490	23
chr15	97965070	97996009	Asb8	30939	-	NM_001170711	97966236	97973210	4
chr15	97998236	98000565	Ccdc184	2329	+	NM_177716	97998746	97999322	1
chr15	98016443	98025973	Olfr288	9530	-	NM_001011733	98017269	98019569	3
chr15	98037401	98051487	Olfr287	14086	-	NM_001011780	98037844	98040439	3
chr15	98057105	98064881	Olfr286	7776	-	NM_001011779	98057105	98059613	4
chr15	98086412	98087738	H1fnt	1326	-	NM_027304	98086500	98087697	1
chr15	98116552	98126514	Zfp641	9962	-	NM_173769	98118902	98124234	6
chr15	98143019	98143979	Olfr257	960	-	NM_207554	98143019	98143979	1
chr15	98143019	98143979	Olfr285	960	-	NM_001011778	98143019	98143979	1
chr15	98170452	98171370	Olfr284	918	-	NM_146281	98170452	98171370	1
chr15	98208609	98209539	Olfr283	930	-	NM_147036	98208609	98209539	1
chr15	98228875	98246566	1700031M16Rik	17691	+	NR_015496	98246566	98246566	11
chr15	98267900	98268828	Olfr282	928	+	NM_146457	98267901	98268828	1
chr15	98286742	98287678	Olfr281	936	+	NM_146280	98286742	98287678	1
chr15	98310830	98313114	Lalba	2284	-	NM_010679	98311119	98313102	4
chr15	98327904	98328837	Olfr279	933	+	NM_001001807	98327904	98328837	1
chr15	98348088	98364700	Kansl2	16612	-	NM_001289438	98349852	98361896	10
chr15	98350147	98350265	Snora34	118	-	NR_034051	98350265	98350265	1
chr15	98350192	98350309	Mir1291	117	-	NR_106171	98350309	98350309	1
chr15	98356778	98356890	Snora2b	112	-	NR_034052	98356890	98356890	1
chr15	98373641	98398067	Ccnt1	24426	-	NM_009833	98373641	98398067	9
chr15	98397754	98401295	9330020H09Rik	3541	+	NR_028442	98401295	98401295	2
chr15	98401434	98420019	4930415O20Rik	18585	+	NM_001201322	98401476	98419891	4
chr15	98420420	98438064	Adcy6	17644	-	NM_007405	98422780	98435162	22
chr15	98462758	98474967	Cacnb3	12209	+	NM_001044741	98462909	98474002	13
chr15	98475937	98493320	Ddx23	17383	-	NM_001080981	98476224	98488866	17
chr15	98499635	98507892	Rnd1	8257	-	NM_172612	98501027	98507780	5
chr15	98538657	98553764	Ccdc65	15107	+	NM_153518	98538826	98553538	8
chr15	98554798	98558629	Fkbp11	3831	-	NM_024169	98554815	98558516	6
chr15	98568056	98593549	Arf3	25493	-	NM_007478	98570763	98573171	5
chr15	98602182	98608581	Wnt10b	6399	-	NM_011718	98602906	98607394	5
chr15	98620287	98624261	Wnt1	3974	+	NM_021279	98620619	98623335	4
chr15	98634212	98638356	Ddn	4144	-	NM_001013741	98635707	98638244	2
chr15	98643227	98661939	Prkag1	18712	-	NM_016781	98643803	98661869	12
chr15	98662099	98701636	Kmt2d	39537	-	NM_001033276	98664930	98697151	55
chr15	98708190	98711845	Rhebl1	3655	-	NM_026967	98708635	98711632	8
chr15	98723457	98728971	Dhh	5514	-	NM_007857	98724365	98728703	3
chr15	98734351	98748529	Lmbr1l	14178	-	NM_029098	98734871	98748352	17
chr15	98761861	98764821	Tuba1b	2960	-	NM_011654	98762012	98764766	4
chr15	98780277	98783932	Tuba1a	3655	-	NM_011653	98780464	98783884	4
chr15	98816395	98819712	4930578M01Rik	3317	+	NR_045991	98819712	98819712	4
chr15	98860321	98868536	Tuba1c	8215	+	NM_009448	98860852	98868440	4
chr15	98885604	98889409	Prph	3805	+	NM_001163589	98885637	98889101	9
chr15	98905403	98913840	Troap	8437	+	NM_030159	98905785	98913706	14
chr15	98911235	98911296	Mir6960	61	+	NR_105925	98911296	98911296	1
chr15	98915184	98918159	C1ql4	2975	-	NM_001024702	98915184	98918159	2
chr15	98929914	98935138	Dnajc22	5224	+	NM_176835	98931366	98934926	3
chr15	98957275	99042897	Spats2	85622	+	NM_139140	98980336	99042792	13
chr15	99055406	99073248	Kcnh3	17842	+	NM_010601	99055406	99072953	15
chr15	99073247	99082392	Mcrs1	9145	-	NM_016766	99073564	99080903	15
chr15	99082218	99092472	1700120C14Rik	10254	+	NR_045627	99092472	99092472	3
chr15	99101448	99117611	Fam186b	16163	-	NM_001081254	99101663	99117471	8
chr15	99125839	99147438	Prpf40b	21599	+	NM_018786	99133776	99146984	26
chr15	99147642	99200913	Fmnl3	53271	-	NM_011711	99149356	99200733	27
chr15	99223377	99240480	Tmbim6	17103	+	NM_001171036	99232038	99238929	11
chr15	99252464	99288179	Nckap5l	35715	-	NM_001001884	99253129	99264581	13
chr15	99300514	99305161	Bcdin3d	4647	-	NM_029236	99300889	99305123	2
chr15	99327435	99358596	Faim2	31161	-	NM_028224	99330578	99358025	12
chr15	99409486	99414976	Aqp2	5490	+	NM_009699	99409583	99414473	4
chr15	99421458	99425260	Aqp5	3802	+	NM_009701	99421702	99424751	4
chr15	99431830	99435908	Aqp6	4078	+	NM_175087	99431838	99434738	5
chr15	99450927	99482087	Racgap1	31160	-	NM_012025	99451819	99473398	18
chr15	99501148	99531559	Asic1	30411	+	NM_009597	99502230	99529569	12
chr15	99532717	99544426	Smarcd1	11709	+	NM_031842	99532752	99542856	13
chr15	99548023	99555438	Gpd1	7415	+	NM_010271	99548038	99553718	8
chr15	99556048	99558567	Cox14	2519	+	NM_183256	99558083	99558257	2
chr15	99566022	99602946	Cers5	36924	-	NM_028015	99566651	99602810	10
chr15	99608898	99705887	Lima1	96989	-	NM_001113545	99610727	99674224	11
chr15	99748778	99762089	1700030F18Rik	13311	-	NM_028180	99748881	99760373	4
chr15	99800495	99846789	Larp4	46294	+	NM_001284522	99800697	99842605	16
chr15	99802597	99803718	2310068J16Rik	1121	-	NR_028124	99803718	99803718	1
chr15	99869094	100049904	Dip2b	180810	+	NM_001159361	99869240	100045861	38
chr15	100058289	100091679	Atf1	33390	+	NM_007497	100063169	100090390	7
chr15	100111267	100123484	Tmprss12	12217	+	NM_183109	100111313	100123192	5
chr15	100135247	100144779	Mettl7a1	9532	+	NM_027334	100135277	100143661	2
chr15	100165359	100170600	Mettl7a3	5241	+	NM_001081471	100165360	100169890	2
chr15	100183630	100192250	Mettl7a2	8620	+	NM_199477	100183640	100191216	2
chr15	100183630	100214866	Methig1	31236	+	NM_001024672	100183640	100214222	4
chr15	100195015	100214386	Higd1c	19371	+	NM_001002900	100195700	100214222	4
chr15	100218330	100253486	Slc11a2	35156	-	NM_008732	100219514	100242655	17
chr15	100253623	100258581	Gm5475	4958	+	NR_040351	100258581	100258581	3
chr15	100299464	100309683	Letmd1	10219	+	NM_134093	100299554	100308277	9
chr15	100310000	100325670	Csrnp2	15670	-	NM_153407	100312234	100320016	5
chr15	100333178	100382439	Tfcp2	49261	-	NM_001289603	100334836	100381877	16
chr15	100405748	100430415	Pou6f1	24667	-	NM_001304965	100408703	100424451	11
chr15	100444570	100445541	C330013E15Rik	971	-	NR_045701	100445541	100445541	2
chr15	100446092	100451192	Dazap2	5100	+	NM_011873	100446142	100449927	4
chr15	100451770	100467371	Smagp	15601	-	NM_001033872	100452278	100466651	4
chr15	100471512	100499931	Bin2	28419	-	NM_001270537	100471965	100499924	11
chr15	100479593	100479660	Mir6961	67	-	NR_105926	100479660	100479660	1
chr15	100504852	100518351	Cela1	13499	-	NM_033612	100505130	100518324	8
chr15	100520345	100559807	Galnt6	39462	-	NM_001161767	100523783	100546849	12
chr15	100560935	100563168	I730030J21Rik	2233	-	NR_045781	100563168	100563168	4
chr15	100592177	100654402	Slc4a8	62225	+	NM_021530	100592360	100646062	25
chr15	100701075	100876369	Scn8a	175294	+	NM_001077499	100766755	100871119	27
chr15	100880622	100884830	Fignl2	4208	-	NM_001214911	100882895	100884830	1
chr15	100946185	100950455	Ankrd33	4270	+	NM_144790	100946312	100950152	4
chr15	100958952	100975767	Acvrl1	16815	+	NM_001277255	100964618	100973908	12
chr15	101004555	101043032	Acvr1b	38477	+	NM_007395	101004575	101041293	9
chr15	101024299	101024362	Mir6962	63	+	NR_105927	101024362	101024362	1
chr15	101051621	101055617	A330009N23Rik	3996	-	NR_045328	101055617	101055617	3
chr15	101051677	101052586	AU021063	909	+	NR_045996	101052586	101052586	3
chr15	101054637	101063187	Grasp	8550	+	NM_019518	101054732	101062447	8
chr15	101097276	101105225	Nr4a1	7949	+	NM_010444	101100515	101104683	7
chr15	101114731	101121365	Atg101	6634	+	NM_026566	101117429	101121103	3
chr15	101123642	101127857	6030408B16Rik	4215	+	NR_033803	101127857	101127857	2
chr15	101180001	101200556	Krt80	20555	-	NM_028770	101180345	101200485	9
chr15	101199782	101199865	Mir1941	83	+	NR_035462	101199865	101199865	1
chr15	101242833	101258237	Krt7	15404	+	NM_033073	101242904	101258096	9
chr15	101261920	101269235	Krt83	7315	-	NM_001003668	101262224	101269201	9
chr15	101278175	101284340	1700011A15Rik	6165	+	NM_025487	101278282	101284060	5
chr15	101289491	101294196	Krt81	4705	-	NM_001166157	101289834	101294128	9
chr15	101303908	101310414	Krt86	6506	+	NM_010667	101303981	101309988	9
chr15	101315560	101321943	5430421N21Rik	6383	-	NM_001201323	101315814	101321880	9
chr15	101334246	101336744	Gm6042	2498	+	NR_002872	101336744	101336744	2
chr15	101346118	101521940	Krt85	175822	-	NM_016879	101347109	101521940	4
chr15	101355456	101363251	Krt84	7795	-	NM_008474	101356149	101363186	9
chr15	101371655	101381090	Krt82	9435	-	NM_053249	101372139	101381034	9
chr15	101382786	101393381	4732456N10Rik	10595	-	NM_177717	101383578	101393256	9
chr15	101393773	101404335	Krt75	10562	-	NM_133357	101395312	101404262	9
chr15	101417747	101419003	Gm5476	1256	-	NR_002868	101419003	101419003	2
chr15	101439304	101440910	Gm5477	1606	+	NR_002869	101440910	101440910	4
chr15	101454458	101458619	Gm5414	4161	-	NM_001003670	101454458	101458619	9
chr15	101473450	101477811	Gm5478	4361	-	NR_003960	101477811	101477811	7
chr15	101506453	101510720	Krt6b	4267	-	NM_010669	101506959	101510654	9
chr15	101520358	101524736	Krt6a	4378	-	NM_008476	101520897	101524679	9
chr15	101537500	101543322	Krt5	5822	-	NM_027011	101537866	101543241	9
chr15	101564379	101573528	Krt71	9149	-	NM_019956	101564927	101573477	9
chr15	101584689	101593935	Krt74	9246	-	NR_033444	101593935	101593935	9
chr15	101606990	101616889	Krt72	9899	-	NM_213728	101606990	101616889	9
chr15	101623738	101632763	Krt73	9025	-	NM_212485	101624237	101632728	9
chr15	101641119	101648600	Krt2	7481	-	NM_010668	101641540	101648532	9
chr15	101675856	101681217	Krt1	5361	-	NM_008473	101676330	101681158	9
chr15	101690286	101700049	Krt77	9763	-	NM_001003667	101690286	101700049	9
chr15	101714781	101723351	Krt76	8570	-	NM_001033177	101715247	101723290	9
chr15	101748965	101755166	Krt4	6201	-	NM_008475	101749455	101755101	9
chr15	101759762	101770755	Krt79	10993	-	NM_146063	101760153	101770645	9
chr15	101776434	101784718	Krt78	8284	-	NM_212487	101776598	101784655	9
chr15	101827141	101834773	Krt8	7632	-	NM_031170	101827370	101834670	9
chr15	101858646	101862457	Krt18	3811	+	NM_010664	101858709	101862392	7
chr15	101904203	101927604	Eif4b	23401	+	NM_145625	101904381	101925764	15
chr15	101933418	101946832	Tns2	13414	+	NM_153533	101933517	101946427	29
chr15	101946958	101966646	Spryd3	19688	-	NM_001033277	101948009	101966589	11
chr15	101974616	101979943	Igfbp6	5327	+	NM_008344	101974978	101979733	4
chr15	101981005	101993867	Soat2	12862	+	NM_146064	101981064	101993378	15
chr15	102007428	102019474	Csad	12046	-	NM_144942	102008043	102019099	15
chr15	102034075	102046041	Zfp740	11966	+	NM_001289691	102038267	102043116	8
chr15	102046425	102062366	Itgb7	15941	-	NM_013566	102046590	102058029	15
chr15	102065368	102087953	Rarg	22585	-	NM_011244	102066454	102083033	10
chr15	102109886	102112175	Mfsd5	2289	+	NM_134100	102110625	102111978	2
chr15	102126723	102154787	Espl1	28064	+	NM_001014976	102127199	102154646	31
chr15	102156546	102161920	Pfdn5	5374	+	NM_027044	102156619	102161780	6
chr15	102162139	102168569	Myg1	6430	+	NM_021713	102162171	102168265	7
chr15	102168677	102181190	Aaas	12513	-	NM_153416	102168711	102181049	16
chr15	102187607	102196702	Sp7	9095	-	NM_130458	102188567	102196665	2
chr15	102236746	102266835	Sp1	30089	+	NM_013672	102236846	102261463	6
chr15	102275797	102285070	Amhr2	9273	+	NM_144547	102275904	102284937	11
chr15	102289600	102293237	Prr13	3637	+	NM_025385	102290558	102292646	5
chr15	102301062	102330490	Pcbp2	29428	+	NM_001103165	102303764	102328956	15
chr15	102328077	102347435	Map3k12	19358	-	NM_001163643	102330511	102335965	16
chr15	102348622	102354107	Tarbp2	5485	+	NM_009319	102348980	102353773	9
chr15	102354269	102355052	Npff	783	-	NM_018787	102354357	102355039	3
chr15	102356376	102455895	Atf7	99519	-	NM_001310070	102356502	102424150	12
chr15	102493298	102501478	Atp5g2	8180	-	NM_026468	102493444	102498180	5
chr15	102502222	102502297	Mir688	75	-	NR_030460	102502297	102502297	1
chr15	102537207	102552609	Calcoco1	15402	-	NM_026192	102537799	102550128	15
chr15	102576871	102577340	Gm38436	469	-	NR_104334	102577340	102577340	1
chr15	102751561	102759245	Hoxc13	7684	+	NM_010464	102751618	102757856	2
chr15	102767283	102768948	Hoxc12	1665	+	NM_010463	102767283	102768948	2
chr15	102774492	102778377	Hotair	3885	-	NR_047528	102778377	102778377	2
chr15	102784956	102787132	Hoxc11	2176	+	NM_001024842	102784956	102787132	2
chr15	102797226	102802328	Hoxc10	5102	+	NM_010462	102797288	102801506	2
chr15	102803780	102803865	Mir196a-2	85	+	NR_029722	102803865	102803865	1
chr15	102807462	102814875	Hoxc9	7413	+	NM_008272	102812083	102814570	3
chr15	102820969	102824685	Hoxc8	3716	+	NM_010466	102821210	102823286	2
chr15	102839992	102842312	Hoxc6	2320	+	NM_010465	102840036	102841472	2
chr15	102844438	102847860	Hoxc5	3422	+	NM_175730	102844512	102845873	2
chr15	102845340	102845432	Mir615	92	+	NR_030526	102845432	102845432	1
chr15	102864825	102867283	Hoxc4	2458	+	NM_013553	102865153	102866423	2
chr15	102953500	102977259	D930007P13Rik	23759	-	NR_045743	102977259	102977259	7
chr15	102983720	102993715	Smug1	9995	-	NM_027885	102986083	102988338	6
chr15	103021976	103070247	Cbx5	48271	-	NM_001076789	103030071	103043639	5
chr15	103070827	103077129	Hnrnpa1	6302	+	NR_104427	103077129	103077129	11
chr15	103070862	103075015	Gm10052	4153	+	NR_002885	103075015	103075015	10
chr15	103070884	103075386	Gm5643	4502	+	NR_002883	103075386	103075386	10
chr15	103078642	103088834	Nfe2	10192	-	NM_001302341	103078871	103081473	3
chr15	103103348	103130295	Copz1	26947	+	NM_019817	103103354	103129171	9
chr15	103115555	103115652	Mir148b	97	+	NR_029766	103115652	103115652	1
chr15	103138665	103140869	Gpr84	2204	-	NM_030720	103138888	103140079	2
chr15	103144325	103170517	Zfp385a	26192	-	NM_013866	103145425	103170487	8
chr15	103174717	103197222	Itga5	22505	-	NM_001314041	103175699	103184530	31
chr15	103180885	103180956	Mir6963	71	-	NR_105928	103180956	103180956	1
chr15	103232889	103260858	Gtsf1	27969	-	NM_028797	103235256	103258786	9
chr15	103269390	103278890	BC048502	9500	-	NM_177631	103269529	103275368	7
chr15	103284255	103329231	Nckap1l	44976	+	NM_153505	103284310	103327974	31
chr15	103333464	103360487	Pde1b	27023	+	NM_008800	103333904	103358756	16
chr15	103360709	103368423	Ppp1r1a	7714	-	NM_021391	103361374	103368309	7
chr15	103393190	103395512	Glycam1	2322	-	NM_001289587	103393421	103395462	4
chr16	3592397	3593339	Olfr161	942	+	NM_146860	3592397	3593339	1
chr16	3707214	3718124	Mefv	10910	-	NM_019453	3707974	3718062	10
chr16	3744098	3750788	Zfp263	6690	+	NM_148924	3744374	3749865	6
chr16	3838974	3839913	Olfr15	939	+	NM_008762	3838974	3839913	1
chr16	3847222	3858880	Zfp174	11658	+	NM_001081217	3847872	3854812	3
chr16	3861543	3872374	Zfp597	10831	-	NM_001033159	3865630	3872091	3
chr16	3884618	3904781	Naa60	20163	+	NM_029090	3894374	3901939	7
chr16	3905797	3908689	1700037C18Rik	2892	-	NM_028484	3906142	3908453	3
chr16	3909008	3941147	Cluap1	32139	+	NM_029738	3909131	3940917	12
chr16	3946932	3976632	Nlrc3	29700	-	NM_001081280	3947448	3976377	18
chr16	3979105	4001678	Slx4	22573	-	NM_177472	3979820	4001370	15
chr16	4037144	4040024	Dnase1	2880	+	NM_010061	4037550	4039865	9
chr16	4039976	4077810	Trap1	37834	-	NM_026508	4040122	4077780	18
chr16	4084047	4213404	Crebbp	129357	-	NM_001025432	4084047	4213223	31
chr16	4219911	4229116	4930455F16Rik	9205	-	NR_040570	4229116	4229116	4
chr16	4229228	4231205	Gm5766	1977	+	NR_003628	4231205	4231205	1
chr16	4284885	4420498	Adcy9	135613	-	NM_001291910	4287897	4418834	12
chr16	4480227	4523053	Srl	42826	-	NM_175347	4482472	4523053	7
chr16	4544660	4559720	Tfap4	15060	-	NM_031182	4545552	4559516	7
chr16	4594712	4615957	Glis2	21245	+	NM_031184	4608646	4614176	7
chr16	4616465	4624946	Pam16	8481	-	NM_025571	4616546	4624853	5
chr16	4626883	4679720	Coro7	52837	-	NM_030205	4627493	4679611	28
chr16	4639944	4651166	Vasn	11222	+	NM_139307	4648190	4650212	2
chr16	4684069	4707693	Dnaja3	23624	+	NM_023646	4684133	4705947	12
chr16	4711317	4719356	Nmral1	8039	-	NM_026393	4711423	4718934	6
chr16	4726360	4766249	Hmox2	39889	+	NM_001136066	4762594	4766105	6
chr16	4765460	4789935	Cdip1	24475	-	NM_025670	4768537	4770127	6
chr16	4835415	4867691	4930562C15Rik	32276	+	NM_030192	4835588	4867473	16
chr16	4874778	4879851	Ubald1	5073	-	NM_145359	4875518	4879736	3
chr16	4886099	4938296	Mgrn1	52197	+	NM_029657	4886385	4934235	17
chr16	4935163	4939585	Gm16861	4422	-	NR_037666	4939585	4939585	3
chr16	4939110	4941033	Nudt16l1	1923	+	NM_001316715	4939140	4939680	3
chr16	4941419	4964330	Anks3	22911	-	NM_028301	4941915	4960659	17
chr16	4964381	4979055	4930451G09Rik	14674	+	NR_073370	4979055	4979055	9
chr16	4986950	4997945	Sept12	10995	-	NM_027669	4988434	4996696	8
chr16	5007380	5008401	Smim22	1021	+	NM_001253803	5007845	5008340	4
chr16	5008821	5013646	Rogdi	4825	-	NM_133185	5009303	5013600	11
chr16	5013994	5050003	Glyr1	36009	-	NM_001079814	5015620	5049936	16
chr16	5050160	5086378	Ubn1	36218	+	NM_026666	5055208	5084198	19
chr16	5086383	5132574	Ppl	46191	-	NM_008909	5087257	5132436	22
chr16	5147201	5184027	Sec14l5	36826	+	NM_001127725	5147878	5183843	16
chr16	5195372	5204105	Nagpa	8733	-	NM_013796	5195940	5204075	10
chr16	5211911	5222392	AU021092	10481	-	NM_001033220	5212084	5222351	8
chr16	5233713	5245001	Alg1	11288	+	NM_145362	5233742	5244719	13
chr16	5244247	5256049	Eef2kmt	11802	-	NM_027446	5245359	5256029	8
chr16	5884885	7412573	Rbfox1	1527688	+	NM_021477	6809314	7409906	17
chr16	5975679	5998589	1700123O21Rik	22910	+	NR_045799	5998589	5998589	4
chr16	8409368	8425229	Tmem114	15861	-	NM_029070	8409621	8424745	4
chr16	8470905	8490290	Mettl22	19385	+	NM_146247	8473941	8490230	11
chr16	8513521	8621660	Abat	108139	+	NM_172961	8572973	8618719	16
chr16	8633823	8637794	Tmem186	3971	-	NM_025708	8635837	8637581	2
chr16	8637799	8657617	Pmm2	19818	+	NM_016881	8637867	8655745	9
chr16	8658679	8672246	Carhsp1	13567	-	NM_025821	8661033	8664508	4
chr16	8688814	8738435	Usp7	49621	-	NM_001003918	8690872	8738378	31
chr16	8830192	8859017	1810013L24Rik	28825	+	NM_001081400	8830552	8856131	4
chr16	9577802	9992626	Grin2a	414824	-	NM_008170	9577919	9992626	12
chr16	10170320	10175004	Rpl39l	4684	+	NM_026594	10174402	10174558	3
chr16	10192998	10243144	Atf7ip2	50146	+	NM_153123	10201402	10242049	11
chr16	10281841	10314061	Emp2	32220	-	NM_007929	10284520	10292432	5
chr16	10324197	10331378	Gm1600	7181	-	NR_126064	10331378	10331378	3
chr16	10358044	10395558	Tekt5	37514	-	NM_001291001	10358098	10395512	7
chr16	10412030	10424518	Nubp1	12488	+	NM_011955	10412069	10423392	11
chr16	10420651	10447443	Tvp23a	26792	-	NM_001013778	10424291	10447138	7
chr16	10480164	10527733	Ciita	47569	+	NM_001302619	10501879	10525335	20
chr16	10530299	10543147	Dexi	12848	-	NM_021428	10542495	10542783	2
chr16	10545431	10744971	Clec16a	199540	+	NM_001204229	10545655	10742062	23
chr16	10783901	10785629	Socs1	1728	-	NM_009896	10784325	10784964	2
chr16	10788027	10788748	Tnp2	721	-	NM_013694	10788169	10788694	2
chr16	10790600	10791007	Prm3	407	-	NM_013638	10790676	10790982	1
chr16	10791469	10792198	Prm2	729	-	NM_008933	10791662	10792091	2
chr16	10796424	10796916	Prm1	492	-	NM_013637	10796576	10796824	2
chr16	10835151	10843328	Rmi2	8177	+	NM_001162932	10835182	10840070	2
chr16	10912104	10914890	Gm21859	2786	-	NR_131135	10914890	10914890	4
chr16	10959365	10993214	Litaf	33849	-	NM_019980	10961035	10966737	4
chr16	11008990	11015277	Gm4262	6287	+	NR_040518	11015277	11015277	3
chr16	11066390	11075078	Snn	8688	+	NM_009223	11072411	11072678	2
chr16	11075003	11134625	Txndc11	59622	-	NM_029582	11075110	11134602	12
chr16	11136686	11176486	Zc3h7a	39800	-	NM_145931	11137388	11164752	23
chr16	11193129	11203385	Rsl1d1	10256	-	NM_025546	11193572	11203348	9
chr16	11203475	11225889	2610020C07Rik	22414	+	NR_038156	11225889	11225889	3
chr16	11216333	11254418	Gspt1	38085	-	NM_146066	11220919	11254090	15
chr16	11254460	11254538	Mir1945	78	-	NR_035466	11254538	11254538	1
chr16	11313901	11320161	Tnfrsf17	6260	+	NM_011608	11314045	11320051	3
chr16	11322996	11755566	Snx29	432570	+	NM_028964	11323064	11755419	21
chr16	11779794	11781594	4833415N18Rik	1800	+	NR_126430	11781594	11781594	2
chr16	11803813	11909516	Cpped1	105703	-	NM_146067	11805449	11909428	4
chr16	11901456	11930687	Gm9961	29231	+	NR_033509	11930687	11930687	3
chr16	11984205	12270997	Shisa9	286792	+	NM_028277	11984673	12267896	5
chr16	12811482	12848746	1700003L19Rik	37264	+	NR_040507	12848746	12848746	5
chr16	13109828	13152102	Ercc4	42274	+	NM_015769	13110027	13148352	11
chr16	13256573	13417622	Mkl2	161049	+	NM_001122667	13326510	13412788	17
chr16	13449615	13449694	Mir193b	79	+	NR_030549	13449694	13449694	1
chr16	13453932	13454019	Mir365-1	87	+	NR_029855	13454019	13454019	1
chr16	13471172	13471273	Mir6365	101	-	NR_105784	13471273	13471273	1
chr16	13514223	13520512	2310015D24Rik	6289	-	NR_037997	13520512	13520512	4
chr16	13538056	13668263	Parn	130207	-	NM_028761	13538942	13668122	24
chr16	13671950	13703705	Bfar	31755	+	NM_025976	13685228	13702350	8
chr16	13672112	13678478	3110001I22Rik	6366	+	NM_025653	13677131	13678070	2
chr16	13715149	13730577	Pla2g10	15428	-	NR_110990	13730577	13730577	5
chr16	13729928	13739564	Pla2g10os	9636	+	NR_040574	13739564	13739564	3
chr16	13780791	13814934	Rrn3	34143	+	NM_001039521	13780849	13813365	18
chr16	13819369	13835543	Ntan1	16174	+	NM_010946	13819448	13835407	10
chr16	13833665	13903238	Pdxdc1	69573	-	NM_001291017	13834906	13903028	24
chr16	13903253	13949712	Mpv17l	46459	+	NM_001289562	13903357	13947018	4
chr16	13981794	13986960	Ifitm7	5166	-	NM_001270718	13982063	13983902	3
chr16	13986729	14101587	2900011O08Rik	114858	+	NM_144518	13986883	14099998	6
chr16	14109258	14159367	Marf1	50109	-	NM_001081154	14111622	14154065	27
chr16	14159718	14159785	Mir484	67	+	NR_030252	14159785	14159785	1
chr16	14163367	14193016	Nde1	29649	+	NM_001285503	14169585	14191695	9
chr16	14194619	14291501	Myh11	96882	-	NM_013607	14198150	14277989	42
chr16	14299336	14317425	Fopnl	18089	-	NM_025345	14300222	14317414	5
chr16	14361650	14474971	Abcc1	113321	+	NM_008576	14361688	14473661	31
chr16	14562409	14621377	A630010A05Rik	58968	+	NR_033556	14621377	14621377	8
chr16	14705951	14709475	Snai2	3524	+	NM_011415	14706066	14708389	3
chr16	14906738	14924615	Efcab1	17877	+	NM_025769	14906847	14924235	6
chr16	15551078	15594611	Ube2v2	43533	-	NM_023585	15556489	15594568	4
chr16	15623989	15637493	Mcm4	13504	-	NM_008565	15624769	15637273	16
chr16	15637958	15842332	Prkdc	204374	+	NM_011159	15637981	15842068	86
chr16	15848533	15863415	Mzt2	14882	-	NM_029354	15848664	15863016	3
chr16	15887378	15889638	Cebpd	2260	+	NM_007679	15887417	15888224	1
chr16	15889317	16146944	Spidr	257627	-	NM_146068	15889722	16146870	20
chr16	16213437	16272805	Pkp2	59368	+	NM_026163	16213465	16272330	13
chr16	16303057	16309733	Yars2	6676	+	NR_038046	16309733	16309733	5
chr16	16312320	16359124	Dnm1l	46804	-	NM_001276340	16314079	16358958	19
chr16	16417007	16600071	Fgd4	183064	-	NM_001301817	16422655	16600021	17
chr16	16673142	16674072	Olfr19	930	-	NM_146335	16673142	16674072	1
chr16	16707779	16718214	4933404G15Rik	10435	-	NR_045920	16718214	16718214	6
chr16	16753108	16829456	Spag6	76348	-	NM_015773	16753906	16829312	11
chr16	16819805	16820289	Rpl31-ps12	484	-	NM_001258458	16819838	16820276	1
chr16	16860763	16864078	Igll1	3315	-	NM_001190325	16860907	16863982	3
chr16	16868493	16869348	Vpreb1	855	-	NM_016982	16868688	16869204	2
chr16	16870983	16893079	Top3b	22096	+	NM_011624	16878039	16892989	18
chr16	16896561	16927468	Ppm1f	30907	+	NM_176833	16903481	16924115	8
chr16	16983474	17047546	Mapk1	64072	+	NM_011949	16983719	17038523	9
chr16	17070231	17086829	Ypel1	16598	+	NM_001291047	17074783	17084695	6
chr16	17086648	17111345	Ppil2	24697	-	NM_144954	17088862	17111267	21
chr16	17113490	17125199	2610318N02Rik	11709	-	NM_183287	17113544	17121610	8
chr16	17124153	17124235	Mir130b	82	-	NR_029659	17124235	17124235	1
chr16	17124492	17124589	Mir301b	97	-	NR_030415	17124589	17124589	1
chr16	17130230	17132476	Sdf2l1	2246	-	NM_022324	17130599	17132403	3
chr16	17139156	17147322	Ccdc116	8166	-	NM_001306169	17141290	17144175	4
chr16	17147059	17148950	Ydjc	1891	+	NM_026940	17147075	17148579	5
chr16	17152107	17201585	Ube2l3	49478	-	NM_009456	17154220	17201554	4
chr16	17208227	17214075	Rimbp3	5848	+	NM_001033338	17208806	17213627	1
chr16	17233679	17263523	Hic2	29844	+	NM_178922	17255133	17259261	3
chr16	17276392	17278754	Tmem191c	2362	+	NM_177473	17276406	17278269	10
chr16	17280443	17406407	Pi4ka	125964	-	NM_001001983	17280661	17389532	55
chr16	17331463	17343665	Serpind1	12202	+	NM_008223	17336403	17343137	5
chr16	17406092	17430919	Snap29	24827	+	NM_023348	17406215	17428393	5
chr16	17452077	17487533	Crkl	35456	+	NM_007764	17452570	17483888	3
chr16	17489769	17507578	Aifm3	17809	+	NM_175178	17492165	17507259	21
chr16	17509063	17526423	Lztr1	17360	+	NM_025808	17509120	17525886	21
chr16	17528074	17531145	Thap7	3071	-	NM_026909	17528280	17530950	5
chr16	17544557	17561340	Lrrc74b	16783	-	NM_029053	17545576	17561304	9
chr16	17561977	17572105	P2rx6	10128	+	NM_011028	17562106	17571058	12
chr16	17572110	17576764	Slc7a4	4654	-	NM_144852	17573369	17576026	5
chr16	17619446	17644923	Smpd4	25477	+	NM_029945	17621579	17642896	20
chr16	17646562	17650831	Ccdc74a	4269	+	NM_001166164	17646617	17650703	8
chr16	17651300	17723040	Med15	71740	-	NM_033609	17652219	17722916	18
chr16	17759713	17793475	Klhl22	33762	+	NM_145479	17764512	17792884	7
chr16	17797374	17808386	Scarf2	11012	+	NM_153790	17797471	17807677	11
chr16	17833211	17835112	B830017H08Rik	1901	+	NR_027959	17835112	17835112	2
chr16	17835368	17838279	Car15	2911	-	NM_030558	17835419	17838200	8
chr16	17840450	17891821	Dgcr2	51371	-	NM_010048	17842613	17891557	10
chr16	17894295	17895746	Tssk1	1451	+	NM_009435	17894445	17895543	1
chr16	17898729	17900117	Tssk2	1388	+	NM_009436	17898827	17899904	1
chr16	17900801	17911441	Dgcr14	10640	-	NM_022408	17902136	17911398	10
chr16	17913646	17915152	Gsc2	1506	-	NM_029469	17913709	17915135	3
chr16	17925303	17928312	Slc25a1	3009	-	NM_153150	17925905	17928172	9
chr16	17980657	17981173	Vpreb2	516	+	NM_016983	17980657	17981173	2
chr16	18052952	18071725	Dgcr6	18773	+	NM_010047	18065251	18071054	6
chr16	18071818	18089283	Prodh	17465	-	NM_011172	18072268	18089250	14
chr16	18127798	18152501	Rtn4r	24703	+	NM_022982	18127973	18152224	2
chr16	18165181	18165263	Mir6366	82	-	NR_105785	18165263	18165263	1
chr16	18209778	18213956	4933432I09Rik	4178	-	NR_015575	18213956	18213956	3
chr16	18220845	18235229	Zdhhc8	14384	-	NM_172151	18223298	18235103	11
chr16	18240071	18248787	Ranbp1	8716	-	NM_011239	18240179	18248655	6
chr16	18248975	18254865	Trmt2a	5890	+	NM_001080999	18249323	18253418	12
chr16	18254057	18289261	Dgcr8	35204	-	NM_033324	18255614	18284509	14
chr16	18284331	18284410	Mir1306	79	-	NR_035467	18284410	18284410	1
chr16	18284642	18284730	Gm24572	88	-	NR_128565	18284730	18284730	1
chr16	18300917	18344025	Tango2	43108	-	NM_138583	18301524	18324505	9
chr16	18327493	18327558	Mir185	65	-	NR_029571	18327558	18327558	1
chr16	18348274	18407167	Arvcf	58893	+	NM_033474	18389270	18405302	19
chr16	18406974	18426809	Comt	19835	-	NM_001111062	18407929	18412050	6
chr16	18426509	18479166	Txnrd2	52657	+	NM_013711	18426537	18477873	18
chr16	18498805	18566773	Gnb1l	67968	+	NM_001285491	18544261	18564379	8
chr16	18581796	18590764	Tbx1	8968	-	NM_001285472	18582085	18588113	9
chr16	18620411	18622496	Gp1bb	2085	-	NM_010327	18620814	18621673	2
chr16	18621903	18630031	Sept5	8128	-	NM_213614	18622832	18629943	12
chr16	18776939	18778355	Cldn5	1416	+	NM_013805	18777088	18777745	1
chr16	18780539	18812065	Cdc45	31526	-	NM_009862	18781990	18811658	20
chr16	18812386	18835354	Ufd1l	22968	+	NM_011672	18812507	18834403	12
chr16	18836672	18840206	2510002D24Rik	3534	+	NM_001033164	18836688	18839308	3
chr16	18872110	18876730	Mrpl40	4620	-	NM_010922	18872430	18876616	4
chr16	18876842	18970401	Hira	93559	+	NM_010435	18877575	18969649	25
chr16	19285886	19286834	Olfr164	948	-	NM_146451	19285886	19286834	1
chr16	19407168	19408110	Olfr165	942	-	NM_146466	19407168	19408110	1
chr16	19486932	19487871	Olfr166	939	+	NM_147068	19486932	19487871	1
chr16	19514788	19515727	Olfr167	939	-	NM_146935	19514788	19515727	1
chr16	19530072	19531011	Olfr168	939	-	NM_146357	19530072	19531011	1
chr16	19566032	19566974	Olfr169	942	-	NM_001011855	19566032	19566974	1
chr16	19605817	19606759	Olfr170	942	-	NM_146957	19605817	19606759	1
chr16	19624249	19625194	Olfr171	945	-	NM_146958	19624249	19625194	1
chr16	19653473	19706458	Lamp3	52985	-	NM_177356	19655479	19706357	6
chr16	19760326	19772846	B3gnt5	12520	+	NM_001159407	19769125	19770256	6
chr16	19876660	19884367	A930003A15Rik	7707	-	NR_027896	19884367	19884367	3
chr16	19946585	19983122	Klhl6	36537	-	NM_183390	19947084	19983076	7
chr16	20097626	20127817	Klhl24	30191	+	NM_029436	20106796	20123179	8
chr16	20141135	20232646	Yeats2	91511	+	NM_001145930	20150533	20230946	31
chr16	20233381	20241431	Map6d1	8050	-	NM_198599	20236034	20241386	3
chr16	20279893	20302435	Parl	22542	-	NM_001005767	20280046	20302400	10
chr16	20308459	20325477	Cyp2ab1	17018	-	NM_183158	20309848	20313965	9
chr16	20331376	20426467	Abcc5	95091	-	NM_013790	20332676	20422506	30
chr16	20498889	20509398	Eif2b5	10509	+	NM_172265	20498986	20509093	16
chr16	20517136	20532260	Dvl3	15124	+	NM_007889	20517267	20531589	15
chr16	20535552	20544982	Ap2m1	9430	+	NM_009679	20537733	20543518	11
chr16	20545184	20548629	Gm15760	3445	-	NR_030670	20548629	20548629	1
chr16	20548675	20561676	Abcf3	13001	+	NM_013852	20548745	20560588	21
chr16	20589654	20605450	Vwa5b2	15796	+	NM_001144953	20591234	20605158	23
chr16	20604524	20604609	Mir1224	85	+	NR_035407	20604609	20604609	1
chr16	20605530	20610822	Alg3	5292	-	NM_145939	20605627	20610811	9
chr16	20611673	20645988	Ece2	34315	+	NM_177941	20611697	20645309	20
chr16	20619287	20621351	Camk2n2	2064	-	NM_028420	20620245	20621267	2
chr16	20651724	20663487	Psmd2	11763	+	NM_134101	20651789	20663318	21
chr16	20672799	20692956	Eif4g1	20157	+	NM_145941	20673974	20692504	33
chr16	20684328	20684386	Snord66	58	+	NR_028530	20684386	20684386	1
chr16	20695129	20703109	Fam131a	7980	+	NM_133778	20695162	20701957	6
chr16	20703038	20716709	Clcn2	13671	-	NM_009900	20703315	20716068	24
chr16	20717898	20722338	Polr2h	4440	+	NM_145632	20717994	20722100	5
chr16	20724526	20734584	Thpo	10058	-	NM_009379	20725480	20729149	6
chr16	20733199	20742457	Chrd	9258	+	NM_009893	20733220	20742050	23
chr16	21152731	21154017	Teddm3	1286	-	NM_025634	21153005	21153890	1
chr16	21204867	21223377	Ephb3	18510	+	NM_010143	21205242	21222589	16
chr16	21247571	21296945	Gm16863	49374	-	NR_046162	21296945	21296945	5
chr16	21256085	21256139	Mir7680	54	-	NR_106145	21256139	21256139	1
chr16	21331972	21333429	Magef1	1457	-	NR_131983	21333429	21333429	1
chr16	21423190	21644754	Vps8	221564	+	NM_001285893	21434983	21644343	47
chr16	21649117	21694738	2510009E07Rik	45621	-	NM_001001881	21653274	21694478	2
chr16	21761357	21787907	Ehhadh	26550	-	NM_023737	21762156	21787853	7
chr16	21794419	21809112	1300002E11Rik	14693	+	NR_037958	21809112	21809112	3
chr16	21892041	21931950	Map3k13	39909	+	NM_172821	21892041	21928121	13
chr16	21934399	21947625	Tmem41a	13226	-	NM_025693	21934897	21947559	5
chr16	21953890	21995615	Liph	41725	-	NM_001289582	21956162	21995442	10
chr16	22009556	22049342	Senp2	39786	+	NM_029457	22009714	22046768	17
chr16	22059081	22163372	Igf2bp2	104291	-	NM_183029	22060865	22163036	16
chr16	22245813	22266002	Tra2b	20189	-	NM_009186	22246928	22265849	9
chr16	22381385	22439643	Etv5	58258	-	NM_023794	22383542	22436555	13
chr16	22466641	22657304	Dgkg	190663	-	NM_138650	22469321	22622334	25
chr16	22511552	22517758	9230117E06Rik	6206	+	NR_130988	22517758	22517758	2
chr16	22532128	22532257	Mir8095	129	-	NR_106170	22532257	22532257	1
chr16	22805275	22811483	Crygs	6208	-	NM_009967	22805391	22811428	3
chr16	22813286	22857742	Tbccd1	44456	-	NM_001081368	22818486	22842137	8
chr16	22857917	22879707	Dnajb11	21790	+	NM_026400	22858114	22871808	11
chr16	22875055	22894459	Gm30505	19404	-	NR_110508	22894459	22894459	4
chr16	22892087	22899524	Ahsg	7437	+	NM_013465	22892187	22899148	7
chr16	22918454	22939841	Fetub	21387	+	NM_001083905	22929148	22939708	8
chr16	22951144	22961732	Hrg	10588	+	NM_053176	22951195	22961657	7
chr16	22985924	23029174	Kng2	43250	-	NM_001102409	22986042	23028982	11
chr16	23058372	23082151	Kng1	23779	+	NM_023125	23058516	23081649	11
chr16	23107540	23114205	Eif4a2	6665	+	NR_110335	23114205	23114205	12
chr16	23109025	23109093	Snord2	68	+	NR_030705	23109093	23109093	1
chr16	23110842	23111006	Snora81	164	+	NR_034048	23111006	23111006	1
chr16	23114020	23127803	Rfc4	13783	-	NM_145480	23114084	23127603	11
chr16	23146608	23158041	Adipoq	11433	+	NM_009605	23155297	23157667	3
chr16	23224812	23360423	St6gal1	135611	+	NM_145933	23321153	23357943	8
chr16	23429205	23434033	Rtp1	4828	+	NM_001004151	23429251	23431751	2
chr16	23451857	23520663	Masp1	68806	-	NM_008555	23452454	23520623	16
chr16	23610004	23614308	Rtp4	4304	+	NM_023386	23610074	23613555	2
chr16	23889666	23890930	Sst	1264	-	NM_009215	23889814	23890830	2
chr16	23925633	23930880	Rtp2	5247	-	NM_001008230	23927293	23930784	2
chr16	23965137	23988698	Bcl6	23561	-	NM_009744	23966210	23977761	10
chr16	24392641	24393741	Lppos	1100	-	NR_037954	24393741	24393741	2
chr16	24393435	24992664	Lpp	599229	+	NM_178665	24608210	24979407	13
chr16	24529399	24534558	Morf4l1-ps1	5159	+	NR_038091	24534558	24534558	1
chr16	25059724	25069144	A230028O05Rik	9420	+	NR_040374	25069144	25069144	3
chr16	25286902	25422430	Tprg	135528	+	NM_175165	25317346	25422401	6
chr16	25683850	25892174	Trp63	208324	+	NM_001127259	25684375	25889390	14
chr16	25960408	26105870	P3h2	145462	-	NM_173379	25960443	26105769	15
chr16	26356731	26371925	Cldn1	15194	-	NM_016674	26359123	26371712	4
chr16	26463220	26482850	Cldn16	19630	+	NM_053241	26463571	26482737	5
chr16	26503878	26526857	Tmem207	22979	-	NM_001101640	26504927	26526800	5
chr16	26581790	26725233	Il1rap	143443	+	NM_001159317	26624241	26723308	12
chr16	26714767	26755588	Gm20319	40821	-	NR_105063	26755588	26755588	3
chr16	26957320	26991738	Gmnc	34418	-	NM_001013761	26960339	26990015	6
chr16	27307726	27351295	Ostn	43569	+	NM_198112	27321424	27347041	5
chr16	27353407	27370325	Uts2b	16918	-	NM_198166	27353797	27370222	5
chr16	27389041	27452304	Ccdc50	63263	+	NM_001289436	27435649	27446353	12
chr16	27850015	27926214	Gm10823	76199	+	NR_033475	27926214	27926214	5
chr16	28157868	28753329	Fgf12	595461	-	NM_010199	28162502	28752932	6
chr16	28600020	28600129	Mir690	109	-	NR_030463	28600129	28600129	1
chr16	28826261	28929784	Mb21d2	103523	-	NM_177718	28827830	28929749	2
chr16	29209780	29230616	Hrasls	20836	+	NM_013751	29217697	29228320	4
chr16	29231999	29378818	Atp13a5	146819	-	NM_175650	29232688	29378623	30
chr16	29396123	29541569	Atp13a4	145446	-	NM_172613	29396478	29541392	30
chr16	29579419	29654688	Opa1	75269	+	NM_001199177	29579625	29649087	30
chr16	29958012	29979210	Gm1968	21198	-	NR_037689	29979210	29979210	6
chr16	30008752	30021516	4632428C04Rik	12764	+	NR_033631	30021516	30021516	3
chr16	30021927	30039565	9030404E10Rik	17638	-	NR_045878	30039565	30039565	4
chr16	30065442	30067882	Hes1	2440	+	NM_008235	30065676	30067514	4
chr16	30256464	30267618	Cpn2	11154	-	NM_027904	30259323	30260967	2
chr16	30269387	30283340	Lrrc15	13953	-	NM_028973	30272865	30274605	2
chr16	30307770	30310867	Gp5	3097	-	NM_008148	30308236	30309940	2
chr16	30312509	30388616	Atp13a3	76107	-	NM_001128096	30315789	30366971	34
chr16	30511940	30550664	Tmem44	38724	-	NM_172614	30514800	30550585	10
chr16	30561454	30587675	Lsg1	26221	-	NM_178069	30561768	30587622	14
chr16	30599808	30602883	Fam43a	3075	+	NM_177632	30600685	30601960	1
chr16	30920639	31275783	Mir1195	355144	-	NR_035427	31275783	31275783	3
chr16	30955588	31081518	Xxylt1	125930	-	NM_198626	30957423	31081421	4
chr16	31092498	31201324	Acap2	108826	-	NM_030138	31096431	31201077	23
chr16	31251626	31275363	Ppp1r2	23737	-	NM_025800	31254772	31275056	6
chr16	31296277	31314894	Apod	18617	-	NM_007470	31297426	31311222	6
chr16	31422382	31458987	Bdh1	36605	+	NM_175177	31438120	31457180	7
chr16	31663528	31873442	Dlg1	209914	+	NM_001252435	31664937	31871867	26
chr16	31878895	31899105	Mfi2	20210	+	NM_013900	31879012	31897307	16
chr16	31933936	31946132	Pigz	12196	+	NM_172822	31942068	31945894	3
chr16	31947136	31948607	0610012G03Rik	1471	-	NR_027897	31948607	31948607	1
chr16	31948631	31958558	Ncbp2	9927	+	NM_026554	31948735	31957096	4
chr16	31959755	32003373	Senp5	43618	-	NM_177103	31963512	31990520	10
chr16	31986916	31987877	Gm15694	961	-	NR_103513	31987877	31987877	1
chr16	32016375	32079428	Pak2	63053	-	NM_177326	32020265	32052448	15
chr16	32084501	32099813	Pigx	15312	-	NM_024464	32084568	32099655	6
chr16	32099887	32108140	Cep19	8253	+	NM_025892	32104003	32107353	4
chr16	32142910	32165562	Nrros	22652	-	NM_146069	32143117	32162394	4
chr16	32179885	32187030	Bex6	7145	+	NM_001033539	32186461	32186806	3
chr16	32230197	32247111	Fbxo45	16914	-	NM_173439	32233168	32246897	3
chr16	32247312	32257169	Wdr53	9857	+	NM_001185162	32251924	32257141	3
chr16	32267535	32267669	Mir1946a	134	-	NR_035468	32267669	32267669	1
chr16	32271694	32274865	Smco1	3171	+	NM_183283	32271694	32274243	3
chr16	32277546	32301525	Rnf168	23979	+	NM_027355	32278194	32299412	6
chr16	32332337	32393833	Ubxn7	61496	+	NM_177633	32332373	32385021	11
chr16	32400591	32408313	Tm4sf19	7722	+	NM_001160402	32405921	32408101	5
chr16	32419787	32428978	Tctex1d2	9191	+	NM_025329	32419894	32428889	5
chr16	32431006	32475151	Pcyt1a	44145	+	NM_009981	32451800	32471589	9
chr16	32475663	32487965	Slc51a	12302	-	NM_145932	32475827	32487608	9
chr16	32496366	32507300	Zdhhc19	10934	+	NM_199309	32497172	32507175	9
chr16	32608981	32632880	Tfrc	23899	+	NM_011638	32613276	32630422	19
chr16	32644728	32683579	Tnk2	38851	+	NM_016788	32663842	32682777	16
chr16	32665308	32668283	Tnk2os	2975	-	NR_033493	32668283	32668283	3
chr16	32735971	32782476	Muc4	46505	+	NM_080457	32736465	32782107	27
chr16	32777504	32797521	Muc20	20017	-	NM_001145874	32779067	32797478	4
chr16	32804973	32810532	Gm933	5559	-	NM_001256309	32805055	32810520	4
chr16	32821787	32868452	Rubcn	46665	-	NM_001200038	32824053	32868246	20
chr16	32877869	32909049	Fyttd1	31180	+	NM_027226	32877979	32905716	9
chr16	32914185	33016115	Lrch3	101930	+	NM_001310674	32914227	33009478	22
chr16	33014355	33056272	Iqcg	41917	-	NM_178378	33017023	33053717	11
chr16	33056538	33060274	Rpl35a	3736	+	NM_001130485	33057253	33060207	5
chr16	33062606	33125745	Lmln	63139	+	NM_172823	33062634	33123708	17
chr16	33105446	33105531	Mir1947	85	+	NR_035469	33105531	33105531	1
chr16	33185156	33243398	Osbpl11	58242	+	NM_176840	33185889	33241884	13
chr16	33251541	33299648	Snx4	48107	+	NM_080557	33251546	33298564	14
chr16	33379939	33380822	1700007L15Rik	883	-	NR_045709	33380822	33380822	2
chr16	33380860	33503989	Zfp148	123129	+	NM_011749	33434727	33497430	9
chr16	33518414	33664221	Slc12a8	145807	+	NM_134251	33518414	33663173	13
chr16	33684551	33768281	Heg1	83730	+	NM_175256	33684697	33766896	15
chr16	33794122	33820013	Muc13	25891	+	NM_010739	33794612	33815955	13
chr16	33829750	33949424	Itgb5	119674	+	NM_001145884	33830046	33948838	15
chr16	33955097	33967089	Umps	11992	-	NM_009471	33956848	33967067	6
chr16	33969158	34514113	Kalrn	544955	-	NM_177357	33975601	34514066	60
chr16	34651296	34678696	Ropn1	27400	+	NM_030744	34666781	34678568	6
chr16	34690701	34725280	Ccdc14	34579	+	NM_172824	34690743	34724020	13
chr16	34785035	35002520	Mylk	217485	+	NM_139300	34785089	35000618	32
chr16	34935940	34939415	1700119H24Rik	3475	-	NR_040536	34939415	34939415	3
chr16	34943260	34959080	E130310I04Rik	15820	-	NR_045723	34959080	34959080	4
chr16	35022506	35109261	Hacd2	86755	+	NM_023587	35022566	35106483	7
chr16	35155721	35304635	Adcy5	148914	+	NM_001012765	35156184	35303827	21
chr16	35311216	35364004	Sec22a	52788	-	NM_133704	35314172	35361828	7
chr16	35397397	35490959	Pdia5	93562	-	NM_028295	35397543	35490850	17
chr16	35503255	35509505	1600019K03Rik	6250	-	NR_040481	35509505	35509505	3
chr16	35541447	35664344	Sema5b	122897	+	NM_013661	35622712	35663361	22
chr16	35694988	35769442	Dirc2	74454	-	NM_153550	35697990	35769327	9
chr16	35770471	35828548	Hspbap1	58077	+	NM_175111	35770561	35825484	8
chr16	35832963	35871468	Parp14	38505	-	NM_001039530	35834731	35871439	17
chr16	35926600	35939113	Dtx3l	12513	-	NM_001013371	35929384	35938963	5
chr16	35938555	35972707	Parp9	34152	+	NM_030253	35941206	35972315	11
chr16	35983448	36036248	Kpna1	52800	+	NM_008465	36000272	36033994	14
chr16	36041275	36043060	Wdr5b	1785	+	NM_027113	36041598	36042585	1
chr16	36043929	36071601	Fam162a	27672	-	NM_027342	36044084	36071589	5
chr16	36071745	36092204	Ccdc58	20459	+	NM_198645	36072172	36091970	5
chr16	36120031	36131275	Csta1	11244	-	NM_001033239	36122329	36131136	3
chr16	36156896	36162034	Stfa2l1	5138	+	NM_173869	36156922	36161958	3
chr16	36184297	36188196	Gm5483	3899	+	NM_001082547	36184345	36188125	3
chr16	36194565	36197972	Gm6815	3407	-	NR_102685	36197972	36197972	1
chr16	36210488	36217874	Gm5416	7386	+	NM_001082542	36210488	36217874	3
chr16	36221647	36257513	2010005H15Rik	35866	+	NM_029733	36253131	36257458	5
chr16	36277233	36285457	Stfa1	8224	+	NM_001082543	36277281	36285381	3
chr16	36321750	36334418	BC117090	12668	-	NM_001001332	36321807	36334379	3
chr16	36359467	36367656	BC100530	8189	-	NM_001082546	36359545	36367587	3
chr16	36404031	36408449	Stfa2	4418	-	NM_001082545	36404112	36408419	3
chr16	36450622	36455478	Stfa3	4856	-	NM_025288	36450694	36455450	3
chr16	36493781	36562220	Casr	68439	-	NM_013803	36494552	36517872	7
chr16	36603954	36666163	Cd86	62209	-	NM_019388	36606639	36666047	8
chr16	36694063	36726890	Ildr1	32827	+	NM_134109	36694245	36725622	8
chr16	36750249	36785048	Slc15a2	34799	-	NM_021301	36751863	36784878	22
chr16	36792969	36874912	Eaf2	81943	-	NM_134111	36793965	36808194	6
chr16	36828485	36872801	Iqcb1	44316	+	NM_177128	36831600	36872507	15
chr16	36880604	36897275	4930565N06Rik	16671	-	NR_040476	36897275	36897275	3
chr16	36885096	36933171	Golgb1	48075	+	NM_030035	36886221	36932043	22
chr16	36935068	36963300	Hcls1	28232	+	NM_008225	36937372	36962835	14
chr16	36966158	36979222	Fbxo40	13064	-	NM_001037321	36966158	36978837	3
chr16	37011871	37095503	Polq	83632	+	NM_029977	37011985	37094700	30
chr16	37107395	37385044	Stxbp5l	277649	-	NM_172440	37115741	37383783	28
chr16	37509881	37539855	Gtf2e1	29974	-	NM_028812	37511474	37536254	5
chr16	37539979	37572471	Rabl3	32492	+	NM_001042499	37540000	37571181	8
chr16	37580238	37632112	Hgd	51874	+	NM_013547	37580407	37631911	14
chr16	37647687	37654454	Ndufb4	6767	-	NM_026610	37647742	37654445	3
chr16	37777140	37836602	Fstl1	59462	+	NM_008047	37777379	37834012	11
chr16	37868485	37888943	Lrrc58	20458	+	NM_177093	37868581	37881548	4
chr16	37916581	38007615	Gpr156	91034	+	NM_153394	37947809	38005905	10
chr16	38017408	38054612	4930542C21Rik	37204	+	NR_040565	38054612	38054612	4
chr16	38085149	38089346	BC031361	4197	-	NR_033221	38089346	38089346	1
chr16	38089086	38246165	Gsk3b	157079	+	NM_019827	38090611	38240655	11
chr16	38248434	38294910	Nr1i2	46476	-	NM_010936	38249330	38266187	9
chr16	38297839	38341946	Maats1	44107	-	NM_001081025	38298169	38341863	17
chr16	38347084	38352849	Cox17	5765	+	NM_001017429	38347186	38349411	3
chr16	38362275	38378302	Popdc2	16027	+	NM_001081984	38362742	38374420	4
chr16	38396202	38433225	Pla1a	37023	-	NM_134102	38396536	38432956	11
chr16	38445478	38452769	Adprh	7291	-	NM_007414	38445769	38450521	4
chr16	38459012	38487014	Cd80	28002	+	NM_009855	38459260	38486483	5
chr16	38497924	38522747	Timmdc1	24823	-	NM_024273	38499014	38522618	7
chr16	38525141	38550338	Poglut1	25197	-	NM_001300827	38526708	38548614	11
chr16	38558810	38592275	Tmem39a	33465	+	NM_001205286	38564301	38591258	9
chr16	38598455	38713148	Arhgap31	114693	-	NM_020260	38601537	38712786	12
chr16	38742371	38769167	B4galt4	26796	+	NM_001285793	38752259	38768143	7
chr16	38773296	38800316	Upk1b	27020	-	NM_178924	38774207	38788156	8
chr16	38812317	38828862	4930435E12Rik	16545	-	NM_029042	38812535	38828858	4
chr16	38902457	39027270	Igsf11	124813	+	NM_170599	38902620	39025308	7
chr16	41533454	42146326	Lsamp	612872	+	NM_175548	41533489	42144920	6
chr16	42248673	42340764	Gap43	92091	-	NM_008083	42249141	42340615	3
chr16	42303474	42303582	Mir6540	108	-	NR_105858	42303582	42303582	1
chr16	42725814	42875700	4932412D23Rik	149886	-	NR_040521	42875700	42875700	4
chr16	42884482	42912183	Gm19522	27701	-	NR_040402	42912183	42912183	4
chr16	42907757	43619236	Zbtb20	711479	+	NM_001285805	43577295	43618857	11
chr16	43410630	43420309	Gm15713	9679	-	NR_046026	43420309	43420309	5
chr16	43640767	43640850	Mir568	83	+	NR_030576	43640850	43640850	1
chr16	43648973	43664297	Tigit	15324	-	NM_001146325	43649113	43664200	4
chr16	43762333	43823045	Drd3	60712	+	NM_007877	43762354	43822952	7
chr16	43861525	43889789	Qtrtd1	28264	-	NM_029128	43863182	43881308	8
chr16	43890014	43964427	Ccdc191	74413	+	NM_027801	43890103	43963525	16
chr16	43969258	43979163	Zdhhc23	9905	-	NM_001007460	43969258	43979163	4
chr16	43980462	44028058	Gramd1c	47596	-	NM_001172107	43982170	44013075	13
chr16	44013964	44014090	Mir3470b	126	+	NR_037302	44014090	44014090	1
chr16	44085516	44139132	Atp6v1a	53616	-	NM_007508	44087536	44116981	15
chr16	44139921	44163477	Naa50	23556	+	NM_028108	44140216	44159753	5
chr16	44173509	44227578	Usf3	54069	+	NM_001029889	44200744	44221937	8
chr16	44240292	44332951	Sidt1	92659	-	NM_001159419	44241749	44332641	25
chr16	44347513	44388605	Spice1	41092	+	NM_144550	44355552	44386952	18
chr16	44394911	44482541	Cfap44	87630	+	NM_001033247	44401538	44481545	35
chr16	44485157	44558983	Boc	73826	-	NM_172506	44485724	44521353	19
chr16	44558158	44558242	Mir3081	84	-	NR_037242	44558242	44558242	1
chr16	44724413	44737397	Nepro	12984	+	NM_145972	44724475	44736288	9
chr16	44738991	44746476	Gtpbp8	7485	-	NM_025332	44739411	44746450	6
chr16	44765848	44795090	Cd200r1	29242	+	NM_021325	44766121	44794453	7
chr16	44820840	44839263	Cd200r4	18423	+	NM_207244	44821008	44838544	6
chr16	44867209	44915953	Cd200r2	48744	+	NM_206535	44878073	44915166	6
chr16	44943790	44981493	Cd200r3	37703	+	NM_029018	44943885	44980918	6
chr16	45094165	45128037	Ccdc80	33872	+	NM_026439	45094995	45127623	8
chr16	45139685	45158786	Slc35a5	19101	-	NM_028756	45142259	45157739	7
chr16	45158941	45188651	Atg3	29710	+	NM_026402	45159212	45187854	12
chr16	45224449	45253008	Btla	28559	+	NM_001037719	45224465	45250710	6
chr16	45382247	45409166	Cd200	26919	-	NM_010818	45392358	45408980	6
chr16	45416867	45493082	Gm609	76215	-	NM_001005854	45417998	45492994	5
chr16	45535378	45607114	Slc9c1	71736	+	NM_198106	45539697	45606974	28
chr16	45610552	45622980	Gcsam	12428	+	NM_001159297	45610644	45620254	6
chr16	45626960	45654231	BC016579	27271	-	NM_145389	45628418	45654154	6
chr16	45656429	45693771	Tmprss7	37342	-	NM_172455	45656520	45693767	18
chr16	45711342	45724644	Tagln3	13302	-	NM_019754	45711680	45724419	4
chr16	45729837	45743068	Abhd10	13231	-	NM_001272070	45730029	45743004	6
chr16	45746343	45844491	Phldb2	98148	-	NM_001252442	45747903	45826194	19
chr16	45959373	46010526	Plcxd2	51153	-	NM_001134480	45965130	46009969	4
chr16	46035769	46120361	Cd96	84592	-	NM_032465	46035985	46120205	15
chr16	46153105	46155190	Gm4737	2085	-	NM_001304528	46153826	46155125	1
chr16	46394970	46497080	Pvrl3	102110	-	NM_021496	46395208	46496887	9
chr16	48283847	48294405	Dppa4	10558	+	NM_028610	48283930	48293845	7
chr16	48310386	48319626	Dppa2	9240	+	NM_028615	48310619	48318824	7
chr16	48399565	48412529	Gm5485	12964	-	NR_015373	48412529	48412529	4
chr16	48431349	48631018	Morc1	199669	+	NM_010816	48431453	48630925	27
chr16	48734802	48772069	Trat1	37267	-	NM_198297	48734886	48772063	6
chr16	48816968	48819005	Retnlb	2037	+	NM_023881	48817325	48818868	4
chr16	48842664	48844574	Retnla	1910	+	NM_020509	48842685	48844414	4
chr16	48872720	48874611	Retnlg	1891	+	NM_181596	48872974	48874457	4
chr16	48924340	48994225	Dzip3	69885	-	NM_001110017	48926104	48984679	32
chr16	48994300	49019818	C330027C09Rik	25518	+	NM_172616	48994390	49018658	21
chr16	49057598	49199217	Myh15	141619	+	NM_001166210	49057598	49198655	41
chr16	49699406	49765239	Ift57	65833	+	NM_028680	49699450	49764033	11
chr16	49855766	49911796	Cd47	56030	+	NM_010581	49855899	49910990	10
chr16	49980572	49997588	Gm6936	17016	+	NR_045001	49997588	49997588	4
chr16	50019770	50072965	Gm4827	53195	-	NR_045935	50072965	50072965	4
chr16	50191956	50432502	Bbx	240546	-	NM_027444	50197671	50280643	17
chr16	50526357	50559572	G730013B05Rik	33215	+	NR_040380	50559572	50559572	5
chr16	50589971	50591267	Ccdc54	1296	-	NM_027046	50590024	50591014	1
chr16	50590615	50654279	4930542D17Rik	63664	+	NR_040566	50654279	50654279	5
chr16	50726863	50732886	Dubr	6023	-	NR_028300	50732886	50732886	2
chr16	50727244	50727358	Mir6363	114	+	NR_105782	50727358	50727358	1
chr16	50783521	50784204	1700116B05Rik	683	+	NR_131006	50784204	50784204	2
chr16	52031661	52208159	Cblb	176498	+	NM_001033238	52033135	52204805	18
chr16	52249108	52453110	Alcam	204002	-	NM_009655	52253261	52452578	16
chr16	52799620	52815857	4930404A05Rik	16237	-	NR_040495	52815857	52815857	3
chr16	55225287	55283350	Zpld1	58063	-	NM_178720	55226469	55267412	12
chr16	55494843	55494910	Mir5118	67	+	NR_039578	55494910	55494910	1
chr16	55811489	55838754	Nfkbiz	27265	-	NM_030612	55812842	55822166	14
chr16	55840065	55895392	Nxpe3	55327	-	NM_001134457	55844288	55890787	6
chr16	55900000	55934961	Cep97	34961	-	NM_028815	55905280	55934908	11
chr16	55966387	55971550	Rpl24	5163	+	NM_024218	55966546	55971504	6
chr16	55973380	55974730	Zbtb11os1	1350	-	NR_027965	55974730	55974730	1
chr16	55973916	56009025	Zbtb11	35109	+	NM_173026	55974174	56007438	11
chr16	56015620	56029830	Pcnp	14210	-	NM_001024622	56017303	56029779	5
chr16	56033832	56037887	Trmt10c	4055	-	NM_029092	56034138	56035383	2
chr16	56075516	56190144	Senp7	114628	+	NM_025483	56075651	56188485	24
chr16	56204425	56273866	Impg2	69441	+	NM_174876	56204644	56270905	20
chr16	56477958	56690248	Abi3bp	212290	+	NM_001014423	56478026	56689162	40
chr16	56690441	56717563	Tfg	27122	-	NM_019678	56690883	56712907	8
chr16	56724721	56795971	Adgrg7	71250	-	NM_172825	56724867	56795774	16
chr16	56805273	56886276	Tmem45a	81003	-	NM_019631	56806795	56825968	6
chr16	57037079	57071459	Tmem45a2	34380	-	NM_183281	57039109	57071144	7
chr16	57121826	57154643	Tomm70a	32817	+	NM_138599	57121974	57152849	12
chr16	57156777	57167445	Nit2	10668	-	NM_023175	57157187	57167400	10
chr16	57168976	57231579	Tbc1d23	62603	-	NM_026254	57170471	57231479	18
chr16	57266251	57292964	Tmem30c	26713	-	NM_027651	57266522	57291020	8
chr16	57302112	57606980	Cmss1	304868	-	NM_025599	57302311	57606839	10
chr16	57353389	57572917	Filip1l	219528	+	NM_001040397	57506721	57572559	5
chr16	57624368	57754850	Col8a1	130482	-	NM_007739	57627023	57632751	4
chr16	58408647	58469858	Dcbld2	61211	+	NM_028523	58408868	58465902	16
chr16	58470654	58523425	St3gal6	52771	-	NM_018784	58470759	58493881	11
chr16	58613798	58617091	Gm813	3293	-	NM_001033404	58613934	58617056	4
chr16	58635374	58638516	E330017A01Rik	3142	-	NM_175011	58635442	58638486	4
chr16	58670320	58680502	Cpox	10182	+	NM_007757	58670540	58678870	7
chr16	58717547	58718837	Gpr15	1290	-	NM_001162955	58717754	58718837	1
chr16	58728022	58734360	Cldnd1	6338	+	NM_001252450	58728190	58733172	6
chr16	58760265	58761353	Olfr172	1088	-	NM_147001	58760357	58761287	1
chr16	58796574	58797738	Olfr173	1164	-	NM_147000	58796674	58797640	1
chr16	58823606	58826587	Olfr175-ps1	2981	-	NM_147002	58823606	58824533	2
chr16	58872040	58872974	Olfr176	934	-	NM_146993	58872040	58872974	3
chr16	58872044	58872974	Olfr177	930	-	NM_146996	58872044	58872974	1
chr16	58889084	58890044	Olfr178	960	-	NM_146997	58889084	58890044	1
chr16	58915511	58918312	Olfr180	2801	-	NM_001011662	58915511	58916465	2
chr16	58925382	58928470	Olfr181	3088	-	NM_146999	58925441	58926395	2
chr16	58995229	59000442	Olfr183	5213	+	NM_146485	58999512	59000442	2
chr16	59026801	59027731	Olfr186	930	-	NM_146321	59026801	59027731	1
chr16	59035605	59039575	Olfr187	3970	-	NM_146322	59035634	59036561	2
chr16	59073980	59074904	Olfr190	924	-	NM_146397	59073980	59074904	1
chr16	59085377	59086307	Olfr191	930	-	NM_001011807	59085377	59086307	1
chr16	59097891	59098816	Olfr192	925	-	NM_207549	59097891	59098816	2
chr16	59109504	59110434	Olfr193	930	-	NM_001011791	59109504	59110434	1
chr16	59118973	59119894	Olfr194	921	-	NM_001005524	59118973	59119894	1
chr16	59148677	59149604	Olfr195	927	+	NM_146998	59148677	59149604	1
chr16	59167037	59167967	Olfr196	930	-	NM_146779	59167037	59167967	1
chr16	59185381	59186307	Olfr197	926	-	NM_146484	59185381	59186307	1
chr16	59201329	59202250	Olfr198	921	-	NM_001011808	59201329	59202250	1
chr16	59215510	59216437	Olfr199	927	-	NM_207550	59215510	59216437	1
chr16	59268564	59269491	Olfr201	927	-	NM_146994	59268564	59269491	1
chr16	59283397	59284321	Olfr202	924	-	NM_146995	59283397	59284321	1
chr16	59302980	59303901	Olfr203	921	+	NM_146486	59302980	59303901	1
chr16	59314313	59315231	Olfr204	918	-	NM_146992	59314313	59315231	1
chr16	59328415	59329333	Olfr205	918	-	NM_001011736	59328415	59329333	1
chr16	59344604	59345525	Olfr206	921	-	NM_146991	59344604	59345525	1
chr16	59361124	59362042	Olfr207	918	-	NM_001011792	59361124	59362042	1
chr16	59361124	59362042	Olfr208	918	-	NM_146384	59361124	59362042	1
chr16	59361124	59362042	Olfr209	918	-	NM_207551	59361124	59362042	1
chr16	59407207	59461565	Gabrr3	54358	+	NM_001081190	59407207	59461504	9
chr16	59466697	59469064	1700022E09Rik	2367	-	NR_040568	59469064	59469064	3
chr16	59471600	59492277	Mina	20677	+	NM_025910	59475363	59491725	10
chr16	59490600	59555578	Crybg3	64978	-	NM_174848	59493422	59555573	19
chr16	59613146	59639165	Arl6	26019	-	NM_019665	59613644	59632259	8
chr16	59636770	59672819	4930547E14Rik	36049	+	NR_040564	59672819	59672819	3
chr16	59653308	60605357	Epha6	952049	-	NM_007938	59653845	60605074	18
chr16	62734677	62786542	Nsun3	51865	-	NM_178925	62734940	62786508	6
chr16	62793514	62846866	Arl13b	53352	-	NM_026577	62795457	62846569	10
chr16	62814501	62822548	Stx19	8047	+	NM_026588	62821648	62822527	2
chr16	62854132	62929168	Pros1	75036	+	NM_011173	62854254	62928019	15
chr16	63545043	63863983	Epha3	318940	-	NM_010140	63545956	63863873	17
chr16	64477636	64478960	Csnka2ip	1324	-	NM_173861	64477662	64478493	1
chr16	64765930	64770765	4930453N24Rik	4835	-	NM_026273	64766138	64770689	3
chr16	64780172	64786147	Zfp654	5975	-	NM_028059	64783094	64786040	2
chr16	64851910	64859317	Cggbp1	7407	+	NM_178647	64855398	64855902	3
chr16	64924554	65105610	Htr1f	181056	-	NM_008310	64925652	64926753	3
chr16	65520963	65534316	Pou1f1	13353	+	NM_008849	65520963	65534316	6
chr16	65539377	65562942	Chmp2b	23565	-	NM_026879	65540384	65562753	6
chr16	65815877	65863311	Vgll3	47434	+	NM_028572	65815877	65860958	4
chr16	66655665	67621153	Cadm2	965488	-	NM_178721	66663337	67620476	10
chr16	66657362	66664871	1700010K23Rik	7509	+	NR_040512	66664871	66664871	3
chr16	69796385	69800626	4930428D20Rik	4241	-	NR_130991	69800626	69800626	2
chr16	69857118	69863989	Speer2	6871	-	NM_173069	69857309	69863857	6
chr16	70314193	70569965	Gbe1	255772	+	NM_028803	70314397	70569290	16
chr16	70616669	70625067	D16Ertd519e	8398	+	NR_040474	70625067	70625067	3
chr16	71131320	71139274	4931420L22Rik	7954	+	NR_040561	71139274	71139274	4
chr16	71250148	71267421	4930567J20Rik	17273	+	NR_040576	71267421	71267421	3
chr16	72226627	72234572	8030451O07Rik	7945	-	NR_131115	72234572	72234572	5
chr16	72663393	73046345	Robo1	382952	+	NM_019413	72664384	73044607	29
chr16	73892550	74411157	Robo2	518607	-	NM_175549	73896070	74411157	28
chr16	74342234	74342312	Mir691	78	-	NR_030464	74342312	74342312	1
chr16	75540758	75586306	Lipi	45548	-	NM_001252513	75541298	75586195	11
chr16	75593135	75603070	Rbm11	9935	+	NM_198302	75593192	75601145	5
chr16	75755435	75767063	Hspa13	11628	-	NR_027492	75767063	75767063	6
chr16	75859038	75909511	Samsn1	50473	-	NM_023380	75859684	75909431	8
chr16	76122857	76156331	4930578N18Rik	33474	+	NR_040575	76156331	76156331	3
chr16	76291106	76373294	Nrip1	82188	-	NM_173440	76291426	76294912	4
chr16	77004472	77011126	1700041M19Rik	6654	-	NR_040573	77011126	77011126	3
chr16	77014313	77117025	Usp25	102712	+	NM_013918	77014340	77115807	24
chr16	77329572	77558673	Mir99ahg	229101	+	NR_015543	77558673	77558673	5
chr16	77599180	77599245	Mir99a	65	+	NR_029535	77599245	77599245	1
chr16	77599901	77599995	Mirlet7c-1	94	+	NR_029728	77599995	77599995	1
chr16	77646517	77646588	Mir125b-2	71	+	NR_029540	77646588	77646588	1
chr16	78251107	78255699	E330011O21Rik	4592	-	NR_045698	78255699	78255699	4
chr16	78301915	78360030	Cxadr	58115	+	NM_009988	78302076	78359497	8
chr16	78360104	78377426	Btg3	17322	-	NM_001297747	78360543	78373662	5
chr16	78360107	78377002	Gm7334	16895	-	NR_002700	78377002	78377002	5
chr16	78540580	78576933	D16Ertd472e	36353	-	NM_025967	78545362	78576292	5
chr16	78560560	78565114	4930478L05Rik	4554	+	NR_040569	78565114	78565114	3
chr16	78931192	78951973	Chodl	20781	+	NM_139134	78931613	78950686	6
chr16	78953252	79091342	Tmprss15	138090	-	NM_008941	78954044	79091162	28
chr16	81200941	81624532	Ncam2	423591	+	NM_001113208	81201158	81623698	18
chr16	84371387	84375750	4930553E22Rik	4363	+	NR_040567	84375750	84375750	3
chr16	84680033	84685392	4930529L06Rik	5359	+	NR_040537	84685392	84685392	3
chr16	84713267	84715489	Mir155hg	2222	+	NR_132106	84715489	84715489	2
chr16	84714384	84714449	Mir155	65	+	NR_029565	84714449	84714449	1
chr16	84717824	84735547	Mrpl39	17723	-	NM_017404	84718578	84735462	10
chr16	84774367	84826620	Jam2	52253	+	NM_023844	84774731	84823064	10
chr16	84828115	84835870	Atp5j	7755	-	NM_001302213	84828202	84831737	6
chr16	84835368	84864023	Gabpa	28655	+	NM_008065	84839351	84860848	10
chr16	84954680	85173952	App	219272	-	NM_001198823	84955575	85173803	18
chr16	84972455	84979696	Gm10791	7241	+	NR_045889	84979696	84979696	4
chr16	85456489	85550618	Cyyr1	94129	-	NM_144853	85457759	85550353	4
chr16	85794072	85803358	Adamts1	9286	-	NM_009621	85795645	85802955	9
chr16	85819455	85827017	4930556C24Rik	7562	+	NR_040506	85827017	85827017	4
chr16	85858401	85901370	Adamts5	42969	-	NM_011782	85862854	85900512	8
chr16	87354429	87368894	N6amt1	14465	+	NM_026366	87354497	87367816	6
chr16	87376895	87432851	Ltn1	55956	-	NM_001081068	87379189	87432712	30
chr16	87433575	87440837	Rwdd2b	7262	-	NM_016924	87434636	87437745	5
chr16	87455229	87483758	Usp16	28529	+	NM_024258	87458926	87483476	18
chr16	87483569	87496114	Cct8	12545	-	NM_009840	87484232	87496033	15
chr16	87496317	87504283	B130034C11Rik	7966	+	NR_040375	87504283	87504283	3
chr16	87553574	87595581	Map3k7cl	42007	+	NM_144854	87556185	87594663	5
chr16	87699198	87733591	Bach1	34393	+	NM_007520	87715635	87730116	5
chr16	87896141	88290503	Grik1	394362	-	NM_146072	87896440	88289947	17
chr16	88506051	88507223	Cldn17	1172	-	NM_181490	88506409	88507084	1
chr16	88561070	88563428	Cldn8	2358	-	NM_018778	88562602	88563280	1
chr16	88610953	88612524	Krtap24-1	1571	-	NM_001163141	88611734	88612481	1
chr16	88627032	88627911	2310079G19Rik	879	-	NM_027173	88627288	88627846	1
chr16	88647068	88648041	Krtap26-1	973	-	NM_027105	88647328	88647976	1
chr16	88671290	88671899	Krtap27-1	609	-	NM_001163105	88671290	88671899	1
chr16	88707415	88708207	2310061N02Rik	792	-	NM_027155	88707627	88708152	1
chr16	88729106	88729856	Krtap13-1	750	+	NM_183189	88729134	88729641	1
chr16	88750989	88751873	Krtap13	884	-	NM_010671	88751249	88751843	1
chr16	88759091	88760034	2310034C09Rik	943	+	NM_054100	88759144	88759789	1
chr16	88773425	88774451	2310057N15Rik	1026	-	NM_027170	88773792	88774395	1
chr16	88811684	88812465	Gm20741	781	-	NR_045150	88812465	88812465	1
chr16	88825535	88826390	Krtap14	855	-	NM_013707	88825830	88826334	1
chr16	88829253	88830089	Krtap15	836	+	NM_013713	88829291	88829744	1
chr16	88869162	88869655	Krtap19-1	493	-	NM_130876	88869378	88869642	1
chr16	88873909	88874514	Krtap19-2	605	-	NM_130870	88874074	88874500	1
chr16	88877757	88878283	Krtap19-3	526	-	NM_130857	88877963	88878227	1
chr16	88885030	88885334	Krtap19-4	304	-	NM_130873	88885056	88885311	1
chr16	88896212	88896694	Krtap19-5	482	-	NM_010676	88896478	88896667	1
chr16	88932048	88932509	Krtap19-9b	461	-	NM_133359	88932279	88932456	1
chr16	88962548	88963118	Krtap16-3	570	-	NM_183296	88962807	88963068	1
chr16	89010624	89011004	Krtap22-2	380	-	NM_001191018	89010749	89010953	1
chr16	89015521	89016091	Gm10229	570	+	NM_001199334	89015573	89015807	1
chr16	89031943	89032537	Krtap6-1	594	+	NM_010672	89031962	89032199	1
chr16	89041167	89041717	Gm10228	550	-	NM_001270487	89041422	89041659	1
chr16	89047533	89048144	Krtap6-5	611	-	NM_130856	89047851	89048088	1
chr16	89063654	89064247	1110025L11Rik	593	-	NM_001276278	89063952	89064189	1
chr16	89206105	89206639	Krtap20-2	534	+	NM_001163615	89206158	89206341	1
chr16	89403271	89404019	Krtap21-1	748	-	NM_028621	89403610	89403997	1
chr16	89419567	89420356	Krtap6-2	789	-	NM_010673	89419854	89420322	1
chr16	89487618	89488197	Krtap8-1	579	-	NM_010675	89487966	89488152	1
chr16	89507947	89508568	Krtap7-1	621	-	NM_027771	89508243	89508507	1
chr16	89570420	89571428	Krtap11-1	1008	-	NM_001113406	89570822	89571374	1
chr16	89787355	89974944	Tiam1	187589	-	NM_001145886	89789366	89898812	28
chr16	90142481	90147072	Gm10789	4591	+	NR_033476	90147072	90147072	1
chr16	90220986	90226569	Sod1	5583	+	NM_011434	90221102	90226502	5
chr16	90229384	90284670	Scaf4	55286	-	NM_178923	90229542	90284277	20
chr16	90386641	90499798	Hunk	113157	+	NM_015755	90386700	90496993	11
chr16	90719556	90727616	Mis18a	8060	-	NM_025642	90720142	90727517	5
chr16	90738568	90750021	Mrap	11453	+	NM_029844	90738808	90749653	3
chr16	90751771	90810658	Urb1	58887	-	NM_029497	90752229	90810585	39
chr16	90826963	90905354	Eva1c	78391	+	NM_001316760	90866624	90904725	10
chr16	90926055	90935094	1110004E09Rik	9039	-	NM_026502	90926216	90934965	7
chr16	90936341	91011553	Synj1	75212	-	NM_001164483	90938484	91011435	32
chr16	91011493	91016748	4930404I05Rik	5255	+	NR_028368	91016748	91016748	3
chr16	91014281	91044624	Paxbp1	30343	-	NM_026110	91015305	91044599	18
chr16	91054179	91069390	4932438H23Rik	15211	-	NM_028905	91055798	91056491	3
chr16	91225794	91228922	Olig2	3128	+	NM_016967	91226644	91227616	2
chr16	91270013	91272184	Olig1	2171	+	NM_016968	91270121	91270904	1
chr16	91373027	91405832	Ifnar2	32805	+	NM_010509	91384143	91404659	9
chr16	91406479	91426079	Il10rb	19600	+	NM_008349	91406562	91425368	7
chr16	91465348	91470368	A930006K02Rik	5020	+	NR_077219	91470368	91470368	2
chr16	91485459	91510767	Ifnar1	25308	+	NM_010508	91485588	91505656	11
chr16	91527687	91527789	Mir6367	102	-	NR_105786	91527789	91527789	1
chr16	91547338	91564252	Ifngr2	16914	+	NM_008338	91547407	91563250	7
chr16	91574752	91597925	Tmem50b	23173	-	NM_030018	91576357	91587285	7
chr16	91614501	91619244	Dnajc28	4743	-	NM_138664	91616441	91617599	2
chr16	91621641	91647217	Gart	25576	-	NM_010256	91621801	91643346	22
chr16	91648068	91679437	Son	31369	+	NM_178880	91648152	91678405	12
chr16	91679509	91688973	Donson	9464	-	NM_021720	91680133	91688957	10
chr16	91689142	91716000	Gm10785	26858	+	NR_040389	91716000	91716000	6
chr16	91689566	91729047	Cryzl1	39481	-	NM_133679	91690060	91717714	13
chr16	91729615	91920824	Itsn1	191209	+	NM_010587	91782437	91912254	39
chr16	91925467	91931875	Atp5o	6408	-	NM_138597	91925522	91931800	7
chr16	92058566	92087718	Slc5a3	29152	+	NM_017391	92077301	92079458	2
chr16	92058580	92112472	Mrps6	53892	+	NM_080456	92058680	92112170	3
chr16	92292633	92298378	Kcne2	5745	+	NM_134110	92296831	92297203	2
chr16	92301547	92313286	Smim11	11739	+	NM_138743	92305630	92311201	4
chr16	92308960	92312711	1700048M11Rik	3751	-	NR_045300	92312711	92312711	2
chr16	92319007	92321686	4930563D23Rik	2679	-	NM_029252	92320887	92321643	1
chr16	92346245	92359713	Kcne1	13468	-	NM_008424	92348809	92349199	2
chr16	92377315	92382928	Gm29805	5613	-	NR_105054	92382928	92382928	3
chr16	92392195	92466414	Rcan1	74219	-	NM_001081549	92393697	92466323	4
chr16	92478986	92497610	2410124H12Rik	18624	+	NM_029740	92479019	92497310	3
chr16	92498391	92541486	Clic6	43095	+	NM_172469	92498698	92539841	6
chr16	92601710	92826319	Runx1	224609	-	NM_001111021	92605899	92825891	8
chr16	93343960	93358957	1810053B23Rik	14997	-	NR_040489	93358957	93358957	4
chr16	93369964	93370061	Mir802	97	+	NR_030429	93370061	93370061	1
chr16	93397059	93459117	1700029J03Rik	62058	-	NR_040494	93459117	93459117	3
chr16	93583705	93604060	Setd4	20355	-	NM_145482	93583794	93601952	12
chr16	93608081	93610594	Cbr1	2513	+	NM_007620	93608210	93610476	3
chr16	93683463	93691236	Cbr3	7773	+	NM_173047	93683569	93691009	3
chr16	93712151	93810833	Dopey2	98682	+	NM_027293	93716419	93810592	37
chr16	93832365	93876318	Morc3	43953	+	NM_001045529	93832554	93875157	17
chr16	93884145	93906351	Chaf1b	22206	+	NM_028083	93884740	93906262	14
chr16	93919275	94009082	Cldn14	89807	-	NM_019500	93919481	93920201	3
chr16	94085504	94348638	Sim2	263134	+	NM_011377	94086060	94347498	11
chr16	94350911	94509463	Hlcs	158552	-	NM_139145	94353399	94490194	10
chr16	94550028	94558542	Ripply3	8514	+	NM_133229	94550103	94557547	4
chr16	94580369	94591937	Pigp	11568	-	NM_001159620	94580734	94591876	4
chr16	94592345	94690828	Ttc3	98483	+	NM_009441	94605529	94689607	46
chr16	94719330	94748236	Dscr3	28906	-	NM_007834	94720606	94748001	8
chr16	94791812	94917126	Dyrk1a	125314	+	NM_007890	94833101	94913808	12
chr16	94970289	95219303	Kcnj6	249014	-	NM_001025584	94970872	95162818	5
chr16	95479164	95521865	Kcnj15	42701	+	NR_073406	95521865	95521865	6
chr16	95580775	95808200	Erg	227425	-	NM_001302152	95582412	95746172	11
chr16	95924013	95942656	Ets2	18643	+	NM_011809	95928027	95940745	10
chr16	96063492	96150684	1600002D24Rik	87192	-	NR_040484	96150684	96150684	4
chr16	96201541	96212510	Psmg1	10969	-	NM_019537	96201643	96212497	7
chr16	96213698	96304035	Brwd1	90337	-	NM_145125	96215204	96303909	42
chr16	96343194	96349332	Hmgn1	6138	-	NM_008251	96343982	96349211	6
chr16	96367025	96379459	Wrb	12434	+	NM_207301	96367083	96377559	5
chr16	96380012	96413864	Lca5l	33852	-	NM_001001492	96380674	96401656	11
chr16	96422076	96450540	Sh3bgr	28464	+	NM_015825	96422310	96446167	8
chr16	96457407	96541465	B3galt5	84058	+	NM_001122993	96536775	96537702	4
chr16	96583367	96643728	Igsf5	60361	+	NM_001177886	96585633	96643443	9
chr16	96643904	96665221	Itgb2l	21317	-	NM_008405	96644227	96660404	16
chr16	96689212	96747400	Pcp4	58188	+	NM_008791	96689388	96747124	3
chr16	96813686	97392342	Dscam	578656	-	NM_031174	96814665	97391883	33
chr16	97578334	97660619	Bace2	82285	+	NM_019517	97578408	97658502	9
chr16	97668641	97684513	Mx1	15872	-	NR_003520	97684513	97684513	9
chr16	97692692	97726543	Fam3b	33851	-	NM_020622	97692740	97726448	8
chr16	97757687	97782508	Mx2	24821	+	NR_003508	97782508	97782508	14
chr16	97786288	97832802	Tmprss2	46514	-	NM_015775	97787746	97820876	14
chr16	97963548	97985362	Ripk4	21814	-	NM_023663	97964691	97985316	8
chr16	98013073	98072834	Prdm15	59761	-	NM_144789	98015786	98072726	24
chr16	98076815	98144243	C2cd2	67428	-	NM_174847	98080962	98143925	14
chr16	98098839	98098898	Mir6964	59	-	NR_105929	98098898	98098898	1
chr16	98168598	98183786	Zbtb21	15188	-	NM_001081685	98171045	98177994	4
chr16	98218511	98237921	B230307C23Rik	19410	+	NR_130962	98237921	98237921	5
chr16	98283676	98303604	A630089N07Rik	19928	-	NR_015491	98303604	98303604	5
chr17	3064317	3084183	Pisd-ps2	19866	-	NR_003519	3084183	3084183	8
chr17	3114971	3198859	Scaf8	83888	+	NM_134123	3115388	3198210	20
chr17	3326572	3519397	Tiam2	192825	+	NM_001122998	3413997	3518728	27
chr17	3519255	3557713	Tfb1m	38458	-	NM_146074	3519551	3557713	7
chr17	3532553	3533213	Cldn20	660	+	NM_001101560	3532553	3533213	1
chr17	3557823	3559863	1700102H20Rik	2040	+	NR_045302	3559863	3559863	3
chr17	3635239	3696261	Nox3	61022	-	NM_198958	3635264	3696201	13
chr17	4044657	4082995	4930470H14Rik	38338	-	NR_045764	4082995	4082995	4
chr17	4119445	4122102	4930548J01Rik	2657	-	NR_045462	4122102	4122102	3
chr17	4634979	4637477	4930517M08Rik	2498	+	NR_130984	4637477	4637477	3
chr17	4995073	5347656	Arid1b	352583	+	NM_001085355	4995094	5343087	20
chr17	5410863	5440260	Tmem242	29397	-	NM_027457	5411368	5440217	4
chr17	5417322	5418767	Ldhal6b	1445	-	NM_175349	5417508	5418657	1
chr17	5480988	5483069	Gm8363	2081	-	NR_073378	5483069	5483069	1
chr17	5492599	5753891	Zdhhc14	261292	+	NM_146073	5493446	5753093	9
chr17	5798656	5803240	3300005D01Rik	4584	+	NR_045081	5803240	5803240	3
chr17	5841379	5930711	Snx9	89332	+	NM_025664	5841534	5930617	18
chr17	5941279	6039390	Synj2	98111	+	NM_001113353	5941450	6038115	27
chr17	6040570	6079739	Serac1	39169	-	NM_001111017	6044113	6074246	17
chr17	6079827	6085485	Gtf2h5	5658	+	NM_181392	6080839	6084652	3
chr17	6106829	6240637	Tulp4	133808	+	NM_001103181	6198707	6236342	14
chr17	6270469	6308314	Tmem181a	37845	+	NM_001033178	6270582	6305447	17
chr17	6306343	6317474	Dynlt1a	11131	-	NM_001166629	6310872	6317400	5
chr17	6429259	6435443	Dynlt1b	6184	+	NM_009342	6429359	6435115	5
chr17	6438149	6450142	Tmem181b-ps	11993	-	NR_033520	6450142	6450142	10
chr17	6814820	6825643	Tmem181c-ps	10823	-	NR_028305	6825643	6825643	9
chr17	6851323	6860656	Dynlt1f	9333	-	NM_001199948	6851794	6860517	6
chr17	6853664	6860548	Dynlt1c	6884	-	NM_001166630	6853984	6860517	5
chr17	6877959	6942393	Sytl3	64434	+	NM_031395	6878235	6942185	15
chr17	6942479	6987129	Ezr	44650	-	NM_009510	6943651	6986992	13
chr17	7099577	7099686	Mir692-1	109	-	NR_030465	7099686	7099686	1
chr17	7109064	7152705	Rsph3b	43641	-	NM_001083945	7109242	7152439	8
chr17	7159313	7165505	Tagap1	6192	-	NM_147155	7160126	7165478	4
chr17	7183208	7202542	Rnaset2b	19334	+	NM_026611	7183346	7202447	9
chr17	7374463	7507664	Rps6ka2	133201	+	NM_011299	7374693	7504690	21
chr17	7529008	7550209	Tcp10a	21201	+	NM_011553	7530228	7549476	12
chr17	7555252	7557045	Ttll2	1793	-	NM_001098267	7555252	7557045	2
chr17	7568060	7589654	Gm9992	21594	-	NM_001142539	7568140	7583639	10
chr17	7931432	7997839	Fndc1	66407	-	NM_001081416	7932079	7997839	20
chr17	8118864	8127762	Tagap	8898	+	NM_145968	8119774	8126994	10
chr17	8138478	8172421	Rsph3a	33943	+	NM_025789	8138674	8172208	8
chr17	8231374	8294093	Gm1604b	62719	-	NM_001033442	8231504	8293799	4
chr17	8321462	8340653	Rnaset2a	19191	-	NM_001083938	8321550	8340559	9
chr17	8358382	8389335	Fgfr1op	30953	+	NM_001197046	8358461	8387460	13
chr17	8428907	8449994	Ccr6	21087	+	NM_001190333	8448829	8449933	3
chr17	8476677	8490526	Mpc1	13849	+	NM_018819	8476755	8490027	4
chr17	8486230	8503983	4930506C21Rik	17753	-	NR_073374	8503983	8503983	5
chr17	8503967	8520307	Sft2d1	16340	+	NM_134114	8504087	8519859	8
chr17	8533270	8536978	Prr18	3708	+	NR_028280	8536978	8536978	2
chr17	8565260	8615591	T2	50331	+	NM_001161832	8565260	8615020	11
chr17	8571909	8582333	Gm16702	10424	-	NR_045795	8582333	8582333	3
chr17	8627287	8635361	T	8074	+	NM_009309	8627395	8634734	8
chr17	8719665	9179513	Pde10a	459848	+	NM_001290707	8719883	9174521	23
chr17	9181197	9201184	1700010I14Rik	19987	+	NM_025851	9181261	9200852	10
chr17	9340583	9360887	6530411M01Rik	20304	-	NR_027881	9360887	9360887	3
chr17	9859361	9862569	Pabpc6	3208	-	NM_001163836	9860553	9862485	1
chr17	9943616	9968731	4930452A19Rik	25115	-	NR_045433	9968731	9968731	4
chr17	10399335	10512226	Qk	112891	-	NM_001159517	10402479	10511738	8
chr17	10512783	10514006	Cahm	1223	+	NR_037588	10514006	10514006	1
chr17	10517466	10522177	1700110C19Rik	4711	+	NR_045461	10522177	10522177	3
chr17	10595877	11033057	Pacrg	437180	-	NM_027032	10596183	11032734	5
chr17	10649081	10685923	A230009B12Rik	36842	+	NR_077237	10685923	10685923	2
chr17	11033224	12256232	Park2	1223008	+	NM_016694	11033348	12254519	12
chr17	12055935	12076055	D17Ertd648e	20120	-	NR_045808	12076055	12076055	3
chr17	12312149	12412506	Agpat4	100357	+	NM_026644	12344637	12411945	9
chr17	12420486	12511526	Map3k4	91040	-	NM_011948	12420965	12511494	27
chr17	12511718	12520116	4732491K20Rik	8398	+	NR_045290	12520116	12520116	2
chr17	12571474	12612250	Plg	40776	+	NM_008877	12571533	12611993	19
chr17	12612839	12700570	Slc22a3	87731	-	NM_011395	12614302	12700190	11
chr17	12659709	12672443	C030013G03Rik	12734	+	NR_077216	12672443	12672443	3
chr17	12777054	12821354	Slc22a2	44300	+	NM_013667	12777146	12820970	11
chr17	12841740	12868704	Slc22a1	26964	-	NM_009202	12841883	12868525	11
chr17	12875271	12962572	Igf2r	87301	-	NM_010515	12876575	12962399	48
chr17	12934176	13052750	Airn	118574	+	NR_027773	13052750	13052750	3
chr17	13033870	13061009	Mas1	27139	-	NM_008552	13034425	13035400	9
chr17	13068899	13070708	Mrgprh	1809	+	NM_030726	13069740	13070706	1
chr17	13081767	13102866	Pnldc1	21099	-	NM_001034866	13081771	13102777	19
chr17	13104220	13108957	Mrpl18	4737	-	NM_026310	13104543	13108864	4
chr17	13109194	13117933	Tcp1	8739	+	NM_013686	13109431	13117342	12
chr17	13115722	13115783	Snora20	61	+	NR_028479	13115783	13115783	1
chr17	13116824	13133262	Acat3	16438	-	NM_153151	13117525	13133166	9
chr17	13135907	13153591	Acat2	17684	-	NM_009338	13136727	13153529	9
chr17	13159664	13185125	Wtap	25461	-	NM_001113533	13160333	13178811	8
chr17	13200704	13210985	Sod2	10281	+	NM_013671	13200911	13208037	5
chr17	13244186	13245146	Gpr31b	960	-	NM_001013832	13244186	13245146	1
chr17	13253976	13275092	Tcp10b	21116	+	NM_009341	13255201	13274614	12
chr17	13289525	13291338	Gm11166	1813	-	NR_024558	13291338	13291338	2
chr17	13301482	13324657	Unc93a	23175	-	NM_199252	13302453	13318519	10
chr17	13397907	13399077	Gm10512	1170	+	NR_033458	13399077	13399077	1
chr17	13414053	13420524	Smok2a	6471	+	NM_013741	13418403	13419918	3
chr17	13423128	13430055	Smok2b	6927	+	NM_001167913	13427820	13429275	3
chr17	13547437	13570089	Tcp10c	22652	+	NM_001167578	13548625	13569242	12
chr17	13679886	13746960	2700054A10Rik	67074	-	NR_045436	13746960	13746960	5
chr17	13714321	13721300	Smok4a	6979	+	NR_030763	13721300	13721300	3
chr17	13853442	13898401	Tcte2	44959	-	NM_022311	13854494	13865022	3
chr17	13897547	14042801	Mllt4	145254	+	NM_010806	13897680	14041014	33
chr17	14085379	14087685	Gm7168	2306	+	NM_001122977	14085379	14086906	2
chr17	14332236	14340838	Dact2	8602	-	NM_172826	14332669	14340736	4
chr17	14416512	14541797	Smoc2	125285	+	NM_022315	14416722	14540519	13
chr17	14526113	14535949	4930474M22Rik	9836	-	NR_027986	14535949	14535949	3
chr17	14802506	14831269	Thbs2	28763	-	NM_011581	14804519	14828421	22
chr17	14955678	15080129	Wdr27	124451	-	NM_175173	14966568	15071658	25
chr17	15080188	15082944	1600012H06Rik	2756	+	NM_026451	15080617	15081175	2
chr17	15081999	15098237	Phf10	16238	-	NM_024250	15082103	15098199	12
chr17	15084740	15085828	LOC106740	1088	-	NR_027905	15085828	15085828	1
chr17	15101152	15115776	Gm3417	14624	-	NM_001123368	15101208	15115621	4
chr17	15101152	15115776	Gm3448	14624	-	NM_001123367	15101208	15115621	4
chr17	15115827	15128541	9030025P20Rik	12714	+	NM_001123370	15115857	15127768	12
chr17	15146803	15159413	Gm3435	12610	+	NM_001123372	15147229	15159136	12
chr17	15164117	15178523	Tcte3	14406	-	NM_011560	15164170	15178361	4
chr17	15178575	15201196	Ermard	22621	+	NM_001039552	15178604	15200581	18
chr17	15368548	15377747	Gm5091	9199	-	NR_046164	15377747	15377747	5
chr17	15487776	15491425	Gm10510	3649	-	NR_033511	15491425	15491425	3
chr17	15504317	15512787	Dll1	8470	-	NM_007865	15504993	15512204	11
chr17	15533165	15570545	Fam120b	37380	+	NR_033586	15570545	15570545	11
chr17	15612684	15635240	Psmb1	22556	-	NM_011185	15612983	15635226	6
chr17	15636851	15654391	Tbp	17540	+	NM_013684	15640038	15653747	8
chr17	15658538	15664265	Pdcd2	5727	-	NM_008799	15658598	15664237	6
chr17	15680042	15700287	Prdm9	20245	-	NM_144809	15680936	15700265	10
chr17	15768751	15778066	4933401D09Rik	9315	+	NR_045431	15778066	15778066	4
chr17	15841930	15909576	Chd1	67646	+	NM_007690	15844050	15907287	36
chr17	15943216	15963550	Rgmb	20334	-	NM_178615	15944108	15963120	3
chr17	17201066	17226595	Zfp960	25529	+	NM_001163919	17201140	17226348	5
chr17	17258346	17283842	Zfp97	25496	+	NM_011765	17258471	17282845	4
chr17	17511295	17531863	Riok2	20568	+	NM_025934	17511568	17530583	10
chr17	17539649	17596351	Lix1	56702	+	NM_025681	17539908	17594357	6
chr17	17664686	17761453	Lnpep	96767	-	NM_172827	17666712	17761376	18
chr17	17840904	17871131	Vmn2r90	30227	+	NM_001104539	17840904	17871131	6
chr17	17967151	17967221	Mir99b	70	+	NR_029536	17967221	17967221	1
chr17	17967315	17967408	Mirlet7e	93	+	NR_029730	17967408	17967408	1
chr17	17967775	17967843	Mir125a	68	+	NR_029539	17967843	17967843	1
chr17	17967938	17976035	Spaca6	8097	+	NM_001162909	17967967	17975982	9
chr17	17980289	17992152	Has1	11863	-	NM_008215	17980587	17992110	5
chr17	18013434	18020903	Fpr1	7469	-	NM_013521	18013594	18014689	2
chr17	18024787	18030916	Fpr2	6129	+	NM_008039	18029707	18030763	2
chr17	18107421	18108641	Fpr3	1220	+	NM_008042	18107432	18108488	1
chr17	18158696	18159668	Fpr-rs4	972	+	NM_008041	18158696	18159668	1
chr17	18186447	18211184	Vmn2r124	24737	+	NM_001271883	18186447	18211184	6
chr17	18222020	18273607	Vmn2r91	51587	+	NM_001104540	18222020	18273607	6
chr17	18288893	18322142	Vmn2r92	33249	+	NM_001104541	18288893	18322142	6
chr17	18380533	18414530	Vmn2r94	33997	-	NM_001104543	18380533	18414472	6
chr17	18435244	18463405	Vmn2r93	28161	+	NM_001104542	18435244	18463405	6
chr17	18561067	18589288	Vmn2r95	28221	+	NM_001102581	18561067	18589288	6
chr17	18718690	18735121	Vmn2r96	16431	+	NM_001104547	18719369	18735121	5
chr17	19051285	19085035	Vmn2r97	33750	+	NM_001104549	19051285	19085035	6
chr17	19190456	19218275	Vmn2r98	27819	+	NM_001104550	19190456	19218275	6
chr17	19499098	19531554	Vmn2r99	32456	+	NM_001104551	19499098	19531554	6
chr17	19641774	19669024	Vmn2r100	27250	+	NM_001104562	19641774	19669024	6
chr17	19714194	19749281	Vmn2r101	35087	+	NM_001104563	19714194	19749281	6
chr17	19797362	19831712	Vmn2r102	34350	+	NM_001104564	19797362	19831712	6
chr17	19910326	19949500	Vmn2r103	39174	+	NM_001104565	19910326	19949500	6
chr17	20166388	20185169	Vmn2r104	18781	-	NM_001104566	20166388	20185169	6
chr17	20319041	20320061	Fpr-rs6	1020	-	NM_177316	20319041	20320061	1
chr17	20345193	20371836	Vmn2r105	26643	-	NM_001104567	20345193	20371836	6
chr17	20404510	20422394	Vmn2r106	17884	-	NM_001104568	20404510	20422394	6
chr17	20482388	20512736	Vmn2r107	30348	+	NM_001104569	20482388	20512736	6
chr17	20556126	20557023	Vmn1r224	897	+	NM_001166735	20556126	20557023	1
chr17	20599336	20618200	Vmn2r108	18864	-	NM_001104570	20599336	20618200	6
chr17	20639262	20640159	Vmn1r225	897	+	NM_134194	20639262	20640159	1
chr17	20677480	20701720	Vmn2r109	24240	-	NM_001104571	20677480	20701720	6
chr17	20710792	20733223	Vmn2r110	22431	-	NM_001104572	20710792	20733223	6
chr17	20760809	20761841	Fpr-rs3	1032	-	NM_008040	20760809	20761841	1
chr17	20824471	20825368	Vmn1r226	897	+	NM_134191	20824471	20825368	1
chr17	20872063	20873090	Vmn1r227	1027	+	NM_134195	20872063	20873090	2
chr17	20913022	20914465	Vmn1r228	1443	-	NM_134192	20913216	20914218	1
chr17	20951458	20952379	Vmn1r229	921	+	NM_134190	20951458	20952379	1
chr17	20983514	20984465	Vmn1r230	951	+	NM_134197	20983514	20984465	1
chr17	21026679	21027615	Vmn1r231	936	-	NM_134196	21026679	21027615	1
chr17	21050168	21051327	Vmn1r232	1159	-	NM_134193	21050244	21051300	1
chr17	21082417	21102869	Ppp2r1a	20452	+	NM_016891	21082469	21102435	15
chr17	21130690	21131650	Vmn1r233	960	-	NM_134202	21130690	21131650	1
chr17	21145904	21165820	Zfp160	19916	+	NM_145483	21148721	21164106	5
chr17	21365789	21366779	Vmn1r234	990	+	NM_134198	21365789	21366779	1
chr17	21397390	21399827	Vmn1r235	2437	+	NM_134199	21398378	21399365	2
chr17	21423496	21424617	Vmn1r236	1121	+	NM_134201	21423585	21424590	1
chr17	21450980	21451850	Vmn1r237	870	+	NM_134200	21450980	21451850	1
chr17	21520711	21536229	Zfp677	15518	+	NM_172486	21529485	21535551	4
chr17	21560190	21572348	Zfp54	12158	+	NM_011760	21564762	21571967	4
chr17	21587337	21602553	Zfp51	15216	+	NM_009558	21589463	21602434	5
chr17	21625951	21647441	Zfp53	21490	+	NM_013843	21628219	21646629	5
chr17	21665159	21672842	9330136K24Rik	7683	-	NR_131123	21672842	21672842	3
chr17	21672502	21699565	Zfp52	27063	+	NM_144515	21692009	21699030	5
chr17	21704009	21725649	Zfp948	21640	+	NM_001002008	21720079	21725518	6
chr17	21787577	21801933	3110052M02Rik	14356	+	NM_001166497	21794548	21799507	6
chr17	21827178	21829180	Gm10509	2002	+	NR_045766	21829180	21829180	1
chr17	21844707	21862603	Zfp760	17896	+	NM_001008501	21856074	21860813	6
chr17	21870690	21885936	Zfp229	15246	+	NM_001164676	21876449	21883875	6
chr17	21953842	21982726	Zfp820	28884	-	NM_029281	21955662	21960840	5
chr17	22016536	22046893	2210404O09Rik	30357	-	NM_001256493	22016904	22024307	5
chr17	22063929	22099431	Zfp942	35502	-	NM_001199048	22065152	22069989	6
chr17	22099525	22131333	Zfp943	31808	+	NM_001025373	22125038	22130425	4
chr17	22281325	22302944	Zfp947	21619	-	NM_177596	22282344	22287031	5
chr17	22334231	22362581	Gm4944	28350	-	NM_001205095	22336947	22342301	5
chr17	22474955	22498367	Zfp944	23412	-	NM_176962	22475752	22480636	6
chr17	22498419	22514248	Zfp758	15829	+	NM_145484	22509025	22513253	4
chr17	22561234	22593656	Zfp946	32422	+	NM_198003	22588089	22592805	7
chr17	22684907	22710240	Vmn2r111	25333	-	NM_001104573	22684907	22710240	6
chr17	22738114	22756100	Vmn2r112	17986	+	NM_001104575	22738114	22756100	6
chr17	22913196	22954714	Gm16386	41518	-	NR_030709	22954714	22954714	5
chr17	22983663	23004101	Zfp945	20438	-	NM_177358	22987568	22998502	6
chr17	23080150	23095781	Vmn2r113	15631	+	NM_001104578	23080150	23095781	6
chr17	23141937	23143626	Vmn2r-ps129	1689	+	NR_033648	23143626	23143626	1
chr17	23310835	23330195	Zfp40	19360	-	NM_009555	23312187	23328346	6
chr17	23427900	23449280	Vmn2r114	21380	-	NM_001102584	23427900	23449280	6
chr17	23480943	23497095	Vmn2r115	16152	+	NM_001104579	23480943	23497095	6
chr17	23521769	23538831	Vmn2r116	17062	+	NM_001104580	23521769	23538831	6
chr17	23596641	23616564	Vmn2r117	19923	-	NM_001104581	23596641	23616564	6
chr17	23687765	23702261	6330415G19Rik	14496	+	NR_126484	23702261	23702261	2
chr17	23693733	23701193	Zfp213	7460	-	NM_001033496	23694626	23698511	6
chr17	23712818	23736454	Zfp13	23636	-	NM_011747	23713023	23722461	6
chr17	23737792	23747986	Zscan10	10194	+	NM_001289484	23742538	23747801	7
chr17	23766424	23782236	Mmp25	15812	-	NM_001033339	23767534	23781821	10
chr17	23797489	23805586	Ccdc64b	8097	+	NM_153784	23798747	23805231	10
chr17	23805585	23810737	Thoc6	5152	-	NM_001008425	23805772	23810519	13
chr17	23810574	23812491	Hcfc1r1	1917	+	NM_181821	23810949	23811986	3
chr17	23812411	23814416	Tnfrsf12a	2005	-	NM_013749	23812957	23814387	4
chr17	23816331	23819414	Cldn6	3083	+	NM_018777	23818030	23818690	3
chr17	23819550	23820993	Cldn9	1443	-	NM_020293	23819962	23820616	1
chr17	23863302	23873696	Pkmyt1	10394	+	NM_023058	23869440	23873573	8
chr17	23873152	23877297	Paqr4	4145	-	NM_023824	23874532	23876992	3
chr17	23878165	23882796	Kremen2	4631	-	NM_028416	23878727	23881992	10
chr17	23886202	23891032	9530082P21Rik	4830	+	NR_015472	23891032	23891032	3
chr17	23892389	23908558	Flywch1	16169	-	NM_153791	23892609	23900195	7
chr17	23913884	23923044	Flywch2	9160	-	NM_029798	23913968	23916916	3
chr17	23940153	23961710	Srrm2	21557	+	NM_175229	23945078	23961192	14
chr17	23960257	23960336	Mir5125	79	+	NR_039586	23960336	23960336	1
chr17	23961706	23966076	Tceb2	4370	-	NM_026305	23961833	23966052	4
chr17	23970327	23972734	Prss33	2407	-	NM_001081399	23970831	23972689	6
chr17	23973751	23981123	Prss41	7372	-	NM_027644	23973875	23981104	7
chr17	23990738	23996743	Prss32	6005	+	NM_027220	23990763	23996313	5
chr17	24005038	24010080	Prss21	5042	+	NM_020487	24005061	24010001	6
chr17	24017842	24019820	Dcpp1	1978	+	NM_019910	24017973	24019761	4
chr17	24035688	24037754	Dcpp2	2066	+	NM_001039238	24035814	24037696	4
chr17	24054424	24056408	Dcpp3	1984	+	NM_001077633	24054551	24056349	4
chr17	24078962	24082574	Sbp	3612	+	NM_011321	24079412	24082412	4
chr17	24090051	24092240	Sbpl	2189	-	NM_001077421	24090211	24091875	4
chr17	24109093	24112197	Prss30	3104	-	NM_013921	24109579	24112147	6
chr17	24130500	24135067	Prss22	4567	-	NM_133731	24130804	24134971	6
chr17	24175209	24182916	Prss27	7707	+	NM_175440	24175273	24182818	6
chr17	24184686	24210452	Kctd5	25766	-	NM_027008	24186381	24210395	6
chr17	24210646	24287889	Pdpk1	77243	-	NM_001286662	24215992	24248027	14
chr17	24292799	24300700	Amdhd2	7901	-	NM_172935	24292963	24300631	11
chr17	24300831	24306340	Atp6v0c-ps2	5509	-	NR_037854	24306340	24306340	3
chr17	24300832	24306374	Atp6v0c	5542	-	NM_009729	24301370	24306229	3
chr17	24312375	24342507	Tbc1d24	30132	-	NM_001163848	24318185	24323113	10
chr17	24340790	24346332	Ntn3	5542	-	NM_010947	24343542	24345931	6
chr17	24352000	24357714	1600002H07Rik	5714	-	NM_028056	24352803	24357685	10
chr17	24360176	24388354	Ccnf	28178	-	NM_007634	24360842	24388255	17
chr17	24371471	24371549	Mir5134	78	-	NR_039596	24371549	24371549	1
chr17	24377828	24377892	Mir6965	64	-	NR_105930	24377892	24377892	1
chr17	24401223	24484197	Abca17	82974	-	NM_001031621	24401223	24484197	30
chr17	24488967	24547149	Abca3	58182	+	NM_013855	24501477	24546345	33
chr17	24546425	24551458	D330041H03Rik	5033	-	NR_033554	24551458	24551458	6
chr17	24551619	24562842	Rnps1	11223	+	NM_009070	24555092	24562130	9
chr17	24563627	24576261	Eci1	12634	+	NM_010023	24563647	24576060	7
chr17	24577712	24580046	Dnase1l2	2334	-	NM_025718	24578000	24579728	8
chr17	24580722	24592337	E4f1	11615	-	NM_001301784	24580925	24592233	14
chr17	24607417	24608541	Pgp	1124	+	NM_025954	24607454	24608512	2
chr17	24610494	24616023	Mlst8	5529	-	NM_019988	24612777	24615393	9
chr17	24610828	24612414	Bricd5	1586	+	NM_175682	24611165	24612279	5
chr17	24625727	24645852	Caskin1	20125	+	NM_027937	24625914	24644161	20
chr17	24645794	24664883	Traf7	19089	-	NM_001172113	24646288	24656153	21
chr17	24665195	24665689	Rab26os	494	+	NR_045289	24665689	24665689	2
chr17	24665998	24670692	Rab26	4694	-	NM_177375	24666485	24670528	9
chr17	24686894	24733459	Pkd1	46565	+	NM_013630	24687207	24732484	46
chr17	24732760	24769572	Tsc2	36812	-	NM_001286713	24733549	24769027	42
chr17	24769626	24775783	Nthl1	6157	+	NM_008743	24769696	24775676	6
chr17	24776226	24787250	Slc9a3r2	11024	-	NM_023055	24777175	24787095	7
chr17	24794274	24795370	Npw	1096	-	NM_001099664	24794349	24795370	2
chr17	24806696	24818961	Zfp598	12265	+	NM_183149	24806702	24818407	12
chr17	24822036	24826894	Syngr3	4858	-	NM_011522	24823175	24826764	4
chr17	24830135	24833101	Gfer	2966	-	NM_023040	24831224	24833012	3
chr17	24833178	24837474	Noxo1	4296	+	NM_027988	24835287	24837300	9
chr17	24837597	24844598	Tbl3	7001	-	NM_145396	24837617	24844509	22
chr17	24852784	24855002	Rnf151	2218	-	NM_026205	24853180	24854930	4
chr17	24856475	24856910	Snhg9	435	-	NR_027900	24856910	24856910	2
chr17	24856620	24856777	Snora78	157	-	NR_028515	24856777	24856777	1
chr17	24857007	24858872	Rps2	1865	+	NM_008503	24857220	24858828	6
chr17	24857733	24857850	Snora64	117	+	NR_002897	24857850	24857850	1
chr17	24859011	24861333	Ndufb10	2322	-	NM_026684	24859061	24861279	4
chr17	24864773	24873094	Rpl3l	8321	+	NM_001163945	24864828	24873001	10
chr17	24873586	24879723	Msrb1	6137	+	NM_013759	24873652	24878882	5
chr17	24889947	24895629	Hs3st6	5682	+	NM_001012402	24890030	24895521	2
chr17	24941326	24976732	Meiob	35406	+	NM_029197	24949957	24976482	14
chr17	24985840	24987247	Fahd1	1407	-	NM_023480	24986362	24987046	1
chr17	24987434	25001395	Hagh	13961	+	NM_024284	24987537	25001237	9
chr17	25015714	25018953	Igfals	3239	+	NM_008340	25015753	25018693	2
chr17	25019555	25023295	Nubp2	3740	-	NM_011956	25020113	25023251	7
chr17	25023618	25029092	Spsb3	5474	+	NM_001163751	25023624	25028648	7
chr17	25029096	25032032	Eme2	2936	-	NM_001163102	25029457	25031994	8
chr17	25032064	25033218	Mrps34	1154	+	NM_023260	25032112	25033025	3
chr17	25033444	25034474	Nme3	1030	+	NM_019730	25033458	25034276	5
chr17	25034450	25073922	Mapk8ip3	39472	-	NM_001163449	25035892	25073799	33
chr17	25079414	25097568	Hn1l	18154	-	NM_198937	25081435	25097556	5
chr17	25098170	25152175	Cramp1l	54005	-	NM_020608	25101726	25150969	21
chr17	25153030	25236442	Ift140	83412	+	NM_134126	25155736	25235883	30
chr17	25194646	25218059	Tmem204	23413	-	NM_001001183	25195173	25217488	3
chr17	25236513	25252912	Telo2	16399	-	NM_001163661	25236952	25252216	21
chr17	25257704	25262213	Ptx4	4509	+	NM_026747	25257795	25262171	3
chr17	25270335	25299048	Clcn7	28713	+	NM_011930	25270421	25297476	25
chr17	25299405	25308858	Ccdc154	9453	+	NM_001079929	25299786	25308827	17
chr17	25321505	25324607	BC003965	3102	+	NM_183150	25321553	25322043	2
chr17	25325344	25371387	Unkl	46043	+	NM_001197024	25325360	25368812	15
chr17	25371261	25377061	Gnptg	5800	-	NM_172529	25371566	25377056	11
chr17	25377114	25379744	Tsr3	2630	+	NM_001163718	25377197	25379606	6
chr17	25379603	25393309	Baiap3	13706	-	NM_001163270	25380582	25389080	34
chr17	25382495	25382583	Mir3547	88	-	NR_105931	25382583	25382583	1
chr17	25397455	25411255	Ube2i	13800	-	NM_011665	25399372	25406413	7
chr17	25411068	25412473	Gm17801	1405	+	NR_027452	25412473	25412473	1
chr17	25435338	25437106	Prss34	1768	+	NM_178372	25435438	25436947	5
chr17	25445590	25448821	Prss28	3231	+	NM_053259	25446349	25448617	6
chr17	25455598	25459629	Prss29	4031	+	NM_053260	25457227	25459452	6
chr17	25480189	25482507	Tpsab1	2318	-	NM_031187	25480363	25482312	5
chr17	25503277	25505037	Tpsb2	1760	+	NM_010781	25503496	25504791	6
chr17	25507497	25511387	Tpsg1	3890	+	NM_012034	25507596	25511205	5
chr17	25511231	25570728	Cacna1h	59497	-	NM_001163691	25513050	25570113	35
chr17	25608534	25613539	Tekt4	5005	+	NM_027951	25608666	25613483	6
chr17	25626819	25634233	Sstr5	7414	-	NM_011425	25628109	25629198	3
chr17	25702837	25707631	Sox8	4794	-	NM_011447	25704277	25707467	3
chr17	25707755	25711988	2810468N07Rik	4233	+	NR_045176	25711988	25711988	2
chr17	25716118	25799771	Lmf1	83653	+	NM_029624	25716131	25799648	11
chr17	25854116	25856047	Gng13	1931	+	NM_022422	25855645	25855977	3
chr17	25855974	25864360	Chtf18	8386	-	NM_145409	25856092	25864282	22
chr17	25864695	25868401	Rpusd1	3706	+	NM_028009	25865154	25867723	6
chr17	25872984	25885275	Mslnl	12291	+	NM_177822	25873865	25885025	16
chr17	25885557	25891272	Msln	5715	-	NM_018857	25885686	25891164	16
chr17	25910720	25920277	Narfl	9557	+	NM_026238	25910766	25919199	11
chr17	25916787	25922531	Haghl	5744	-	NM_001271435	25917059	25922053	9
chr17	25917752	25917824	Mir6966	72	+	NR_105932	25917824	25917824	1
chr17	25923524	25927458	Ccdc78	3934	+	NM_001165929	25923560	25927157	13
chr17	25927444	25929339	Fam173a	1895	-	NM_145410	25927492	25929159	5
chr17	25931515	25933990	Metrn	2475	-	NM_133719	25931919	25933907	4
chr17	25946029	25958210	Fbxl16	12181	+	NM_001164225	25953375	25956467	6
chr17	25960571	25965675	Wdr24	5104	+	NM_173741	25961150	25965528	9
chr17	25965987	25968788	Jmjd8	2801	+	NM_028101	25966010	25967535	9
chr17	25967580	25970306	Stub1	2726	-	NM_019719	25967829	25969798	7
chr17	25968309	25968373	Mir3082	64	-	NR_037243	25968373	25968373	1
chr17	25971409	25974072	Rhbdl1	2663	-	NM_144816	25971729	25973971	8
chr17	25975782	25981796	Rhot2	6014	-	NM_145999	25976312	25981381	19
chr17	25981678	25998460	Wdr90	16782	-	NM_001163766	25982012	25998405	41
chr17	26000642	26005683	Fam195a	5041	-	NM_026633	26000913	26005621	5
chr17	26012444	26014108	0610011F06Rik	1664	+	NM_026686	26012474	26013942	6
chr17	26014572	26017803	Wfikkn1	3231	-	NM_001100454	26014634	26016988	2
chr17	26019058	26056659	Rab40c	37601	-	NM_139154	26020572	26056451	7
chr17	26038800	26039172	Gm10012	372	-	NR_028042	26039172	26039172	1
chr17	26063364	26078934	Pigq	15570	-	NM_001291025	26064548	26074397	12
chr17	26079177	26081876	Nhlrc4	2699	-	NM_001039038	26080305	26080716	2
chr17	26096500	26102450	Capn15	5950	-	NM_015830	26096500	26102450	11
chr17	26125980	26206122	Rab11fip3	80142	-	NM_001162869	26127716	26206122	15
chr17	26218155	26227109	Decr2	8954	-	NM_011933	26219820	26226988	9
chr17	26228689	26232415	Nme4	3726	-	NM_019731	26228973	26232397	5
chr17	26250260	26260198	Tmem8	9938	+	NM_021793	26250394	26259179	13
chr17	26260447	26263558	Mrpl28	3111	+	NM_024227	26260506	26263326	5
chr17	26275630	26332756	Axin1	57126	+	NM_009733	26279628	26332006	11
chr17	26332943	26336032	Pdia2	3089	-	NM_001081070	26333026	26335978	11
chr17	26336127	26338295	Arhgdig	2168	-	NM_008113	26336274	26338088	6
chr17	26339906	26348269	Rgs11	8363	+	NM_001081069	26339917	26347675	17
chr17	26349636	26381187	Fam234a	31551	-	NM_001206335	26350450	26357493	13
chr17	26389854	26422451	Luc7l	32597	+	NM_028190	26389975	26418711	10
chr17	26551909	26583287	Neurl1b	31378	+	NM_001081656	26551909	26578740	5
chr17	26642535	26645417	Dusp1	2882	-	NM_013642	26643224	26645268	4
chr17	26698456	26793878	Ergic1	95422	+	NM_026170	26698557	26792119	10
chr17	26813340	26836591	Atp6v0e	23251	+	NM_025272	26813419	26832393	4
chr17	26852594	26913571	Crebrf	60977	+	NM_029870	26873919	26908352	9
chr17	26918023	26929466	Bnip1	11443	+	NM_172149	26918037	26929082	6
chr17	26975609	26978510	Nkx2-5	2901	-	NM_008700	26975966	26978300	2
chr17	27054035	27069524	Kifc5b	15489	+	NM_053173	27054212	27069093	11
chr17	27057906	27057964	Gm27740	58	+	NR_128569	27057964	27057964	1
chr17	27057906	27057964	Gm27775	58	+	NR_105933	27057964	27057964	1
chr17	27070071	27074853	Phf1	4782	+	NM_009343	27071154	27074510	15
chr17	27072416	27072484	Mir6968	68	+	NR_105934	27072484	27072484	1
chr17	27074916	27076483	Cuta	1567	-	NM_026307	27074994	27076303	7
chr17	27078396	27107590	Syngap1	29194	+	NM_001281491	27078396	27107590	19
chr17	27085000	27085064	Mir3083	64	-	NR_037244	27085064	27085064	1
chr17	27110123	27113148	Zbtb9	3025	+	NM_001005916	27110567	27111947	2
chr17	27154979	27173322	Ggnbp1	18343	+	NM_001251881	27155074	27173111	7
chr17	27156756	27165571	Bak1	8815	-	NM_007523	27157875	27162801	6
chr17	27194248	27259168	Itpr3	64920	+	NM_080553	27194530	27258473	58
chr17	27228189	27228256	Mir7677	67	+	NR_106142	27228256	27228256	1
chr17	27259609	27270836	Uqcc2	11227	-	NM_026063	27259657	27270822	4
chr17	27280915	27304709	Ip6k3	23794	-	NM_173027	27281826	27294680	6
chr17	27326544	27341383	Lemd2	14839	-	NM_146075	27327584	27341363	9
chr17	27372019	27385011	9630028I04Rik	12992	-	NR_131118	27385011	27385011	3
chr17	27453979	27454040	Mir7214	61	-	NR_106073	27454040	27454040	1
chr17	27465329	27465405	Mir7216	76	+	NR_106075	27465405	27465405	1
chr17	27492682	27492744	Mir7217	62	+	NR_106076	27492744	27492744	1
chr17	27495041	27495100	Mir7218	59	+	NR_106077	27495100	27495100	1
chr17	27559332	27640478	Grm4	81146	-	NM_001013385	27559669	27640110	9
chr17	27693518	27700617	Hmga1	7099	+	NM_001039356	27696513	27699436	6
chr17	27693597	27700616	Hmga1-rs1	7019	+	NM_001166477	27696513	27699436	5
chr17	27700713	27702672	AI413582	1959	-	NM_001002895	27700895	27701617	5
chr17	27716335	27760397	Nudt3	44062	-	NM_019837	27717732	27760130	5
chr17	27767373	27772187	Rps10	4814	-	NM_025963	27767409	27771420	6
chr17	27792535	27848062	Pacsin1	55527	+	NM_001286743	27838832	27845480	10
chr17	27851391	27865896	Spdef	14505	-	NM_013891	27851812	27857315	6
chr17	27888176	27957487	D17Wsu92e	69311	-	NM_001033279	27890904	27957279	5
chr17	27977031	27988912	Snrpc	11881	+	NM_011432	27977106	27988707	6
chr17	27993451	28036985	Uhrf1bp1	43534	+	NM_001080769	27993695	28032952	21
chr17	28038072	28044669	Taf11	6597	-	NM_026836	28038603	28044616	5
chr17	28046250	28199724	Anks1	153474	+	NM_181413	28046406	28197510	25
chr17	28203691	28217584	Tcp11	13893	-	NM_001085555	28203880	28217224	10
chr17	28279470	28308290	Scube3	28820	+	NM_001004366	28279470	28308290	22
chr17	28314362	28342831	Zfp523	28469	+	NM_172617	28326824	28342154	15
chr17	28344722	28365553	Def6	20831	+	NM_027185	28344787	28365234	11
chr17	28369698	28438414	Ppard	68716	+	NM_011145	28423285	28436794	8
chr17	28408652	28410108	1810013A23Rik	1456	+	NR_045427	28410108	28410108	3
chr17	28450474	28463519	Fance	13045	+	NM_001163819	28450588	28463198	10
chr17	28465415	28467978	Rpl10a	2563	+	NM_011287	28465558	28467945	6
chr17	28468617	28487750	Tead3	19133	-	NM_011566	28469664	28478495	13
chr17	28488463	28502088	Tulp1	13625	-	NM_021478	28488813	28502062	15
chr17	28535697	28623094	Fkbp5	87397	-	NM_010220	28537991	28577977	11
chr17	28667805	28675920	Armc12	8115	+	NM_026290	28667828	28675863	6
chr17	28686431	28689563	Clpsl2	3132	+	NM_001034871	28686458	28689455	3
chr17	28695154	28697711	Clps	2557	-	NM_025469	28695253	28697602	3
chr17	28695385	28695446	Mir6969	61	-	NR_105935	28695446	28695446	1
chr17	28712663	28720538	Lhfpl5	7875	+	NM_026571	28712945	28719935	4
chr17	28726536	28759399	Srpk1	32863	-	NM_016795	28727001	28759357	16
chr17	28774723	28826932	Slc26a8	52209	-	NM_001290320	28775112	28821833	20
chr17	28828286	28885350	Mapk14	57064	+	NM_001168514	28850833	28883283	13
chr17	28906261	28915649	Mapk13	9388	+	NM_011950	28906354	28915455	12
chr17	28938070	28975734	Brpf3	37664	+	NM_001081315	28942899	28973638	13
chr17	28995355	29027253	Pnpla1	31898	+	NM_001034885	28995811	29025026	10
chr17	29033339	29052269	4930539E08Rik	18930	-	NM_172450	29035832	29052178	12
chr17	29042209	29043716	1700030A11Rik	1507	+	NR_045457	29043716	29043716	3
chr17	29070930	29079207	Pxt1	8277	-	NM_153390	29071646	29078237	3
chr17	29090160	29104882	Kctd20	14722	+	NM_025888	29094842	29103889	8
chr17	29107829	29144882	Stk38	37053	-	NM_134115	29109490	29137084	14
chr17	29169604	29180317	Srsf3	10713	+	NR_036613	29180317	29180317	7
chr17	29194418	29216071	Trp53cor1	21653	-	NR_036469	29216071	29216071	2
chr17	29227923	29237667	Cdkn1a	9744	+	NM_001111099	29235352	29236338	3
chr17	29272000	29285921	Rab44	13921	+	NM_001002786	29273226	29285220	8
chr17	29293465	29374735	Cpne5	81270	-	NM_153166	29295966	29374652	21
chr17	29387779	29400916	Ppil1	13137	-	NM_026845	29388449	29400872	4
chr17	29405732	29439832	BC004004	34100	+	NM_030561	29419023	29438395	9
chr17	29455826	29465847	Pi16	10021	+	NM_023734	29456159	29464895	7
chr17	29469020	29484849	Mtch1	15829	-	NM_019880	29469651	29484732	12
chr17	29497858	29516480	Fgd2	18622	+	NM_013710	29498037	29516005	16
chr17	29627989	29632404	Pim1	4415	+	NM_008842	29628088	29631692	6
chr17	29662962	29686538	Tmem217	23576	-	NM_001162901	29663129	29663699	3
chr17	29686746	29743753	Tbc1d22b	57007	+	NM_198647	29686883	29741917	13
chr17	29715760	29733250	Tbc1d22bos	17490	-	NR_045447	29733250	29733250	4
chr17	29732482	29732545	Mir7667	63	+	NR_106127	29732545	29732545	1
chr17	29751733	29778609	Rnf8	26876	+	NM_021419	29751912	29778177	8
chr17	29751733	29842924	Rnf8-cmtr1	91191	+	NR_132314	29842924	29842924	28
chr17	29797539	29842924	Cmtr1	45385	+	NM_028791	29800121	29839240	24
chr17	29832921	29853962	Ccdc167	21041	-	NM_001163741	29837172	29853920	5
chr17	29964902	30024827	Mdga1	59925	-	NM_001081160	29969252	30024458	16
chr17	30142031	30346965	Zfand3	204934	+	NM_148926	30142182	30345117	5
chr17	30352468	30713232	Btbd9	360764	-	NM_172618	30357317	30667283	12
chr17	30393401	30393480	Mir6412	79	-	NR_105839	30393480	30393480	2
chr17	30531769	30533125	Gm6402	1356	-	NR_030688	30533125	30533125	1
chr17	30729806	30749604	Glo1	19798	-	NM_001113560	30731082	30749496	7
chr17	30759385	30763850	1700097N02Rik	4465	-	NR_045287	30763850	30763850	4
chr17	30763880	31012209	Dnah8	248329	+	NM_013811	30772310	31012074	93
chr17	31038811	31073455	Glp1r	34644	+	NM_021332	31038821	31073377	13
chr17	31091627	31147655	Umodl1	56028	+	NM_177465	31091692	31145686	22
chr17	31194638	31254926	Abcg1	60288	+	NM_009593	31194759	31251230	15
chr17	31262250	31266556	Tff3	4306	-	NM_011575	31262427	31266521	3
chr17	31278006	31281227	Tff2	3221	-	NM_009363	31278153	31281193	4
chr17	31316211	31335919	Tmprss3	19708	-	NM_001163776	31317530	31335790	13
chr17	31345010	31379348	Ubash3a	34338	+	NM_177823	31345063	31378323	14
chr17	31391964	31414301	Rsph1	22337	-	NM_025290	31392120	31414200	9
chr17	31432427	31487643	Slc37a1	55216	+	NM_153062	31437396	31486742	20
chr17	31523178	31613254	Pde9a	90076	+	NM_001163748	31523232	31610204	19
chr17	31631266	31649432	Wdr4	18166	-	NM_021322	31633682	31649329	11
chr17	31657059	31668270	Ndufv3	11211	+	NM_030087	31657158	31668197	4
chr17	31701717	31744638	Pknox1	42921	+	NR_027493	31744638	31744638	12
chr17	31749567	31774150	Cbs	24583	-	NM_144855	31750134	31769972	17
chr17	31784026	31795699	U2af1	11673	-	NM_024187	31784155	31795641	8
chr17	31814875	31818675	Cryaa	3800	+	NM_013501	31814945	31818140	4
chr17	31981194	31992737	Sik1	11543	-	NM_010831	31983227	31991994	14
chr17	32081713	32171453	Hsf2bp	89740	-	NM_028902	32083547	32171437	8
chr17	32173106	32199807	Rrp1b	26701	+	NM_028244	32173419	32197486	16
chr17	32213027	32228368	Pdxk-ps	15341	-	NR_027316	32228368	32228368	9
chr17	32257837	32303797	Notch3	45960	-	NM_008716	32258764	32303738	33
chr17	32320714	32326408	Ephx3	5694	-	NM_001033163	32321840	32326393	7
chr17	32333216	32421078	Brd4	87862	-	NM_020508	32334696	32366646	20
chr17	32378864	32379800	Gm4432	936	+	NR_102329	32379800	32379800	1
chr17	32440616	32458183	Akap8	17567	-	NM_019774	32442201	32458048	14
chr17	32458368	32487522	Akap8l	29154	-	NM_017476	32458436	32487444	14
chr17	32490994	32526384	Wiz	35390	-	NR_033525	32526384	32526384	11
chr17	32527605	32540526	Rasal3	12921	-	NM_178785	32528024	32540394	17
chr17	32539958	32541753	A530088E08Rik	1795	+	NR_029458	32541753	32541753	1
chr17	32549405	32561112	Pglyrp2	11707	-	NM_001271476	32550407	32557808	6
chr17	32589667	32630265	Cyp4f39	40598	+	NM_177307	32605406	32629424	14
chr17	32643406	32665839	Cyp4f17	22433	+	NM_001101445	32643839	32665839	13
chr17	32673573	32688742	Cyp4f16	15169	+	NM_024442	32673943	32688178	13
chr17	32758263	32773129	Cyp4f37	14866	+	NM_001100187	32758639	32772164	13
chr17	32796427	32813425	Cyp4f40	16998	+	NM_001101588	32796430	32813425	12
chr17	32822603	32840294	Cyp4f15	17691	+	NM_134127	32822742	32839905	13
chr17	32902441	32925232	Zfp871	22791	-	NM_172458	32911296	32925085	4
chr17	32932620	32946876	Zfp811	14256	-	NM_183177	32934350	32946729	4
chr17	32952397	32967206	Zfp799	14809	-	NM_177359	32956288	32967036	4
chr17	33016165	33028548	Zfp870	12383	-	NM_207245	33019615	33028388	4
chr17	33042014	33054287	Cyp4f14	12273	-	NM_001204336	33042445	33053830	13
chr17	33061632	33084306	Cyp4f13	22674	-	NM_130882	33061721	33083947	13
chr17	33087905	33102661	Cyp4f41-ps	14756	-	NR_033585	33102661	33102661	3
chr17	33102775	33116156	Zfp472	13381	+	NM_153063	33102853	33115502	4
chr17	33130083	33142402	Zfp952	12319	+	NM_001045559	33130182	33141008	4
chr17	33153808	33170326	Zfp763	16518	-	NM_028543	33155347	33170247	4
chr17	33201087	33205003	4921501E09Rik	3916	-	NM_001009544	33202044	33204771	1
chr17	33226311	33247649	Zfp563	21338	+	NM_001024950	33226421	33242724	4
chr17	33272534	33276628	Morc2b	4094	-	NM_177719	33272672	33275741	2
chr17	33313360	33314308	Olfr55	948	+	NM_010998	33313360	33314308	1
chr17	33336006	33336954	Olfr239	948	+	NM_207175	33336006	33336954	1
chr17	33352205	33353296	Gm4461	1091	-	NM_001199062	33352339	33353296	1
chr17	33376451	33392090	Zfp955a	15639	-	NM_029952	33378463	33391985	4
chr17	33405670	33406621	Olfr63	951	+	NM_146937	33405670	33406621	1
chr17	33426488	33441634	Zfp955b	15146	+	NM_001142957	33426593	33440141	4
chr17	33470672	33495823	Zfp81	25151	-	NM_207541	33471187	33495681	4
chr17	33517123	33531582	Zfp101	14459	-	NM_009542	33517886	33531453	4
chr17	33569843	33571212	Actl9	1369	+	NM_183282	33569912	33571160	1
chr17	33661140	33690727	Adamts10	29587	+	NM_172619	33665327	33690139	25
chr17	33692651	33744709	Myo1f	52058	+	NM_053214	33692798	33744320	28
chr17	33766036	33768659	Zfp414	2623	+	NR_034153	33768659	33768659	7
chr17	33775000	33782651	Pram1	7651	+	NM_001002842	33775119	33782520	10
chr17	33783177	33822403	Hnrnpm	39226	-	NM_001109913	33783440	33822324	17
chr17	33822636	33855622	March2	32986	-	NR_045522	33855622	33855622	7
chr17	33879428	33897431	Rab11b	18003	-	NM_008997	33884612	33897207	5
chr17	33911844	33918520	Angptl4	6676	-	NM_020581	33912331	33918337	7
chr17	33947467	33959859	Kank3	12392	+	NM_030697	33953156	33959670	11
chr17	33959981	33961443	Rps28	1462	-	NM_016844	33960152	33961417	4
chr17	33961516	33975261	Ndufa7	13745	+	NM_023202	33961574	33975134	4
chr17	33980035	33986719	Cd320	6684	+	NM_019421	33980115	33985373	5
chr17	34012610	34027578	Kifc1	14968	-	NM_001195298	34012769	34027440	11
chr17	34042079	34043620	Platr17	1541	+	NR_040470	34043620	34043620	3
chr17	34045126	34046123	BC051226	997	-	NR_045146	34046123	34046123	2
chr17	34046389	34052535	Daxx	6146	+	NM_007829	34047391	34052347	8
chr17	34053120	34056270	Zbtb22	3150	+	NM_020625	34053827	34055744	2
chr17	34056422	34066235	Tapbp	9813	+	NM_009318	34056632	34065096	8
chr17	34066838	34074632	Rgl2	7794	+	NM_009059	34067230	34074221	18
chr17	34075853	34077288	Pfdn6	1435	-	NM_010385	34075932	34077032	4
chr17	34077667	34086640	Wdr46	8973	+	NM_020603	34077682	34086360	15
chr17	34086856	34088433	B3galt4	1577	-	NM_019420	34087091	34088207	1
chr17	34088943	34092586	Rps18	3643	-	NM_011296	34088987	34092565	5
chr17	34092826	34103433	Vps52	10607	+	NM_172620	34093037	34103050	20
chr17	34111603	34115736	H2-K2	4133	-	NR_004446	34115736	34115736	6
chr17	34118436	34122303	AA388235	3867	+	NR_033305	34122303	34122303	1
chr17	34132956	34137278	H2-K1	4322	-	NM_001001892	34133416	34137202	8
chr17	34157736	34161625	Ring1	3889	-	NM_009066	34158326	34161311	7
chr17	34161927	34162037	Mir219a-1	110	-	NR_029800	34162037	34162037	1
chr17	34161956	34162016	Mir219c	60	+	NR_106154	34162016	34162016	1
chr17	34162977	34165000	H2-Ke6	2023	-	NM_013543	34163153	34164992	9
chr17	34165210	34168635	Slc39a7	3425	-	NM_001077709	34165740	34168203	8
chr17	34168756	34175348	Rxrb	6592	+	NM_001205214	34168942	34174476	10
chr17	34176082	34203629	Col11a2	27547	+	NM_001317722	34176599	34202753	65
chr17	34220787	34232254	BC051537	11467	-	NR_046183	34232254	34232254	5
chr17	34229323	34232179	H2-Oa	2856	+	NM_008206	34229391	34231951	5
chr17	34248963	34259552	Brd2	10589	-	NM_001204973	34249519	34255576	13
chr17	34259776	34276046	H2-DMa	16270	+	NM_010386	34272615	34275766	6
chr17	34282360	34288040	H2-DMb2	5680	+	NM_010388	34282360	34288040	6
chr17	34290135	34297174	H2-DMb1	7039	+	NM_010387	34290343	34296884	6
chr17	34319043	34324275	Psmb9	5232	-	NM_013585	34319168	34324254	6
chr17	34324500	34334170	Tap1	9670	+	NM_001161730	34324824	34333719	12
chr17	34335139	34338399	Psmb8	3260	+	NM_010724	34335343	34338211	6
chr17	34341423	34353266	Tap2	11843	+	NM_011530	34342239	34353038	12
chr17	34375849	34382853	H2-Ob	7004	+	NM_010389	34375916	34381066	6
chr17	34400171	34406363	H2-Ab1	6192	+	NM_207105	34400256	34406053	6
chr17	34419695	34424716	H2-Aa	5021	-	NM_010378	34420119	34424711	5
chr17	34442811	34453619	H2-Eb1	10808	+	NM_010382	34442898	34452832	6
chr17	34462619	34478355	H2-Eb2	15736	+	NM_001033978	34462636	34475856	5
chr17	34479156	34481590	H2-Ea-ps	2434	-	NM_010381	34479877	34481590	4
chr17	34491766	34506437	Btnl2	14671	+	NM_079835	34493166	34505673	9
chr17	34514076	34522973	Btnl1	8897	+	NM_001111094	34514839	34522721	10
chr17	34535764	34597679	BC051142	61915	+	NM_001163855	34554465	34597195	24
chr17	34605986	34612882	Btnl4	6896	-	NM_030746	34605986	34612882	9
chr17	34624350	34634374	Btnl5-ps	10024	-	NR_004051	34634374	34634374	9
chr17	34644879	34654297	Btnl6	9418	-	NM_030747	34644879	34654297	9
chr17	34701239	34725488	Notch4	24249	+	NM_010929	34701390	34724930	30
chr17	34726750	34728699	Gpsm3	1949	+	NM_134116	34727166	34728252	4
chr17	34729415	34734286	Pbx2	4871	+	NM_017463	34729498	34732861	9
chr17	34734794	34737882	Ager	3088	+	NM_007425	34734838	34737748	11
chr17	34738043	34740506	Rnf5	2463	-	NM_019403	34738513	34740418	6
chr17	34742805	34750394	Agpat1	7589	+	NM_001163379	34747398	34749382	7
chr17	34750294	34752916	Egfl8	2622	-	NM_152922	34750482	34752212	9
chr17	34753606	34765224	Ppt2	11618	-	NM_001302393	34754288	34763932	9
chr17	34766630	34769205	Prrt1	2575	+	NM_030890	34766630	34769205	4
chr17	34781827	34783272	Fkbpl	1445	+	NM_019873	34782204	34783248	2
chr17	34784090	34792019	Atf6b	7929	+	NM_017406	34784158	34791642	18
chr17	34807479	34856760	Tnxb	49281	+	NM_031176	34807479	34856572	33
chr17	34865325	34880842	C4b	15517	-	NM_009780	34865430	34880771	41
chr17	34938292	34941371	Cyp21a1	3079	-	NM_009995	34938724	34941344	10
chr17	34946036	34960399	C4a	14363	-	NM_011413	34946141	34960350	41
chr17	34960937	34973848	Stk19	12911	-	NM_019442	34961223	34973821	7
chr17	34973963	34976131	Dxo	2168	+	NM_033613	34974343	34976082	7
chr17	34976170	34987149	Skiv2l	10979	-	NM_021337	34976349	34987100	28
chr17	34978753	34978816	Mir6971	63	-	NR_105937	34978816	34978816	1
chr17	34982045	34982112	Mir6970	67	-	NR_105936	34982112	34982112	1
chr17	34987335	34993317	Nelfe	5982	+	NM_138580	34987863	34993103	11
chr17	34993318	34999459	Cfb	6141	-	NM_001142706	34993517	34999057	18
chr17	34994513	34994577	Mir6972	64	-	NR_105938	34994577	34994577	1
chr17	34999546	35019045	C2	19499	-	NM_013484	34999802	35018940	18
chr17	35031503	35033789	Zbtb12	2286	+	NM_198886	35032185	35033565	2
chr17	35035436	35050995	Ehmt2	15559	+	NM_001286575	35035443	35050765	28
chr17	35051410	35067381	Slc44a4	15971	+	NM_023557	35051431	35067181	21
chr17	35068197	35074242	Neu1	6045	+	NM_010893	35068351	35071776	6
chr17	35087180	35089416	1110038B12Rik	2236	-	NR_015536	35089416	35089416	4
chr17	35087894	35087953	Snord52	59	-	NR_028527	35087953	35087953	1
chr17	35093373	35096183	Hspa1b	2810	-	NM_010478	35094023	35095952	1
chr17	35106303	35109101	Hspa1a	2798	-	NM_010479	35106944	35108870	1
chr17	35109647	35116173	Hspa1l	6526	+	NM_013558	35113931	35115857	2
chr17	35118798	35122838	Lsm2	4040	+	NM_001110101	35119027	35122487	5
chr17	35133668	35137691	D17H6S56E-5	4023	-	NM_033075	35134630	35137118	2
chr17	35137851	35153274	Vars	15423	+	NM_011690	35138388	35153200	30
chr17	35153523	35163686	Vwa7	10163	+	NM_138582	35154016	35162253	17
chr17	35162919	35164961	Sapcd1	2042	-	NR_028258	35164961	35164961	5
chr17	35165549	35183690	Msh5	18141	-	NM_001146215	35165685	35183319	25
chr17	35187187	35195664	Clic1	8477	+	NM_033444	35187392	35195436	6
chr17	35195979	35199044	Ddah2	3065	+	NM_016765	35197109	35198755	7
chr17	35199637	35203129	G6b	3492	-	NM_001191012	35201276	35203115	6
chr17	35201381	35202541	G6bos	1160	+	NR_001462	35202541	35202541	1
chr17	35204269	35206993	Ly6g6c	2724	+	NM_023463	35204334	35206479	3
chr17	35208292	35211409	Ly6g6d	3117	-	NM_033478	35208489	35211409	3
chr17	35213886	35215749	Ly6g6e	1863	+	NM_027366	35214099	35215230	3
chr17	35217482	35222540	Ly6g6f	5058	-	NM_001163192	35217626	35222519	6
chr17	35226235	35239932	Abhd16a	13697	+	NM_178592	35226269	35239698	20
chr17	35245244	35248898	Ly6g5c	3654	+	NM_148947	35245244	35248898	3
chr17	35250889	35252345	Ly6g5b	1456	-	NM_148939	35251359	35252345	3
chr17	35253139	35258998	Csnk2b	5859	-	NM_001303446	35253279	35258790	7
chr17	35258440	35261760	Gpank1	3320	+	NM_001128597	35259999	35261609	3
chr17	35263346	35265800	D17H6S53E	2454	+	NM_033477	35264059	35264941	3
chr17	35265941	35268697	Apom	2756	-	NM_018816	35266054	35268668	6
chr17	35272122	35284267	Bag6	12145	+	NM_057171	35273072	35284181	25
chr17	35286030	35301822	Prrc2a	15792	-	NM_001199044	35286205	35299928	31
chr17	35307936	35312946	Aif1	5010	-	NM_019467	35308053	35309484	8
chr17	35322039	35325385	Lst1	3346	-	NM_010734	35322123	35325335	4
chr17	35331451	35333250	Ltb	1799	+	NM_008518	35331466	35333091	3
chr17	35331916	35331994	Mir6973a	78	+	NR_105939	35331994	35331994	1
chr17	35336311	35338952	Tnf	2641	-	NM_013693	35337089	35338785	4
chr17	35340109	35342296	Lta	2187	-	NM_010735	35340681	35341598	4
chr17	35341419	35341502	Mir6974	83	-	NR_105940	35341502	35341502	1
chr17	35357119	35372760	Nfkbil1	15641	-	NM_010909	35357334	35372651	4
chr17	35373540	35375712	Atp6v1g2	2172	+	NM_023179	35373708	35374743	3
chr17	35378690	35390652	Ddx39b	11962	+	NM_019693	35380184	35390434	11
chr17	35381019	35381080	Mir6975	61	+	NR_105941	35381080	35381080	1
chr17	35388233	35388350	Mir8094	117	+	NR_106169	35388350	35388350	1
chr17	35400038	35404442	H2-D1	4404	+	NM_010380	35400058	35403815	8
chr17	35400067	35403675	H2-L	3608	+	NM_001267808	35400067	35403675	11
chr17	35402723	35462354	LOC547349	59631	+	NM_001025208	35402723	35462316	4
chr17	35457502	35462044	H2-Q1	4542	+	NM_010390	35457506	35461131	8
chr17	35479277	35482667	H2-Q2	3390	+	NM_010392	35479277	35482651	7
chr17	35516561	35521619	H2-Q4	5058	+	NM_001143689	35516588	35520300	6
chr17	35531043	35532575	H2-Q5	1532	+	NR_051981	35532575	35532575	3
chr17	35561791	35565306	H2-Q8	3515	+	NM_023124	35561821	35565306	5
chr17	35561821	35565306	H2-Q6	3485	+	NM_207648	35561821	35565306	5
chr17	35576099	35580718	H2-Q7	4619	+	NM_010394	35576165	35579732	7
chr17	35576111	35580715	H2-Q9	4604	+	NM_001201460	35576165	35579732	7
chr17	35607033	35611508	H2-Q10	4475	+	NM_010391	35607051	35610513	7
chr17	35642976	35647722	Pou5f1	4746	+	NM_013633	35643044	35647496	5
chr17	35649679	35653769	Tcf19	4090	-	NM_001163764	35650122	35653060	4
chr17	35654060	35667960	Cchcr1	13900	+	NM_146248	35655212	35667779	18
chr17	35670145	35671592	Psors1c2	1447	+	NM_020576	35670184	35671196	2
chr17	35689072	35694125	Cdsn	5053	+	NM_001008424	35689145	35693206	2
chr17	35704429	35705890	2300002M23Rik	1461	+	NM_175148	35704498	35705761	2
chr17	35754867	35763582	Gm9573	8715	-	NM_001244654	35755077	35763382	3
chr17	35772699	35780640	Dpcr1	7941	-	NM_001033366	35773777	35780613	3
chr17	35786652	35787514	Sfta2	862	+	NM_001163194	35786812	35787402	3
chr17	35792579	35804537	Vars2	11958	-	NM_175137	35793501	35804218	29
chr17	35804672	35810688	Gtf2h4	6016	-	NM_010364	35804774	35809770	14
chr17	35818511	35841084	Ddr1	22573	-	NM_007584	35819322	35830820	18
chr17	35909394	35917632	4833427F10Rik	8238	+	NR_045459	35917632	35917632	3
chr17	35958657	35959856	Ier3	1199	+	NM_133662	35958663	35959255	2
chr17	35960301	35969732	Flot1	9431	+	NM_008027	35960765	35969484	13
chr17	35970864	35975246	Tubb5	4382	-	NM_011655	35971926	35974998	4
chr17	35978442	35996615	Mdc1	18173	+	NM_001010833	35981379	35994575	16
chr17	35998262	36002345	Nrm	4083	+	NM_134122	35998329	36001737	4
chr17	36002539	36012541	Ppp1r18	10002	+	NM_001146711	36004179	36011761	4
chr17	36016722	36029613	Dhx16	12891	+	NM_026987	36016856	36029492	20
chr17	36029621	36034323	2310061I04Rik	4702	-	NM_001033630	36029797	36034207	6
chr17	36034540	36047013	Atat1	12473	-	NM_001142744	36034685	36046980	13
chr17	36047329	36053314	Mrps18b	5985	-	NM_025878	36047611	36053308	7
chr17	36054140	36069228	Ppp1r10	15088	+	NM_001163818	36060263	36068203	19
chr17	36054833	36054914	Mir1894	81	+	NR_035445	36054914	36054914	1
chr17	36084098	36090262	Gm8801	6164	+	NR_028278	36090262	36090262	6
chr17	36093763	36106695	Abcf1	12932	-	NM_013854	36094367	36106663	23
chr17	36097674	36097759	Mir877	85	-	NR_030608	36097759	36097759	1
chr17	36109483	36116770	Prr3	7287	-	NM_001282013	36110641	36115359	6
chr17	36116899	36126407	Gnl1	9508	+	NM_008136	36117119	36125707	12
chr17	36131448	36175119	A930015D03Rik	43671	+	NR_015618	36175119	36175119	2
chr17	36142639	36157505	H2-T24	14866	-	NM_008207	36143680	36157456	6
chr17	36166921	36169646	H2-T23	2725	-	NM_010398	36167132	36169614	7
chr17	36175353	36179637	H2-T9	4284	-	NM_010399	36175695	36179371	10
chr17	36175353	36179647	H2-T22	4294	-	NM_010397	36175695	36179371	9
chr17	36179905	36195590	Gm6034	15685	+	NM_001034909	36180074	36194480	3
chr17	36192760	36195316	Gm11127	2556	-	NM_001199967	36192969	36195306	6
chr17	36217133	36221194	H2-Bl	4061	-	NM_008199	36217221	36221192	6
chr17	36245974	36248621	C920025E04Rik	2647	-	NM_001271005	36246378	36248602	7
chr17	36252815	36258389	H2-T10	5574	-	NR_046286	36258389	36258389	10
chr17	36264553	36266370	Gm7030	1817	-	NM_001177467	36264584	36266360	4
chr17	36281962	36299319	2410017I17Rik	17357	+	NR_033517	36299319	36299319	4
chr17	36301388	36305482	Gm8909	4094	-	NM_001081032	36301608	36305452	8
chr17	36315721	36318309	Gm6623	2588	+	NR_033619	36318309	36318309	1
chr17	36322515	36327096	H2-T3	4581	-	NM_008208	36323515	36327073	6
chr17	36392617	36394791	Rpp21	2174	-	NM_026308	36392657	36394784	5
chr17	36395817	36408949	Trim39	13132	-	NM_024468	36397318	36406006	7
chr17	36421225	36423366	H2-M10.2	2141	-	NM_177923	36421225	36423366	5
chr17	36459804	36463095	H2-M10.1	3291	-	NM_013544	36460960	36463095	6
chr17	36501948	36505362	H2-M10.3	3414	-	NM_201608	36503210	36505356	6
chr17	36597108	36599274	H2-M10.4	2166	-	NM_177634	36597108	36599274	5
chr17	36684019	36686197	H2-M11	2178	+	NM_177635	36684019	36686197	5
chr17	36777369	36779589	H2-M9	2220	-	NM_008205	36777369	36779589	5
chr17	36806952	36809142	H2-M1	2190	-	NM_177636	36806952	36809142	5
chr17	36909854	36913180	H2-M10.5	3326	+	NM_177637	36909854	36912015	6
chr17	36949119	36952511	H2-M10.6	3392	+	NM_201611	36949121	36951256	6
chr17	36974090	36996343	Trim26	22253	+	NM_001025599	36987635	36995027	10
chr17	36997635	37004155	Trim15	6520	-	NM_001177872	36998427	37004046	7
chr17	37006518	37014778	Trim10	8260	+	NM_011280	37006823	37014308	7
chr17	37018542	37027070	Trim40	8528	-	NM_001172168	37019340	37026129	6
chr17	37035074	37047162	Trim31	12088	+	NM_146077	37035298	37046662	8
chr17	37060736	37070377	1700031A10Rik	9641	+	NR_045439	37070377	37070377	3
chr17	37079995	37084931	Rnf39	4936	+	NM_001099632	37080032	37084581	4
chr17	37085299	37088737	Ppp1r11	3438	-	NM_029632	37086296	37088451	3
chr17	37091302	37095373	Znrd1	4071	-	NM_023162	37091472	37095229	4
chr17	37095536	37102568	Znrd1as	7032	+	NM_029602	37095627	37102561	3
chr17	37114645	37118182	2410137M14Rik	3537	-	NM_029747	37114926	37118087	4
chr17	37123799	37126449	H2-M5	2650	-	NM_001115075	37123922	37126449	6
chr17	37138107	37147674	Zfp57	9567	+	NM_001168502	37141830	37147466	6
chr17	37147684	37160343	Mog	12659	-	NM_010814	37148448	37160144	8
chr17	37182910	37211250	Gabbr1	28340	+	NM_019439	37183639	37209971	23
chr17	37222135	37223181	Olfr90	1046	-	NM_146477	37222175	37223108	1
chr17	37229878	37230817	Olfr91	939	-	NM_182714	37229878	37230817	1
chr17	37247986	37248925	Olfr92	939	-	NM_146456	37247986	37248925	1
chr17	37287976	37288915	Olfr93	939	-	NM_001011813	37287976	37288915	1
chr17	37330836	37333046	Ubd	2210	+	NM_023137	37330896	37332658	2
chr17	37333750	37334911	Olfr94	1161	-	NM_001011518	37333750	37334911	1
chr17	37347857	37348796	Olfr95	939	-	NM_146513	37347857	37348796	1
chr17	37362071	37363013	Olfr96	942	+	NM_146514	37362071	37363013	1
chr17	37368380	37369313	Olfr97	933	-	NM_146512	37368380	37369313	1
chr17	37399677	37400607	Olfr98	930	-	NM_146510	37399677	37400607	1
chr17	37407178	37411430	H2-M3	4252	+	NM_013819	37407206	37410674	8
chr17	37416445	37417363	Olfr99	918	-	NM_146515	37416445	37417363	1
chr17	37436438	37437365	Olfr101	927	-	NM_146834	37436438	37437365	1
chr17	37450355	37451382	Olfr102	1027	-	NM_001011721	37450400	37451327	1
chr17	37450400	37451327	Olfr100	927	-	NM_207673	37450400	37451327	1
chr17	37473233	37474175	Olfr103	942	-	NM_146833	37473233	37474175	1
chr17	37542421	37543454	Olfr107	1033	+	NM_146511	37542494	37543424	1
chr17	37582424	37583462	Olfr108	1038	+	NM_146465	37582467	37583430	1
chr17	37603152	37604097	Olfr109	945	+	NM_146835	37603152	37604097	1
chr17	37617795	37620474	H2-M2	2679	-	NM_008204	37618408	37620474	4
chr17	37629412	37636619	Olfr110	7207	+	NM_146328	37635597	37636551	2
chr17	37666901	37667942	Olfr111	1041	+	NM_001005485	37666923	37667877	1
chr17	37700183	37706396	Olfr112	6213	-	NM_001013575	37700291	37701254	3
chr17	37711427	37712366	Olfr113	939	-	NM_146289	37711427	37712366	1
chr17	37726357	37727296	Olfr114	939	-	NM_146287	37726357	37727296	1
chr17	37746729	37747724	Olfr115	995	-	NM_001011753	37746761	37747700	1
chr17	37760612	37761578	Olfr116	966	-	NM_146632	37760612	37761578	1
chr17	37796322	37797276	Olfr117	954	-	NM_207155	37796322	37797276	1
chr17	37808969	37809935	Olfr118	966	+	NM_213721	37808969	37809935	1
chr17	37833629	37838582	Olfr119	4953	+	NM_001011830	37837616	37838582	2
chr17	37862943	37863936	Olfr120	993	+	NM_146631	37862943	37863936	1
chr17	37885810	37889949	Olfr121	4139	+	NM_146629	37888800	37889766	2
chr17	37905586	37909565	Olfr122	3979	+	NM_146288	37908599	37909565	2
chr17	37932390	37933320	Olfr123	930	+	NM_146630	37932390	37933320	1
chr17	37942013	37943135	Olfr124	1122	+	NM_147062	37942091	37943039	1
chr17	37971855	37972973	Olfr125	1118	+	NM_146290	37971945	37972908	1
chr17	37987538	37988498	Olfr126	960	+	NM_146890	37987538	37988498	1
chr17	38040492	38041464	Olfr127	972	+	NM_146377	38040492	38041464	1
chr17	38060512	38061439	Olfr128	927	+	NM_206816	38060512	38061439	1
chr17	38088995	38089967	Olfr761	972	-	NM_001011829	38088995	38089967	1
chr17	38191543	38196729	Olfr129	5186	-	NM_146327	38191543	38192509	4
chr17	38204117	38205071	Olfr130	954	+	NM_146487	38204117	38205071	1
chr17	38218976	38219921	Olfr131	945	-	NM_146867	38218976	38219921	1
chr17	38267193	38268135	Olfr132	942	-	NM_001005481	38267193	38268135	1
chr17	38285534	38286473	Olfr133	939	+	NM_146831	38285534	38286473	1
chr17	38312030	38312969	Olfr134	939	+	NM_146832	38312030	38312969	1
chr17	38345191	38346130	Olfr135	939	+	NM_146332	38345191	38346130	1
chr17	38411717	38412656	Olfr138	939	+	NM_130868	38411717	38412656	1
chr17	38441465	38442404	Olfr137	939	-	NM_146488	38441465	38442404	1
chr17	38472103	38473042	Olfr136	939	+	NM_146807	38472103	38473042	1
chr17	38553418	38557130	Esp36	3712	-	NM_001177587	38553979	38555943	4
chr17	38691136	38697566	Esp34	6430	+	NM_001177585	38692815	38696617	3
chr17	38776391	38782598	Esp31	6207	+	NM_001177586	38777995	38781757	3
chr17	39173639	39177172	Esp24	3533	+	NM_001256050	39175229	39177062	3
chr17	39210635	39213982	Esp23	3347	-	NM_001177582	39210733	39212253	3
chr17	39543303	39547937	Esp18	4634	+	NM_001244763	39545056	39547086	3
chr17	39673086	39677792	Esp16	4706	+	NM_001255977	39674761	39676934	3
chr17	39777901	39782612	Esp15	4711	+	NM_001244651	39779568	39781746	3
chr17	39979941	39985774	Rn45s	5833	+	NR_046233	39985774	39985774	1
chr17	40087464	40092232	Esp38	4768	+	NM_001256051	40090297	40092189	3
chr17	40343962	40345554	Pgk2	1592	-	NM_031190	40344226	40345480	1
chr17	40358725	40379207	Crisp3	20482	-	NM_009639	40359361	40376201	8
chr17	40430706	40456156	Crisp1	25450	-	NM_009638	40431332	40450025	8
chr17	40656970	40667651	Esp8	10681	+	NM_001177584	40657018	40667248	3
chr17	40698455	40702573	Esp6	4118	+	NM_001177529	40699872	40702422	3
chr17	40698455	40716498	Esp6Esp5	18043	+	NM_001287195	40713541	40715998	5
chr17	40711659	40716498	Esp5	4839	+	NM_001287194	40711792	40715998	3
chr17	40735542	40739566	Esp4	4024	+	NM_001177583	40737159	40739546	3
chr17	40769023	40774009	Esp3	4986	+	NM_001251916	40769066	40773000	3
chr17	40864068	40868731	Esp1	4663	+	NM_001038500	40865774	40868076	3
chr17	40901682	40931095	Crisp2	29413	-	NM_009420	40902158	40927604	10
chr17	40948097	40977703	Rhag	29606	+	NM_011269	40948124	40976731	10
chr17	41012430	41017507	9130008F23Rik	5077	-	NM_027834	41016939	41017485	2
chr17	41041689	41051299	Glyatl3	9610	-	NM_001145060	41041689	41051299	5
chr17	41060003	41071500	Cenpq	11497	-	NM_031863	41060436	41070134	9
chr17	41071633	41098938	Mut	27305	+	NM_008650	41074032	41097645	13
chr17	42452895	42644690	Ptchd4	191795	+	NM_028474	42453253	42640864	4
chr17	42693731	42748262	Opn5	54531	-	NM_181753	42694417	42748258	7
chr17	42793835	42829233	Adgrf4	35398	-	NM_001289501	42799307	42813690	10
chr17	42845885	42879128	Adgrf2	33243	-	NM_001033493	42846945	42856515	6
chr17	42929899	43013373	Cd2ap	83474	-	NM_009847	42933276	43013265	18
chr17	43153503	43226137	Tnfrsf21	72634	+	NM_178589	43153945	43224921	6
chr17	43282989	43295240	E130008D07Rik	12251	-	NR_045155	43295240	43295240	6
chr17	43407295	43461355	Adgrf1	54060	+	NM_133776	43427996	43460867	16
chr17	43526414	43596506	Adgrf5	70092	+	NM_001081178	43540890	43592284	21
chr17	43611277	43639722	Mep1a	28445	-	NM_008585	43611901	43639706	14
chr17	43671122	43680588	Ankrd66	9466	-	NM_001254953	43671864	43680588	3
chr17	43705399	43749150	Pla2g7	43751	+	NM_013737	43725546	43748928	12
chr17	43725288	43728458	1700071M16Rik	3170	-	NR_045445	43728458	43728458	4
chr17	43752283	43767248	Tdrd6	14965	-	NM_001161366	43752793	43767104	5
chr17	43778848	43803964	Slc25a27	25116	-	NM_028711	43780553	43803951	9
chr17	43804320	43888380	Cyp39a1	84060	+	NM_018887	43804557	43886924	12
chr17	43938799	44176465	Rcan2	237666	+	NM_207649	43973221	44174082	5
chr17	44215794	44223510	Enpp5	7716	+	NM_032003	44217630	44222581	4
chr17	44233258	44242757	Enpp4	9499	-	NM_199016	44236261	44239590	4
chr17	44325520	44417117	Clic5	91597	+	NM_172621	44325847	44412330	6
chr17	44632935	44873125	Runx2	240190	-	NR_073425	44873125	44873125	6
chr17	44914119	45256233	Supt3	342114	+	NM_178652	44923558	45256133	12
chr17	45016652	45017834	4930564C03Rik	1182	-	NM_029257	45016712	45017237	1
chr17	45528838	45570656	Cdc5l	41818	-	NM_152810	45529148	45570384	16
chr17	45570779	45579493	B230354K17Rik	8714	+	NR_130960	45579493	45579493	3
chr17	45585885	45611887	Spats1	26002	-	NM_027649	45586111	45611763	8
chr17	45643789	45657792	Aars2	14003	+	NM_198608	45643802	45657399	22
chr17	45660382	45679626	Tcte1	19244	+	NM_013688	45670048	45678288	5
chr17	45678888	45686626	Tmem151b	7738	-	NM_001013749	45681775	45686348	3
chr17	45692648	45700117	Nfkbie	7469	+	NM_001304956	45692889	45699105	6
chr17	45701100	45704618	Slc35b2	3518	+	NM_028662	45701664	45704193	3
chr17	45704726	45710210	Hsp90ab1	5484	-	NM_008302	45704963	45708860	11
chr17	45722148	45736552	Slc29a1	14404	-	NM_001199115	45722619	45729156	13
chr17	45737915	45739051	Gm7325	1136	-	NM_001177469	45738365	45738620	2
chr17	45767152	45796258	Capn11	29106	-	NM_001013767	45767533	45796209	22
chr17	45797125	45823167	Tmem63b	26042	-	NM_198167	45797737	45816639	24
chr17	45823320	45835444	Mrpl14	12124	+	NM_026732	45832450	45835363	3
chr17	45869812	45870793	1600014C23Rik	981	-	NM_028164	45869973	45870742	2
chr17	46153942	46169326	Vegfa	15384	-	NM_001025250	46155806	46168839	8
chr17	46247952	46265857	Mrps18a	17905	+	NM_026768	46247966	46265598	6
chr17	46266225	46281147	Rsph9	14922	-	NM_029338	46266286	46281097	5
chr17	46284333	46290500	Mad2l1bp	6167	-	NM_025649	46284720	46290446	3
chr17	46297980	46306319	Gtpbp2	8339	+	NM_001145979	46301193	46305271	12
chr17	46308941	46339574	Polh	30633	-	NM_030715	46309201	46336477	11
chr17	46339803	46379248	Xpo5	39445	+	NM_028198	46339869	46379220	32
chr17	46368479	46368568	Mir693	89	+	NR_030466	46368568	46368568	1
chr17	46380868	46384994	Polr1c	4126	-	NM_009085	46381050	46384912	9
chr17	46385028	46389486	Yipf3	4458	+	NM_145353	46385196	46388663	9
chr17	46391113	46394265	Lrrc73	3152	+	NM_001111142	46391293	46394012	6
chr17	46394799	46419975	Tjap1	25176	-	NM_028751	46395361	46400736	11
chr17	46434431	46440220	Dlk2	5789	+	NM_001286028	46435571	46440047	6
chr17	46440178	46464972	Abcc10	24794	-	NM_170680	46440438	46464881	21
chr17	46520714	46557867	Zfp318	37153	+	NM_207671	46520787	46550735	10
chr17	46565890	46568720	Crip3	2830	+	NM_053250	46565899	46568333	8
chr17	46569133	46575426	Slc22a7	6293	-	NM_144856	46569429	46575338	10
chr17	46579396	46624624	Ttbk1	45228	-	NM_001162864	46582124	46621206	15
chr17	46633737	46636567	Dnph1	2830	+	NM_207161	46633758	46636004	4
chr17	46637557	46683337	Cul9	45780	-	NM_001081335	46637656	46680723	41
chr17	46683787	46693111	Srf	9324	-	NM_020493	46686031	46692777	7
chr17	46690775	46690838	Mir6976	63	-	NR_105942	46690838	46690838	1
chr17	46701399	46766453	Ptk7	65054	-	NM_175168	46702283	46766271	20
chr17	46767579	46782093	Klc4	14514	-	NM_029091	46767971	46781455	16
chr17	46783169	46787081	Mrpl2	3912	+	NM_001316742	46783207	46787045	7
chr17	46787286	46801313	Cul7	14027	+	NM_025611	46788393	46801240	26
chr17	46804404	46811204	Rrp36	6800	-	NM_144857	46804898	46811182	7
chr17	46811499	46817879	Klhdc3	6380	-	NM_027910	46812034	46815383	12
chr17	46817401	46820075	Mea1	2674	+	NM_001277310	46818576	46819819	4
chr17	46819939	46841951	Ppp2r5d	22012	-	NM_009358	46820937	46841808	15
chr17	46848411	46862490	Pex6	14079	+	NM_145488	46848448	46862273	17
chr17	46862612	46866114	Gnmt	3502	-	NM_010321	46862748	46866100	6
chr17	46872659	46889163	Cnpy3	16504	-	NM_028065	46873639	46889072	6
chr17	46892611	46900661	Ptcra	8050	-	NM_011195	46893175	46900563	4
chr17	46909583	46910356	2310039H08Rik	773	+	NM_025966	46909761	46910106	1
chr17	46910855	46919605	Rpl7l1	8750	-	NM_025433	46915011	46919581	7
chr17	46935064	46968362	Gltscr1l	33298	-	NM_001100452	46937996	46967940	11
chr17	47027569	47029412	Tbcc	1843	+	NM_178385	47027638	47028664	1
chr17	47047433	47061875	Prph2	14442	+	NM_008938	47047645	47060496	3
chr17	47065239	47147481	Ubr2	82242	-	NM_001177374	47067307	47147168	47
chr17	47277890	47496407	Trerf1	218517	+	NM_001097623	47451015	47496180	20
chr17	47505835	47515628	Mrps10	9793	+	NM_001146212	47505855	47515234	7
chr17	47522341	47529916	Guca1b	7575	+	NM_146079	47522438	47528951	4
chr17	47531505	47537555	Guca1a	6050	-	NM_008189	47531605	47537368	4
chr17	47549682	47574324	1700001C19Rik	24642	-	NM_029296	47550510	47574163	4
chr17	47573587	47607587	AI661453	34000	+	NM_145489	47573753	47606342	5
chr17	47624998	47639236	Taf8	14238	-	NM_022015	47626832	47639218	9
chr17	47641999	47736637	Ccnd3	94638	+	NM_001081636	47730603	47735725	7
chr17	47736279	47748441	Bysl	12162	-	NM_016859	47738501	47748120	7
chr17	47748544	47761367	Med20	12823	+	NM_020048	47748627	47760049	4
chr17	47767638	47821016	Usp49	53378	+	NM_198421	47809020	47817821	7
chr17	47823593	47825335	Tomm6	1742	-	NM_001164729	47824140	47824975	3
chr17	47824558	47828041	Tomm6os	3483	+	NR_045945	47828041	47828041	3
chr17	47825422	47831685	Prickle4	6263	-	NM_001290337	47825465	47829415	7
chr17	47832155	47841235	Frs3	9080	+	NM_144939	47835544	47840811	7
chr17	47836917	47838945	Frs3os	2028	-	NR_045913	47838945	47838945	3
chr17	47863790	47871427	Pgc	7637	+	NM_025973	47863854	47871286	9
chr17	47873985	47929365	Tfeb	55380	+	NM_001161722	47922935	47928763	9
chr17	47952276	47971640	Mdfi	19364	-	NM_001109973	47952856	47969968	5
chr17	48004081	48061581	Foxp4	57500	-	NM_028767	48005604	48041466	17
chr17	48173694	48175243	1700122O11Rik	1549	-	NM_029689	48173717	48175221	3
chr17	48201738	48227328	A730006G06Rik	25590	-	NR_110485	48227328	48227328	3
chr17	48226581	48227870	1700067P10Rik	1289	+	NM_026625	48226983	48227698	3
chr17	48262554	48283257	9830107B12Rik	20703	-	NM_001177897	48265388	48282958	4
chr17	48288845	48304207	A530064D06Rik	15362	-	NM_178796	48289786	48303938	4
chr17	48371902	48386091	Trem1	14189	+	NM_021406	48371958	48383816	4
chr17	48386895	48398213	Trem3	11318	+	NM_021407	48387015	48397837	4
chr17	48403660	48414724	Treml4	11064	+	NM_001033922	48403745	48413859	6
chr17	48439362	48451859	Treml2	12497	+	NM_001033405	48439851	48448829	5
chr17	48455486	48465836	B430306N03Rik	10350	+	NM_177083	48455752	48463510	6
chr17	48485725	48491601	Trem2	5876	+	NM_001272078	48485880	48491360	5
chr17	48499240	48506501	Treml1	7261	+	NM_027763	48499261	48506241	6
chr17	48526209	48549145	Nfya	22936	-	NM_001110832	48528613	48539837	10
chr17	48549324	48556595	Oard1	7271	+	NM_001289491	48550190	48556111	6
chr17	48558555	48572053	Apobec2	13498	-	NM_009694	48562286	48571934	3
chr17	48587759	48590826	Tspo2	3067	-	NM_027292	48587948	48589377	5
chr17	48594225	48608009	Unc5cl	13784	+	NM_152823	48598924	48606863	9
chr17	49071906	49236915	Lrfn2	165009	+	NM_027452	49209217	49236542	3
chr17	49251588	49252858	1700008K24Rik	1270	-	NR_038143	49252858	49252858	3
chr17	49443803	49452285	Gm17830	8482	-	NR_033486	49452285	49452285	5
chr17	49567688	49594755	Mocs1	27067	+	NM_028464	49567766	49592175	11
chr17	49595346	49703662	Daam2	108316	-	NM_001008231	49597850	49638198	26
chr17	49754496	50049172	Kif6	294676	+	NM_177052	49754561	50048118	23
chr17	50132631	50329822	Rftn1	197191	-	NM_181397	50133479	50308472	10
chr17	50378532	50385641	AY702103	7109	+	NR_131975	50385641	50385641	2
chr17	50418717	50432945	Dazl	14228	-	NM_010021	50420573	50432734	11
chr17	50648871	50827819	Plcl2	178948	+	NM_013880	50648932	50827216	6
chr17	50872451	51318677	Tbc1d5	446226	-	NM_001285991	50875269	51164495	23
chr17	51564533	51587594	C330011F03Rik	23061	-	NR_046166	51587594	51587594	5
chr17	51875511	51972615	Satb1	97104	-	NM_001163632	51879222	51948578	11
chr17	52022051	52104582	Gm20098	82531	+	NR_045095	52104582	52104582	3
chr17	52742033	53044544	Kcnh8	302511	+	NM_001031811	52742129	53044544	11
chr17	53538213	53602646	Efhb	64433	-	NM_172497	53538270	53602604	13
chr17	53618558	53647003	Rab5a	28445	+	NM_025887	53623237	53645754	6
chr17	53646784	53678776	Pp2d1	31992	-	NM_173449	53647156	53678535	3
chr17	53706295	53812046	Kat2b	105751	+	NM_020005	53706654	53810193	18
chr17	53814111	53828640	Sgol1	14529	-	NM_028232	53815924	53827177	9
chr17	53855833	53873168	4932415M13Rik	17335	+	NR_073205	53873168	53873168	8
chr17	53968961	53985283	Sult1c2	16322	-	NM_026935	53969326	53978307	8
chr17	54412914	54438359	Slc5a7	25445	-	NM_022025	54415842	54436461	9
chr17	54491907	54509399	1700025K24Rik	17492	-	NR_045825	54509399	54509399	3
chr17	55585014	55638524	St6gal2	53510	+	NM_172829	55621264	55637718	5
chr17	55731638	55763970	Vmn2r118	32332	-	NM_001104582	55731638	55763970	6
chr17	55791322	55851926	Pot1b	60604	-	NM_028370	55792703	55845412	17
chr17	55889248	55992927	Adgre4	103679	+	NM_139138	55899812	55991651	17
chr17	56004156	56018218	Zfp119a	14062	-	NM_144546	56004468	56018127	4
chr17	56031515	56038353	Zfp959	6838	+	NM_145490	56031606	56038007	4
chr17	56077795	56088923	Zfp119b	11128	-	NM_001310337	56077975	56080642	4
chr17	56092045	56096445	Ebi3	4400	+	NM_015766	56092284	56096200	5
chr17	56094193	56098824	Gm16712	4631	-	NR_108021	56098824	56098824	3
chr17	56098609	56107374	Ccdc94	8765	+	NM_028381	56098660	56107057	8
chr17	56109904	56116042	Shd	6138	+	NM_009168	56110861	56115827	7
chr17	56125933	56136304	Fsd1	10371	+	NM_183178	56126061	56136175	13
chr17	56136498	56145029	Stap2	8531	-	NM_145934	56136719	56144954	13
chr17	56148623	56156206	Mpnd	7583	+	NM_026530	56148672	56156025	13
chr17	56156172	56176060	Sh3gl1	19888	-	NM_013664	56156962	56175882	10
chr17	56179838	56207449	Chaf1a	27611	+	NM_013733	56179934	56206973	14
chr17	56207676	56214412	Ubxn6	6736	-	NM_024432	56207977	56214341	11
chr17	56219053	56240027	Hdgfrp2	20974	+	NM_008233	56219177	56239876	16
chr17	56240013	56249225	Plin4	9212	-	NM_020568	56241429	56249011	9
chr17	56251023	56256971	Plin5	5948	-	NM_025874	56251451	56256549	9
chr17	56259100	56261369	Lrg1	2269	-	NM_029796	56259364	56261309	2
chr17	56262507	56279766	Sema6b	17259	-	NM_001130456	56263423	56272262	17
chr17	56301913	56313378	Tnfaip8l1	11465	+	NM_025566	56311134	56311695	2
chr17	56315963	56323343	Mydgf	7380	-	NM_080837	56316346	56323314	6
chr17	56326104	56358312	Dpp9	32208	-	NM_172624	56326791	56351225	21
chr17	56382410	56382521	Mir7b	111	+	NR_029827	56382521	56382521	1
chr17	56396215	56403031	Fem1a	6816	+	NM_010192	56396331	56398296	1
chr17	56408884	56416190	Ticam1	7306	-	NM_174989	56409317	56411516	2
chr17	56418384	56429934	Plin3	11550	-	NM_025836	56419154	56427282	8
chr17	56433533	56439709	Arrdc5	6176	-	NM_029799	56433568	56439666	3
chr17	56442759	56462909	Uhrf1	20150	+	NM_010931	56444520	56461925	17
chr17	56465472	56542296	Kdm4b	76824	+	NM_172132	56491079	56541151	23
chr17	56551848	56615903	Ptprs	64055	-	NM_011218	56552747	56597705	33
chr17	56558268	56558332	Mir6977	64	-	NR_105943	56558332	56558332	1
chr17	56650670	56651906	Znrf4	1236	-	NM_011483	56650744	56651728	1
chr17	56690836	56693810	Gm20219	2974	-	NR_130128	56693810	56693810	4
chr17	56702364	56724006	Safb2	21642	-	NM_001029979	56702521	56723867	21
chr17	56724404	56745717	Safb	21313	+	NM_001163300	56724584	56745528	21
chr17	56746874	56749194	2410015M20Rik	2320	-	NM_153152	56747166	56749091	4
chr17	56752817	56753669	Rpl36	852	+	NM_018730	56753010	56753636	4
chr17	56753721	56766326	Lonp1	12605	-	NM_028782	56753806	56766296	18
chr17	56767565	56803879	Catsperd	36314	+	NM_175350	56767611	56803778	22
chr17	56812647	56851192	Ranbp3	38545	+	NM_001252466	56812812	56850322	17
chr17	56853354	56857122	Vmac	3768	-	NM_001166474	56854906	56855155	2
chr17	56857184	56863671	Ndufa11	6487	+	NM_027244	56857262	56861520	4
chr17	56873650	56878715	Fut4-ps1	5065	+	NR_033644	56878715	56878715	2
chr17	56890747	56896953	Nrtn	6206	-	NM_008738	56890834	56891900	3
chr17	56904173	56909516	Dus3l	5343	+	NM_144858	56904278	56909231	13
chr17	56909698	56911557	Prr22	1859	+	NM_001195673	56909762	56911540	3
chr17	56915319	56970431	Rfx2	55112	-	NM_027787	56916384	56947740	18
chr17	56982526	57013870	Acsbg2	31344	-	NM_001039114	56984859	57012274	15
chr17	57015055	57028261	1700061G19Rik	13206	+	NM_030141	57015683	57028145	14
chr17	57032033	57074811	Mllt1	42778	-	NM_022328	57033884	57074697	12
chr17	57092912	57121549	Acer1	28637	-	NM_175731	57094501	57121531	6
chr17	57129686	57135794	Clpp	6108	+	NM_017393	57129750	57135470	6
chr17	57136761	57138759	Alkbh7	1998	+	NM_025538	57136786	57138515	4
chr17	57138879	57139441	Pspn	562	-	NM_008954	57138879	57139438	2
chr17	57142824	57150711	Gtf2f1	7887	-	NM_133801	57142849	57150543	13
chr17	57160471	57170930	Khsrp	10459	-	NM_010613	57162115	57170822	18
chr17	57172194	57181077	Slc25a41	8883	-	NM_175333	57172418	57181014	7
chr17	57183133	57199286	Slc25a23	16153	-	NM_025877	57184901	57199096	10
chr17	57201699	57205337	Crb3	3638	+	NM_177638	57202116	57204719	4
chr17	57205477	57217933	Dennd1c	12456	-	NM_153551	57205533	57217829	24
chr17	57219488	57227205	Tubb4a	7717	-	NM_009451	57220112	57226936	4
chr17	57231445	57245365	Gm11110	13920	-	NR_033508	57245365	57245365	4
chr17	57244807	57247180	Tnfsf9	2373	+	NM_009404	57244854	57246927	3
chr17	57285419	57289200	Cd70	3781	-	NM_011617	57285497	57289024	3
chr17	57328896	57333604	Tnfsf14	4708	-	NM_019418	57329933	57333492	4
chr17	57343389	57367559	C3	24170	-	NM_009778	57343435	57367458	41
chr17	57356594	57356651	Mir6978	57	-	NR_105944	57356651	57356651	1
chr17	57374337	57387112	Gpr108	12775	-	NM_001308072	57374716	57387059	17
chr17	57388873	57403120	Trip10	14247	+	NM_001242390	57388970	57402571	15
chr17	57418522	57468659	Vav1	50137	+	NM_001163815	57418620	57467127	28
chr17	57498108	57622952	Adgre1	124844	+	NM_010130	57498148	57622543	22
chr17	57648205	57684737	Vmn2r120	36532	-	NM_001104591	57648205	57684737	7
chr17	57908992	58549765	Cntnap5c	640773	+	NM_001081653	57908992	58549765	24
chr17	59018230	59130798	Pdzph1	112568	-	NM_027001	59018500	59126895	13
chr17	59140823	59152745	Nudt12	11922	-	NM_026497	59141603	59150671	7
chr17	62952305	63230666	Efna5	278361	-	NM_207654	62956690	63230479	5
chr17	63395300	63849929	Fbxl17	454629	-	NM_015794	63409619	63849366	9
chr17	63654794	63662322	4930405O22Rik	7528	-	NR_130176	63662322	63662322	4
chr17	64213329	64488846	Fer	275517	+	NM_001037997	64245425	64488366	19
chr17	64399210	64400021	1110058D11Rik	811	-	NR_130982	64400021	64400021	2
chr17	64630354	64681223	Pja2	50869	-	NM_001025309	64632761	64662372	10
chr17	64790145	64790247	Mir6420	102	+	NR_105848	64790247	64790247	1
chr17	64863428	64904930	AU016765	41502	-	NR_045899	64904930	64904930	4
chr17	64950988	65104450	Man2a1	153462	+	NM_008549	64951075	65101912	22
chr17	65116450	65117271	Dreh	821	+	NR_105051	65117271	65117271	2
chr17	65605344	65890122	Tmem232	284778	-	NM_001289485	65605708	65849536	16
chr17	65929392	65962895	Vapa	33503	-	NM_013933	65930028	65962638	6
chr17	65986844	65991544	Txndc2	4700	-	NM_001146002	65986867	65991321	3
chr17	66001065	66122092	Rab31	121027	-	NM_133685	66003745	66121884	7
chr17	66132694	66191266	Ppp4r1	58572	+	NM_001114131	66132782	66190360	20
chr17	66197768	66235095	Ralbp1	37327	-	NM_009067	66199289	66217115	10
chr17	66272404	66300527	Twsg1	28123	-	NM_023053	66275624	66298117	5
chr17	66316840	66426386	Ankrd12	109546	-	NM_001025572	66319491	66402380	13
chr17	66428134	66450899	Ndufv2	22765	-	NM_001278415	66428833	66438580	9
chr17	66460885	66469843	Wash1	8958	+	NM_026833	66463207	66468476	11
chr17	66472859	66501508	Ddx11	28649	+	NM_001003919	66475516	66500178	27
chr17	66686321	66799090	Mtcl1	112769	-	NM_001114098	66689841	66798685	15
chr17	66843851	66869010	Rab12	25159	-	NM_024448	66845029	66868910	6
chr17	66904591	66943962	Themis3	39371	-	NM_028998	66904591	66943874	4
chr17	67016187	67703799	Ptprm	687612	-	NM_008984	67016967	67703369	31
chr17	67375486	67375575	Mir5709	89	-	NR_049205	67375575	67375575	1
chr17	67980304	67982063	Lrrc30	1759	-	NM_001033340	67981020	67981923	1
chr17	68046604	68171985	Lama1	125381	+	NM_008480	68046674	68171789	63
chr17	68192047	68353448	Arhgap28	161401	-	NM_172964	68195074	68353350	18
chr17	68623136	69129426	L3mbtl4	506290	+	NM_177278	68708818	69127301	21
chr17	69186475	69192478	Tmem200c	6003	+	NM_001206661	69189763	69191677	2
chr17	69506149	69639327	Epb41l3	133178	+	NM_013813	69557209	69637062	22
chr17	69624701	69626546	2410021H03Rik	1845	-	NR_045428	69626546	69626546	3
chr17	69733317	69739884	Zbtb14	6567	+	NM_009547	69734841	69737998	3
chr17	69765786	69768532	C030034I22Rik	2746	+	NR_026848	69768532	69768532	1
chr17	69788665	69838573	A330050F15Rik	49908	+	NM_001145192	69788865	69836687	2
chr17	70774131	71170753	Dlgap1	396622	+	NM_177639	70865361	71167574	12
chr17	71193544	71202872	Tgif1	9328	-	NM_001164074	71194036	71195694	3
chr17	71323302	71339856	Myl12b	16554	-	NM_023402	71323663	71326571	4
chr17	71343132	71351873	Myl12a	8741	-	NM_026064	71343951	71346220	4
chr17	71368896	71476196	Myom1	107300	+	NM_010867	71372214	71475709	38
chr17	71533317	71599158	Lpin2	65841	+	NM_022882	71564312	71596311	20
chr17	71601515	71660305	Emilin2	58790	-	NM_145158	71602095	71660200	8
chr17	71682540	71691144	Gm4566	8604	-	NR_028023	71691144	71691144	3
chr17	71693833	71824683	Smchd1	130850	-	NM_028887	71694677	71824504	48
chr17	71845439	71876197	Ndc80	30758	-	NM_023294	71845555	71875073	17
chr17	71901400	71938873	Spdya	37473	+	NM_029254	71905597	71938014	7
chr17	71906366	71948101	Trmt61b	41735	-	NR_015549	71948101	71948101	7
chr17	71965554	72008371	Wdr43	42817	+	NM_175639	71965600	72007001	18
chr17	71980618	71980701	Snord92	83	+	NR_028556	71980701	71980701	1
chr17	71990228	71990296	Snord53	68	+	NR_028551	71990296	71990296	1
chr17	72022600	72079009	Fam179a	56409	+	NM_177087	72034504	72078865	20
chr17	72092894	72102225	BC027072	9331	-	NM_146082	72093855	72102020	2
chr17	72119030	72213550	Clip4	94520	+	NR_073185	72213550	72213550	17
chr17	72218327	72953647	Alk	735320	-	NM_007439	72218781	72953049	29
chr17	73186043	73200535	Ypel5	14492	+	NM_027166	73195642	73198144	3
chr17	73267644	73291286	Lbh	23642	+	NM_029999	73267892	73288784	3
chr17	73457324	73592706	Lclat1	135382	+	NM_001177968	73511166	73589560	6
chr17	73655803	73748636	Capn13	92833	-	NM_001033444	73664635	73732354	23
chr17	73843090	74059791	Galnt14	216701	-	NM_027864	73843512	74059399	15
chr17	74154180	74181433	Ehd3	27253	+	NM_020578	74154582	74179785	6
chr17	74233234	74299536	Xdh	66302	-	NM_011723	74233772	74299468	36
chr17	74367045	74397256	Srd5a2	30211	-	NM_053188	74367045	74397167	5
chr17	74600039	74694203	Memo1	94164	-	NM_133771	74600533	74694092	9
chr17	74698813	74723284	Dpy30	24471	-	NM_024428	74699091	74715419	5
chr17	74738326	74790453	Spast	52127	+	NM_001162870	74738376	74787652	17
chr17	74794947	74823569	Slc30a6	28622	+	NM_001252478	74795005	74822854	14
chr17	74825634	74858448	Nlrc4	32814	-	NM_001033367	74826181	74852393	9
chr17	74888832	74899617	Yipf4	10785	+	NM_026417	74889055	74898448	6
chr17	74927634	75102696	Birc6	175062	+	NM_007566	74927807	75101723	73
chr17	75117089	75262910	Ttc27	145821	+	NM_152817	75117251	75262796	20
chr17	75404868	75792307	Ltbp1	387439	+	NM_019919	75405225	75789893	34
chr17	75835244	75928393	Rasgrp3	93149	+	NM_001166493	75891230	75926191	17
chr17	75936425	75951286	Fam98a	14861	-	NM_133747	75937541	75951133	8
chr17	76260362	76288379	Gm4710	28017	+	NR_033456	76288379	76288379	5
chr17	78599587	78775932	Crim1	176345	+	NM_015800	78600108	78773572	17
chr17	78768551	78817492	Fez2	48941	-	NM_001285949	78771211	78817423	8
chr17	78907402	79026749	Vit	119347	+	NM_028813	78933972	79026263	14
chr17	79053303	79135900	Strn	82597	-	NM_011500	79054829	79135827	18
chr17	79152245	79234721	Heatr5b	82476	-	NM_001081179	79152371	79233561	36
chr17	79234855	79247648	Gpatch11	12793	+	NM_181649	79237183	79244539	10
chr17	79249844	79251884	Gm6548	2040	-	NR_003363	79251884	79251884	1
chr17	79251889	79281912	Eif2ak2	30023	-	NM_011163	79254478	79277597	16
chr17	79283277	79306332	Sult6b1	23055	-	NM_001163625	79284425	79306332	7
chr17	79315838	79320388	Cebpzos	4550	+	NM_001177403	79317697	79319181	5
chr17	79318342	79336410	Cebpz	18068	-	NM_001024806	79319220	79336370	16
chr17	79336474	79347392	Ndufaf7	10918	+	NM_028611	79336504	79346430	10
chr17	79348744	79420156	Prkd3	71412	-	NM_001171004	79351196	79412251	19
chr17	79451245	79489718	Qpct	38473	+	NM_027455	79451605	79489108	7
chr17	79733364	79754431	Cdc42ep3	21067	-	NM_026514	79734064	79734829	2
chr17	79874963	79877225	4930429F11Rik	2262	-	NR_033463	79877225	79877225	2
chr17	79905388	79909826	Gm10494	4438	-	NR_033462	79909826	79909826	4
chr17	80014239	80081492	Rmdn2	67253	+	NM_201361	80020660	80081026	11
chr17	80106292	80114381	Cyp1b1	8089	-	NM_009994	80109432	80113651	3
chr17	80247729	80295463	Atl2	47734	-	NM_001286647	80250025	80264132	13
chr17	80428826	80461608	Hnrnpll	32782	-	NM_144802	80429824	80461332	13
chr17	80526810	80584372	Galm	57562	+	NM_176963	80527055	80583401	7
chr17	80599419	80606645	Srsf7	7226	-	NR_036615	80606645	80606645	9
chr17	80615253	80617276	Ttc39d	2023	+	NM_026351	80615253	80617068	1
chr17	80623828	80627837	Gemin6	4009	+	NM_026053	80624979	80627453	3
chr17	80637643	80689816	Dhx57	52173	-	NM_001163759	80638126	80680762	24
chr17	80689551	80696816	Morn2	7265	+	NM_194269	80694852	80696696	5
chr17	80706746	80788029	Arhgef33	81283	+	NM_001145452	80734657	80785758	18
chr17	80771196	80772882	Gm10190	1686	-	NR_028385	80772882	80772882	1
chr17	80793091	80879793	Sos1	86702	-	NM_009231	80797520	80879263	22
chr17	80922889	80963174	Cdkl4	40285	-	NM_001033443	80924624	80959857	10
chr17	80979852	81127365	Map4k3	147513	-	NM_001290345	80981187	81127229	34
chr17	81296132	81332787	C230072F16Rik	36655	+	NR_131127	81332787	81332787	6
chr17	81343971	81401156	Tmem178	57185	+	NM_026516	81344028	81400411	4
chr17	81425666	81464425	Thumpd2	38759	-	NM_028138	81425910	81464400	10
chr17	81772444	82137727	Slc8a1	365283	-	NM_001286684	81785358	82048947	12
chr17	83432931	83477565	Gm19689	44634	-	NR_045094	83477565	83477565	4
chr17	83614622	83624409	Pkdcc	9787	+	NM_134117	83614805	83623617	7
chr17	83750270	83879699	Eml4	129429	+	NM_001114361	83750554	83877507	24
chr17	83901256	83913673	Cox7a2l	12417	-	NM_001159529	83901942	83913615	4
chr17	83985296	84031235	Kcng3	45939	-	NM_153512	83987073	84030958	2
chr17	84105502	84214245	Mta3	108743	+	NM_054082	84105597	84214001	17
chr17	84230693	84246130	Haao	15437	-	NM_025325	84230982	84246056	10
chr17	84397891	84412748	8430430B14Rik	14857	+	NR_130994	84412748	84412748	2
chr17	84477999	84489215	4933433H22Rik	11216	+	NR_045458	84489215	84489215	6
chr17	84583268	84587287	Zfp36l2	4019	-	NM_001001806	84585092	84587034	2
chr17	84589395	84865548	Thada	276153	-	NM_183021	84591290	84863772	38
chr17	84911234	85021482	Plekhh2	110248	+	NM_177606	84921042	85019149	30
chr17	85025838	85054904	Dync2li1	29066	+	NM_172256	85025908	85054703	13
chr17	85057513	85082351	Abcg5	24838	-	NM_031884	85057827	85082213	13
chr17	85075641	85099673	Abcg8	24032	+	NM_001286005	85091195	85098139	12
chr17	85104586	85190126	Lrpprc	85540	-	NM_028233	85104755	85189853	38
chr17	85316521	85356763	1110020A21Rik	40242	-	NR_027929	85356763	85356763	4
chr17	85356080	85423332	Ppm1b	67252	+	NM_001159497	85393033	85423074	6
chr17	85427686	85463581	Slc3a1	35895	+	NM_009205	85427771	85463419	10
chr17	85462816	85489614	Prepl	26798	-	NM_001163624	85463983	85482607	14
chr17	85490039	85857920	Camkmt	367881	+	NM_028576	85490065	85857479	11
chr17	86001271	86017736	Six3os1	16465	-	NR_038085	86017736	86017736	4
chr17	86020173	86025531	Six3	5358	+	NM_011381	86020579	86023259	2
chr17	86083607	86087594	Six2	3987	-	NM_011380	86084522	86087292	2
chr17	86384004	86544515	Srbd1	160511	-	NM_030133	86384533	86541779	21
chr17	86567124	87057259	Prkce	490135	+	NM_011104	86567932	87054027	15
chr17	86684506	86686518	2010106C02Rik	2012	-	NR_045435	86686518	86686518	3
chr17	87153203	87232750	Epas1	79547	+	NM_010137	87153622	87230442	16
chr17	87316687	87321707	Tmem247	5020	+	NM_001277980	87316804	87321707	3
chr17	87343448	87347227	Atp6v1e2	3779	-	NM_029121	87343627	87344308	2
chr17	87362450	87399409	Rhoq	36959	+	NM_145491	87362945	87396400	5
chr17	87396598	87424741	Pigf	28143	-	NM_008838	87396793	87423232	6
chr17	87424900	87435148	Cript	10248	+	NM_019936	87424999	87434382	5
chr17	87507018	87536925	Socs5	29907	+	NM_019654	87532973	87534584	3
chr17	87591555	87594282	C330024C12Rik	2727	-	NR_046016	87594282	87594282	4
chr17	87653782	87665287	Mcfd2	11505	-	NM_176808	87655265	87657413	5
chr17	87674225	87682154	4833418N02Rik	7929	-	NR_015506	87682154	87682154	5
chr17	87682225	87781110	Ttc7	98885	+	NM_028639	87682563	87779410	20
chr17	87788910	87827081	1700011E24Rik	38171	-	NM_029298	87788935	87827003	7
chr17	87832740	87846275	Calm2	13535	-	NM_007589	87833366	87846135	6
chr17	88035318	88050467	Epcam	15149	+	NM_008532	88036158	88049809	10
chr17	88071896	88123053	Msh2	51157	+	NM_008628	88071935	88122844	16
chr17	88145160	88197334	Kcnk12	52174	-	NM_199251	88145279	88196794	2
chr17	88374389	88390232	Msh6	15843	+	NM_010830	88374488	88390145	10
chr17	88390198	88464625	Fbxo11	74427	-	NM_001081034	88391385	88464592	23
chr17	88524851	88530456	Gm4832	5605	+	NM_001190356	88530054	88530456	2
chr17	88840051	88889873	Foxn2	49822	+	NM_180974	88862066	88886266	6
chr17	88929463	88987707	Ppp1r21	58244	+	NM_028658	88929601	88987053	22
chr17	89025894	89045064	Ston1	19170	+	NM_029858	89034507	89044629	4
chr17	89067999	89114490	Gtf2a1l	46491	+	NM_023630	89068050	89114329	9
chr17	89140888	89191316	Lhcgr	50428	-	NM_013582	89141333	89191311	11
chr17	89384291	89600015	Fshr	215724	-	NM_013523	89384509	89599952	10
chr17	89719566	89726673	4933400B14Rik	7107	+	NR_045432	89726673	89726673	5
chr17	89778580	89784333	Gm4719	5753	+	NR_045952	89784333	89784333	4
chr17	90432983	91492142	Nrxn1	1059159	-	NM_020252	90436416	91488066	23
chr17	91260508	91266442	4930480K15Rik	5934	+	NR_045463	91266442	91266442	3
chr17	93598356	93605877	Adcyap1	7521	+	NM_001315503	93599353	93603467	5
chr17	95126419	95149232	Mettl4	22813	-	NM_176917	95126589	95147349	9
chr17	95149439	95174469	2700099C18Rik	25030	+	NR_024720	95174469	95174469	10
chr17	95159281	95234139	Gm1976	74858	-	NR_045963	95234139	95234139	5
chr17	95213816	95234160	2610044O15Rik8	20344	-	NM_153780	95215175	95233664	6
chr17_random	581194	612733	Sult1c1	31539	+	NM_018751	600274	612276	8
chr18	3122491	3123412	Vmn1r238	921	-	NM_001167539	3122491	3123412	1
chr18	3266351	3327589	Crem	61238	-	NM_001110859	3267585	3327535	9
chr18	3336413	3366861	Gm6225	30448	+	NR_033457	3366861	3366861	2
chr18	3383222	3436698	Cul2	53476	+	NM_029402	3399865	3434973	21
chr18	3507954	3516402	Bambi	8448	+	NM_026505	3508207	3512398	3
chr18	4165829	4182234	Lyzl1	16405	+	NM_026092	4168519	4181972	5
chr18	4331324	4352951	Map3k8	21627	-	NM_007746	4332303	4349314	8
chr18	4353544	4368943	4833419F23Rik	15399	+	NR_040328	4368943	4368943	4
chr18	4375589	4397328	Mtpap	21739	+	NM_026157	4375619	4396465	9
chr18	4634926	4682867	9430020K01Rik	47941	+	NM_001081963	4649128	4680258	4
chr18	4812483	4850957	Gm10556	38474	+	NR_045881	4850957	4850957	10
chr18	5046586	5119291	Svil	72705	+	NM_153153	5046636	5118430	35
chr18	5210028	5334437	Zfp438	124409	-	NM_178722	5210637	5245420	5
chr18	5491498	5592435	Gm10125	100937	-	NR_033552	5592435	5592435	7
chr18	5591857	5775466	Zeb1	183609	+	NM_011546	5591907	5773064	8
chr18	6024447	6136096	Arhgap12	111649	-	NM_001039692	6026553	6112360	19
chr18	6201002	6241522	Kif5b	40520	-	NM_008448	6208202	6241105	26
chr18	6435948	6516106	Epc1	80158	-	NM_007935	6437232	6515865	14
chr18	6490561	6490644	Mir1893	83	-	NR_035446	6490644	6490644	1
chr18	6603630	6638964	4921524L21Rik	35334	+	NM_027598	6619376	6638917	10
chr18	6765164	6791604	Rab18	26440	+	NM_001278447	6765262	6788653	7
chr18	6934963	7004777	Mkx	69814	-	NM_177595	6936862	7002542	7
chr18	7088230	7297899	Armc4	209669	-	NM_001081393	7088451	7294609	21
chr18	7347959	7626861	Mpp7	278902	-	NM_001081287	7350962	7561760	17
chr18	7868829	7929026	Wac	60197	+	NM_001282093	7871603	7926137	14
chr18	9212853	9216199	Fzd8	3346	+	NM_008058	9212917	9214975	1
chr18	9278604	9282807	Gjd4	4203	-	NM_153086	9279979	9282616	2
chr18	9314041	9450148	Ccny	136107	-	NM_026484	9316553	9449669	10
chr18	9618416	9619467	Cetn1	1051	-	NM_007593	9618898	9619417	1
chr18	9707645	9877993	Colec12	170348	+	NM_130449	9707750	9877005	10
chr18	9958177	9995482	Thoc1	37305	+	NM_153552	9958190	9993614	21
chr18	9993612	10030147	Usp14	36535	-	NM_021522	9996094	10029926	16
chr18	10064398	10181790	Rock1	117392	-	NM_009071	10066045	10181315	33
chr18	10325176	10562939	Greb1l	237763	+	NM_001083628	10458222	10560481	33
chr18	10566509	10610350	Esco1	43841	-	NM_001081222	10567496	10595282	11
chr18	10617793	10628228	Snrpd1	10435	+	NM_009226	10617910	10627868	4
chr18	10644408	10706694	Abhd3	62286	-	NM_134130	10645054	10706689	9
chr18	10706857	10711830	4930563E18Rik	4973	+	NR_045379	10711830	10711830	3
chr18	10725622	10812215	Mib1	86593	+	NM_144860	10726302	10812123	21
chr18	10782906	10782974	Mir133a-1	68	-	NR_029547	10782974	10782974	1
chr18	10785443	10785565	Mir1b	122	+	NR_035413	10785565	10785565	1
chr18	10785478	10785550	Mir1a-2	72	-	NR_029781	10785550	10785550	1
chr18	11042034	11052565	1010001N08Rik	10531	-	NR_105023	11052565	11052565	6
chr18	11052507	11085633	Gata6	33126	+	NM_010258	11054070	11084480	7
chr18	11791784	11901716	Rbbp8	109932	+	NM_001252495	11819341	11901222	19
chr18	11979596	11997886	Gm6277	18290	-	NR_045421	11997886	11997886	4
chr18	11997782	12104136	Cables1	106354	+	NM_001146287	11998314	12103110	10
chr18	11998869	11998947	Mir1901	78	-	NR_035447	11998947	11998947	1
chr18	12139811	12280046	Tmem241	140235	-	NR_110356	12280046	12280046	16
chr18	12287358	12315876	Riok3	28518	+	NM_024182	12287419	12313836	13
chr18	12327238	12348478	3110002H16Rik	21240	+	NM_029623	12327309	12348394	20
chr18	12348202	12394895	Npc1	46693	-	NM_008720	12349428	12394746	25
chr18	12410865	12464229	Ankrd29	53364	-	NM_001190371	12413102	12464140	10
chr18	12492532	12741521	Lama3	248989	+	NM_010680	12492532	12741172	75
chr18	12802041	12895561	Ttc39c	93520	+	NM_028341	12802394	12895272	14
chr18	12873319	12873404	Mir1948	85	+	NR_035471	12873404	12873404	1
chr18	12899863	12913651	Cabyr	13788	+	NM_181731	12903025	12912968	6
chr18	12913820	13100350	Osbpl1a	186530	-	NM_207530	12914713	13092209	28
chr18	13130760	13151457	Impact	20697	+	NM_008378	13130845	13149067	11
chr18	13165498	13181391	Hrh4	15893	+	NM_153087	13165558	13181090	3
chr18	13845522	14131242	Zfp521	285720	-	NM_145492	13847503	14129912	8
chr18	14390814	14437051	8430422H06Rik	46237	+	NR_045373	14437051	14437051	4
chr18	14784137	14841423	Ss18	57286	-	NM_009280	14785793	14841244	11
chr18	14864659	14920808	Psma8	56149	+	NM_001163609	14864739	14919948	7
chr18	14941753	15058868	Taf4b	117115	+	NM_001100449	14942103	15056637	15
chr18	15127193	15309955	Kctd1	182762	-	NM_134112	15128045	15309833	5
chr18	15147503	15206496	4933424G05Rik	58993	+	NR_045372	15206496	15206496	5
chr18	15547902	15569491	Aqp4	21589	-	NM_001308646	15551959	15558477	8
chr18	15610683	15876555	Chst9	265872	-	NM_199055	15610771	15876516	4
chr18	16747385	16967755	Cdh2	220370	-	NM_007664	16748655	16966903	16
chr18	16974915	16981292	Gm15328	6377	+	NR_045399	16981292	16981292	3
chr18	17194016	17296068	1700001G01Rik	102052	+	NR_130158	17296068	17296068	8
chr18	17392991	17393991	4921533I20Rik	1000	-	NR_033607	17393991	17393991	1
chr18	17727254	17739499	4930545E07Rik	12245	-	NR_045374	17739499	17739499	3
chr18	20119430	20160598	Dsc3	41168	-	NM_001291809	20122165	20160426	17
chr18	20189133	20218055	Dsc2	28922	-	NM_001317363	20191000	20206820	18
chr18	20241972	20273274	Dsc1	31302	-	NM_013504	20244345	20273057	17
chr18	20405840	20442424	Dsg1c	36584	+	NM_181680	20405940	20442280	15
chr18	20469373	20501854	Dsg1a	32481	+	NM_010079	20469518	20499546	15
chr18	20535335	20568242	Dsg1b	32907	+	NM_181682	20535435	20568121	15
chr18	20594675	20630322	Dsg4	35647	+	NM_181564	20594809	20630104	16
chr18	20668804	20699811	Dsg3	31007	+	NM_030596	20668875	20698756	16
chr18	20716616	20763027	Dsg2	46411	+	NM_007883	20716785	20760836	15
chr18	20823750	20832827	Ttr	9077	+	NM_013697	20823939	20832239	4
chr18	20843099	20904905	B4galt6	61806	-	NM_019737	20846821	20903968	9
chr18	20975724	21054579	Trappc8	78855	-	NM_177038	20976577	21054568	29
chr18	21103125	21142349	Rnf125	39224	+	NM_026301	21132914	21141686	6
chr18	21159800	21186725	Rnf138	26925	+	NM_019706	21160560	21184655	7
chr18	21230844	21258700	Mep1b	27856	+	NM_008586	21230874	21258559	15
chr18	21285842	21458640	Garem	172798	-	NM_001033445	21287625	21458271	6
chr18	21708877	21810869	Klhl14	101992	-	NM_001081403	21711002	21810869	8
chr18	21810065	21814608	4930426D05Rik	4543	+	NM_001271580	21811275	21813547	4
chr18	21969397	22329897	Ccdc178	360500	-	NM_027616	21970000	22308972	23
chr18	22503589	22688728	Asxl3	185139	+	NM_001167777	22568452	22684050	13
chr18	22851655	23200154	Nol4	348499	-	NM_199024	22853620	23198543	10
chr18	23376096	23376319	Gm7788	223	+	NR_110491	23376319	23376319	1
chr18	23468520	23818220	Dtna	349700	+	NM_001285813	23693663	23811847	22
chr18	23908948	23910806	Gm15972	1858	-	NR_126066	23910806	23910806	3
chr18	23910833	24052362	Mapre2	141529	+	NM_001162942	23991360	24049432	8
chr18	23933364	23933490	Mir6360	126	-	NR_105778	23933490	23933490	1
chr18	24113188	24123171	Zfp397	9983	+	NM_027007	24114940	24119544	4
chr18	24148134	24163872	Zfp35	15738	+	NM_011755	24148842	24162844	3
chr18	24170767	24179272	Zfp24	8505	-	NM_021559	24172647	24176588	4
chr18	24263261	24280320	Ino80c	17059	-	NM_172625	24265027	24280302	5
chr18	24363844	24445317	Galnt1	81473	+	NM_013814	24396847	24443357	13
chr18	24587610	24587671	Mir187	61	-	NR_029573	24587671	24587671	1
chr18	24629371	24636268	2700062C07Rik	6897	+	NM_026529	24629404	24635923	5
chr18	24643462	24688705	Rprd1a	45243	-	NM_144861	24646682	24688567	7
chr18	24738381	24762318	Slc39a6	23937	-	NM_139143	24739425	24760131	10
chr18	24762461	24797331	Elp2	34870	+	NM_021448	24762495	24797072	22
chr18	24812191	24860057	Mocos	47866	+	NM_026779	24812426	24859997	15
chr18	24867123	25292008	Fhod3	424885	+	NM_175276	24868109	25291494	27
chr18	25285723	25327378	Tpgs2	41655	-	NM_001142698	25288335	25327109	7
chr18	25327520	25625822	AW554918	298302	+	NM_001033532	25327532	25622322	11
chr18	25636120	25912484	Celf4	276364	-	NM_001146292	25645338	25912128	13
chr18	28718664	29156677	4930474G06Rik	438013	+	NR_045398	29156677	29156677	5
chr18	29556369	29656070	4930578E11Rik	99701	-	NR_045391	29656070	29656070	8
chr18	29601853	29625761	4930527G23Rik	23908	+	NR_045395	29625761	29625761	4
chr18	30432549	30507774	Pik3c3	75225	+	NM_181414	30432604	30507391	25
chr18	31133967	31476782	Rit2	342815	-	NM_009065	31134930	31476597	5
chr18	31597461	31607069	Syt4	9608	-	NM_009308	31599836	31606821	4
chr18	31739821	31769556	Slc25a46	29735	-	NM_026165	31742844	31769465	8
chr18	31794036	31882715	Sap130	88679	+	NM_172965	31795641	31881984	21
chr18	31919477	31943737	Ammecr1l	24260	+	NM_153515	31931361	31940409	8
chr18	31948829	31956355	Polr2d	7526	+	NM_027101	31951534	31955782	4
chr18	31963710	32068641	Wdr33	104931	+	NM_028866	31986938	32066649	22
chr18	32068747	32071557	Sft2d3	2810	-	NM_026006	32070253	32070892	1
chr18	32091160	32118273	Lims2	27113	+	NM_144862	32091193	32117644	10
chr18	32102652	32109290	Gpr17	6638	-	NM_001025381	32106642	32107662	2
chr18	32118887	32196585	Myo7b	77698	-	NM_032394	32119054	32181206	47
chr18	32227387	32263985	Iws1	36598	+	NM_173441	32227659	32256935	14
chr18	32282779	32299224	Proc	16445	-	NM_001042767	32282883	32295584	9
chr18	32322742	32396405	Map3k2	73663	+	NM_011946	32351620	32388002	17
chr18	32399984	32429801	Ercc3	29817	+	NM_133658	32400047	32429543	15
chr18	32518710	32537938	A830052D11Rik	19228	-	NR_045403	32537938	32537938	3
chr18	32536870	32595394	Bin1	58524	+	NM_009668	32537060	32594896	19
chr18	32687973	32719688	Gypc	31715	-	NM_001048207	32689658	32719479	3
chr18	32823295	32996941	4930455D15Rik	173646	-	NR_045381	32996941	32996941	5
chr18	32975036	32979453	Tslp	4417	+	NM_021367	32975053	32978760	5
chr18	32996878	33026074	Wdr36	29196	+	NM_001110015	32997041	33025656	23
chr18	33040226	33040327	Mir6361	101	-	NR_105779	33040327	33040327	1
chr18	33098694	33355421	Camk4	256727	+	NM_009793	33099049	33344855	11
chr18	33361074	33373470	Stard4	12396	-	NM_133774	33363239	33373325	6
chr18	33596672	33623683	Nrep	27011	-	NM_001109988	33598367	33621677	5
chr18	33623816	33634364	Gm10549	10548	+	NR_045415	33634364	33634364	3
chr18	33954545	33955643	Epb41l4aos	1098	+	NR_038151	33955643	33955643	3
chr18	33955980	34166860	Epb41l4a	210880	-	NM_013512	33956995	34165737	24
chr18	34367428	34381426	Gm10548	13998	-	NR_040534	34381426	34381426	2
chr18	34380637	34481844	Apc	101207	+	NM_007462	34420676	34478235	16
chr18	34490798	34496253	Srp19	5455	+	NM_025527	34490872	34495886	5
chr18	34504539	34533069	Reep5	28530	-	NM_007874	34506772	34532975	5
chr18	34569076	34602442	Pkd2l2	33366	+	NM_016927	34569120	34598469	15
chr18	34602004	34666477	Fam13b	64473	-	NM_146084	34602295	34657778	21
chr18	34701981	34707715	Wnt8a	5734	+	NM_009290	34702022	34707302	6
chr18	34722294	34738760	Nme5	16466	-	NM_080637	34722376	34738340	6
chr18	34739499	34757122	4933408B17Rik	17623	-	NM_177773	34739847	34755930	6
chr18	34758268	34784517	Brd8	26249	-	NM_030147	34759835	34784210	22
chr18	34784277	34792931	Kif20a	8654	+	NM_001166407	34785133	34792269	19
chr18	34791336	34811390	Cdc23	20054	-	NM_178347	34793647	34811361	16
chr18	34849551	34880041	Gfra3	30490	-	NM_010280	34850187	34879874	8
chr18	34892648	34911187	Cdc25c	18539	-	NM_009860	34892894	34910582	15
chr18	34918559	34933414	Fam53c	14855	+	NM_175104	34922300	34930512	5
chr18	34936661	34999024	Kdm3b	62363	+	NM_001081256	34936784	34997324	24
chr18	35000242	35007117	Reep2	6875	+	NM_144865	35000409	35006123	8
chr18	35020860	35024610	Egr1	3750	+	NM_007913	35021142	35023422	2
chr18	35062438	35091657	Etf1	29219	-	NM_144866	35064641	35091308	11
chr18	35097068	35114005	Hspa9	16937	-	NM_010481	35097969	35113904	17
chr18	35278565	35414429	Ctnna1	135864	+	NM_009818	35312256	35413546	18
chr18	35368662	35374678	Lrrtm2	6016	-	NM_178005	35372353	35374250	2
chr18	35426049	35658579	Sil1	232530	-	NM_030749	35426206	35598025	10
chr18	35713063	35717970	Snhg4	4907	+	NR_038073	35717970	35717970	4
chr18	35714220	35714290	Mir1949	70	+	NR_035472	35714290	35714290	1
chr18	35716683	35716881	Snora74a	198	+	NR_002905	35716881	35716881	1
chr18	35721811	35751699	Matr3	29888	+	NM_010771	35731677	35750084	15
chr18	35758320	35776839	Paip2	18519	+	NM_026420	35770550	35775909	4
chr18	35774257	35786881	Slc23a1	12624	-	NM_011397	35779058	35786791	15
chr18	35806918	35809021	Mzb1	2103	-	NM_027222	35807223	35808987	4
chr18	35810004	35814853	Prob1	4849	-	NM_001270646	35811820	35814853	1
chr18	35816342	35821840	Spata24	5498	-	NM_029485	35816368	35821782	6
chr18	35830758	35862798	Dnajc18	32040	-	NM_029669	35834772	35862719	8
chr18	35872742	35881145	Ecscr	8403	-	NM_001033141	35873079	35881064	9
chr18	35886642	35890523	1700066B19Rik	3881	+	NM_001033168	35886741	35888502	2
chr18	35893331	35900208	Tmem173	6877	-	NM_028261	35894158	35899231	8
chr18	35931212	35966826	Ube2d2a	35614	+	NM_019912	35931642	35965217	7
chr18	35989471	36021342	Cxxc5	31871	+	NM_133687	36018201	36020348	3
chr18	36124483	36174369	Psd2	49886	+	NM_001289602	36137977	36172502	15
chr18	36177311	36356814	Nrg2	179503	-	NM_001167891	36177567	36356814	10
chr18	36265856	36269608	4930471G03Rik	3752	+	NR_015571	36269608	36269608	2
chr18	36440815	36447898	Pura	7083	+	NM_008989	36446815	36447781	2
chr18	36459754	36461132	Igip	1378	+	NM_001267796	36460836	36460998	1
chr18	36508277	36553024	Cystm1	44747	+	NM_001081365	36526187	36552962	3
chr18	36563332	36614149	Pfdn1	50817	-	NM_026027	36564030	36614139	4
chr18	36664580	36675459	Hbegf	10879	-	NM_010415	36666306	36675167	6
chr18	36687805	36715926	Slc4a9	28121	+	NM_001271547	36687840	36700906	20
chr18	36720256	36818562	Ankhd1	98306	+	NM_175375	36720391	36818113	34
chr18	36823713	36825978	Eif4ebp3	2265	+	NM_201256	36823853	36825273	3
chr18	36826840	36829965	Sra1	3125	-	NM_025291	36827107	36829962	5
chr18	36830812	36839020	Apbb3	8208	-	NM_146085	36831092	36838699	12
chr18	36838868	36843516	Slc35a4	4648	+	NM_001083317	36841772	36842747	4
chr18	36844576	36855579	E230025N22Rik	11003	-	NM_172831	36844979	36855277	13
chr18	36884717	36886469	Cd14	1752	-	NM_009841	36884953	36886145	2
chr18	36894723	36902045	Tmco6	7322	+	NM_028036	36894825	36901817	12
chr18	36901985	36904241	Ndufa2	2256	-	NM_010885	36902220	36904174	3
chr18	36904309	36917293	Ik	12984	+	NM_011879	36904426	36917088	20
chr18	36919892	36923362	Wdr55	3470	+	NM_026464	36919940	36923079	7
chr18	36923324	36925868	Dnd1	2544	-	NM_173383	36923686	36925820	4
chr18	36926181	36942859	Hars	16678	-	NM_008214	36926535	36942754	13
chr18	36942862	36952214	Hars2	9352	+	NM_080636	36943046	36950783	13
chr18	36953576	36959314	Zmat2	5738	+	NM_025594	36953595	36957676	6
chr18	36961416	36961761	Vaultrc5	345	+	NR_027885	36961761	36961761	1
chr18	37079958	37081861	Gm6756	1903	+	NR_076393	37081861	37081861	1
chr18	37089938	37347311	Pcdha1	257373	+	NM_054072	37089938	37344910	4
chr18	37098858	37347314	Pcdha2	248456	+	NM_198117	37098971	37344910	4
chr18	37105860	37347311	Pcdha3	241451	+	NM_138662	37105860	37344910	4
chr18	37112301	38001526	Gm37013	889225	+	NM_001174154	37112419	37999783	4
chr18	37112342	37347311	Pcdha4	234969	+	NM_007766	37112419	37344910	4
chr18	37120093	37347311	Pcdha5	227218	+	NM_009959	37120093	37344910	4
chr18	37127284	38001526	Gm38666	874242	+	NM_001301256	37127382	37999783	4
chr18	37127409	37347311	Pcdha6	219902	+	NM_007767	37127409	37344910	4
chr18	37133455	38001526	Pcdha7-g	868071	+	NM_001301259	37133550	37999783	4
chr18	37133577	37347311	Pcdha7	213734	+	NM_009957	37133577	37344910	4
chr18	37152120	37347311	Pcdha8	195191	+	NM_201243	37152120	37344910	4
chr18	37157533	37347311	Pcdha9	189778	+	NM_138661	37157533	37344910	4
chr18	37164973	37347311	Pcdha10	182338	+	NM_009961	37164973	37344910	4
chr18	37170511	37347311	Pcdha11	176800	+	NM_009960	37170511	37344910	4
chr18	37179883	37347311	Pcdha12	167428	+	NM_138663	37179883	37344910	4
chr18	37249789	37347311	Pcdhac1	97522	+	NM_001003671	37249789	37344910	4
chr18	37303622	37347311	Pcdhac2	43689	+	NM_001003672	37303622	37344910	4
chr18	37424651	37427108	Pcdhb1	2457	+	NM_053126	37424651	37427108	1
chr18	37454493	37457268	Pcdhb2	2775	+	NM_053127	37454629	37457029	1
chr18	37460452	37464239	Pcdhb3	3787	+	NM_053128	37460636	37462991	1
chr18	37467108	37470827	Pcdhb4	3719	+	NM_053129	37467292	37469647	1
chr18	37480034	37483567	Pcdhb5	3533	+	NM_053130	37480222	37482601	1
chr18	37493681	37496000	Pcdhb6	2319	+	NM_053131	37493681	37496000	1
chr18	37501355	37504861	Pcdhb7	3506	+	NM_053132	37501466	37503956	1
chr18	37514924	37517264	Pcdhb8	2340	+	NM_053133	37514924	37517264	1
chr18	37560508	37563563	Pcdhb9	3055	+	NM_053134	37560608	37563095	1
chr18	37571327	37574168	Pcdhb10	2841	+	NM_053135	37571526	37573920	1
chr18	37581071	37584686	Pcdhb11	3615	+	NM_053136	37581272	37583666	1
chr18	37595274	37598308	Pcdhb12	3034	+	NM_053137	37595456	37597826	1
chr18	37602170	37605863	Pcdhb13	3693	+	NM_053138	37602224	37604615	1
chr18	37607310	37610748	Pcdhb14	3438	+	NM_053139	37607496	37609887	1
chr18	37633199	37635994	Pcdhb15	2795	+	NM_053140	37633370	37635731	1
chr18	37637421	37642691	Pcdhb16	5270	+	NM_053141	37637642	37640051	1
chr18	37644674	37647944	Pcdhb17	3270	+	NM_053142	37644812	37647212	1
chr18	37649118	37654157	Pcdhb18	5039	+	NM_053143	37649272	37651651	1
chr18	37656651	37661365	Pcdhb19	4714	+	NM_053144	37656807	37659213	1
chr18	37663917	37667314	Pcdhb20	3397	+	NM_053145	37664076	37666476	1
chr18	37673305	37676017	Pcdhb21	2712	+	NM_053146	37673473	37675798	1
chr18	37678006	37681073	Pcdhb22	3067	+	NM_053147	37678134	37680519	1
chr18	37797031	37798377	Slc25a2	1346	-	NM_001159275	37797330	37798128	1
chr18	37800144	37803858	Taf7	3714	-	NM_175770	37802140	37803166	2
chr18	37821598	38001524	Pcdhga1	179926	+	NM_033584	37821598	37999783	4
chr18	37828758	38001524	Pcdhga2	172766	+	NM_033585	37828758	37999783	4
chr18	37833988	38001526	Pcdhga3	167538	+	NM_033586	37834149	37999783	4
chr18	37840111	38001524	Pcdhgb1	161413	+	NM_033574	37840111	37999783	4
chr18	37845053	38001524	Pcdhga4	156471	+	NM_033587	37845053	37999783	4
chr18	37849512	38001526	Pcdhgb2	152014	+	NM_033575	37849611	37999783	4
chr18	37854154	38001524	Pcdhga5	147370	+	NM_033588	37854154	37999783	4
chr18	37866882	38001524	Pcdhga6	134642	+	NM_033589	37866882	37999783	4
chr18	37874487	38001526	Pcdhga7	127039	+	NM_033590	37874595	37999783	4
chr18	37880207	38001524	Pcdhgb4	121317	+	NM_033576	37880207	37999783	4
chr18	37885359	38001526	Pcdhga8	116167	+	NM_033591	37885546	37999783	4
chr18	37890807	38001524	Pcdhgb5	110717	+	NM_033577	37890807	37999783	4
chr18	37896589	38001517	Pcdhga9	104928	+	NM_033592	37896773	37999783	4
chr18	37901747	38001526	Pcdhgb6	99779	+	NM_033578	37901894	37999783	4
chr18	37906841	38001524	Pcdhga10	94683	+	NM_033593	37906841	37999783	4
chr18	37911432	38001524	Pcdhgb7	90092	+	NM_033579	37911432	37999783	4
chr18	37915426	38001526	Pcdhga11	86100	+	NM_033594	37915594	37999783	4
chr18	37921454	38001526	Pcdhgb8	80072	+	NM_033580	37921532	37999783	4
chr18	37925233	38001526	Pcdhga12	76293	+	NM_033595	37925770	37999783	4
chr18	37966063	38001526	Pcdhgc3	35463	+	NM_033581	37966201	37999783	4
chr18	37974732	38001526	Pcdhgc4	26794	+	NM_033582	37975186	37999783	4
chr18	37979199	38001526	Pcdhgc5	22327	+	NM_033583	37979328	37999783	4
chr18	38003254	38095077	Diaph1	91823	-	NM_001305981	38004994	38066053	29
chr18	38014258	38014314	Mir6979	56	-	NR_105945	38014314	38014314	1
chr18	38096624	38114642	Hdac3	18018	-	NM_010411	38097267	38114567	15
chr18	38115212	38118833	Rell2	3621	+	NM_153793	38116037	38118198	8
chr18	38117087	38129385	Fchsd1	12298	-	NM_175684	38119242	38129380	20
chr18	38132276	38158623	Arap3	26347	-	NM_001205336	38132825	38156526	33
chr18	38134156	38134271	Mir6981	115	-	NR_105947	38134271	38134271	1
chr18	38150540	38150599	Mir6980	59	-	NR_105946	38150599	38150599	1
chr18	38356347	38369416	Pcdh1	13069	-	NM_029357	38356902	38363234	3
chr18	38398058	38410219	1700086O06Rik	12161	-	NR_027904	38410219	38410219	2
chr18	38409902	38422283	0610009O20Rik	12381	+	NM_024179	38410022	38420938	13
chr18	38426745	38444055	Pcdh12	17310	-	NM_017378	38428458	38443724	4
chr18	38456288	38477503	Rnf14	21215	+	NM_020012	38460090	38476266	9
chr18	38487190	38498647	Gnpda1	11457	-	NM_011937	38488526	38497868	7
chr18	38578628	38624060	Ndfip1	45432	+	NM_022996	38578767	38620302	8
chr18	38745918	38760922	Spry4	15004	-	NM_011898	38749459	38750362	2
chr18	38998326	39078353	Fgf1	80027	-	NM_010197	39001580	39018368	4
chr18	39052109	39130928	Gm5820	78819	+	NM_001033789	39052370	39129242	5
chr18	39152798	39535939	Arhgap26	383141	+	NM_175164	39153129	39530816	23
chr18	39570198	39646899	Nr3c1	76701	-	NM_008173	39574135	39646886	8
chr18	39933150	39935736	Pabpc2	2586	+	NM_011033	39933337	39935224	1
chr18	40364518	40379053	Yipf5	14535	-	NM_023311	40365891	40378509	6
chr18	40416615	40417341	2900055J20Rik	726	+	NR_045177	40417341	40417341	1
chr18	40418014	40690838	Kctd16	272824	+	NM_026135	40418014	40690757	2
chr18	42035349	42110848	Prelid2	75499	-	NM_029942	42040879	42110829	7
chr18	42144976	42158703	Grxcr2	13727	-	NM_001033426	42146162	42158656	3
chr18	42213363	42318349	Sh3rf2	104986	+	NM_001146299	42213471	42315881	9
chr18	42338328	42356363	Plac8l1	18035	-	NM_027072	42338472	42356278	4
chr18	42362002	42421725	Lars	59723	-	NM_134137	42362166	42421620	32
chr18	42434033	42434851	Gm4013	818	-	NR_033452	42434851	42434851	2
chr18	42435006	42501194	Rbm27	66188	+	NM_172626	42435187	42498129	20
chr18	42554250	42555747	Pou4f3	1497	+	NM_138945	42554296	42555664	2
chr18	42671140	42735439	Tcerg1	64299	+	NR_110344	42735439	42735439	23
chr18	42737673	42739306	Gpr151	1633	-	NM_181543	42737996	42739265	1
chr18	42804874	43219125	Ppp2r2b	414251	-	NM_028392	42805381	43218894	9
chr18	43367350	43477135	Stk32a	109785	+	NM_178749	43371641	43474808	13
chr18	43480632	43597940	Dpysl3	117308	-	NM_001291455	43483985	43597861	14
chr18	43691061	43847427	Jakmip2	156366	-	NM_001163637	43697329	43750330	22
chr18	43887722	43896891	Spink1	9169	-	NM_009258	43887813	43896803	4
chr18	43923954	43927053	Scgb3a2	3099	+	NM_001289644	43924071	43926908	3
chr18	43936849	43952532	Gm94	15683	-	NM_001033280	43940863	43952496	4
chr18	44122894	44182141	Spink5	59247	+	NM_001081180	44122959	44180495	32
chr18	44187522	44191862	Spink14	4340	+	NM_001039218	44188412	44191562	6
chr18	44231046	44243264	Spink6	12218	+	NM_001013797	44231122	44243071	5
chr18	44264176	44268197	Spink12	4021	+	NM_030061	44264310	44267758	4
chr18	44316056	44319539	Gm10267	3483	-	NM_001281470	44316057	44318957	5
chr18	44326011	44334727	Spinkl	8716	-	NM_183123	44326277	44334246	5
chr18	44349698	44355831	Spink11	6133	-	NM_001048217	44350099	44355831	5
chr18	44429780	44437354	Npy6r	7574	+	NM_010935	44435167	44436283	2
chr18	44493727	44515376	Myot	21649	+	NM_001033621	44496611	44514934	10
chr18	44540153	44584623	Dcp2	44470	+	NM_027490	44540287	44577383	11
chr18	44584713	44971836	Mcc	387123	-	NM_001085373	44589540	44971817	19
chr18	44821318	44835925	A930012L18Rik	14607	+	NR_026853	44835925	44835925	5
chr18	44988318	45049374	Ythdc2	61056	+	NM_001163013	44988340	45047342	30
chr18	45428513	45845537	Kcnn2	417024	+	NM_001312905	45718120	45845216	11
chr18	45843140	46204914	A330093E20Rik	361774	-	NR_040342	46204914	46204914	4
chr18	46324953	46372261	Trim36	47308	-	NM_178872	46327066	46372018	10
chr18	46399602	46440504	Pggt1b	40902	-	NM_172627	46401173	46440473	9
chr18	46441804	46471582	Ccdc112	29778	-	NM_001160399	46442909	46471464	10
chr18	46624587	46625470	Mospd4	883	-	NR_045438	46625470	46625470	1
chr18	46664259	46685625	Fem1c	21366	-	NM_173423	46664733	46684299	3
chr18	46717884	46734187	Ticam2	16303	-	NM_173394	46719973	46720672	3
chr18	46745581	46757189	Tmed7	11608	-	NM_025698	46748105	46756936	3
chr18	46757357	46769879	Eif1a	12522	+	NM_010120	46767353	46767788	3
chr18	46872858	46887996	Cdo1	15138	-	NM_033037	46873585	46887796	5
chr18	46892070	46901233	Atg12	9163	-	NM_026217	46894103	46901200	4
chr18	46901529	46950480	Ap3s1	48951	+	NM_001303015	46901666	46943448	7
chr18	47009692	47065100	Lvrn	55408	+	NM_029008	47009845	47065010	20
chr18	47081468	47093876	Arl14epl	12408	+	NM_001033446	47085973	47092282	5
chr18	47118529	47247648	Commd10	129119	+	NM_178377	47118541	47246720	7
chr18	47404907	47528524	Sema6a	123617	-	NM_001311097	47408036	47466109	18
chr18	47612321	47630522	9130209A04Rik	18201	+	NR_033453	47630522	47630522	4
chr18	47697388	47878290	Gm5095	180902	+	NR_033454	47878290	47878290	6
chr18	48082494	48267634	G630055G22Rik	185140	+	NR_045404	48267634	48267634	4
chr18	49682942	49684094	1700044K03Rik	1152	+	NR_033785	49684094	49684094	2
chr18	49855798	49915255	Dtwd2	59457	-	NM_026854	49857983	49915192	6
chr18	49962985	49977610	1700065O20Rik	14625	-	NR_045386	49977610	49977610	5
chr18	49992650	50125127	Dmxl1	132477	+	NM_001081371	49992743	50122051	43
chr18	50139080	50252883	Tnfaip8	113803	+	NM_001177760	50139279	50251006	3
chr18	50287854	50355924	Hsd17b4	68070	+	NM_008292	50288005	50355598	24
chr18	50438022	50442673	Fam170a	4651	+	NM_001004061	50438277	50442588	4
chr18	50727309	50728353	Hdhd1a	1044	-	NM_026108	50727609	50728314	1
chr18	51277551	51464295	Prr16	186744	+	NM_001081224	51277584	51463019	2
chr18	52491189	52492650	Ftmt	1461	+	NM_026286	52491267	52491981	1
chr18	52625346	52650392	Srfbp1	25046	+	NM_026040	52625373	52650282	8
chr18	52675713	52689521	Lox	13808	-	NM_001286182	52678880	52688983	8
chr18	52775568	52799484	Zfp474	23916	+	NM_025749	52797930	52798974	2
chr18	52805873	52823385	1700034E13Rik	17512	+	NM_030097	52820050	52823372	4
chr18	52853332	52855247	Gykl1	1915	+	NM_010293	52853375	52855025	1
chr18	52927464	53075585	Sncaip	148121	+	NM_001199151	52997663	53075045	12
chr18	53336018	53380514	Snx2	44496	+	NM_026386	53336033	53380076	15
chr18	53405315	53550479	Snx24	145164	+	NM_029394	53405446	53549238	7
chr18	53565994	53577661	Ppic	11667	-	NM_008908	53566590	53577610	5
chr18	53624199	53735511	Prdm6	111312	+	NM_001033281	53624221	53734723	7
chr18	53807804	53865072	Gm19466	57268	+	NR_040349	53865072	53865072	3
chr18	53841376	53904201	Cep120	62825	-	NM_178686	53842886	53903984	21
chr18	54021766	54115338	Csnk1g3	93572	+	NM_152809	54055430	54112953	13
chr18	54581948	54612948	Redrum	31000	+	NR_040338	54612948	54612948	3
chr18	54771397	54799524	9330117O12Rik	28127	+	NR_045400	54799524	54799524	3
chr18	55047698	55149834	Zfp608	102136	-	NM_175751	55048728	55148167	10
chr18	56591785	56663446	Gramd3	71661	+	NM_026240	56591928	56662283	14
chr18	56685389	56732593	Aldh7a1	47204	-	NM_001127338	56686606	56721794	20
chr18	56697792	56697852	Mir1258	60	+	NR_106160	56697852	56697852	1
chr18	56722222	56747366	Phax	25144	+	NM_001162989	56722347	56746800	5
chr18	56748001	56754433	Tex43	6432	+	NM_026099	56748017	56754311	3
chr18	56867466	56913079	Lmnb1	45613	+	NM_010721	56867766	56912302	11
chr18	56921369	57085202	March3	163833	-	NM_177115	56922168	56971673	5
chr18	57095913	57100172	Gm10536	4259	+	NR_033455	57100172	57100172	1
chr18	57115484	57135033	C330018D20Rik	19549	-	NM_029909	57117395	57122165	5
chr18	57292743	57457121	Megf10	164378	+	NM_001001979	57340139	57453709	25
chr18	57514386	57552373	Prrc1	37987	+	NM_028447	57522106	57549083	9
chr18	57628139	57637788	Ctxn3	9649	+	NM_001134697	57636766	57637009	2
chr18	57664075	57693406	1700066O22Rik	29331	-	NR_015541	57693406	57693406	2
chr18	57693433	57890719	1700011I03Rik	197286	+	NM_001311063	57693506	57890440	6
chr18	57705014	57711521	4930511M06Rik	6507	-	NR_027945	57711521	57711521	4
chr18	57791732	57798239	2210409D07Rik	6507	-	NR_045360	57798239	57798239	3
chr18	58038331	58106475	Slc12a2	68144	+	NM_009194	58038460	58103705	27
chr18	58168276	58369580	Fbn2	201304	-	NM_010181	58169911	58369459	65
chr18	58715893	58772523	Slc27a6	56630	+	NM_001081072	58716117	58772009	10
chr18	58819135	58839224	Isoc1	20089	+	NM_025478	58819145	58837565	5
chr18	58996417	59213332	Adamts19	216915	+	NM_175506	58996460	59212342	23
chr18	59222034	59236614	A730017C20Rik	14580	+	NR_033765	59236614	59236614	5
chr18	59334993	59570990	Chsy3	235997	+	NM_001081328	59335330	59570100	3
chr18	59739283	59739389	Mir6355	106	+	NR_105773	59739389	59739389	1
chr18	60371730	60407474	Gm4951	35744	+	NM_001033767	60405048	60406269	3
chr18	60427954	60432921	Gm4841	4967	-	NM_001034859	60429419	60430673	2
chr18	60453033	60462670	F830016B08Rik	9637	+	NM_001101475	60459500	60460751	2
chr18	60535682	60552283	Iigp1	16601	+	NM_001146275	60549465	60550707	3
chr18	60633844	60661637	Smim3	27793	-	NM_134133	60635049	60635232	2
chr18	60685874	60718416	Dctn4	32542	+	NM_026302	60685884	60716095	13
chr18	60720439	60732383	Rbm22	11944	+	NM_025776	60720479	60731607	11
chr18	60733370	60751370	Myoz3	18000	-	NM_133363	60736003	60749900	7
chr18	60753643	60783959	Synpo	30316	-	NM_177340	60755479	60763809	3
chr18	60823063	60831278	G630071F17Rik	8215	+	NR_045401	60831278	60831278	3
chr18	60845629	60873043	Ndst1	27414	-	NM_008306	60848898	60872889	14
chr18	60934249	60938200	Rps14	3951	+	NM_020600	60936056	60938152	5
chr18	60963502	60972306	Cd74	8804	+	NM_001042605	60963587	60971816	9
chr18	60971729	60971817	Mir5107	88	+	NR_039567	60971817	60971817	1
chr18	60973409	61008618	Tcof1	35209	-	NM_001198984	60974195	61008512	26
chr18	61071893	61077422	Arsi	5529	+	NM_001038499	61071893	61077422	2
chr18	61085285	61147806	Camk2a	62521	+	NM_177407	61085432	61144434	18
chr18	61113526	61113586	Mir7220	60	+	NR_106079	61113586	61113586	1
chr18	61117726	61117794	Mir6982	68	+	NR_105948	61117794	61117794	1
chr18	61155033	61173853	Slc6a7	18820	-	NM_201353	61156272	61173663	14
chr18	61178515	61195853	Cdx1	17338	-	NM_009880	61179379	61195774	3
chr18	61204803	61244721	Pdgfrb	39918	+	NM_008809	61219803	61243037	23
chr18	61265225	61290793	Csf1r	25568	+	NM_001037859	61265603	61290134	22
chr18	61277121	61277185	Mir6983	64	+	NR_105949	61277185	61277185	1
chr18	61290930	61336704	Hmgxb3	45774	-	NM_134134	61291793	61331938	21
chr18	61356507	61371250	Slc26a2	14743	-	NM_007885	61357791	61362033	4
chr18	61380152	61449372	Pde6a	69220	+	NM_146086	61380258	61447863	22
chr18	61457789	61560085	Ppargc1b	102296	-	NM_133249	61458336	61560021	12
chr18	61557488	61557554	Mir378a	66	-	NR_029879	61557554	61557554	1
chr18	61629878	61644261	A530050N04Rik	14383	-	NR_045419	61644261	61644261	4
chr18	61653447	61696190	Arhgef37	42743	-	NM_177828	61654493	61683646	13
chr18	61715235	61747953	Csnk1a1	32718	+	NM_146087	61715404	61747087	10
chr18	61799306	61807139	Bvht	7833	+	NR_045420	61807139	61807139	3
chr18	61805531	61825192	Mir143hg	19661	-	NR_045402	61825192	61825192	5
chr18	61807478	61807548	Mir145a	70	-	NR_029557	61807548	61807548	1
chr18	61808849	61808912	Mir143	63	-	NR_029601	61808912	61808912	1
chr18	61847588	61852191	Il17b	4603	+	NM_019508	61847637	61852091	3
chr18	61856490	61867289	Pcyox1l	10799	-	NM_172832	61856965	61867235	6
chr18	61872077	61885985	Grpel2	13908	-	NM_021296	61875416	61885953	4
chr18	61886043	61887907	1500015A07Rik	1864	+	NR_029432	61887907	61887907	1
chr18	61889915	61946316	Afap1l1	56401	-	NM_178928	61890940	61946245	19
chr18	61959046	62071506	Ablim3	112460	-	NM_001164491	61960948	62070895	24
chr18	62112728	62175373	Sh3tc2	62645	+	NM_172628	62112769	62174744	17
chr18	62337366	62339635	Adrb2	2269	-	NM_007420	62338149	62339406	1
chr18	62483857	62627456	Htr4	143599	+	NM_008313	62500705	62624178	7
chr18	62663712	62708397	Fbxo38	44685	-	NM_134136	62664355	62700662	22
chr18	62708564	62821042	Spink10	112478	+	NM_177829	62810513	62820641	9
chr18	62752066	62755918	Spink7	3852	-	NM_001001803	62752066	62755918	4
chr18	62767193	62901041	Spink13	133848	-	NM_001168423	62767386	62774640	5
chr18	62911327	62916001	2700046A07Rik	4674	-	NR_037693	62916001	62916001	3
chr18	63081980	63112849	Apcdd1	30869	+	NM_133237	63082317	63111932	5
chr18	63137569	63159104	Napg	21535	+	NM_028017	63137622	63156614	12
chr18	63169866	63546837	Piezo2	376971	-	NM_001039485	63171201	63545923	54
chr18	63822454	63852013	Txnl1	29559	-	NM_016792	63823956	63851827	8
chr18	63868348	64149413	Wdr7	281065	+	NM_001014981	63879884	64147013	28
chr18	64317377	64436834	St8sia3os	119457	-	NR_045366	64436834	64436834	6
chr18	64414012	64435798	St8sia3	21786	+	NM_009182	64425125	64431450	6
chr18	64500017	64558142	Onecut2	58125	+	NM_194268	64500033	64546285	2
chr18	64616203	64648720	Fech	32517	-	NM_007998	64617736	64648621	11
chr18	64659300	64676211	Nars	16911	-	NM_001142950	64660171	64676112	15
chr18	64688632	64820654	Atp8b1	132022	-	NM_001001488	64690993	64765032	28
chr18	65047409	65377480	Nedd4l	330071	+	NM_001114386	65047701	65372540	31
chr18	65408514	65408580	Mir122	66	+	NR_029600	65408580	65408580	1
chr18	65425185	65553542	Alpk2	128357	-	NM_001037294	65425724	65537778	13
chr18	65590650	65638446	Malt1	47796	+	NM_172833	65590825	65636079	16
chr18	65739883	65849090	Zfp532	109207	+	NM_207255	65782651	65847110	6
chr18	65857921	65911191	Oacyl	53270	+	NM_177028	65857947	65909844	15
chr18	65960231	65977311	Sec11c	17080	+	NM_025468	65960278	65977167	6
chr18	66033139	66046250	Grp	13111	+	NM_175012	66033260	66045924	3
chr18	66094292	66098743	Rax	4451	-	NM_013833	66094657	66098468	3
chr18	66115375	66129832	Cplx4	14457	-	NM_145493	66116517	66129701	3
chr18	66140392	66162289	Lman1	21897	-	NM_027400	66143504	66162265	14
chr18	66216509	66451492	Ccbe1	234983	-	NM_178793	66220940	66451408	11
chr18	66378917	66378987	Mir694	70	-	NR_030467	66378987	66378987	1
chr18	66618257	66625212	Pmaip1	6955	+	NM_021451	66618414	66623027	3
chr18	66663831	66671391	Gm9926	7560	+	NR_040528	66671391	66671391	3
chr18	67017358	67020141	Mc4r	2783	-	NM_016977	67018695	67019694	1
chr18	67084415	67109615	Gm19784	25200	-	NR_040461	67109615	67109615	5
chr18	67247951	67386445	Gnal	138494	+	NM_177137	67248181	67382369	12
chr18	67365012	67367541	Chmp1b	2529	+	NM_024190	67365154	67365754	1
chr18	67385183	67405484	Mppe1	20301	-	NM_172630	67385355	67397278	11
chr18	67448876	67478495	Impa2	29619	+	NM_053261	67449058	67478164	8
chr18	67480862	67503757	B430212C06Rik	22895	-	NR_033214	67503757	67503757	4
chr18	67503217	67527448	Cidea	24231	+	NM_007702	67503456	67527177	5
chr18	67550384	67562403	Tubb6	12019	+	NM_026473	67550411	67562030	4
chr18	67564417	67608790	Afg3l2	44373	-	NM_027130	67564931	67608655	17
chr18	67624502	67640235	Slmo1	15733	+	NM_144867	67624578	67637657	7
chr18	67647862	67712375	Spire1	64513	-	NM_194355	67650944	67712356	15
chr18	67777050	67800990	Cep76	23940	-	NM_001081073	67778887	67800828	12
chr18	67801252	67813816	Psmg2	12564	+	NM_134138	67801332	67813632	7
chr18	67825154	67884275	Ptpn2	59121	-	NM_008977	67825506	67884164	10
chr18	67934529	67955141	Seh1l	20612	+	NM_001039088	67934663	67952816	9
chr18	67935686	67959597	4930549G23Rik	23911	-	NR_045376	67959597	67959597	4
chr18	67959760	68044824	Cep192	85064	+	NM_027556	67962646	68044531	46
chr18	68092910	68415203	Ldlrad4	322293	+	NM_172631	68224300	68414193	6
chr18	68419838	68459987	Fam210a	40149	-	NM_153794	68428372	68435891	4
chr18	68420573	68420627	Mir7219	54	-	NR_106078	68420627	68420627	1
chr18	68460008	68484506	Rnmt	24498	+	NM_026440	68465475	68481009	11
chr18	68497256	68499365	Mc5r	2109	+	NM_013596	68497278	68499344	2
chr18	68566552	68588974	Mc2r	22422	-	NM_001301372	68566983	68567874	5
chr18	68899053	68899155	Mir6356	102	+	NR_105774	68899155	68899155	1
chr18	69049140	69111182	4930546C10Rik	62042	-	NR_038051	69111182	69111182	7
chr18	69181852	69181927	Mir145b	75	-	NR_105780	69181927	69181927	1
chr18	69504145	69847621	Tcf4	343476	+	NM_013685	69506952	69842473	20
chr18	70085212	70129138	Ccdc68	43926	+	NM_201362	70098507	70128689	11
chr18	70138784	70301259	Rab27b	162475	-	NM_001082553	70144841	70155875	7
chr18	70400082	70404238	Dynap	4156	-	NM_029346	70400621	70404036	3
chr18	70612793	70632134	4930503L19Rik	19341	-	NM_172967	70612969	70629394	9
chr18	70632107	70660719	Stard6	28612	+	NM_029019	70635757	70660279	9
chr18	70668333	70689975	Poli	21642	-	NM_001289515	70668567	70683033	10
chr18	70676439	70676543	Mir6357	104	+	NR_105775	70676543	70676543	1
chr18	70727945	70785785	Mbd2	57840	+	NM_010773	70728070	70782363	7
chr18	71413285	72510723	Dcc	1097438	-	NM_007831	71418643	72510100	29
chr18	73732358	73752232	Mex3c	19874	+	NM_001039214	73732697	73750450	2
chr18	73798666	73863395	Smad4	64729	-	NM_008540	73799911	73837565	12
chr18	73894691	73914133	Elac1	19442	-	NM_053255	73898487	73906977	4
chr18	73929693	73975046	Me2	45353	-	NM_145494	73930279	73964813	16
chr18	74019038	74038788	Mro	19750	+	NM_001305882	74029611	74037552	9
chr18	74088140	74224603	Mapk4	136463	-	NM_172632	74090051	74130090	6
chr18	74177560	74179742	D730045A05Rik	2182	+	NR_045390	74179742	74179742	3
chr18	74354952	74367472	Ska1	12520	-	NM_001164355	74356556	74366527	7
chr18	74375865	74381145	Cxxc1	5280	+	NM_028868	74376133	74380859	15
chr18	74427941	74442338	Mbd1	14397	+	NM_013594	74429082	74441605	15
chr18	74442753	74519638	Cfap53	76885	+	NR_029424	74519638	74519638	9
chr18	74602272	74931131	Myo5b	328859	+	NM_201600	74602434	74930103	39
chr18	74655331	74690778	1700120E14Rik	35447	-	NR_045368	74690778	74690778	4
chr18	74938047	74938109	Scarna17	62	-	NR_028560	74938109	74938109	1
chr18	74938865	74965861	Acaa2	26996	+	NM_177470	74938903	74965593	10
chr18	75098975	75120917	Lipg	21942	-	NM_010720	75100970	75120628	10
chr18	75132417	75141201	9030625G05Rik	8784	-	NR_110446	75141201	75141201	7
chr18	75160130	75163035	Rpl17	2905	+	NM_001002239	75160857	75162895	7
chr18	75160721	75160776	Snord58b	55	+	NR_028552	75160776	75160776	1
chr18	75165553	75169587	BC031181	4034	+	NM_001001181	75168327	75168997	3
chr18	75178425	75446620	Dym	268195	+	NM_027727	75202783	75446423	17
chr18	75448313	75456971	2010010A06Rik	8658	-	NR_045394	75456971	75456971	2
chr18	75527018	75555588	Smad7	28570	+	NM_001042660	75528609	75554019	4
chr18	75590870	75857350	Ctif	266480	-	NM_201354	75594847	75796966	12
chr18	75674298	75682460	Gm10532	8162	+	NR_045879	75682460	75682460	4
chr18	75979831	76308218	Zbtb7c	328387	+	NM_145356	76296496	76305986	5
chr18	76251210	76258125	2900057B20Rik	6915	-	NR_045365	76258125	76258125	3
chr18	76330205	76330306	Mir6358	101	+	NR_105776	76330306	76330306	1
chr18	76401354	76471401	Smad2	70047	+	NM_010754	76422145	76464384	11
chr18	77095143	77139081	Skor2	43938	+	NM_001109743	77097323	77132894	9
chr18	77168765	77180353	Ier3ip1	11588	+	NM_025409	77168864	77179307	3
chr18	77182853	77210910	Hdhd2	28057	+	NM_029826	77189861	77209453	7
chr18	77231938	77286035	Katnal2	54097	-	NM_027721	77232309	77285963	14
chr18	77303946	77394447	Pias2	90501	+	NM_001164167	77304134	77391436	14
chr18	77424585	77494189	St8sia5	69604	+	NM_013666	77424833	77493573	8
chr18	77520696	77680996	Loxhd1	160300	+	NM_172834	77520696	77680608	39
chr18	77694848	77803875	Rnf165	109027	-	NM_001164504	77701070	77803841	8
chr18	77872019	77952749	8030462N17Rik	80730	-	NM_178670	77873877	77913353	5
chr18	77952922	77954184	4930465K10Rik	1262	+	NR_027978	77954184	77954184	1
chr18	77996305	78006519	Haus1	10214	-	NM_146089	77996441	78006488	9
chr18	78012506	78021607	Atp5a1	9101	+	NM_007505	78012789	78021121	12
chr18	78033288	78121618	Pstpip2	88330	+	NM_013831	78033456	78118144	15
chr18	78135205	78231766	Epg5	96561	+	NM_001195633	78135238	78229846	44
chr18	78240352	78254007	Siglec15	13655	-	NM_001101038	78240352	78254007	6
chr18	78296829	78338858	Slc14a1	42029	-	NM_001171011	78299133	78313247	9
chr18	78342882	78793689	Slc14a2	450807	-	NM_207651	78343678	78405833	22
chr18	78947116	79306130	Setbp1	359014	-	NM_053099	78951953	79283754	6
chr18	80243633	80316379	Pard6g	72746	+	NM_053117	80243809	80314561	3
chr18	80323873	80348221	Adnp2	24348	-	NM_175028	80324433	80339495	4
chr18	80382977	80390308	LOC105246506	7331	+	NR_131039	80390308	80390308	5
chr18	80389002	80397358	Rbfa	8356	-	NM_199197	80389218	80397288	6
chr18	80403536	80422590	Txnl4a	19054	+	NM_025299	80403929	80419089	4
chr18	80426494	80443841	Hsbp1l1	17347	-	NM_001136181	80427294	80433485	5
chr18	80451983	80489463	Pqlc1	37480	+	NM_001164420	80453654	80488522	5
chr18	80491282	80560993	Kcng2	69711	-	NM_001190373	80492367	80519874	4
chr18	80604697	80666406	Ctdp1	61709	-	NM_026295	80605378	80666285	13
chr18	80738630	80741285	Gm2176	2655	-	NR_028424	80741285	80741285	4
chr18	80802943	80909810	Nfatc1	106867	-	NM_198429	80804761	80909505	10
chr18	80930879	81130797	Atp9b	199918	-	NM_001201569	80932751	81130678	30
chr18	81163112	81183317	Sall3	20205	-	NM_178280	81166211	81183275	4
chr18	82188748	82188819	Mir5127	71	-	NR_039589	82188819	82188819	1
chr18	82561887	82576169	Galr1	14282	-	NM_008082	82563084	82575542	3
chr18	82644514	82755029	Mbp	110515	+	NM_010777	82670143	82753548	7
chr18	82762988	82862126	Zfp236	99138	-	NM_177832	82767024	82862089	30
chr18	82889672	82889732	Mir5112	60	+	NR_039572	82889732	82889732	1
chr18	82923896	82928431	2210420H20Rik	4535	-	NR_045389	82928431	82928431	4
chr18	83025288	83028554	4930445N18Rik	3266	+	NR_125720	83028554	83028554	3
chr18	83080270	83174706	Zfp516	94436	+	NM_183033	83125070	83170724	6
chr18	83087796	83089952	4930592I03Rik	2156	-	NR_033307	83089952	83089952	3
chr18	83462183	83495276	4921531P14Rik	33093	-	NR_045361	83495276	83495276	4
chr18	84181018	84255954	Tshz1	74936	-	NM_001081300	84182418	84254795	2
chr18	84257549	84266906	Zadh2	9357	+	NM_146090	84257556	84264726	2
chr18	84377093	84758896	Zfp407	381803	-	NM_001033341	84378133	84732378	9
chr18	84779900	84819487	Cndp1	39587	-	NM_177450	84780979	84809670	12
chr18	84836856	84855094	Cndp2	18238	-	NM_023149	84837422	84851289	12
chr18	84889633	84909828	Fam69c	20195	+	NM_173770	84899670	84908979	5
chr18	85020805	85049255	Cyb5a	28450	+	NM_025797	85020870	85048976	5
chr18	85104416	85150784	Fbxo15	46368	+	NM_015798	85104549	85150768	10
chr18	85116685	85120916	Timm21	4231	-	NM_025969	85117038	85120689	6
chr18	86564343	86671289	Neto1	106946	+	NM_144946	86565274	86669465	11
chr18	86880501	86887675	Cbln2	7174	+	NM_001302356	86882460	86886170	5
chr18	89037271	89063599	Socs6	26328	-	NM_018821	89038579	89040181	3
chr18	89141181	89300406	Rttn	159225	+	NM_175542	89141439	89300076	49
chr18	89141421	89141502	Mir6359	81	+	NR_105777	89141502	89141502	1
chr18	89366818	89439719	Cd226	72901	+	NM_178687	89375987	89438473	7
chr18	89470526	89938528	Dok6	468002	-	NM_001039173	89470526	89938528	8
chr18	90679545	90712659	Tmx3	33114	+	NM_198295	90679714	90709588	16
chr19	3153798	3197703	1700030N03Rik	43905	-	NR_045304	3197703	3197703	3
chr19	3259075	3283010	Ighmbp2	23935	-	NM_009212	3261431	3282786	15
chr19	3283046	3292837	Mrpl21	9791	+	NM_172252	3283071	3292521	7
chr19	3288919	3288983	Mir6984	64	+	NR_105950	3288983	3288983	1
chr19	3323300	3385733	Cpt1a	62433	+	NM_013495	3349201	3383841	19
chr19	3388856	3407823	Mtl5	18967	+	NM_001039657	3388949	3407110	9
chr19	3409916	3414457	Gal	4541	-	NM_010253	3410094	3414112	6
chr19	3454927	3575749	Ppp6r3	120822	-	NM_028999	3456999	3526928	24
chr19	3584824	3686564	Lrp5	101740	-	NM_008513	3585029	3686442	23
chr19	3708332	3717881	1810055G02Rik	9549	+	NM_028077	3715726	3717593	4
chr19	3767420	3818303	Suv420h1	50883	+	NM_001167885	3786464	3815589	13
chr19	3851772	3894369	Chka	42597	+	NR_073190	3894369	3894369	13
chr19	3896049	3907133	Tcirg1	11084	-	NM_001136091	3896113	3904701	20
chr19	3908862	3912774	Ndufs8	3912	-	NM_001271444	3908942	3911746	7
chr19	3913490	3929716	Aldh3b1	16226	-	NM_026316	3913893	3923900	10
chr19	3935185	3949340	Unc93b1	14155	+	NM_019449	3935193	3948942	11
chr19	3958807	3970438	Aldh3b3	11631	+	NM_028545	3958875	3969947	10
chr19	3972327	3981665	Aldh3b2	9338	+	NM_001177438	3972575	3981192	10
chr19	3986569	3990005	Acy3	3436	+	NM_001302479	3987069	3989868	8
chr19	3992751	3999512	Tbx10	6761	+	NM_011533	3996644	3999248	8
chr19	4000579	4002102	Nudt8	1523	+	NM_025529	4000653	4002023	4
chr19	4003384	4007005	Doc2g	3621	+	NM_021791	4003570	4006849	11
chr19	4007498	4012755	Ndufv1	5257	-	NM_133666	4007578	4012622	10
chr19	4035410	4037912	Gstp1	2502	-	NM_013541	4035472	4037863	7
chr19	4040287	4042221	Gstp2	1934	-	NM_181796	4040350	4042165	7
chr19	4057486	4059294	BC021614	1808	-	NM_144869	4057529	4059294	6
chr19	4082487	4087339	Cabp2	4852	+	NM_001160253	4082705	4087136	6
chr19	4097350	4099017	Cdk2ap2	1667	+	NM_026373	4097425	4098565	4
chr19	4099997	4113965	Pitpnm1	13968	+	NR_075078	4113965	4113965	24
chr19	4113755	4125858	Aip	12103	-	NM_016666	4114590	4121434	7
chr19	4125959	4132307	Tmem134	6348	+	NM_001078649	4126025	4131444	8
chr19	4135422	4139609	Cabp4	4187	-	NM_144532	4135986	4139556	6
chr19	4139798	4145740	Gpr152	5942	+	NM_206973	4142461	4143997	2
chr19	4148662	4154035	Coro1b	5373	+	NM_011778	4149343	4153722	11
chr19	4154645	4156710	Ptprcap	2065	+	NM_016933	4154700	4156513	2
chr19	4156976	4163245	Rps6kb2	6269	-	NM_021485	4157009	4163245	15
chr19	4164323	4175479	Carns1	11156	-	NM_134148	4165337	4175007	10
chr19	4184356	4191047	Tbc1d10c	6691	-	NM_178650	4184725	4190809	10
chr19	4192173	4195419	Ppp1ca	3246	+	NM_031868	4192216	4195092	7
chr19	4195197	4201603	Rad9a	6406	-	NM_011237	4195986	4201516	11
chr19	4214237	4223505	Clcf1	9268	+	NM_001310038	4220191	4222568	4
chr19	4214237	4233634	Clcf1-pold4	19397	+	NR_132308	4233634	4233634	4
chr19	4231892	4233634	Pold4	1742	+	NM_027196	4232091	4233238	4
chr19	4261667	4269172	Ssh3	7505	-	NM_198113	4262353	4269080	14
chr19	4263817	4263878	Mir6985	61	-	NR_105951	4263878	4263878	1
chr19	4270179	4283137	Ankrd13d	12958	-	NM_026720	4270335	4282970	15
chr19	4285998	4306222	Adrbk1	20224	-	NM_130863	4287099	4294913	22
chr19	4316146	4397077	Kdm2a	80931	-	NM_001001984	4319099	4394833	21
chr19	4425456	4439424	Rhod	13968	-	NM_007485	4426088	4439351	5
chr19	4439322	4448325	A930001C03Rik	9003	+	NR_045990	4448325	4448325	3
chr19	4445907	4477143	Syt12	31236	-	NM_134164	4447686	4467940	8
chr19	4496787	4498583	2010003K11Rik	1796	-	NM_027237	4497515	4498519	2
chr19	4510471	4621752	Pcx	111281	+	NM_001162946	4515687	4621288	21
chr19	4611783	4615667	Lrfn4	3884	-	NM_153388	4612076	4614504	3
chr19	4622550	4625617	Rce1	3067	-	NM_023131	4623006	4625617	8
chr19	4623897	4623955	Mir6986	58	-	NR_105952	4623955	4623955	1
chr19	4625840	4698668	Gm960	72828	-	NM_001033447	4625840	4698668	15
chr19	4711222	4752352	Sptbn2	41130	+	NM_021287	4718840	4751728	37
chr19	4756524	4765940	Rbm4b	9416	+	NM_025717	4757257	4762638	4
chr19	4784292	4794009	Rbm4	9717	-	NM_001290123	4787368	4792809	4
chr19	4784292	4811634	Gm21992	27342	-	NM_001290127	4787368	4811508	4
chr19	4800565	4811634	Rbm14	11069	-	NM_019869	4801597	4811508	3
chr19	4825365	4839322	Ccs	13957	-	NM_016892	4825510	4839235	8
chr19	4839365	4842528	Ccdc87	3163	+	NM_207268	4839481	4842049	1
chr19	4855128	4860912	Ctsf	5784	+	NM_019861	4855267	4860465	14
chr19	4861215	4877909	Actn3	16694	-	NM_013456	4861344	4877854	21
chr19	4878667	4885397	Zdhhc24	6730	+	NM_001168516	4880385	4883771	3
chr19	4886881	4906627	Bbs1	19746	-	NM_001033128	4890671	4906602	17
chr19	4907228	4928287	Dpp3	21059	-	NM_133803	4907621	4927054	18
chr19	4931854	4943092	Peli3	11238	-	NM_172835	4932297	4941911	7
chr19	4962305	4966995	Mrpl11	4690	+	NM_025553	4962392	4964779	5
chr19	4984354	4989971	Npas4	5617	-	NM_153553	4985067	4989816	8
chr19	5024005	5031972	Slc29a2	7967	+	NM_007854	5024248	5031113	12
chr19	5038825	5041134	B4gat1	2309	+	NM_175383	5038976	5040498	2
chr19	5041403	5049917	Brms1	8514	+	NM_134155	5045899	5049414	10
chr19	5050807	5057071	Rin1	6264	+	NM_145495	5050858	5055238	10
chr19	5068077	5070639	Cd248	2562	+	NM_054042	5068125	5070423	1
chr19	5079336	5085477	Tmem151a	6141	-	NM_001001885	5081769	5085372	2
chr19	5088537	5092879	Yif1a	4342	+	NM_026553	5088717	5092448	8
chr19	5092867	5098521	Cnih2	5654	-	NM_001302333	5093469	5094720	6
chr19	5099206	5106996	Rab1b	7790	-	NM_029576	5100377	5106938	6
chr19	5107745	5118408	Klc2	10663	-	NM_008451	5108604	5117421	16
chr19	5133684	5273119	Pacs1	139435	-	NM_153129	5134909	5272888	24
chr19	5273920	5295455	Sf3b2	21535	-	NM_030109	5274455	5295394	21
chr19	5298330	5308739	Gal3st3	10409	+	NM_001024717	5302546	5307894	3
chr19	5335740	5344153	Catsper1	8413	+	NM_139301	5335740	5344153	12
chr19	5344704	5349574	Cst6	4870	-	NM_028623	5347965	5349334	3
chr19	5364632	5366876	Banf1	2244	-	NM_011793	5365011	5365940	3
chr19	5366812	5371511	Eif1ad	4699	+	NM_027236	5368189	5370085	6
chr19	5377522	5388703	Sart1	11181	-	NM_016882	5380116	5388627	20
chr19	5388335	5390069	D330050I16Rik	1734	+	NR_033224	5390069	5390069	1
chr19	5406814	5422847	4930481A15Rik	16033	+	NR_015545	5422847	5422847	5
chr19	5422803	5424979	Drap1	2176	-	NM_024176	5422919	5424714	7
chr19	5425143	5427316	AI837181	2173	+	NM_134149	5425168	5426707	2
chr19	5447697	5455938	Fosl1	8241	+	NM_010235	5447950	5455308	4
chr19	5453162	5457563	Ccdc85b	4401	-	NM_001243307	5456984	5457397	2
chr19	5460606	5465052	Fibp	4446	+	NM_001253832	5460693	5464994	10
chr19	5465042	5468507	Ctsw	3465	-	NM_009985	5465340	5468483	10
chr19	5474689	5481854	Efemp2	7165	+	NM_021474	5475067	5481722	11
chr19	5482839	5488336	Mus81	5497	-	NM_027877	5482962	5488122	16
chr19	5490454	5494031	Cfl1	3577	+	NM_007687	5490599	5493493	4
chr19	5495277	5510489	Snx32	15212	-	NM_001024560	5495594	5510371	13
chr19	5502768	5503787	1700020D05Rik	1019	-	NM_023781	5502866	5503751	1
chr19	5549136	5560575	Ovol1	11439	-	NM_019935	5550957	5560300	4
chr19	5568073	5571261	Ap5b1	3188	+	NM_001033448	5568457	5571184	2
chr19	5601872	5602959	Rnaseh2c	1087	+	NM_026616	5601908	5602850	4
chr19	5603013	5610094	Kat5	7081	-	NM_178637	5603417	5610029	14
chr19	5637489	5648130	Rela	10641	+	NM_009045	5637834	5647416	11
chr19	5651184	5663707	Sipa1	12523	-	NM_001164481	5651415	5660980	18
chr19	5664634	5688908	Pcnxl3	24274	-	NM_144868	5665052	5688149	35
chr19	5679003	5679076	Mir6987	73	-	NR_105953	5679076	5679076	1
chr19	5689130	5702864	Map3k11	13734	+	NM_022012	5690246	5702344	12
chr19	5704475	5707101	Kcnk7	2626	+	NM_010609	5704475	5707016	3
chr19	5707373	5726317	Ehbp1l1	18944	-	NM_053252	5708325	5726020	19
chr19	5728086	5729666	Fam89b	1580	-	NM_023166	5728589	5729527	2
chr19	5730305	5731732	Sssca1	1427	-	NM_020491	5730368	5731694	4
chr19	5740903	5758532	Ltbp3	17629	+	NM_008520	5742240	5758092	28
chr19	5758426	5771401	Scyl1	12975	-	NM_023912	5758571	5771330	17
chr19	5795689	5802671	Malat1	6982	-	NR_002847	5802671	5802671	1
chr19	5824709	5845478	Neat1	20769	-	NR_131212	5845478	5845478	1
chr19	5850973	5875208	Frmd8	24235	-	NM_026169	5852620	5874794	11
chr19	5878465	5885768	Slc25a45	7303	+	NM_134154	5878654	5884991	6
chr19	5891137	5894107	Tigd3	2970	-	NM_198634	5891687	5893100	2
chr19	5896515	5912871	Dpf2	16356	-	NM_001291078	5898554	5912772	12
chr19	5917555	5924816	Cdc42ep2	7261	-	NM_026772	5918030	5918675	2
chr19	5940542	5964206	Pola2	23664	-	NM_008893	5940861	5963904	18
chr19	5970233	5986143	Slc22a20	15910	-	NM_198650	5970456	5986140	10
chr19	5988544	6015825	Capn1	27281	-	NM_001110504	5989360	6014467	22
chr19	6012619	6018459	Gm10814	5840	+	NR_045783	6018459	6018459	5
chr19	6046575	6053718	Syvn1	7143	+	NM_028769	6047933	6052657	16
chr19	6051333	6051392	Mir6988	59	+	NR_105954	6051392	6051392	1
chr19	6053629	6057751	Mrpl49	4122	-	NM_026246	6054835	6057736	4
chr19	6057887	6059524	Fau	1637	+	NM_001160239	6058250	6059474	5
chr19	6061206	6062468	Znhit2	1262	+	NM_013859	6061226	6062426	1
chr19	6062820	6067850	Tm7sf2	5030	-	NM_028454	6062912	6067720	10
chr19	6067841	6077187	Vps51	9346	-	NM_001081041	6068114	6077178	10
chr19	6080037	6080785	BC048609	748	+	NM_001111317	6080142	6080704	3
chr19	6080762	6084891	Zfpl1	4129	-	NM_024231	6081027	6084453	8
chr19	6085096	6091773	Cdca5	6677	+	NM_026410	6085162	6090728	6
chr19	6105797	6115555	Naaladl1	9758	+	NM_001009546	6105797	6115555	18
chr19	6116003	6118586	Sac3d1	2583	-	NM_133678	6116093	6118586	2
chr19	6119403	6128215	Snx15	8812	-	NM_026912	6119862	6128147	8
chr19	6134388	6141137	Arl2	6749	-	NM_019722	6134666	6141101	5
chr19	6164457	6172475	Batf2	8018	+	NM_028967	6164514	6171995	3
chr19	6184409	6224219	1700123I01Rik	39810	+	NM_001165919	6195679	6223566	11
chr19	6226400	6227768	Gpha2	1368	+	NM_130453	6226787	6227602	4
chr19	6227766	6235840	Ppp2r5b	8074	-	NM_198168	6228383	6234831	14
chr19	6241667	6262304	Atg2a	20637	+	NM_194348	6241795	6261837	40
chr19	6264642	6264728	Mir194-2	86	+	NR_029830	6264728	6264728	1
chr19	6264843	6264932	Mir192	89	+	NR_029720	6264932	6264932	1
chr19	6276895	6300096	Ehd1	23201	+	NM_010119	6276974	6298598	5
chr19	6306456	6325652	Cdc42bpg	19196	+	NM_001033342	6306715	6324573	37
chr19	6334978	6340894	Men1	5916	+	NM_001168488	6335068	6340172	10
chr19	6341159	6355619	Map4k2	14460	+	NM_009006	6341249	6353527	32
chr19	6346479	6346544	Mir6989	65	+	NR_105955	6346544	6346544	1
chr19	6363689	6378038	Sf1	14349	+	NM_011750	6364087	6376360	13
chr19	6384407	6398464	Pygm	14057	+	NM_011224	6384478	6398194	20
chr19	6400582	6415216	Rasgrp2	14634	+	NM_011242	6401790	6414850	17
chr19	6418737	6533217	Nrxn2	114480	+	NM_020253	6428048	6532148	23
chr19	6535855	6543070	Slc22a12	7215	-	NM_009203	6536128	6542752	10
chr19	6903573	6915117	Rps6ka4	11544	-	NM_019924	6904428	6915037	18
chr19	6904375	6904434	Mir5046	59	-	NR_039555	6904434	6904434	1
chr19	6919112	6932701	Ccdc88b	13589	-	NM_001081291	6919553	6932629	27
chr19	6981308	6984135	Prdx5	2827	-	NM_012021	6981335	6984107	6
chr19	6984187	6985516	Trmt112	1329	+	NM_026306	6984674	6985349	5
chr19	6985466	6996298	Esrra	10832	-	NM_007953	6986240	6994877	7
chr19	6988685	6988776	Mir6990	91	-	NR_105956	6988776	6988776	1
chr19	6996915	6999870	Tex40	2955	-	NM_001039494	6997040	6999799	5
chr19	7000179	7009005	Kcnk4	8826	-	NM_008431	7000472	7007381	7
chr19	7012559	7016940	Gpr137	4381	-	NM_001177361	7012859	7016647	7
chr19	7016350	7026395	Bad	10045	+	NM_007522	7016812	7026014	4
chr19	7028202	7044304	Plcb3	16102	-	NM_001290349	7028585	7044135	31
chr19	7049537	7051814	Ppp1r14b	2277	+	NM_008889	7049738	7051540	4
chr19	7052228	7054951	Fkbp2	2723	-	NM_001166368	7052362	7053627	6
chr19	7056961	7062141	Vegfb	5180	-	NM_001185164	7057335	7061901	7
chr19	7062400	7066762	Dnajc4	4362	-	NM_020566	7062486	7066743	6
chr19	7067508	7070527	Nudt22	3019	-	NM_026675	7067533	7070208	6
chr19	7070620	7073536	Trpt1	2916	+	NM_153597	7070954	7073476	7
chr19	7073447	7093959	Fermt3	20512	-	NM_153795	7073830	7093315	15
chr19	7095185	7114516	Stip1	19331	-	NM_016737	7095588	7114378	14
chr19	7131257	7272552	Macrod1	141295	+	NM_134147	7131380	7272196	11
chr19	7166501	7180219	Flrt1	13718	-	NM_201411	7169645	7171670	2
chr19	7272695	7280774	Otub1	8079	-	NM_134150	7273531	7280749	7
chr19	7289647	7292106	Cox8a	2459	-	NM_007750	7289878	7292002	2
chr19	7300157	7315712	Naa40	15555	-	NM_027643	7302439	7315433	8
chr19	7344253	7349715	Rcor2	5462	+	NM_054048	7344259	7349147	11
chr19	7349885	7416350	Mark2	66465	-	NM_001080389	7351579	7415711	18
chr19	7430953	7457516	AI846148	26563	-	NM_001033139	7432765	7457291	6
chr19	7457492	7458047	1700105P06Rik	555	+	NR_045703	7458047	7458047	1
chr19	7492114	7500394	2700081O15Rik	8280	+	NM_175381	7492268	7497596	5
chr19	7497062	7497132	Mir6991	70	+	NR_105957	7497132	7497132	1
chr19	7500384	7557781	Rtn3	57397	-	NM_001003934	7502319	7557573	9
chr19	7568529	7613099	Atl3	44570	+	NM_001163505	7568820	7608526	13
chr19	7631948	7663035	Pla2g16	31087	+	NM_139269	7632470	7660156	5
chr19	7671150	7681666	Lgals12	10516	-	NM_019516	7672514	7681220	9
chr19	7687058	7713728	Hrasls5	26670	+	NM_025731	7687100	7713611	6
chr19	7747565	7785800	Slc22a19	38235	-	NM_144785	7747775	7785683	10
chr19	7856472	7877157	Slc22a26	20685	-	NM_146232	7856599	7876939	10
chr19	7938878	8040517	Slc22a27	101639	-	NM_134256	7939266	8001260	11
chr19	8136698	8206472	Slc22a28	69774	-	NM_001013820	8136837	8206266	10
chr19	8234657	8293329	Slc22a29	58672	-	NM_172776	8235043	8293163	10
chr19	8410112	8479595	Slc22a30	69483	-	NM_177002	8410250	8479395	10
chr19	8665743	8686325	Slc22a8	20582	+	NM_031194	8668396	8684767	12
chr19	8692485	8702789	Slc22a6	10304	+	NM_008766	8692785	8700701	10
chr19	8726285	8737825	9830166K06Rik	11540	-	NR_045314	8737825	8737825	3
chr19	8738494	8758092	Chrm1	19598	+	NM_001112697	8752422	8753805	3
chr19	8781371	8797859	Slc3a2	16488	-	NM_001161413	8782212	8797585	10
chr19	8797976	8800816	Snhg1	2840	+	NR_002896	8800816	8800816	10
chr19	8800355	8800481	Snord22	126	+	NR_004445	8800481	8800481	1
chr19	8810328	8815114	Wdr74	4786	+	NM_134139	8810331	8815068	11
chr19	8815207	8815715	1700092M07Rik	508	+	NM_001177347	8815257	8815646	2
chr19	8815913	8830132	Stx5a	14219	+	NM_001167799	8816762	8829558	11
chr19	8817460	8817569	Mir6992	109	+	NR_105958	8817569	8817569	1
chr19	8829278	8831459	LOC102640359	2181	-	NR_132423	8831459	8831459	2
chr19	8831592	8845400	Nxf1	13808	+	NM_016813	8831721	8845102	21
chr19	8845485	8846965	Tmem223	1480	+	NM_025791	8845498	8846830	2
chr19	8847011	8848957	Tmem179b	1946	-	NM_026325	8847162	8848920	5
chr19	8848843	8860907	Taf6l	12064	-	NM_001177798	8849018	8859619	12
chr19	8848974	8851452	Gm2518	2478	+	NR_015538	8851452	8851452	1
chr19	8867618	8873047	Polr2g	5429	-	NM_026329	8867880	8872960	8
chr19	8876985	8879344	Zbtb3	2359	+	NM_133759	8877514	8879071	2
chr19	8883564	8893784	Ttc9c	10220	-	NM_027412	8886233	8893163	4
chr19	8893890	8908632	Hnrnpul2	14742	+	NM_001081196	8894771	8906025	14
chr19	8911418	8913736	Gng3	2318	-	NM_010316	8912632	8913142	3
chr19	8911956	8923173	Bscl2	11217	+	NM_001136064	8914199	8923075	12
chr19	8925274	8928399	Lrrn4cl	3125	+	NM_001013019	8926149	8926869	2
chr19	8946048	8950146	Ubxn1	4098	+	NM_146093	8946187	8950061	10
chr19	8954503	8955423	Uqcc3	920	-	NM_001160356	8954956	8955315	2
chr19	8958367	8965249	Lbhd1	6882	+	NM_001286103	8958419	8964931	6
chr19	8962876	8963260	5730408K05Rik	384	-	NR_027866	8963260	8963260	1
chr19	8963188	8963264	Mir5136	76	-	NR_039598	8963264	8963264	1
chr19	8963372	8965249	1810009A15Rik	1877	+	NM_025463	8963415	8965010	4
chr19	8967476	8972380	Ints5	4904	+	NM_176843	8967558	8972225	2
chr19	8972546	8991232	Ganab	18686	+	NM_008060	8972611	8990224	25
chr19	8994882	9001726	B3gat3	6844	+	NM_024256	8995056	9001324	5
chr19	9001871	9003846	Rom1	1975	-	NM_009073	9002158	9003663	3
chr19	9004183	9016072	Eml3	11889	+	NM_144872	9004420	9015823	22
chr19	9016409	9026790	Mta2	10381	+	NM_011842	9016844	9026145	18
chr19	9028339	9040700	Tut1	12361	+	NM_197993	9028429	9040650	9
chr19	9041530	9052670	Eef1g	11140	+	NM_026007	9041703	9052592	10
chr19	9063773	9151416	Ahnak	87643	+	NM_001286518	9074589	9120191	7
chr19	9158131	9162446	Scgb1a1	4315	-	NM_011681	9158253	9162391	3
chr19	9186208	9210056	Asrgl1	23848	-	NM_025610	9187489	9210044	7
chr19	9632095	9633738	Stxbp3-ps	1643	-	NR_073559	9633738	9633738	2
chr19	9946786	9974023	Incenp	27237	-	NM_016692	9947166	9969950	18
chr19	10055089	10059601	Fth1	4512	+	NR_073181	10059601	10059601	5
chr19	10059661	10076123	Best1	16462	-	NM_011913	10059875	10071668	12
chr19	10092717	10110076	Rab3il1	17359	+	NM_144538	10092838	10109029	10
chr19	10116037	10134161	Fads3	18124	+	NM_021890	10116221	10132426	12
chr19	10138653	10175993	Fads2	37340	-	NM_019699	10138752	10175919	12
chr19	10257377	10271362	Fads1	13985	+	NM_146094	10257541	10269412	12
chr19	10265864	10265929	Mir6993	65	+	NR_105959	10265929	10265929	1
chr19	10273621	10278433	Fen1	4812	-	NM_001271615	10274425	10275568	2
chr19	10278691	10282314	Tmem258	3623	+	NM_026919	10278751	10281780	4
chr19	10282760	10315238	Myrf	32478	-	NM_001033481	10284874	10315094	26
chr19	10319754	10379367	Dagla	59613	-	NM_198114	10322153	10346078	20
chr19	10463579	10527671	Syt7	64092	+	NM_173068	10463972	10522934	11
chr19	10529860	10531937	Lrrc10b	2077	-	NM_001111140	10530926	10531805	1
chr19	10548746	10557387	Ppp1r32	8641	-	NM_133689	10548988	10556831	14
chr19	10575001	10599699	Sdhaf2	24698	-	NM_025333	10577488	10599584	4
chr19	10599733	10622225	Cpsf7	22492	+	NM_001164272	10600496	10615333	10
chr19	10624950	10630728	Tmem216	5778	-	NM_026798	10625514	10629064	5
chr19	10644967	10651876	Tmem138	6909	-	NM_028411	10645645	10649857	5
chr19	10651646	10664531	Cyb561a3	12885	+	NM_001282067	10656802	10663038	9
chr19	10666686	10678748	Tkfc	12062	-	NM_145496	10667117	10678660	17
chr19	10680114	10704311	Ddb1	24197	+	NM_015735	10680195	10703652	27
chr19	10708722	10739700	Vwce	30978	+	NM_027913	10708963	10739191	20
chr19	10720183	10722543	4930524O05Rik	2360	-	NR_045316	10722543	10722543	3
chr19	10743446	10752561	Pga5	9115	-	NM_021453	10743598	10752461	9
chr19	10759282	10760046	2210404E10Rik	764	+	NR_131163	10760046	10760046	2
chr19	10763304	10788909	Vps37c	25605	+	NM_181403	10780705	10787724	5
chr19	10792632	10813464	Cd5	20832	-	NM_007650	10794027	10813336	11
chr19	10815436	10860533	A430093F15Rik	45097	+	NR_027805	10860533	10860533	4
chr19	10863828	10904548	Cd6	40720	-	NM_009852	10864662	10904346	13
chr19	10917033	10932405	Slc15a3	15372	+	NM_023044	10917510	10932274	8
chr19	10932318	10944269	Tmem132a	11951	-	NM_133804	10932597	10944116	11
chr19	10945151	10956233	Tmem109	11082	-	NM_134142	10946247	10948968	4
chr19	10969720	10984049	Prpf19	14329	+	NM_134129	10969939	10979622	16
chr19	10988786	10995091	Zp1	6305	-	NM_009580	10988812	10995065	12
chr19	11011649	11017001	Ptgdr2	5352	+	NM_009962	11014610	11015759	3
chr19	11015970	11023756	Ccdc86	7786	-	NM_023731	11017659	11023723	4
chr19	11036784	11049160	Ms4a10	12376	-	NM_023529	11037447	11043255	9
chr19	11052796	11067740	Ms4a15	14944	-	NM_001034898	11053698	11067667	7
chr19	11071514	11092453	Ms4a18	20939	-	NM_001251849	11071780	11088218	7
chr19	11122101	11125056	AW112010	2955	-	NR_102366	11125056	11125056	3
chr19	11141960	11155593	Ms4a8a	13633	-	NM_022430	11142162	11155586	7
chr19	11171305	11205368	1700017D01Rik	34063	-	NM_027058	11171426	11190956	7
chr19	11214172	11239810	1700025F22Rik	25638	-	NM_027074	11216020	11237943	7
chr19	11243907	11271213	Ms4a13	27306	-	NM_198224	11244426	11267468	8
chr19	11271306	11374374	4930526L06Rik	103068	+	NR_045317	11374374	11374374	3
chr19	11325092	11340641	Ms4a1	15549	-	NM_007641	11326154	11333311	7
chr19	11348355	11358303	Ms4a5	9948	-	NM_183190	11348686	11358283	5
chr19	11395528	11410636	Ms4a7	15108	-	NM_027836	11396006	11407843	7
chr19	11449977	11467405	Ms4a4a	17428	+	NM_001310331	11453242	11467280	7
chr19	11482150	11501736	Ms4a4c	19586	+	NM_029499	11489306	11500826	7
chr19	11518047	11538038	Ms4a4b	19991	+	NM_021718	11524408	11537589	7
chr19	11543857	11556686	Ms4a6c	12829	+	NM_028595	11545594	11555702	7
chr19	11566527	11587067	Gm8369	20540	+	NM_001164202	11576697	11586341	5
chr19	11593048	11604893	Ms4a6b	11845	+	NM_027209	11594828	11604073	7
chr19	11611338	11632956	Ms4a4d	21618	+	NM_025658	11622993	11632507	7
chr19	11661095	11679294	Ms4a6d	18199	-	NM_026835	11661575	11677782	7
chr19	11690010	11698209	Ms4a2	8199	-	NM_013516	11691962	11698111	7
chr19	11703988	11715341	Ms4a3	11353	-	NM_133246	11704147	11713766	7
chr19	11721773	11735049	Oosp2	13276	-	NM_001037634	11721907	11735017	4
chr19	11741949	11765541	Oosp1	23592	-	NM_133353	11742179	11765507	5
chr19	11771544	11786348	Oosp3	14804	+	NM_001033283	11771588	11786173	6
chr19	11822048	11837937	Gif	15889	+	NM_008118	11822136	11837747	9
chr19	11844904	11849436	Mrpl16	4532	+	NM_025606	11844959	11849123	4
chr19	11849607	11893893	Stx3	44286	-	NM_001286543	11851582	11862724	12
chr19	11902566	11903514	Olfr1417	948	-	NM_146936	11902566	11903514	1
chr19	11929484	11930441	Olfr1418	957	-	NM_001011524	11929484	11930441	1
chr19	11944672	11945704	Olfr1419	1032	-	NM_001011775	11944672	11945704	1
chr19	11970512	11971442	Olfr1420	930	+	NM_146410	11970512	11971442	1
chr19	11986888	12019586	Patl1	32698	+	NM_172635	11987052	12017842	19
chr19	11998217	11998290	Mir6994	73	+	NR_105960	11998290	11998290	1
chr19	12040333	12068604	Osbp	28271	+	NM_001033174	12040430	12066532	14
chr19	12110297	12111230	Olfr1423	933	-	NM_146680	12110297	12111230	1
chr19	12133298	12134240	Olfr1424	942	-	NM_146681	12133298	12134240	1
chr19	12148184	12149120	Olfr1425	936	-	NM_001011853	12148184	12149120	1
chr19	12162099	12166337	Olfr1426	4238	-	NM_146809	12162344	12163280	3
chr19	12173191	12174127	Olfr1427	936	-	NM_146679	12173191	12174127	1
chr19	12183089	12184034	Olfr1428	945	-	NM_146678	12183089	12184034	1
chr19	12194210	12195164	Olfr76	954	-	NM_146682	12194210	12195164	1
chr19	12284057	12284996	Olfr1431	939	+	NM_146414	12284057	12284996	1
chr19	12303008	12304052	Olfr1432	1044	-	NM_001011788	12303008	12304052	1
chr19	12315210	12316149	Olfr262	939	-	NM_146688	12315210	12316149	1
chr19	12342721	12343660	Olfr235	939	+	NM_146686	12342721	12343660	1
chr19	12354343	12358478	Olfr1434	4135	+	NM_146685	12357539	12358478	2
chr19	12372672	12373620	Olfr1436	948	-	NM_146687	12372672	12373620	1
chr19	12396376	12397315	Olfr1437	939	-	NM_001011839	12396376	12397315	1
chr19	12468754	12469702	Olfr1440	948	+	NM_146684	12468754	12469702	1
chr19	12496800	12497757	Olfr1441	957	+	NM_146683	12496800	12497757	1
chr19	12502394	12506600	Pfpl	4206	+	NM_019540	12502876	12504985	2
chr19	12535268	12539775	Mpeg1	4507	+	NM_010821	12535669	12537832	2
chr19	12540825	12576486	Dtx4	35661	-	NM_172442	12543965	12575707	9
chr19	12648014	12664186	Fam111a	16172	+	NM_026640	12658534	12663088	4
chr19	12660357	12671056	A330040F15Rik	10699	-	NR_015503	12671056	12671056	2
chr19	12674473	12702106	Gm4952	27633	+	NM_001167907	12687973	12701606	6
chr19	12707797	12726227	Glyat	18430	+	NM_145935	12714275	12726121	6
chr19	12748668	12749733	Olfr1442	1065	+	NM_146697	12748696	12749635	1
chr19	12752655	12758335	Olfr1443	5680	+	NM_146698	12754599	12755538	3
chr19	12770279	12794386	Keg1	24107	+	NM_029550	12784098	12793672	6
chr19	12838017	12840122	Cntf	2105	-	NM_170786	12838387	12839884	2
chr19	12838017	12870613	Zfp91Cntf	32596	-	NR_024093	12870613	12870613	13
chr19	12841428	12870613	Zfp91	29185	-	NM_053009	12844528	12869823	11
chr19	12873098	12908298	Lpxn	35200	+	NM_134152	12873156	12907844	9
chr19	12936266	12937226	Olfr1444	960	+	NM_146702	12936266	12937226	1
chr19	12958372	12959317	Olfr1445	945	+	NM_146699	12958372	12959317	1
chr19	12964138	12965065	Olfr1446	927	-	NM_146704	12964138	12965065	1
chr19	12975338	12976268	Olfr1447	930	-	NM_146703	12975338	12976268	1
chr19	12993852	12994797	Olfr1448	945	-	NM_146701	12993852	12994797	1
chr19	13009229	13010174	Olfr1449	945	+	NM_146303	13009229	13010174	1
chr19	13028080	13029058	Olfr1450	978	+	NM_146371	13028080	13029058	1
chr19	13073477	13074410	Olfr1451	933	+	NM_146705	13073477	13074410	1
chr19	13101893	13102817	Olfr1453	924	-	NM_146700	13101893	13102817	1
chr19	13137902	13138826	Olfr1454	924	+	NM_146692	13137902	13138826	1
chr19	13169182	13170136	Olfr1457	954	-	NM_146575	13169182	13170136	1
chr19	13220223	13221147	Olfr1459	924	-	NM_146689	13220223	13221147	1
chr19	13239505	13240444	Olfr1461	939	+	NM_146302	13239505	13240444	1
chr19	13265158	13266082	Olfr1462	924	+	NM_146693	13265158	13266082	1
chr19	13308741	13309674	Olfr1463	933	+	NM_001011840	13308741	13309674	1
chr19	13387849	13388773	Olfr1465	924	-	NM_001011841	13387849	13388773	1
chr19	13416249	13417182	Olfr1466	933	+	NM_146694	13416249	13417182	1
chr19	13439119	13440046	Olfr1467	927	+	NM_146691	13439119	13440046	1
chr19	13485060	13485990	Olfr1469	930	+	NM_146695	13485060	13485990	1
chr19	13519503	13520448	Olfr1471	945	+	NM_207132	13519503	13520448	1
chr19	13528060	13529005	Olfr1472	945	-	NM_146690	13528060	13529005	1
chr19	13545461	13546406	Olfr1474	945	+	NM_001011842	13545461	13546406	1
chr19	13553741	13554686	Olfr1475	945	-	NM_146301	13553741	13554686	1
chr19	13575035	13577782	Olfr1477	2747	+	NM_146696	13576834	13577782	2
chr19	13604164	13605112	Olfr1480	948	+	NM_207575	13604164	13605112	1
chr19	13659795	13660743	Olfr1484	948	+	NM_146291	13659795	13660743	1
chr19	13693653	13694601	Olfr1487	948	+	NM_146636	13693653	13694601	1
chr19	13707602	13708544	Olfr1489	942	+	NM_146635	13707602	13708544	1
chr19	13728935	13729886	Olfr1490	951	+	NM_001011832	13728935	13729886	1
chr19	13779318	13780278	Olfr1491	960	+	NM_146345	13779318	13780278	1
chr19	13823597	13824545	Olfr1494	948	+	NM_146990	13823597	13824545	1
chr19	13842833	13843793	Olfr1495	960	+	NM_146344	13842833	13843793	1
chr19	13855037	13856104	Olfr1496	1067	+	NM_146989	13855103	13856057	1
chr19	13869154	13870099	Olfr1497	945	-	NM_146741	13869154	13870099	1
chr19	13889133	13890078	Olfr1499	945	-	NM_146796	13889133	13890078	1
chr19	13901948	13902884	Olfr1500	936	-	NM_001011831	13901948	13902884	1
chr19	13912713	13913661	Olfr1501	948	-	NM_146633	13912713	13913661	1
chr19	13936284	13937235	Olfr1502	951	+	NM_146797	13936284	13937235	1
chr19	13961750	13962698	Olfr1504	948	-	NM_146634	13961750	13962698	1
chr19	13993511	13994462	Olfr1505	951	+	NM_001011850	13993511	13994462	1
chr19	14522561	14672673	Tle4	150112	-	NM_001302947	14524223	14671902	20
chr19	15979612	15999549	Psat1	19937	-	NM_177420	15980535	15999413	9
chr19	16030262	16059479	Cep78	29217	-	NM_198019	16030329	16059370	15
chr19	16059564	16085402	C130060C02Rik	25838	+	NR_045355	16085402	16085402	3
chr19	16207320	16461943	Gnaq	254623	+	NM_008139	16207815	16457884	7
chr19	16238587	16244948	E030024N20Rik	6361	+	NR_033228	16244948	16244948	1
chr19	16389381	16389494	Mir496b	113	-	NR_105832	16389494	16389494	1
chr19	16510156	16685308	Gna14	175152	+	NM_008137	16511183	16684020	7
chr19	16689855	16855423	Vps13a	165568	-	NM_173028	16691354	16855259	72
chr19	16946805	16948320	Foxb2	1515	-	NM_008023	16946843	16948130	1
chr19	17030607	17298422	Prune2	267815	+	NM_181348	17030746	17295304	20
chr19	17400630	17447334	Gcnt1	46704	-	NM_010265	17403562	17404849	3
chr19	17468532	17475839	Rfk	7307	+	NM_019437	17468800	17474093	4
chr19	17506803	17912122	Pcsk5	405319	-	NM_001190483	17507882	17911642	38
chr19	18654853	18706303	Ostf1	51450	-	NM_017375	18655759	18706143	10
chr19	18706505	18726674	Nmrk1	20169	+	NM_145497	18710603	18725733	9
chr19	18745269	18779282	Carnmt1	34013	+	NM_026120	18745489	18778611	8
chr19	18787725	18792918	D030056L22Rik	5193	+	NM_177640	18787813	18791864	2
chr19	18824472	18967001	Trpm6	142529	+	NM_153417	18824520	18966627	39
chr19	19005098	19185686	Rorb	180588	-	NM_001043354	19012369	19185048	10
chr19	20447923	20465161	Anxa1	17238	-	NM_010730	20448203	20459248	13
chr19	20479777	20497275	1500015L24Rik	17498	+	NR_045817	20497275	20497275	3
chr19	20567204	20630900	E030003E18Rik	63696	+	NR_015502	20630900	20630900	4
chr19	20609016	20626820	C730002L08Rik	17804	-	NR_045778	20626820	20626820	3
chr19	20676471	20717952	Aldh1a1	41481	+	NM_013467	20676501	20717456	13
chr19	20767442	20802046	Aldh1a7	34604	-	NM_011921	20767952	20802002	13
chr19	20857947	21028692	Tmc1	170745	-	NM_028953	20859583	21015398	21
chr19	21179199	21180028	4930554I06Rik	829	+	NR_126458	21180028	21180028	2
chr19	21346767	21361330	Zfand5	14563	+	NM_009551	21350924	21355061	6
chr19	21465796	21547151	Gda	81355	-	NM_010266	21469677	21546980	14
chr19	21671802	21727281	1110059E24Rik	55479	-	NM_025423	21672679	21727198	4
chr19	21727798	21760127	Abhd17b	32329	+	NM_146096	21752845	21758807	4
chr19	21852829	21932850	Tmem2	80021	+	NM_031997	21867139	21930841	25
chr19	22213606	23064372	Trpm3	850766	+	NM_001035240	22213608	23062798	26
chr19	22825094	22825162	Mir204	68	+	NR_029591	22825162	22825162	1
chr19	23215715	23241401	Klf9	25686	+	NM_010638	23216244	23239402	2
chr19	23223920	23224041	Mir1192	121	+	NR_035423	23224041	23224041	1
chr19	23280930	23348387	Smc5	67457	-	NM_001252684	23283317	23348308	25
chr19	23377098	23522812	Mamdc2	145714	-	NM_174857	23378111	23522548	14
chr19	23633249	23727302	1700028P14Rik	94053	-	NM_026188	23633344	23727216	6
chr19	23761889	23795619	Ptar1	33730	+	NM_028208	23761949	23794890	7
chr19	23833365	24024087	Apba1	190722	+	NM_177034	23967295	24020271	13
chr19	24047239	24105509	Fam189a2	58270	-	NM_001114174	24047914	24105427	11
chr19	24168991	24299516	Tjp2	130525	-	NM_011597	24169914	24213313	23
chr19	24335942	24355076	Fxn	19134	-	NM_008044	24336392	24355055	5
chr19	24369285	24630317	Pip5k1b	261032	-	NM_008846	24370041	24513611	15
chr19	24550268	24551964	Fam122a	1696	-	NM_026520	24550991	24551846	1
chr19	24748497	24754151	Tmem252	5654	+	NM_183160	24748558	24752302	2
chr19	24752750	24936332	Pgm5	183582	-	NM_175013	24758974	24936279	11
chr19	24973454	24975799	Foxd4	2345	-	NM_008022	24973989	24975324	1
chr19	24994405	25036106	Cbwd1	41701	-	NM_146097	24995082	25036021	15
chr19	25016725	25016793	Gm38437	68	-	NR_105743	25016793	25016793	1
chr19	25016725	25016793	Mir3084-1	68	-	NR_037245	25016793	25016793	1
chr19	25074018	25276922	Dock8	202904	+	NM_028785	25074140	25275537	48
chr19	25311691	25508986	Kank1	197295	+	NM_181404	25452983	25508073	14
chr19	25580195	25678818	Dmrt1	98623	+	NM_015826	25580343	25677840	5
chr19	25685026	25698411	Dmrt3	13385	+	NM_177360	25685288	25697713	2
chr19	25745623	25746729	2610016A17Rik	1106	-	NR_045347	25746729	25746729	2
chr19	25746900	25753481	Dmrt2	6581	+	NM_145831	25747941	25753214	4
chr19	26679649	26852811	Smarca2	173162	+	NM_011416	26694209	26851860	33
chr19	26843290	26898397	4931403E22Rik	55107	-	NR_045306	26898397	26898397	4
chr19	26960414	26963137	Gm815	2723	+	NM_001033407	26960468	26962921	4
chr19	27291509	27328721	Vldlr	37212	+	NM_013703	27292104	27323630	19
chr19	27397108	27411669	Kcnv2	14561	+	NM_183179	27397240	27408413	2
chr19	27463187	27504398	Pum3	41211	-	NM_177474	27464670	27501611	18
chr19	27504526	27507121	C030016D13Rik	2595	+	NR_027987	27507121	27507121	1
chr19	27836210	28085656	Rfx3	249446	-	NM_011265	27842944	27975385	17
chr19	28333340	28754567	Glis3	421227	-	NM_175459	28337468	28740630	11
chr19	28752713	28794517	D930032P07Rik	41804	+	NR_045330	28794517	28794517	5
chr19	28909655	28988450	Slc1a1	78795	+	NM_009199	28909731	28986390	12
chr19	28997553	29038644	4430402I18Rik	41091	-	NM_198651	29002150	29038040	13
chr19	29038409	29041291	Plpp6	2882	+	NM_028922	29038490	29039369	1
chr19	29064841	29101168	Cdc37l1	36327	+	NM_001302380	29065027	29099323	7
chr19	29095321	29122392	Ak3	27071	-	NM_021299	29097315	29122319	5
chr19	29121972	29123219	1700018L02Rik	1247	+	NR_028360	29123219	29123219	1
chr19	29141790	29143993	Gm9895	2203	+	NR_045687	29143993	29143993	2
chr19	29175864	29218333	Rcl1	42469	+	NM_021525	29175994	29217782	9
chr19	29209768	29209865	Mir101b	97	+	NR_029778	29209865	29209865	1
chr19	29326292	29387570	Jak2	61278	+	NM_008413	29336697	29386338	25
chr19	29395843	29399808	Insl6	3965	-	NM_013754	29395924	29399805	2
chr19	29406244	29409160	Rln1	2916	-	NM_011272	29406309	29409086	2
chr19	29423166	29436361	Plgrkt	13195	-	NM_026362	29423373	29432887	6
chr19	29441927	29462584	Cd274	20657	+	NM_021893	29446957	29459902	7
chr19	29485408	29547417	Pdcd1lg2	62009	+	NM_021396	29496873	29529067	6
chr19	29578152	29596477	A930007I19Rik	18325	-	NR_015567	29596477	29596477	4
chr19	29596771	29680411	Ric1	83640	+	NM_001081319	29597012	29678639	26
chr19	29684372	29722910	Ermp1	38538	-	NM_001081213	29687004	29722845	15
chr19	29772430	29782796	Mlana	10366	+	NM_029993	29774589	29782723	5
chr19	29788891	29880499	9930021J03Rik	91608	-	NM_172836	29790497	29880364	8
chr19	29882597	29887464	Ranbp6	4867	-	NM_177721	29884122	29887440	1
chr19	29999603	30035205	Il33	35602	+	NM_133775	30024160	30033531	8
chr19	30078279	30080510	Trpd52l3	2231	+	NM_025741	30078336	30079032	1
chr19	30105002	30168214	Uhrf2	63212	+	NM_144873	30105268	30167354	16
chr19	30172930	30249931	Gldc	77001	-	NM_138595	30173456	30249750	25
chr19	30307446	30314172	Mbl2	6726	+	NM_010776	30308470	30314014	6
chr19	30613365	30614169	Ppp1r2-ps3	804	-	NR_003650	30614169	30614169	1
chr19	30620373	30623986	Dkk1	3613	-	NM_010051	30621674	30623869	4
chr19	30638976	31839523	Prkg1	1200547	-	NM_001013833	30643727	31839312	18
chr19	31004875	31005452	Gm6642	577	-	NR_033643	31005452	31005452	1
chr19	31157330	31161082	Cstf2t	3752	+	NM_031249	31157555	31159454	1
chr19	31288032	31290886	8430431K14Rik	2854	-	NR_002849	31290886	31290886	1
chr19	31943250	32023896	A1cf	80646	+	NM_001081074	31967589	32022000	12
chr19	32059140	32177630	Asah2	118490	-	NM_018830	32061247	32132413	24
chr19	32197216	32462944	Sgms1	265728	-	NM_144792	32198834	32234654	10
chr19	32463705	32465674	2700046G09Rik	1969	+	NR_033198	32465674	32465674	2
chr19	32560258	32589860	Minpp1	29602	+	NM_010799	32560430	32588859	5
chr19	32670204	32741677	Papss2	71473	+	NM_001201470	32670338	32740057	12
chr19	32747052	32786788	Atad1	39736	-	NM_026487	32748733	32781486	10
chr19	32832066	32900650	Pten	68584	+	NM_008960	32832934	32894518	9
chr19	33212234	33466785	Rnls	254551	-	NM_001167818	33212611	33465667	7
chr19	33231601	33231691	Mir3970	90	+	NR_039552	33231691	33231691	1
chr19	33629770	33664801	Lipo1	35031	-	NM_001013770	33630720	33659458	11
chr19	34035737	34051303	Lipf	15566	+	NM_026334	34039011	34051188	10
chr19	34082743	34122393	Lipk	39650	+	NM_172837	34093179	34121505	10
chr19	34141847	34159408	Lipn	17561	+	NM_027340	34143118	34159339	10
chr19	34175432	34197177	Lipm	21745	+	NM_023903	34175659	34195886	10
chr19	34197038	34240531	Ankrd22	43493	-	NM_024204	34197950	34240265	6
chr19	34266759	34314818	Stambpl1	48059	+	NM_029682	34294726	34314563	11
chr19	34314825	34329863	Acta2	15038	-	NM_007392	34316156	34327043	9
chr19	34365148	34402260	Fas	37112	+	NM_007987	34365204	34401814	9
chr19	34548273	34549625	Ch25h	1352	-	NM_009890	34548719	34549616	1
chr19	34566805	34601964	Lipa	35159	-	NM_001111100	34568469	34599332	10
chr19	34625183	34651024	Ifit2	25841	+	NM_008332	34644855	34648964	3
chr19	34658018	34663472	Ifit3	5454	+	NM_010501	34658089	34662757	2
chr19	34667377	34676458	Ifit1bl1	9081	-	NM_001101605	34668132	34676411	2
chr19	34682446	34687891	Ifit3b	5445	+	NM_001005858	34682483	34687127	2
chr19	34691540	34715233	Ifit1bl2	23693	-	NM_053217	34693303	34704249	3
chr19	34715378	34724499	Ifit1	9121	+	NM_008331	34715472	34723347	2
chr19	34742895	34821601	Slc16a12	78706	-	NM_172838	34745120	34765243	7
chr19	34881425	34953945	Pank1	72520	-	NM_001114339	34886817	34953566	7
chr19	34895176	34895263	Mir107	87	-	NR_029783	34895263	34895263	1
chr19	34996847	35050221	Kif20b	53374	+	NM_183046	34999115	35050060	32
chr19	35039885	35039959	Mir1950	74	+	NR_035473	35039959	35039959	1
chr19	36033218	36131850	Htr7	98632	-	NM_008315	36034846	36131743	3
chr19	36158205	36179263	Rpp30	21058	+	NM_019428	36158226	36178935	11
chr19	36186454	36194334	Ankrd1	7880	-	NM_013468	36187196	36194271	9
chr19	36453556	36530694	Pcgf5	77138	+	NM_029508	36486614	36530158	9
chr19	36629128	36695625	Hectd2	66497	+	NM_001163471	36629273	36693334	21
chr19	36693907	36763969	1500017E21Rik	70062	-	NR_033510	36763969	36763969	5
chr19	36806220	36811094	Ppp1r3c	4874	-	NM_016854	36807904	36811056	2
chr19	36908721	36967967	Tnks2	59246	+	NM_001163635	36909027	36965293	27
chr19	36992039	36994089	Fgfbp3	2050	-	NM_028263	36992953	36993706	2
chr19	37000568	37088547	Btaf1	87979	+	NM_001080706	37000877	37085894	38
chr19	37095780	37281961	Cpeb3	186181	-	NM_198300	37099349	37249464	11
chr19	37248332	37271031	A330032B11Rik	22699	+	NR_045329	37271031	37271031	3
chr19	37282034	37298947	March5	16913	+	NM_027314	37282359	37295996	6
chr19	37332918	37338585	4931408D14Rik	5667	-	NR_040298	37338585	37338585	4
chr19	37343230	37405103	Ide	61873	-	NM_031156	37345231	37405103	24
chr19	37450892	37496349	Kif11	45457	+	NM_010615	37451083	37494880	22
chr19	37509330	37515221	Hhex	5891	+	NM_008245	37509359	37514295	4
chr19	37539743	37546317	1700122C19Rik	6574	+	NR_131008	37546317	37546317	2
chr19	37624907	37757739	Exoc6	132832	+	NM_175353	37624954	37757468	22
chr19	37760169	37767797	Cyp26c1	7628	+	NM_001105201	37760169	37767797	6
chr19	37772297	37776026	Cyp26a1	3729	+	NM_007811	37772399	37775841	7
chr19	37973525	38118067	Myof	144542	-	NM_001302140	37974218	38117813	54
chr19	38129514	38148915	Cep55	19401	+	NM_028293	38132290	38147988	9
chr19	38171568	38188753	Ffar4	17185	+	NM_181748	38171616	38188494	3
chr19	38191109	38199811	Rbp4	8702	-	NM_001159487	38191361	38199558	6
chr19	38207270	38258441	Pde6c	51171	+	NM_033614	38207435	38258229	22
chr19	38262968	38298622	Fra10ac1	35654	-	NM_001081075	38263247	38296403	14
chr19	38339271	38383429	Lgi1	44158	+	NM_020278	38339372	38380945	8
chr19	38470469	38480097	Slc35g1	9628	+	NM_175507	38470604	38477868	3
chr19	38598686	38859590	Plce1	260904	+	NM_019588	38598748	38855238	32
chr19	38862617	38893727	Noc3l	31110	-	NM_021315	38864034	38893591	21
chr19	38911068	38994413	Tbc1d12	83345	+	NM_145952	38911196	38992429	13
chr19	39005479	39042767	Hells	37288	+	NM_008234	39005897	39042317	22
chr19	39081508	39117177	Cyp2c55	35669	+	NM_028089	39081535	39116688	9
chr19	39135495	39168438	Cyp2c65	32943	+	NM_028191	39135519	39167994	9
chr19	39188387	39261246	Cyp2c66	72859	+	NM_001011707	39188418	39261120	9
chr19	39303743	39349227	Cyp2c53-ps	45484	+	NR_033614	39349227	39349227	9
chr19	39361574	39405203	Cyp2c29	43629	+	NM_007815	39361607	39404923	9
chr19	39464045	39537565	Cyp2c38	73520	-	NM_010002	39465420	39537544	9
chr19	39585311	39643019	Cyp2c39	57708	+	NM_010003	39585360	39642684	9
chr19	39683348	39723532	Cyp2c67	40184	-	NM_001024719	39683566	39723520	9
chr19	39763325	39815591	Cyp2c68	52266	-	NM_001039555	39763558	39815531	9
chr19	39841562	39887304	Cyp2c40	45742	-	NM_010004	39841795	39887299	9
chr19	39917149	39961259	Cyp2c69	44110	-	NM_001104525	39917381	39961197	9
chr19	40066913	40086733	Cyp2c37	19820	+	NM_010001	40066929	40086398	9
chr19	40112429	40148303	Cyp2c54	35874	-	NM_206537	40112726	40148301	9
chr19	40164168	40188445	Cyp2c50	24277	+	NM_134144	40164189	40188105	9
chr19	40227850	40261776	Cyp2c70	33926	-	NM_145499	40228065	40261752	9
chr19	40296728	40346106	Pdlim1	49378	-	NM_016861	40297074	40345931	7
chr19	40366529	40588302	Sorbs1	221773	-	NM_009166	40369538	40476757	24
chr19	40624746	40662953	Aldh18a1	38207	-	NM_019698	40625637	40660067	19
chr19	40670935	40686705	Tctn3	15770	-	NM_026260	40671801	40686634	14
chr19	40686855	40816092	Entpd1	129237	+	NM_001304721	40686910	40813519	10
chr19	40905768	40923060	Ccnj	17292	+	NM_172839	40906509	40920588	6
chr19	40942805	40957129	E030044B06Rik	14324	+	NR_045343	40957129	40957129	5
chr19	40969192	40969279	Mir8092	87	+	NR_106167	40969279	40969279	1
chr19	40969194	40992437	Zfp518a	23243	+	NM_028319	40986118	40990555	5
chr19	41003416	41069025	Blnk	65609	-	NM_008528	41003662	41068548	17
chr19	41103764	41134015	Dntt	30251	+	NM_009345	41103928	41133642	12
chr19	41137909	41151603	Opalin	13694	-	NM_153520	41138292	41151526	6
chr19	41158470	41281264	Tll2	122794	-	NM_011904	41158671	41281135	21
chr19	41285331	41338494	Tm9sf3	53163	-	NM_133352	41289561	41338344	15
chr19	41348707	41459560	Pik3ap1	110853	-	NM_031376	41348785	41459459	17
chr19	41624128	41634271	Lcor	10143	+	NM_172154	41626988	41633770	3
chr19	41663140	41663279	Mir8091	139	+	NR_106166	41663279	41663279	1
chr19	41674746	41818346	Slit1	143600	-	NM_015748	41674940	41817898	37
chr19	41821450	41824587	Gm19424	3137	+	NR_040320	41824587	41824587	3
chr19	41841077	41876574	Arhgap19	35497	-	NM_027667	41844675	41876517	12
chr19	41904459	41907073	Frat1	2614	+	NM_008043	41904657	41905482	1
chr19	41920464	41922622	Frat2	2158	-	NM_177603	41921705	41922401	1
chr19	41937340	41970643	Rrp12	33303	-	NM_199447	41937696	41970567	34
chr19	41986360	41993155	Pgam1	6795	+	NM_023418	41986537	41992265	4
chr19	41997469	42007804	Exosc1	10335	-	NM_025644	41998471	42007772	8
chr19	42007961	42018593	Zdhhc16	10632	+	NM_023740	42012097	42018186	11
chr19	42018196	42055626	Mms19	37430	-	NM_028152	42019042	42055603	31
chr19	42056252	42109131	Ubtd1	52879	+	NM_145500	42056428	42108464	3
chr19	42110527	42119600	Ankrd2	9073	+	NM_020033	42110537	42119497	9
chr19	42120340	42145429	Hoga1	25089	+	NM_026152	42120407	42144827	7
chr19	42126717	42128118	4933411K16Rik	1401	+	NM_025752	42126921	42127836	1
chr19	42149428	42160860	Morn4	11432	-	NM_198108	42150596	42153040	5
chr19	42164924	42196708	Pi4k2a	31784	+	NM_145501	42164991	42194444	9
chr19	42197764	42203483	Avpi1	5719	-	NM_027106	42198178	42199506	3
chr19	42221878	42226193	Marveld1	4315	+	NM_183195	42222138	42222660	2
chr19	42245056	42269082	Zfyve27	24026	+	NM_177319	42246036	42264937	13
chr19	42272460	42276742	Sfrp5	4282	-	NM_018780	42273174	42276501	3
chr19	42322067	42344838	Golga7b	22771	+	NM_001141983	42330661	42342952	7
chr19	42354571	42354660	Mir3085	89	-	NR_037246	42354660	42354660	1
chr19	42357526	42506273	Crtac1	148747	-	NM_145123	42358051	42506123	15
chr19	42593294	42666746	R3hcc1l	73452	+	NM_177464	42637055	42665162	7
chr19	42666768	42687296	Loxl4	20528	-	NM_001164311	42669823	42683021	15
chr19	42800347	42827265	Pyroxd2	26918	-	NM_029011	42801408	42826953	16
chr19	42829685	42854466	Hps1	24781	-	NM_019424	42830123	42852728	20
chr19	42863084	43462845	Hpse2	599761	-	NM_001081257	42863436	43462801	12
chr19	43514925	43571703	Cnnm1	56778	+	NM_031396	43514934	43569528	11
chr19	43574242	43599095	Got1	24853	-	NM_010324	43574907	43598945	9
chr19	43686814	43690382	Nkx2-3	3568	+	NM_008699	43686990	43689535	2
chr19	43738291	43749371	Slc25a28	11080	-	NM_145156	43738615	43749256	4
chr19	43749667	43751660	BC037704	1993	+	NR_045645	43751660	43751660	1
chr19	43764178	43808343	Entpd7	44165	+	NM_053103	43764763	43804425	13
chr19	43807743	43827490	Cox15	19747	-	NM_144874	43811210	43827401	9
chr19	43827512	43843128	Cutc	15616	+	NM_025530	43827652	43842779	9
chr19	43856797	43912708	Abcc2	55911	+	NM_013806	43856893	43912047	32
chr19	43913292	43915335	Gm10768	2043	+	NR_033472	43915335	43915335	1
chr19	43921304	44014688	Dnmbp	93384	-	NM_028029	43922582	43986869	16
chr19	44030797	44061010	Cpn1	30213	-	NM_030703	44030982	44060778	9
chr19	44079511	44103737	Cyp2c44	24226	-	NM_001001446	44079930	44103677	9
chr19	44109432	44144275	Erlin1	34843	-	NM_001164360	44111416	44143874	12
chr19	44147823	44181967	Chuk	34144	-	NM_001162410	44149951	44181882	21
chr19	44183126	44210366	Cwf19l1	27240	-	NM_001081077	44185005	44210278	14
chr19	44213736	44220936	Bloc1s2	7200	-	NM_028607	44214171	44220906	5
chr19	44222126	44266932	Pkd2l1	44806	-	NM_181422	44222996	44266764	15
chr19	44277777	44318506	Scd3	40729	+	NM_024450	44278010	44316349	6
chr19	44368165	44381352	Scd2	13187	+	NM_009128	44368877	44377690	6
chr19	44377660	44377721	Mir5114	61	+	NR_039574	44377721	44377721	1
chr19	44407815	44421233	Scd4	13418	+	NM_183216	44407981	44419389	6
chr19	44468939	44482199	Scd1	13260	-	NM_009127	44472408	44481899	6
chr19	44567961	44588763	Wnt8b	20802	+	NM_011720	44568039	44586572	6
chr19	44591446	44620338	Sec31b	28892	-	NM_001033343	44591798	44618269	26
chr19	44624743	44629905	Ndufb8	5162	-	NM_026061	44624809	44629891	5
chr19	44637343	44650764	Hif1an	13421	+	NM_176958	44637367	44645648	8
chr19	44831883	44912359	Pax2	80476	+	NM_011037	44831883	44910517	10
chr19	44882895	44883019	Mir6405	124	+	NR_105831	44883019	44883019	1
chr19	44902982	44910428	1700039E22Rik	7446	-	NR_045315	44910428	44910428	3
chr19	45005608	45058277	Fam178a	52669	+	NM_001081225	45005800	45055081	20
chr19	45046606	45059040	4930414N06Rik	12434	-	NR_040294	45059040	45059040	3
chr19	45063833	45077885	Sema4g	14052	+	NM_011976	45067004	45076487	15
chr19	45079503	45080932	Mrpl43	1429	-	NM_053164	45080188	45080884	3
chr19	45081047	45087252	Peo1	6205	+	NM_153796	45081619	45086394	5
chr19	45089665	45101594	Lzts2	11929	+	NM_145503	45095918	45100975	5
chr19	45101396	45120262	Pdzd7	18866	-	NM_001195265	45102104	45120133	16
chr19	45122065	45130873	Sfxn3	8808	+	NM_053197	45123596	45129191	11
chr19	45150628	45153779	Kazald1	3151	+	NM_178929	45151171	45153457	5
chr19	45225204	45231433	Tlx1	6229	+	NM_021901	45225405	45230606	3
chr19	45308217	45309726	Lbx1	1509	-	NM_010691	45308223	45309717	2
chr19	45438223	45607833	Btrc	169610	+	NM_001037758	45438328	45601915	15
chr19	45626765	45635033	Poll	8268	-	NM_020032	45627295	45634181	9
chr19	45635104	45652777	Dpcd	17673	+	NM_172639	45635133	45652065	6
chr19	45652746	45734683	Fbxw4	81937	-	NM_013907	45653295	45734519	9
chr19	45801044	45805048	4933429K18Rik	4004	-	NR_045307	45805048	45805048	3
chr19	45811287	45817374	Fgf8	6087	-	NM_001166361	45811479	45817174	6
chr19	45822223	45824053	Npm3	1830	-	NM_008723	45822660	45824046	6
chr19	45824748	45857781	Mgea5	33033	-	NM_023799	45826633	45857620	16
chr19	45866835	45890553	Kcnip2	23718	-	NM_145703	45868159	45890293	10
chr19	45892633	46072978	9130011E15Rik	180345	-	NM_198296	45893375	46053191	26
chr19	46077967	46080663	Hps6	2696	+	NM_176785	46078115	46080533	1
chr19	46107090	46119701	Ldb1	12611	-	NM_001113408	46107600	46119344	11
chr19	46131028	46147399	Pprc1	16371	+	NM_001081214	46131080	46147142	14
chr19	46150336	46160033	Nolc1	9697	+	NM_001039352	46150519	46158660	13
chr19	46206388	46210184	Elovl3	3796	+	NM_007703	46206559	46209292	4
chr19	46210175	46222815	Pitx3	12640	-	NM_008852	46210507	46211972	4
chr19	46227047	46361000	Gbf1	133953	+	NM_178930	46238019	46360430	40
chr19	46379226	46386580	Nfkb2	7354	+	NM_001177369	46380493	46386384	23
chr19	46386576	46401646	Psd	15070	-	NM_028627	46387188	46399419	18
chr19	46402673	46404936	Fbxl15	2263	+	NM_133694	46402963	46404781	4
chr19	46404301	46413150	Cuedc2	8849	-	NM_001164290	46405177	46407181	10
chr19	46417251	46417360	Mir146b	109	+	NR_030468	46417360	46417360	1
chr19	46422690	46423478	2310034G01Rik	788	-	NR_040418	46423478	46423478	1
chr19	46431369	46449744	Tmem180	18375	+	NM_029186	46440875	46449204	9
chr19	46451303	46470225	Actr1a	18922	-	NM_016860	46452856	46470167	11
chr19	46471385	46563294	Sufu	91909	+	NM_015752	46471592	46560434	12
chr19	46576137	46590945	Trim8	14808	+	NM_053100	46576933	46590156	6
chr19	46605598	46647575	Arl3	41977	-	NM_019718	46605828	46647532	6
chr19	46647854	46671390	Sfxn2	23536	+	NM_053196	46656992	46669261	12
chr19	46673595	46731879	Wbp1l	58284	+	NM_001177812	46673693	46729209	5
chr19	46741654	46747490	Cyp17a1	5836	-	NM_007809	46741814	46747333	8
chr19	46764395	46777872	Borcs7	13477	+	NM_025563	46764437	46776056	5
chr19	46781932	46815585	As3mt	33653	+	NM_020577	46782025	46815058	11
chr19	46836098	46953070	Cnnm2	116972	+	NM_033569	46836262	46952532	8
chr19	46961320	47089679	Nt5c2	128359	-	NM_001164363	46963307	47089246	18
chr19	47089187	47098836	Ina	9649	+	NM_146100	47089244	47098140	3
chr19	47108106	47125396	Pcgf6	17290	-	NM_027654	47109118	47125309	10
chr19	47142237	47157969	Taf5	15732	+	NM_177342	47142254	47157134	11
chr19	47157960	47165115	Usmg5	7155	-	NM_023211	47160447	47160710	4
chr19	47165255	47205635	Pdcd11	40380	+	NM_011053	47167288	47205300	36
chr19	47206721	47212784	Calhm2	6063	-	NM_133746	47207246	47210393	3
chr19	47215524	47218664	Calhm1	3140	-	NM_001081271	47215524	47218664	2
chr19	47253309	47333931	Neurl1a	80622	+	NM_021360	47253956	47332145	6
chr19	47334663	47538901	Sh3pxd2a	204238	-	NM_008018	47341476	47538625	15
chr19	47348008	47348079	Mir6995	71	-	NR_105961	47348079	47348079	1
chr19	47575537	47611510	Obfc1	35973	-	NM_175360	47576049	47610839	10
chr19	47587471	47591068	Gm19557	3597	+	NR_045322	47591068	47591068	3
chr19	47654508	47719736	Slk	65228	+	NM_009289	47654683	47716583	19
chr19	47720830	47766532	Col17a1	45702	-	NM_001290825	47721715	47760076	54
chr19	47806245	47810078	Sfr1	3833	+	NM_026377	47806298	47809508	4
chr19	47811346	47911851	Cfap43	100505	-	NM_027559	47812210	47911817	38
chr19	47829511	47829647	Mir8090	136	-	NR_106165	47829647	47829647	1
chr19	47929462	47939278	Gsto1	9816	+	NM_010362	47929578	47938940	6
chr19	47940034	47960795	Gsto2	20761	+	NM_030051	47946259	47960679	9
chr19	47969085	47993789	Itprip	24704	-	NM_001001738	47970996	47972664	2
chr19	48012201	48109869	Cfap58	97668	+	NM_001163267	48012317	48109262	18
chr19	48280514	48879995	Sorcs3	599481	+	NM_025696	48280669	48878176	27
chr19	50217790	50753136	Sorcs1	535346	-	NM_001252501	50218429	50752958	26
chr19	52338786	52339499	Ins1	713	+	NM_008386	52339113	52339440	2
chr19	52997670	53001421	AA387883	3751	+	NR_030678	53001421	53001421	2
chr19	53065669	53113144	Xpnpep1	47475	-	NM_133216	53066080	53113035	21
chr19	53085145	53085246	Mir6407	101	-	NR_105834	53085246	53085246	1
chr19	53150741	53158882	1700054A03Rik	8141	+	NR_045320	53158882	53158882	3
chr19	53214932	53321816	Add3	106884	+	NM_001164099	53291310	53319780	15
chr19	53323225	53329695	1700001K23Rik	6470	-	NR_036590	53329695	53329695	3
chr19	53384995	53450300	Mxi1	65305	+	NM_001008542	53385189	53446226	6
chr19	53453703	53465063	Smndc1	11360	-	NM_172429	53454953	53463912	6
chr19	53515701	53539286	Mirt1	23585	-	NR_028427	53539286	53539286	10
chr19	53603807	53615812	Dusp5	12005	+	NM_001085390	53603807	53615812	4
chr19	53674885	53720321	Smc3	45436	+	NM_007790	53675029	53719268	29
chr19	53751795	53941570	Rbm20	189775	+	NM_001170847	53751897	53938680	14
chr19	53966720	54004351	Pdcd4	37631	+	NM_011050	53982002	54003633	12
chr19	54004148	54019117	Bbip1	14969	-	NM_001195348	54005834	54006665	4
chr19	54018795	54107768	Shoc2	88973	+	NM_001168505	54062170	54105766	9
chr19	54119671	54123472	Adra2a	3801	+	NM_007417	54120704	54122102	1
chr19	55144223	55173937	Gpam	29714	-	NM_008149	55145419	55172088	21
chr19	55255374	55270803	Tectb	15429	+	NM_009348	55255504	55269198	10
chr19	55267167	55267224	Mir6715	57	+	NR_106146	55267224	55267224	1
chr19	55272587	55315726	Gucy2g	43139	-	NM_001081076	55273173	55315726	21
chr19	55327858	55371118	Acsl5	43260	+	NM_027976	55343162	55370003	22
chr19	55372788	55390522	Zdhhc6	17734	-	NM_001033573	55373274	55389057	11
chr19	55390546	55701951	Vti1a	311405	+	NM_001293685	55390940	55698400	9
chr19	55715078	55776694	4930552P12Rik	61616	-	NR_045318	55776694	55776694	4
chr19	55816299	56008145	Tcf7l2	191846	+	NM_001142918	55816831	56002226	15
chr19	56362427	56394579	Habp2	32152	+	NM_146101	56362485	56394125	12
chr19	56394530	56464528	Nrap	69998	-	NM_008733	56394684	56464367	42
chr19	56471618	56516833	Casp7	45215	+	NM_007611	56478905	56515585	7
chr19	56536126	56561219	Plekhs1	25093	+	NM_001164263	56539059	56560338	13
chr19	56603650	56622712	Dclre1a	19062	-	NM_018831	56603991	56621640	10
chr19	56622750	56673336	Nhlrc2	50586	+	NM_025811	56623172	56672002	11
chr19	56796861	56799352	Adrb1	2491	+	NM_007419	56796861	56798262	1
chr19	56865452	56888173	Ccdc186	22721	-	NM_170757	56865452	56888173	15
chr19	56900698	56944502	Tdrd1	43804	+	NM_001002238	56905559	56941132	26
chr19	56948905	56986568	Vwa2	37663	+	NM_172840	56955624	56985235	14
chr19	56986843	57083065	Afap1l2	96222	-	NM_146102	56987871	57019246	21
chr19	57107753	57290522	Ablim1	182769	-	NM_178688	57111713	57290447	25
chr19	57348449	57351542	4930449E18Rik	3093	+	NR_045319	57351542	57351542	3
chr19	57397686	57435389	B230217O12Rik	37703	-	NR_040316	57435389	57435389	3
chr19	57435498	57464084	Fam160b1	28586	+	NM_145505	57435815	57461066	17
chr19	57527395	57565495	Trub1	38100	+	NM_028115	57527436	57562758	8
chr19	57583053	57587278	6720468P15Rik	4225	+	NR_040306	57587278	57587278	4
chr19	57685523	58207830	Atrnl1	522307	+	NM_181415	57685843	58205704	29
chr19	58125656	58125726	Mir5623	70	+	NR_049196	58125726	58125726	1
chr19	58310070	58529888	Gfra1	219818	-	NR_104342	58529888	58529888	12
chr19	58370693	58374838	Gm10007	4145	+	NR_040449	58374838	58374838	3
chr19	58586491	58627575	Ccdc172	41084	+	NM_029372	58586847	58627404	9
chr19	58680818	58704243	1810007D17Rik	23425	+	NR_038136	58704243	58704243	3
chr19	58744854	58756278	Pnlip	11424	+	NM_026925	58745028	58756217	13
chr19	58773406	58775813	1810018F18Rik	2407	+	NR_038140	58775813	58775813	3
chr19	58803376	58818659	Pnliprp1	15283	+	NM_018874	58803614	58818618	13
chr19	58834212	58852024	Pnliprp2	17812	+	NM_011128	58834278	58851971	12
chr19	58860292	58868904	1700019N19Rik	8612	-	NM_026208	58860485	58868888	6
chr19	58870240	58935474	Hspa12a	65234	-	NM_175199	58873850	58935379	12
chr19	58986162	58986249	Mir3086	87	-	NR_037247	58986249	58986249	1
chr19	59017914	59045911	Eno4	27997	+	NM_178689	59017946	59045233	14
chr19	59047847	59150559	Shtn1	102712	-	NM_001114312	59049475	59150002	17
chr19	59238974	59244519	Vax1	5545	-	NM_009501	59240676	59244519	3
chr19	59294137	59311860	Kcnk18	17723	+	NM_207261	59294223	59310099	3
chr19	59335367	59370502	Slc18a2	35135	+	NM_172523	59335822	59368406	16
chr19	59370573	59420270	Pdzd8	49697	-	NM_001033222	59374012	59420077	5
chr19	59499593	59533125	Emx2os	33532	-	NR_002863	59533125	59533125	4
chr19	59533179	59539847	Emx2	6668	+	NM_010132	59533705	59538537	3
chr19	59567625	59635294	2700089I24Rik	67669	+	NR_045308	59635294	59635294	5
chr19	59978786	60019557	Rab11fip2	40771	-	NM_001164367	59982818	60013260	5
chr19	60220577	60238494	E330013P04Rik	17917	+	NR_026942	60238494	60238494	5
chr19	60274488	60302600	Fam204a	28112	-	NM_029648	60275338	60297199	8
chr19	60542635	60544207	Prlhr	1572	-	NM_201615	60542916	60544029	1
chr19	60600598	60656926	Cacul1	56328	-	NM_030197	60604949	60656621	9
chr19	60831889	60835817	Nanos1	3928	+	NM_178421	60832168	60832972	1
chr19	60837018	60866596	Eif3a	29578	-	NM_010123	60837983	60866420	22
chr19	60850232	60850288	Snora19	56	-	NR_034047	60850288	60850288	1
chr19	60887472	60912132	Fam45a	24660	+	NM_001167829	60887521	60910905	9
chr19	60913179	60937333	Sfxn4	24154	-	NM_053198	60914875	60937240	14
chr19	60939968	60950441	Prdx3	10473	-	NM_007452	60940568	60950370	7
chr19	60965651	61168458	Grk5	202807	+	NM_018869	60966482	61167895	16
chr19	61129742	61216743	Zfp950	87001	-	NR_131953	61216743	61216743	7
chr19	61250588	61252212	Gm7102	1624	-	NM_001177513	61251361	61251898	1
chr19	61300304	61304321	Csf2ra	4017	-	NM_009970	61300906	61303268	12
chrUn_random	3052	4452	Tcstv3	1400	-	NM_153523	3237	3747	2
chrUn_random	12474	21008	BC147527	8534	-	NM_001037925	12668	13172	5
chrUn_random	37342	38736	Tcstv1	1394	-	NM_018756	37534	38049	3
chrUn_random	125697	127960	AF067063	2263	-	NM_001001449	125904	126398	4
chrUn_random	588638	612480	4933409K07Rik	23842	+	NR_033123	612480	612480	5
chrUn_random	1919827	1957720	Gm6367	37893	-	NR_044992	1957720	1957720	4
chrUn_random	2674944	2678407	Mucl2	3463	-	NM_009267	2675093	2678336	4
chrUn_random	2735804	2743961	Vmn2r-ps159	8157	+	NR_038052	2743961	2743961	6
chrUn_random	2735832	2743962	Vmn2r123	8130	+	NM_009485	2735885	2743532	9
chrUn_random	2889606	2891056	B020031M17Rik	1450	-	NM_001033769	2889796	2890318	2
chrUn_random	3058602	3072666	Ulbp1	14064	+	NM_029975	3058602	3071988	5
chrUn_random	4834599	4838176	Mucl1	3577	+	NR_126081	4838176	4838176	4
chrX	3241669	3243629	Gm3701	1960	-	NM_001243011	3242047	3243544	1
chrX	3241669	3243629	Gm14345	1960	-	NM_001085545	3242047	3243544	1
chrX	3241669	3243629	Gm14346	1960	-	NM_001085551	3242047	3243544	1
chrX	3241674	3243629	Gm3706	1955	-	NM_001243001	3242047	3243544	1
chrX	3241674	3243629	Gm3750	1955	-	NM_001099643	3242047	3243544	1
chrX	3241674	3243629	Gm14351	1955	-	NM_001085552	3242047	3243544	1
chrX	3241680	3243584	Gm21950	1904	-	NM_001270667	3242047	3243544	1
chrX	3241680	3243601	Gm21951	1921	-	NM_001270669	3242047	3243544	1
chrX	3461360	3463320	Gm2913	1960	-	NM_001243015	3461738	3463235	1
chrX	3546313	3547091	Gm21637	778	-	NM_001270685	3546335	3547046	1
chrX	3546313	3547091	Spin2-ps1	778	-	NM_029106	3546335	3547046	1
chrX	3907010	3908970	Gm14347	1960	+	NM_001085543	3907095	3908592	1
chrX	3993613	3995573	Gm10922	1960	-	NM_001085554	3993991	3995488	1
chrX	4074963	4076923	Gm10921	1960	+	NM_001085553	4075048	4076545	1
chrX	4219982	4221937	Gm5925	1955	+	NR_040410	4221937	4221937	1
chrX	4598165	4600108	Gm3763	1943	+	NM_001243024	4598250	4599747	1
chrX	5044021	5046383	Mycs	2362	-	NM_010850	5044846	5046142	1
chrX	5246184	5248144	Gm14374	1960	+	NM_001085523	5246269	5247766	1
chrX	5624624	5631869	Nudt11	7245	+	NM_021431	5625028	5630145	2
chrX	5658335	5660538	AU022751	2203	-	NM_001033211	5658670	5660440	2
chrX	5745814	5750109	Nudt10	4295	-	NM_001031664	5746913	5749953	2
chrX	5891223	5897841	Bmp15	6618	-	NM_009757	5892747	5897481	2
chrX	5977149	6214572	Shroom4	237423	+	NM_001040459	5977262	6210835	9
chrX	6029493	6151781	5430428K19Rik	122288	-	NR_045426	6151781	6151781	3
chrX	6356431	6525489	Dgkk	169058	+	NM_177914	6356591	6521850	28
chrX	6556777	6618745	Ccnb3	61968	-	NM_183015	6557011	6608012	14
chrX	6644640	6655732	Akap4	11092	+	NM_009651	6644755	6655545	6
chrX	6735537	6896484	Clcn5	160947	-	NM_001243762	6736854	6893800	14
chrX	6814808	6814900	Mir500	92	-	NR_030495	6814900	6814900	1
chrX	6818368	6818477	Mir501	109	-	NR_030496	6818477	6818477	1
chrX	6819108	6819172	Mir362	64	-	NR_029851	6819172	6819172	1
chrX	6825114	6825182	Mir188	68	-	NR_029574	6825182	6825182	1
chrX	6825527	6825623	Mir532	96	-	NR_030242	6825623	6825623	1
chrX	6949716	6952956	Usp27x	3240	-	NM_019461	6950670	6951987	1
chrX	6953050	6955168	Gm14379	2118	+	NR_026741	6955168	6955168	2
chrX	6988942	7000114	2010204K13Rik	11172	-	NR_027924	7000114	7000114	2
chrX	7135687	7151407	Ppp1r3f	15720	-	NM_138605	7136743	7151374	4
chrX	7150725	7158142	Ppp1r3fos	7417	+	NR_029473	7158142	7158142	3
chrX	7156801	7172369	Foxp3	15568	+	NM_001199347	7163480	7170169	14
chrX	7170934	7182546	Ccdc22	11612	-	NM_138603	7171179	7182419	17
chrX	7184228	7212322	Cacna1f	28094	+	NM_019582	7184271	7212245	48
chrX	7215705	7230382	Syp	14677	+	NM_009305	7215818	7226009	7
chrX	7234504	7245312	Prickle3	10808	+	NM_001290624	7234584	7244857	9
chrX	7245066	7248516	Plp2	3450	-	NM_019755	7245612	7248364	5
chrX	7250291	7258377	Magix	8086	-	NR_037581	7258377	7258377	6
chrX	7274259	7287385	Gpkow	13126	+	NM_173747	7274351	7285371	11
chrX	7299345	7305327	Wdr45	5982	+	NM_172372	7300991	7304985	11
chrX	7305696	7308189	Praf2	2493	+	NM_138602	7305709	7307533	3
chrX	7308839	7318450	Ccdc120	9611	-	NM_207202	7310281	7315336	10
chrX	7339786	7352328	Tfe3	12542	+	NM_172472	7340070	7351057	10
chrX	7367118	7397693	Gripap1	30575	+	NM_001290455	7367152	7397220	26
chrX	7384226	7384347	Mir1198	121	+	NR_035430	7384347	7384347	1
chrX	7400884	7415404	Kcnd1	14520	+	NM_008423	7400968	7413629	6
chrX	7418956	7453752	Otud5	34796	+	NM_001290536	7419242	7451480	9
chrX	7455431	7460558	Pim2	5127	+	NM_138606	7455444	7459643	6
chrX	7461369	7471618	Slc35a2	10249	+	NM_078484	7461468	7471344	5
chrX	7471644	7476395	Pqbp1	4751	-	NM_001252529	7471836	7476368	7
chrX	7476461	7484778	Timm17b	8317	+	NM_011591	7476569	7483702	6
chrX	7496947	7501536	Pcsk1n	4589	+	NM_013892	7497056	7500229	3
chrX	7501401	7505733	Eras	4332	-	NM_181548	7501617	7502301	2
chrX	7507247	7525015	Hdac6	17768	-	NM_001130416	7507594	7524340	29
chrX	7536385	7545036	Gata1	8651	-	NM_008089	7536882	7540348	6
chrX	7581326	7595618	Glod5	14292	-	NM_027227	7581502	7595569	4
chrX	7638296	7651886	Suv39h1	13590	-	NM_011514	7639975	7651688	6
chrX	7658591	7667617	Was	9026	-	NM_009515	7659059	7667554	12
chrX	7674212	7683827	Gm6787	9615	+	NR_003632	7683827	7683827	4
chrX	7700426	7709984	Wdr13	9558	-	NM_001290783	7702670	7708516	9
chrX	7716100	7723006	Rbm3	6906	-	NM_016809	7720397	7722183	7
chrX	7722552	7725089	Rbm3os	2537	+	NR_033561	7725089	7725089	3
chrX	7731597	7753307	Tbc1d25	21710	-	NM_001166437	7731830	7753271	7
chrX	7762454	7770638	Ebp	8184	-	NM_007898	7762735	7767505	5
chrX	7770971	7783651	Porcn	12680	-	NM_023638	7771301	7782826	15
chrX	7815793	7829532	Ftsj1	13739	-	NM_001290430	7822200	7828126	13
chrX	7848506	7857302	Slc38a5	8796	+	NM_172479	7848608	7856979	16
chrX	7904549	7913361	Ssxb10	8812	+	NM_199064	7907164	7912775	8
chrX	7944103	7952514	Ssxb9	8411	+	NM_199066	7946680	7951928	8
chrX	7990430	7999283	Ssxb1	8853	+	NM_026492	7993055	7998699	8
chrX	8031468	8038852	Ssxb2	7384	-	NM_001001450	8032055	8038034	7
chrX	8091177	8102080	Gm14459	10903	-	NM_001126491	8091177	8102080	6
chrX	8119729	8125381	Ssxb6	5652	-	NM_001205108	8119733	8125376	6
chrX	8160669	8166372	Ssxb3	5703	-	NM_198898	8161118	8166326	7
chrX	8262456	8267970	Ssxb8	5514	-	NM_001081565	8262456	8267965	6
chrX	8325555	8331713	Ssx9	6158	+	NM_199063	8325601	8331264	7
chrX	8380816	8386512	Ssxb5	5696	+	NM_199319	8380894	8386064	7
chrX	8421119	8426733	Gm6592	5614	+	NM_001081564	8421119	8426733	6
chrX	8469478	8472090	B630019K06Rik	2612	+	NR_045448	8472090	8472090	1
chrX	8539259	8540101	Fthl17b	842	-	NM_001085524	8539424	8539955	1
chrX	8552843	8553685	Fthl17c	842	-	NM_001085525	8553008	8553539	1
chrX	8552843	8553715	Fthl17-ps1	872	-	NM_001277184	8553008	8553539	2
chrX	8563065	8563798	Fthl17d	733	-	NM_001099326	8563190	8563721	1
chrX	8610611	8611459	Fthl17e	848	+	NM_031261	8610763	8611294	1
chrX	8640215	8640948	Fthl17f	733	+	NM_001038697	8640292	8640823	1
chrX	8681687	8683468	4930402K13Rik	1781	+	NM_001270700	8681799	8683047	1
chrX	8777098	8845211	Lancl3	68113	+	NM_173414	8777355	8842811	5
chrX	8849909	8890371	Xk	40462	+	NM_023500	8850115	8886875	3
chrX	8860889	8861414	1700012L04Rik	525	+	NM_029588	8860984	8861302	1
chrX	8927724	8928263	Gm14501	539	+	NM_001085537	8927821	8928139	1
chrX	9012379	9046450	Cybb	34071	-	NM_007807	9015342	9046376	13
chrX	9149085	9149517	Gm5132	432	-	NM_001085517	9149141	9149474	1
chrX	9231395	9240109	Dynlt3	8714	-	NM_025975	9233112	9240024	5
chrX	9424072	9424626	Hypm	554	+	NM_026096	9424156	9424510	1
chrX	9426828	9427378	4930557A04Rik	550	+	NM_029229	9426876	9427263	1
chrX	9462746	9575990	Sytl5	113244	+	NM_177704	9462786	9571669	17
chrX	9615102	9694787	Srpx	79685	-	NM_016911	9616042	9694666	10
chrX	9735341	9793921	Rpgr	58580	-	NM_001177950	9735799	9793819	18
chrX	9829430	9898150	Otc	68720	+	NM_008769	9829562	9897028	10
chrX	10062241	10173730	Tspan7	111489	+	NM_019634	10062283	10172473	8
chrX	10294490	10296828	Mid1ip1	2338	+	NM_001166635	10295355	10295904	2
chrX	10876382	10876883	Gm14483	501	+	NM_001111037	10876446	10876764	1
chrX	10876446	10876764	Gm14475	318	+	NM_001242954	10876446	10876764	1
chrX	10876446	10876764	Gm14476	318	+	NM_001242950	10876446	10876764	1
chrX	10876446	10876764	Gm14477	318	+	NM_001242949	10876446	10876764	1
chrX	10876446	10876764	Gm14479	318	+	NM_001242951	10876446	10876764	1
chrX	10879557	10880047	Gm14474	490	+	NM_001242947	10879614	10879932	1
chrX	10885880	10886389	Gm14482	509	+	NM_001242952	10885949	10886267	1
chrX	10889059	10889553	Gm14484	494	+	NM_001025260	10889116	10889434	1
chrX	10898578	10899020	Gm14478	442	+	NM_001242953	10898617	10898935	1
chrX	10904947	10905277	Gm4906	330	+	NM_001114529	10904947	10905277	1
chrX	11613863	11737481	Bcor	123618	-	NM_001168321	11614751	11638733	14
chrX	11711579	11737472	2900008C10Rik	25893	-	NR_045434	11737472	11737472	4
chrX	11916904	11932122	Gm14635	15218	-	NR_045321	11932122	11932122	4
chrX	12164884	12194177	Atp6ap2	29293	+	NM_027439	12165021	12192999	9
chrX	12229008	12229946	Gm4984	938	+	NM_001101484	12229428	12229788	1
chrX	12232007	12250765	1810030O07Rik	18758	-	NM_175141	12234988	12250667	7
chrX	12252496	12339099	Med14	86603	-	NM_001048208	12254703	12338825	31
chrX	12339403	12398618	Gm14634	59215	+	NR_045852	12398618	12398618	5
chrX	12513998	12515667	AA414768	1669	+	NM_001272033	12514090	12515254	1
chrX	12619140	12622421	5730405O15Rik	3281	+	NR_038158	12622421	12622421	3
chrX	12648623	12750453	Usp9x	101830	+	NM_009481	12671207	12746610	45
chrX	12811766	12824859	2010308F09Rik	13093	-	NR_045429	12824859	12824859	3
chrX	12858147	12871109	Ddx3x	12962	+	NM_010028	12858238	12868618	17
chrX	13044797	13066439	Nyx	21642	+	NM_173415	13045318	13064465	3
chrX	13094207	13423682	Cask	329475	-	NM_001284503	13099296	13423192	27
chrX	13209894	13217984	Gpr34	8090	+	NM_011823	13216359	13217487	3
chrX	13238488	13244559	Gpr82	6071	+	NM_175669	13242340	13243327	4
chrX	13788273	13788783	Gm5382	510	+	NM_001034100	13788334	13788664	1
chrX	14687711	14688615	Ppp1r2-ps9	904	-	NR_033171	14688615	14688615	1
chrX	16099994	16100817	Cypt1	823	+	NM_025738	16100018	16100685	2
chrX	16100006	16100741	Cypt7	735	+	NM_001039943	16100018	16100685	2
chrX	16100006	16100741	Cypt8	735	+	NM_001039941	16100018	16100685	2
chrX	16196823	16264938	Maoa	68115	+	NM_173740	16196966	16262501	15
chrX	16286406	16394492	Maob	108086	-	NM_172778	16287164	16394401	15
chrX	16462647	16488900	Ndp	26253	-	NM_010883	16463594	16471701	3
chrX	16709174	16896494	Efhc2	187320	-	NM_028916	16709390	16896409	15
chrX	17132725	17149451	Fundc1	16726	-	NM_028058	17135059	17149306	5
chrX	17722995	17723818	Dusp21	823	+	NM_028568	17723074	17723644	1
chrX	17739700	17857062	Kdm6a	117362	+	NM_009483	17740131	17855833	29
chrX	17992006	18038523	4930578C19Rik	46517	-	NR_132634	18038523	18038523	9
chrX	18723419	18723514	Mir221	95	-	NR_029806	18723514	18723514	1
chrX	18724018	18724097	Mir222	79	-	NR_029807	18724097	18724097	1
chrX	19636695	19674646	Chst7	37951	+	NM_021715	19636841	19638296	2
chrX	19682880	19868890	Slc9a7	186010	-	NM_177353	19683088	19868810	17
chrX	19941606	19982779	Rp2	41173	+	NR_110967	19982779	19982779	9
chrX	20002813	20097065	Jade3	94252	+	NM_001289684	20066852	20095022	14
chrX	20126943	20139213	Rgn	12270	+	NM_009060	20127504	20138611	7
chrX	20192451	20194690	Ndufb11	2239	-	NM_019435	20192544	20194386	3
chrX	20194628	20228031	Rbm10	33403	+	NM_001167775	20197223	20227810	24
chrX	20235427	20260305	Uba1	24878	+	NM_001276316	20245574	20259639	27
chrX	20265079	20277005	Cdk16	11926	+	NM_001310456	20271066	20275772	16
chrX	20281034	20297665	Usp11	16631	+	NM_145628	20281093	20297026	21
chrX	20425668	20437647	Araf	11979	+	NM_009703	20427112	20437239	16
chrX	20437636	20498044	Syn1	60408	-	NM_013680	20438599	20497915	13
chrX	20440251	20440308	Mir5617	57	-	NR_049190	20440308	20440308	1
chrX	20447291	20451863	Timp1	4572	+	NM_001044384	20448164	20451758	6
chrX	20502579	20508681	Cfp	6102	-	NM_008823	20502719	20508580	9
chrX	20510520	20527734	Elk1	17214	-	NM_007922	20512575	20518889	6
chrX	20528790	20539104	Uxt	10314	-	NM_013840	20529095	20538903	7
chrX	20538801	20564475	A230072C01Rik	25674	+	NR_027445	20564475	20564475	6
chrX	20603309	20639164	Zfp182	35855	-	NM_001111076	20607189	20637643	5
chrX	20645613	20655085	Spaca5	9472	+	NM_001085393	20645613	20655014	4
chrX	20656275	20666355	Zfp300	10080	-	NM_183185	20658711	20661480	5
chrX	20783705	20798791	4930453H23Rik	15086	-	NM_001252013	20784182	20784440	5
chrX	20889335	20911853	Gm6938	22518	-	NR_033482	20911853	20911853	3
chrX	20937990	20941750	Gm5124	3760	+	NR_045668	20941750	20941750	2
chrX	21061749	21065959	Agtr2	4210	+	NM_007429	21063254	21064346	3
chrX	21292025	21319483	Slc6a14	27458	+	NM_020049	21292273	21318216	14
chrX	22038721	22040669	Ppp1r2-ps7	1948	+	NR_033731	22040669	22040669	1
chrX	22796396	22942208	Klhl13	145812	-	NM_026167	22797490	22892305	9
chrX	23270176	23383127	Wdr44	112951	+	NM_001305675	23270588	23382109	21
chrX	23469888	23484676	Gm4907	14788	+	NM_001034864	23469909	23484623	2
chrX	24051433	24076289	Gm5934	24856	-	NM_001100444	24051759	24076263	8
chrX	24129375	24150431	Gm4297	21056	-	NM_001100446	24129702	24150405	8
chrX	24330287	24352290	Gm5935	22003	-	NM_001081657	24330391	24350701	9
chrX	24704608	24728581	Gm5169	23973	-	NM_001040669	24704730	24726973	9
chrX	24975626	24997575	Gm1993	21949	-	NM_001102677	24975747	24995957	9
chrX	25455339	25478167	Gm5168	22828	-	NM_001025607	25455442	25476584	9
chrX	25628008	26362795	Gm2012	734787	-	NM_001104946	25628128	26361184	9
chrX	25714324	25737170	Gm2030	22846	-	NM_001100445	25714429	25735551	9
chrX	25949782	25972691	Slx	22909	-	NM_001136476	25949904	25971075	9
chrX	26099905	26129764	Gm14525	29859	-	NM_001162364	26100024	26128196	9
chrX	26339869	26362795	Gm6121	22926	-	NM_001114754	26339990	26361184	9
chrX	29483981	29506865	Gm10488	22884	+	NM_001099325	29485575	29506762	9
chrX	29924763	29947680	Gm10230	22917	-	NM_001099347	29924885	29946073	9
chrX	29924763	29947680	Gm14632	22917	-	NM_001100610	29924885	29946073	9
chrX	29924763	29947680	Gm14819	22917	-	NM_001110250	29924885	29946073	9
chrX	29924763	29947708	Gm10486	22945	-	NM_001109970	29924885	29946073	9
chrX	29924766	29947680	Gm10147	22914	-	NM_001099919	29924885	29946073	9
chrX	29924766	29947708	Gm10096	22942	-	NM_001102678	29924885	29946073	9
chrX	29924767	29947677	Gm10058	22910	-	NM_001109969	29924885	29946073	9
chrX	29924780	29947708	Gm4836	22928	-	NM_009529	29924885	29946073	9
chrX	29924780	29947708	Gm10487	22928	-	NM_001100609	29924885	29946073	9
chrX	30732633	30734583	Gm2799	1950	+	NM_001168334	30732718	30734215	1
chrX	30732633	30734588	Gmcl1l	1955	+	NM_027955	30732718	30734215	1
chrX	30977792	30979742	Gm2825	1950	+	NM_001168337	30977877	30979374	1
chrX	31060181	31060959	Gm2837	778	+	NR_040388	31060959	31060959	1
chrX	31349046	31350997	Gm2863	1951	-	NM_001099333	31349415	31350912	1
chrX	31750733	31752434	Gm2933	1701	-	NM_001145038	31750884	31752381	1
chrX	31832259	31834202	Gm2927	1943	+	NM_001282034	31832344	31833841	1
chrX	33428826	33616557	Dock11	187731	+	NM_001009947	33428925	33616213	53
chrX	33652102	33711256	Il13ra1	59154	+	NM_133990	33652188	33708901	11
chrX	33735898	33739153	Zcchc12	3255	+	NM_028325	33737426	33738635	5
chrX	33868403	33906851	Lonrf3	38448	+	NM_028894	33868574	33901914	11
chrX	33943471	33944649	Gm6268	1178	+	NR_044989	33944649	33944649	3
chrX	34138187	34146074	Pgrmc1	7887	+	NM_016783	34138281	34144886	3
chrX	34148177	34185409	Akap17b	37232	-	NM_001081956	34150967	34164315	7
chrX	34283626	34317302	Slc25a43	33676	+	NR_075096	34317302	34317302	6
chrX	34335591	34338803	Slc25a5	3212	+	NM_007451	34335725	34338539	4
chrX	34354762	34357195	2310010G23Rik	2433	-	NR_131979	34357195	34357195	2
chrX	34388538	34404241	C330007P06Rik	15703	-	NM_029951	34391094	34404127	7
chrX	34414289	34424215	Ube2a	9926	+	NM_001313696	34414480	34423135	6
chrX	34427536	34442894	Nkrf	15358	-	NM_029891	34428549	34431734	3
chrX	34450828	34451980	Gm15008	1152	+	NR_045917	34451980	34451980	4
chrX	34451266	34529690	Sept6	78424	-	NM_001177323	34453239	34529403	10
chrX	34588839	34590413	Sowahd	1574	+	NM_173779	34588918	34589902	1
chrX	34622512	34625217	Rpl39	2705	-	NM_026055	34622695	34625122	3
chrX	34622906	34623028	Snora69	122	-	NR_002900	34623028	34623028	1
chrX	34631672	34650317	Upf3b	18645	-	NM_026573	34632506	34650226	10
chrX	34666757	34690741	Nkap	23984	+	NM_025937	34666990	34687960	9
chrX	34690692	34708837	Akap14	18145	-	NM_001033785	34690789	34704075	6
chrX	34727583	34731233	Ndufa1	3650	-	NM_019443	34727715	34731085	3
chrX	34731216	34732460	Rnf113a1	1244	+	NM_153503	34731386	34732412	1
chrX	34748496	34751036	Gm9	2540	-	NM_001033234	34749921	34750894	4
chrX	34753799	34762253	Rhox1	8454	-	NM_001025084	34753991	34762238	5
chrX	34784986	34789685	Rhox2a	4699	+	NM_001310503	34785014	34787510	5
chrX	34784986	34831309	Rhox2e	46323	+	NM_001085348	34785014	34831134	4
chrX	34789913	34798973	Rhox3a	9060	+	NM_194063	34794872	34798793	6
chrX	34805369	34810130	Rhox4a	4761	+	NM_001039688	34805505	34809993	4
chrX	34826611	34831313	Rhox2b	4702	+	NM_001099316	34826617	34831134	4
chrX	34847000	34851785	Rhox4b	4785	+	NM_021300	34847131	34851648	4
chrX	34868165	34872882	Rhox2c	4717	+	NM_001099318	34868193	34872707	4
chrX	34884374	34888468	Rhox3c	4094	+	NM_001102457	34884374	34888286	4
chrX	34894843	34899631	Rhox4c	4788	+	NM_001039689	34894991	34899494	4
chrX	34907916	34912222	Rhox2d	4306	+	NM_001081669	34907955	34912042	4
chrX	34929041	34933682	Rhox4d	4641	+	NM_001039695	34929045	34933545	4
chrX	34961481	34965404	Rhox3e	3923	+	NM_001184969	34961481	34965404	4
chrX	34971918	34976789	Rhox4e	4871	+	NM_201236	34972140	34976652	4
chrX	34985927	34990666	Rhox2f	4739	+	NM_001085356	34985955	34990491	4
chrX	34995858	35000003	Rhox3f	4145	+	NM_001040089	34995858	34999818	4
chrX	35017401	35022193	Rhox4f	4792	-	NM_001039696	35017538	35022019	4
chrX	35037938	35042646	Rhox3g	4708	-	NM_001145406	35038009	35042611	4
chrX	35053618	35057977	Rhox2g	4359	-	NM_001114153	35053798	35057933	4
chrX	35061007	35065834	Rhox4g	4827	-	NM_001039698	35061144	35065611	4
chrX	35072194	35083271	Rhox3h	11077	-	NM_001114157	35072379	35076298	6
chrX	35083503	35087784	Rhox2h	4281	-	NM_001100465	35083678	35087756	4
chrX	35180231	35183034	Rhox6	2803	+	NM_008955	35180274	35182896	4
chrX	35184862	35194348	Rhox7a	9486	+	NM_001025086	35186241	35194348	8
chrX	35227952	35232121	Rhox8	4169	-	NM_001004193	35228132	35232058	4
chrX	35252273	35254947	Rhox9	2674	-	NM_023894	35252380	35254856	4
chrX	35367084	35371992	Btg1-ps1	4908	-	NM_001243943	35367084	35367570	5
chrX	35391375	35396291	Btg1-ps2	4916	-	NM_001034856	35391523	35392009	5
chrX	35419651	35424865	Rhox10	5214	+	NM_001024850	35419773	35424818	3
chrX	35429774	35438316	Rhox11	8542	-	NM_198598	35429796	35438154	3
chrX	35457238	35464084	Rhox12	6846	-	NM_001025083	35457354	35461320	4
chrX	35474016	35483143	Rhox13	9127	+	NM_001185002	35474466	35483038	3
chrX	35542969	35550223	Zbtb33	7254	+	NM_001079513	35545393	35547409	2
chrX	35549749	35605658	Tmem255a	55909	-	NM_001289727	35550370	35605478	10
chrX	35563617	35563697	Mir3110	80	+	NR_037297	35563697	35563697	1
chrX	35669298	35689961	Atp1b4	20663	+	NM_001290389	35669443	35686899	8
chrX	35754533	35809637	Lamp2	55104	-	NM_001290485	35755315	35809480	9
chrX	35884797	35929373	Cul4b	44576	-	NM_028288	35886809	35925641	23
chrX	35953834	35966699	Mcts1	12865	+	NM_026902	35953944	35966479	6
chrX	35983959	35988320	C1galt1c1	4361	-	NM_021550	35984343	35985294	2
chrX	36125956	36315865	6030498E09Rik	189909	+	NM_183126	36311260	36312732	4
chrX	36699442	36700138	Cypt15	696	+	NM_001177380	36699463	36699905	2
chrX	37216095	37216781	Cypt14	686	-	NM_001191032	37216318	37216760	2
chrX	38754477	39031778	Gria3	277301	+	NR_104053	39031778	39031778	17
chrX	39148170	39265078	Thoc2	116908	-	NM_001033422	39156141	39265048	39
chrX	39421012	39462841	Xiap	41829	+	NM_009688	39447575	39458161	8
chrX	39502588	39630363	Stag2	127775	+	NM_001077712	39555127	39628463	33
chrX	39855741	39875272	Sh2d1a	19531	+	NM_001313688	39855899	39874929	5
chrX	39885569	40627961	Tenm1	742392	-	NM_011855	39885641	40520931	33
chrX	40944165	40946707	Gm362	2542	+	NM_001195271	40944336	40946151	2
chrX	41718633	41721514	Dcaf12l2	2881	-	NM_175539	41719777	41721187	1
chrX	42139743	42143374	Dcaf12l1	3631	-	NM_178739	42141590	42143096	2
chrX	42444080	42445967	Prr32	1887	+	NM_026841	42444188	42445821	2
chrX	43620735	43682088	4930515L19Rik	61353	-	NR_045440	43682088	43682088	3
chrX	43682183	43683522	Actrt1	1339	+	NM_028514	43682286	43683417	1
chrX	45162546	45245729	Smarca1	83183	-	NM_001290708	45163225	45245573	24
chrX	45265632	45319043	Ocrl	53411	+	NM_177215	45265829	45316761	24
chrX	45378322	45388029	Apln	9707	-	NM_013912	45381475	45387682	3
chrX	45461901	45490158	Xpnpep2	28257	+	NM_001289729	45462322	45489106	21
chrX	45499612	45514742	Sash3	15130	+	NM_001313749	45499837	45513433	8
chrX	45525147	45561879	Zdhhc9	36732	-	NM_172465	45526701	45560011	10
chrX	45610110	45635626	Utp14a	25516	+	NM_028276	45610119	45635508	15
chrX	45629968	45638603	9530027J09Rik	8635	-	NR_045916	45638603	45638603	4
chrX	45694534	45759905	Bcorl1	65371	+	NM_178782	45714753	45759376	15
chrX	45764225	45816309	Elf4	52084	-	NM_019680	45767839	45777326	9
chrX	45828120	45866740	Aifm1	38620	-	NM_012019	45828293	45866515	16
chrX	45872461	45883417	Rab33a	10956	+	NM_011228	45872777	45883281	2
chrX	45894802	45947629	Zfp280c	52827	-	NM_001166649	45896450	45941910	20
chrX	45976754	46015475	Slc25a14	38721	+	NM_001290704	45982458	46015101	13
chrX	46021155	46027655	Gpr119	6500	-	NM_181751	46026427	46027435	2
chrX	46048180	46063896	Rbmx2	15716	+	NM_173376	46048292	46063246	6
chrX	46194642	46230890	Gm595	36248	-	NM_001085499	46194698	46230792	21
chrX	46362883	46641419	Enox2	278536	-	NM_145951	46364679	46433890	16
chrX	46823626	46853427	Arhgap36	29801	+	NM_001081123	46823783	46852318	13
chrX	47036680	47037640	Olfr1320	960	+	NM_207240	47036680	47037640	1
chrX	47080149	47081109	Olfr1321	960	-	NM_207631	47080149	47081109	1
chrX	47135713	47150922	Igsf1	15209	-	NM_177591	47135993	47148495	20
chrX	47238645	47239578	Olfr1322	933	-	NM_001011794	47238645	47239578	1
chrX	47362482	47363412	Olfr1323	930	-	NM_146390	47362482	47363412	1
chrX	47778672	47779671	Olfr1324	999	-	NM_146292	47778672	47779671	1
chrX	47890565	47915775	Gm35612	25210	+	NR_131207	47915775	47915775	3
chrX	47916296	47988498	Firre	72202	-	NR_015505	47988498	47988498	20
chrX	48194547	48246275	Stk26	51728	+	NM_001313744	48194970	48243121	12
chrX	48245821	48295887	Frmd7	50066	-	NM_001190332	48248356	48295887	12
chrX	48357090	48371195	Rap2c	14105	-	NM_172413	48368181	48371075	3
chrX	48466670	48559167	Mbnl3	92497	-	NM_134163	48474183	48517771	8
chrX	48739813	49034779	Hs6st2	294966	-	NM_001077202	48742646	49034779	5
chrX	49107135	49154410	Usp26	47275	-	NM_031388	49108065	49110573	9
chrX	49321871	49325949	1700080O16Rik	4078	-	NM_028851	49322129	49322984	4
chrX	49406194	49518100	Gpc4	111906	-	NM_008150	49406697	49517952	9
chrX	49625603	49967151	Gpc3	341548	-	NM_016697	49625961	49966981	8
chrX	49731297	49731358	Mir6384	61	-	NR_105805	49731358	49731358	1
chrX	49775583	49775692	Mir717	109	-	NR_030497	49775692	49775692	1
chrX	49929019	49972224	A630012P03Rik	43205	+	NR_045367	49972224	49972224	5
chrX	50094869	50094944	Mir363	75	-	NR_029853	50094944	50094944	1
chrX	50095014	50095105	Mir92-2	91	-	NR_029748	50095105	50095105	1
chrX	50095159	50095243	Mir19b-2	84	-	NR_029715	50095243	50095243	1
chrX	50095289	50095369	Mir20b	80	-	NR_030273	50095369	50095369	1
chrX	50095507	50095590	Mir18b	83	-	NR_030548	50095590	50095590	1
chrX	50095679	50095744	Mir106a	65	-	NR_029657	50095744	50095744	1
chrX	50095739	50097770	Kis2	2031	-	NR_003188	50097770	50097770	1
chrX	50144376	50152645	Ccdc160	8269	+	NM_001034059	50151259	50152231	2
chrX	50265390	50310138	Phf6	44748	+	NM_027642	50269775	50306755	11
chrX	50341254	50374837	Hprt	33583	+	NM_013556	50341400	50374291	9
chrX	50401173	50401255	Mir450b	82	-	NR_030498	50401255	50401255	1
chrX	50401330	50401421	Mir450-1	91	-	NR_029963	50401421	50401421	1
chrX	50401475	50401544	Mir450-2	69	-	NR_030274	50401544	50401544	1
chrX	50402579	50402664	Mir542	85	-	NR_030264	50402664	50402664	1
chrX	50406288	50410367	C430049B03Rik	4079	-	NR_038185	50410367	50410367	4
chrX	50406431	50406530	Mir351	99	-	NR_029776	50406530	50406530	1
chrX	50407160	50407231	Mir503	71	-	NR_030275	50407231	50407231	1
chrX	50407431	50407526	Mir322	95	-	NR_029756	50407526	50407526	1
chrX	50423178	50467582	Plac1	44404	-	NM_019538	50423486	50424008	3
chrX	50596591	50622982	Fam122b	26391	-	NM_030167	50599322	50622150	9
chrX	50626609	50654678	Fam122c	28069	+	NM_028671	50630795	50654564	8
chrX	50697770	50723736	Mospd1	25966	-	NR_110964	50723736	50723736	7
chrX	50788094	50796753	Etd	8659	+	NR_034074	50796753	50796753	2
chrX	50911098	50912311	Cxx1c	1213	+	NM_028375	50911222	50911561	2
chrX	50945665	50946940	Cxx1a	1275	-	NM_024170	50946456	50946798	1
chrX	50972353	50973585	Cxx1b	1232	-	NM_001018063	50973133	50973475	1
chrX	50989667	50994509	4933416I08Rik	4842	+	NM_027700	50989813	50994236	5
chrX	50989703	50994502	LOC100504039	4799	+	NR_102724	50994502	50994502	5
chrX	51000098	51019755	AW822252	19657	-	NR_110489	51019755	51019755	7
chrX	51028007	51041399	4930502E18Rik	13392	+	NM_029142	51028134	51041034	5
chrX	51046077	51061008	1700013H16Rik	14931	-	NM_001200013	51046342	51055020	9
chrX	51075862	51079571	Zfp36l3	3709	-	NM_001009549	51077244	51079422	2
chrX	51080294	51100883	Xlr	20589	-	NM_001291748	51081499	51099389	8
chrX	51834384	51851190	Gm16405	16806	+	NM_001166646	51835973	51851043	6
chrX	51834384	51851190	Gm16430	16806	+	NM_001166601	51835973	51851043	6
chrX	52480052	52496913	Slxl1	16861	+	NM_029181	52481671	52496758	6
chrX	52683411	52700069	Gm14625	16658	+	NM_001220498	52684995	52699970	6
chrX	52804772	52821634	Gm16404	16862	+	NM_001220497	52806323	52821535	6
chrX	53389748	53406673	3830403N18Rik	16925	+	NM_027510	53391203	53406390	8
chrX	53443003	53466058	Gm773	23055	-	NM_001033423	53443241	53455943	8
chrX	53570784	53573841	1600025M17Rik	3057	+	NR_038168	53573841	53573841	3
chrX	53599576	53618851	Zfp449	19275	+	NM_030139	53601551	53616802	5
chrX	53627762	53631647	Smim10l2a	3885	+	NR_028086	53631647	53631647	2
chrX	53708015	53761020	Ddx26b	53005	+	NM_172779	53708382	53760165	17
chrX	53797050	53802783	Gm648	5733	-	NM_001033372	53797242	53800424	5
chrX	53838688	53851096	Mmgt1	12408	-	NM_146234	53842320	53851040	4
chrX	53841028	53841091	Mir5116	63	-	NR_039576	53841091	53841091	1
chrX	53863011	53917407	Slc9a6	54396	+	NM_172780	53863036	53914625	16
chrX	53984937	54046523	Fhl1	61586	+	NM_010211	54041191	54045175	7
chrX	54051129	54075502	Mtap7d3	24373	-	NM_177293	54051271	54075480	16
chrX	54296250	54301935	Brs3	5685	+	NM_009766	54296421	54300534	3
chrX	54306746	54320359	Htatsf1	13613	+	NM_028242	54307186	54320031	10
chrX	54341282	54359717	Vgll1	18435	+	NM_001313763	54345449	54358623	9
chrX	54453813	54457553	Gm14718	3740	+	NR_038463	54457553	54457553	2
chrX	54465319	54477219	Cd40lg	11900	+	NM_011616	54465331	54476764	5
chrX	54484661	54591906	Arhgef6	107245	-	NM_152801	54486687	54591751	22
chrX	54636524	54646213	Rbmx	9689	-	NR_029425	54646213	54646213	10
chrX	54644624	54644686	Snord61	62	-	NR_002903	54644686	54644686	1
chrX	54662325	54741948	Gm364	79623	+	NM_001128625	54662355	54741829	17
chrX	54749844	54756934	Gpr101	7090	-	NM_001033360	54753429	54754965	2
chrX	55283804	55289807	Zic3	6003	+	NM_009575	55284357	55287726	3
chrX	56164637	56173481	4930550L24Rik	8844	+	NM_023774	56172059	56173022	2
chrX	56315323	56838749	Fgf13	523426	-	NM_001290414	56316709	56820365	7
chrX	56350834	56350913	Mir504	79	-	NR_030574	56350913	56350913	1
chrX	57252640	57283937	F9	31297	+	NM_007979	57252640	57282618	8
chrX	57309132	57432266	Mcf2	123134	-	NM_001289731	57309840	57432083	28
chrX	57476466	57657156	Atp11c	180690	-	NM_001037863	57482327	57657006	30
chrX	57647577	57647667	Mir505	90	-	NR_030499	57647667	57647667	1
chrX	57689226	57709370	Gm7073	20144	-	NM_001039240	57689337	57693350	4
chrX	57801182	57802391	Gm715	1209	+	NM_001271548	57801193	57802024	1
chrX	58144540	58146605	Sox3	2065	-	NM_009237	58145252	58146605	1
chrX	58369552	58392635	C230004F18Rik	23083	+	NR_030706	58392635	58392635	8
chrX	58436420	58438733	Cdr1	2313	-	NM_001166658	58437179	58438733	1
chrX	58444467	58447339	C030023E24Rik	2872	+	NR_033502	58447339	58447339	1
chrX	58962790	58964125	Ldoc1	1335	+	NM_001018087	58962884	58963340	1
chrX	59536673	59545253	4933402E13Rik	8580	+	NM_001199997	59543550	59544840	4
chrX	59763713	59780186	1700019B21Rik	16473	-	NR_045442	59780186	59780186	3
chrX	61404580	61405373	Gm6760	793	-	NM_001177377	61404750	61405204	2
chrX	61426722	61431953	3830417A13Rik	5231	+	NM_027512	61430615	61431527	4
chrX	61522618	61530171	Slitrk4	7553	-	NM_178740	61523720	61526234	3
chrX	62300818	62302192	Ctag2	1374	+	NM_027302	62300859	62302036	3
chrX	63902492	63914577	Slitrk2	12085	+	NM_001161431	63907079	63909620	3
chrX	64029931	64029993	Mir743	62	-	NR_030532	64029993	64029993	1
chrX	64030430	64030507	Mir743b	77	-	NR_030535	64030507	64030507	1
chrX	64033547	64033612	Mir742	65	-	NR_030531	64033612	64033612	1
chrX	64033932	64034008	Mir883a	76	-	NR_030541	64034008	64034008	1
chrX	64043064	64043142	Mir883b	78	-	NR_030542	64043142	64043142	1
chrX	64045769	64045836	Mir471	67	-	NR_030154	64045836	64045836	1
chrX	64049979	64050050	Mir741	71	-	NR_030530	64050050	64050050	1
chrX	64052397	64052472	Mir463	75	-	NR_030147	64052472	64052472	1
chrX	64053704	64053782	Mir880	78	-	NR_030538	64053782	64053782	1
chrX	64054682	64054760	Mir878	78	-	NR_030603	64054760	64054760	1
chrX	64055118	64055196	Mir881	78	-	NR_030539	64055196	64055196	1
chrX	64063602	64063679	Mir871	77	-	NR_030536	64063679	64063679	1
chrX	64067125	64067200	Mir470	75	-	NR_030153	64067200	64067200	1
chrX	64075830	64075888	Mir465d	58	-	NR_106148	64075888	64075888	1
chrX	64079129	64079210	Mir465c-1	81	-	NR_030562	64079210	64079210	1
chrX	64082376	64082455	Mir465b-1	79	-	NR_030560	64082455	64082455	1
chrX	64082376	64082455	Mir465b-2	79	-	NR_030561	64082455	64082455	1
chrX	64085691	64085772	Mir465c-2	81	-	NR_030563	64085772	64085772	1
chrX	64092226	64092300	Mir465	74	-	NR_030149	64092300	64092300	1
chrX	64936074	64946737	Gm1140	10663	-	NM_001126317	64936166	64946737	8
chrX	64936166	64946737	Gm14692	10571	-	NM_001163195	64936166	64946737	8
chrX	65173038	65174625	4933436I01Rik	1587	-	NM_025763	65173136	65174587	2
chrX	65241270	65241336	Mir201	66	-	NR_029588	65241336	65241336	1
chrX	65241548	65241626	Mir547	78	-	NR_030265	65241626	65241626	1
chrX	65263279	65263354	Mir509	75	-	NR_030575	65263354	65263354	1
chrX	65920688	65931574	Fmr1os	10886	-	NR_033481	65931574	65931574	4
chrX	65931715	65971136	Fmr1	39421	+	NM_008031	65931991	65968850	17
chrX	66015013	66057735	Fmr1nb	42722	+	NM_174993	66015108	66057617	6
chrX	66145547	66146228	Gm6812	681	-	NM_001098842	66145689	66146182	2
chrX	66613505	67121212	Aff2	507707	+	NM_008032	66613966	67121006	20
chrX	67182434	67396763	1700111N16Rik	214329	-	NR_033213	67396763	67396763	9
chrX	67198455	67199155	1700020N15Rik	700	+	NM_029316	67198520	67199013	2
chrX	67596244	67618260	Ids	22016	-	NM_010498	67599375	67618078	9
chrX	67639087	67642591	1110012L19Rik	3504	+	NM_026787	67641088	67642267	3
chrX	67647075	67647915	4930567H17Rik	840	-	NM_001033807	67647158	67647860	1
chrX	67713230	67730218	BC023829	16988	-	NM_001033328	67714222	67730190	6
chrX	67798732	67799560	Gm14725	828	+	NM_001081476	67798787	67799477	1
chrX	68303430	68407892	Mamld1	104462	+	NM_001081354	68354722	68405405	7
chrX	68463941	68568470	Mtm1	104529	+	NM_001164190	68484573	68566988	15
chrX	68617934	68672371	Mtmr1	54437	+	NM_001313702	68618089	68669902	18
chrX	68673234	68746024	Cd99l2	72790	-	NM_001199349	68675859	68745763	10
chrX	68809091	68813848	Hmgb3	4757	+	NM_001293625	68811232	68812979	5
chrX	68916841	68922432	Gpr50	5591	+	NM_001308501	68916966	68920359	3
chrX	69061418	69070045	Vma21	8627	+	NM_001290781	69061928	69066286	4
chrX	69177776	69186210	Gm1141	8434	+	NR_027801	69186210	69186210	9
chrX	69207963	69218061	Prrg3	10098	+	NM_001303028	69211184	69212923	4
chrX	69218324	69234385	Fate1	16061	+	NR_003243	69234385	69234385	5
chrX	69237187	69255557	Cnga2	18370	+	NM_007724	69248631	69254854	7
chrX	69467355	69468303	Magea4	948	+	NM_020280	69467355	69468303	1
chrX	69502770	69520060	Gabre	17290	-	NM_017369	69502790	69520040	9
chrX	69506369	69506451	Mir224	82	-	NR_029808	69506451	69506451	1
chrX	69507562	69507647	Mir452	85	-	NR_029974	69507647	69507647	1
chrX	69627208	69632197	Magea10	4989	-	NM_001085506	69627747	69628725	4
chrX	69678014	69901585	Gabra3	223571	-	NM_008067	69679987	69798155	10
chrX	69835326	69835433	Mir767	107	-	NR_035528	69835433	69835433	1
chrX	69836838	69836918	Mir105	80	-	NR_030546	69836918	69836918	1
chrX	70070516	70087941	Gabrq	17425	+	NM_001290435	70070794	70084854	10
chrX	70158903	70163683	Cetn2	4780	-	NM_019405	70159542	70163655	5
chrX	70163859	70203867	Nsdhl	40008	+	NM_010941	70171674	70202953	8
chrX	70232677	70276882	Zfp185	44205	+	NM_009549	70242417	70274282	19
chrX	70237417	70237483	Mir2137	66	+	NR_035517	70237483	70237483	1
chrX	70279319	70282442	Pnma5	3123	-	NM_001100461	70280556	70282413	2
chrX	70310125	70313530	Pnma3	3405	+	NM_153169	70310160	70311561	1
chrX	70319683	70327846	Xlr4a	8163	-	NM_001081642	70319987	70326909	9
chrX	70331631	70342434	Xlr3a	10803	-	NM_001110784	70332466	70340390	9
chrX	70352973	70363041	Xlr5a	10068	-	NM_001045539	70353780	70360579	9
chrX	70382570	70388763	Gm14685	6193	-	NM_001025383	70382739	70384827	4
chrX	70382570	70394789	DXBay18	12219	-	NM_001025384	70382739	70384827	5
chrX	70394179	70403738	Xlr5b	9559	+	NM_001111293	70396595	70403402	9
chrX	70420640	70422328	Spin2d	1688	-	NM_001243002	70420690	70421401	2
chrX	70437517	70448269	Xlr3b	10752	+	NM_001081643	70439539	70447435	9
chrX	70459671	70467792	Xlr4b	8121	+	NM_021365	70460597	70467487	9
chrX	70473644	70476134	F8a	2490	+	NM_007978	70473654	70474800	1
chrX	70479414	70488469	Xlr4c	9055	-	NM_183094	70479720	70487503	9
chrX	70499878	70510729	Xlr3c	10851	-	NM_011727	70500710	70508760	9
chrX	70530535	70535854	Xlr5c	5319	-	NM_031493	70530535	70535854	6
chrX	70587958	70604419	Zfp275	16461	+	NM_031494	70590223	70599722	6
chrX	70656898	70673721	Zfp92	16823	+	NM_001310531	70665212	70673006	6
chrX	70679043	70680682	Trex2	1639	-	NM_011907	70679267	70679978	2
chrX	70682653	70704368	Haus7	21715	-	NM_028633	70682833	70704278	10
chrX	70728939	70741275	Bgn	12336	+	NM_007542	70736128	70740135	8
chrX	70748424	70818609	Atp2b3	70185	+	NM_177236	70768293	70815893	21
chrX	70884779	70888853	Dusp9	4074	+	NM_029352	70885566	70887748	4
chrX	70901330	70905409	Pnck	4079	-	NM_001199352	70902015	70904586	12
chrX	70918471	70927839	Slc6a8	9368	+	NM_001142809	70919127	70926439	13
chrX	70931516	70963154	Bcap31	31638	-	NM_001313698	70931895	70960223	8
chrX	70961935	70983626	Abcd1	21691	+	NM_007435	70962369	70982870	10
chrX	71002441	71017849	Plxnb3	15408	+	NM_019587	71003866	71017589	35
chrX	71019743	71024263	Srpk3	4520	+	NM_019684	71019789	71024027	15
chrX	71024301	71032236	Idh3g	7935	-	NM_008323	71024408	71032194	13
chrX	71032366	71036167	Ssr4	3801	+	NM_001166480	71032578	71036097	6
chrX	71038695	71070308	Pdzd4	31613	-	NM_001029868	71039720	71069680	8
chrX	71099118	71126173	L1cam	27055	-	NM_008478	71100373	71115143	29
chrX	71137440	71139767	Avpr2	2327	+	NM_019404	71137582	71139213	3
chrX	71139690	71156637	Arhgap4	16947	-	NM_138630	71140074	71156568	22
chrX	71162208	71167283	Naa10	5075	-	NM_019870	71162297	71167115	8
chrX	71167459	71176189	Renbp	8730	-	NM_023132	71167477	71176082	11
chrX	71188130	71211696	Hcfc1	23566	-	NM_008224	71189776	71211342	26
chrX	71259252	71269260	Irak1	10008	-	NM_001177974	71260778	71269084	15
chrX	71268866	71268937	Mir5132	71	-	NR_039594	71268937	71268937	1
chrX	71269187	71269275	Mir718	88	-	NR_030758	71269275	71269275	1
chrX	71271930	71331029	Mecp2	59099	-	NM_010788	71280755	71325273	4
chrX	71372804	71396094	Opn1mw	23290	+	NM_008106	71372845	71395995	6
chrX	71396282	71413177	Tex28	16895	-	NM_001126488	71396432	71412123	5
chrX	71422597	71453837	Tktl1	31240	+	NM_031379	71422628	71453185	13
chrX	71468799	71491873	Flna	23074	-	NM_001290421	71469128	71485035	47
chrX	71500025	71503232	Emd	3207	+	NM_007927	71500290	71502676	6
chrX	71516154	71518474	Rpl10	2320	+	NM_052835	71516340	71518406	7
chrX	71517830	71517959	Snora70	129	+	NR_002899	71517959	71517959	1
chrX	71518555	71527672	Dnase1l1	9117	-	NM_001172154	71518907	71522569	8
chrX	71519365	71519444	Mir7091	79	-	NR_106059	71519444	71519444	1
chrX	71528056	71535490	Taz	7434	+	NM_001173547	71528346	71534739	10
chrX	71542435	71550060	Atp6ap1	7625	+	NM_018794	71542517	71549345	10
chrX	71550350	71557206	Gdi1	6856	+	NM_010273	71550735	71556278	11
chrX	71558371	71565488	Fam50a	7117	+	NM_138607	71558553	71565307	13
chrX	71562700	71562768	Mir7092	68	+	NR_106060	71562768	71562768	1
chrX	71574404	71590028	Plxna3	15624	+	NM_008883	71576334	71588881	33
chrX	71597500	71598957	Lage3	1457	-	NM_025410	71597722	71598866	3
chrX	71611056	71613887	Ubl4a	2831	-	NM_145405	71612814	71613802	4
chrX	71612785	71618688	SlcUbl4a	5903	-	NM_001278272	71612814	71613802	7
chrX	71614557	71618688	Slc10a3	4131	-	NM_145406	71614789	71616211	3
chrX	71630058	71638613	Fam3a	8555	-	NM_001313725	71630678	71638026	10
chrX	71638629	71699117	Ikbkg	60488	+	NM_001161424	71678158	71693698	10
chrX	71654824	71674500	G6pdx	19676	-	NM_008062	71655545	71673510	13
chrX	71725625	71726738	Gm6880	1113	-	NM_001099305	71725625	71726738	3
chrX	71839666	71840614	Olfr1325	948	+	NM_146398	71839666	71840614	1
chrX	71884457	71890974	Gm5640	6517	-	NM_001099302	71884630	71886817	4
chrX	71986265	71987527	Gm6890	1262	+	NM_001099306	71986265	71987378	3
chrX	72082534	72088708	Gm5936	6174	+	NM_001081670	72086334	72088521	4
chrX	72212182	72214464	Gm38425	2282	-	NM_001251890	72213182	72214373	3
chrX	72233886	72330244	Gab3	96358	-	NM_181584	72234058	72330078	10
chrX	72341192	72355115	Dkc1	13923	+	NM_001030307	72341450	72354100	15
chrX	72355071	72376355	Mpp1	21284	-	NM_008621	72356005	72376165	12
chrX	72391395	72409090	Smim9	17695	-	NM_001033786	72391572	72406959	5
chrX	72418055	72625380	F8	207325	-	NM_007977	72418193	72624971	26
chrX	72627737	72642497	Fundc2	14760	+	NM_026126	72627771	72639726	5
chrX	72650185	72661923	Cmc4	11738	-	NM_001294277	72650408	72654942	4
chrX	72655780	72661923	Mtcp1	6143	-	NM_001039373	72656560	72657078	5
chrX	72661966	72701040	Brcc3	39074	+	NM_001166459	72662057	72695459	11
chrX	72759635	72780285	Vbp1	20650	+	NM_011692	72759677	72779317	6
chrX	72817383	72823570	Rab39b	6187	-	NM_175122	72819919	72823346	2
chrX	72970796	73010038	4933407K13Rik	39242	-	NR_029443	73010038	73010038	9
chrX	73030992	73120509	Pls3	89517	-	NM_001166453	73032105	73072284	16
chrX	73509644	73513012	Cldn34b3	3368	+	NM_001013760	73512166	73512796	2
chrX	73638688	73643318	Cldn34b4	4630	+	NM_001033799	73642477	73643113	3
chrX	73827948	73848263	Cldn34d	20315	-	NM_001201395	73828150	73828783	2
chrX	74756565	74905604	Tbl1x	149039	+	NM_020601	74886788	74905080	16
chrX	74920152	74920791	Cldn34-ps	639	-	NM_001101585	74920152	74920791	1
chrX	75007373	75041299	Prkx	33926	-	NM_016979	75009467	75041043	9
chrX	75083236	75098839	Pbsn	15603	-	NM_017471	75087221	75098822	7
chrX	75110096	75115372	Gm14744	5276	+	NM_001085544	75110151	75114538	7
chrX	75233629	75238906	5430402E10Rik	5277	+	NM_027768	75233684	75238075	7
chrX	75330843	75336713	Obp1a	5870	-	NM_008754	75331636	75336661	7
chrX	75370805	75375742	Gm5938	4937	+	NM_001085534	75370857	75374915	7
chrX	75432146	75437581	Obp1b	5435	+	NM_001310328	75432165	75436800	7
chrX	75485800	75491260	Gm14743	5460	-	NM_001126321	75486632	75491250	7
chrX	75614981	75616467	4930480E11Rik	1486	+	NM_001177966	75615009	75616194	1
chrX	75694948	75829236	Prrg1	134288	-	NM_001289683	75698025	75766119	5
chrX	75983101	75984749	Fam47c	1648	+	NM_001164739	75983152	75984445	1
chrX	76575851	76603407	Gm8787	27556	-	NM_001099310	76576049	76603298	8
chrX	76727906	76762624	Gm7173	34718	-	NM_001099307	76727906	76762624	16
chrX	76868569	76916774	Mageb16	48205	-	NM_028025	76869025	76870117	4
chrX	78315982	78343214	Tmem47	27232	+	NM_138751	78316273	78339969	3
chrX	78664913	78703461	4930595M18Rik	38548	-	NM_173435	78664948	78703341	4
chrX	80194208	82450389	Dmd	2256181	+	NM_007868	80194455	82447821	79
chrX	80732014	80733263	Tsga8	1249	-	NM_021898	80732123	80733017	2
chrX	82495015	82515630	Fthl17a	20615	+	NM_028046	82514951	82515500	2
chrX	82819360	82879808	Tab3	60448	+	NM_025729	82854821	82875893	9
chrX	82947275	83022158	Gk	74883	-	NM_001294140	82949724	83021842	21
chrX	83115611	83136838	5430427O19Rik	21227	+	NM_001163539	83133168	83134065	2
chrX	83289537	83292652	Samt3	3115	+	NM_028554	83290115	83292544	3
chrX	83437113	83441285	Nr0b1	4172	+	NM_007430	83437139	83440934	2
chrX	83495594	83501558	Mageb4	5964	-	NM_001033492	83496089	83497760	3
chrX	83590813	83600333	Gm41	9520	-	NR_036689	83600333	83600333	2
chrX	83992580	85360962	Il1rapl1	1368382	-	NM_001160403	83992580	85135574	11
chrX	86004812	86004892	Mir1906-1	80	-	NR_035440	86004892	86004892	1
chrX	86004812	86004892	Mir1906-2	80	-	NR_037313	86004892	86004892	1
chrX	86649186	86655028	Pet2	5842	-	NM_008821	86649616	86651860	12
chrX	86997606	87000830	4932429P05Rik	3224	+	NM_001085511	86997902	87000260	2
chrX	87175435	87178191	4930415L06Rik	2756	-	NM_001033880	87175486	87177928	2
chrX	88137480	88138473	Gm44	993	+	NM_001101450	88137480	88138473	1
chrX	88400506	88401128	LOC101055749	622	+	NR_126535	88401128	88401128	2
chrX	88577093	88578236	Mageb1	1143	+	NM_010759	88577093	88578236	1
chrX	88577243	88578236	Mageb2	993	+	NM_031171	88577243	88578236	1
chrX	88637838	88638873	Gm5072	1035	+	NM_001114678	88637838	88638873	1
chrX	88820550	88821250	1700084M14Rik	700	-	NR_126536	88821250	88821250	2
chrX	88877532	88881010	Gm14781	3478	+	NM_001205268	88879782	88880883	2
chrX	89024946	89028315	Mageb5	3369	-	NM_028847	89025009	89026110	2
chrX	89177284	89178319	Gm5071	1035	-	NM_001256004	89177284	89178319	1
chrX	89364217	89844911	Mageb18	480694	-	NM_173783	89364989	89365973	5
chrX	89735287	89736018	Gm5941	731	+	NM_001034103	89735366	89735893	2
chrX	90401492	90402210	BC061195	718	+	NR_105038	90402210	90402210	2
chrX	90401559	90402210	1700003E24Rik	651	+	NR_103799	90402210	90402210	2
chrX	90531845	90543694	Arx	11849	+	NM_001305940	90532066	90542742	6
chrX	90550104	90877494	Pola1	327390	-	NM_008892	90551009	90877450	37
chrX	90900201	90995287	Pcyt1b	95086	+	NM_177546	90900528	90991770	8
chrX	91009954	91077434	Pdk3	67480	-	NM_145630	91010563	91077291	12
chrX	91213994	91220809	AU015836	6815	+	NR_028320	91220809	91220809	3
chrX	91319969	91368746	Zfx	48777	-	NM_001044386	91324134	91347690	9
chrX	91434047	91457990	Eif2s3x	23943	-	NM_012010	91436197	91457972	12
chrX	91480268	91518854	Klhl15	38586	+	NM_001039061	91497760	91518804	3
chrX	91519912	91519976	Mir7673	64	+	NR_106133	91519976	91519976	1
chrX	91612448	91662431	Apoo	49983	+	NM_026673	91612492	91657834	9
chrX	91612462	91643541	Apoo-ps	31079	+	NR_004438	91643541	91643541	7
chrX	91688070	91693066	Gm14827	4996	+	NR_045323	91693066	91693066	4
chrX	91780812	91787413	Maged1	6601	-	NM_019791	91781206	91786634	13
chrX	91881407	91883900	Gspt2	2493	+	NM_008179	91881595	91883494	1
chrX	91969907	91975530	Zxdb	5623	+	NM_001081473	91970013	91972635	1
chrX	92036623	92043628	Zxda	7005	-	NR_003292	92043628	92043628	1
chrX	92217845	92222021	Spin4	4176	-	NM_178753	92220783	92221533	1
chrX	92244273	92361878	Arhgef9	117605	-	NM_001033329	92247311	92360940	11
chrX	92615652	92640179	Amer1	24527	-	NM_175179	92620450	92623849	2
chrX	92665537	92753326	Asb12	87789	-	NM_001313743	92665674	92666997	5
chrX	92834532	92853848	Zc4h2	19316	-	NM_001003916	92835876	92853643	5
chrX	92907016	93123309	Zc3h12b	216293	+	NM_001034907	93094434	93123309	9
chrX	92927928	92928604	1700010D01Rik	676	-	NM_029590	92928051	92928578	2
chrX	93130651	93152313	Las1l	21662	-	NM_152822	93130858	93152187	13
chrX	93291383	93363892	Msn	72509	+	NM_010833	93291570	93361973	13
chrX	93435264	93438981	F630028O10Rik	3717	+	NR_030718	93438981	93438981	3
chrX	93438155	93438265	Mir223	110	+	NR_029801	93438265	93438265	1
chrX	93442541	93488777	Vsig4	46236	-	NM_177789	93443060	93488707	7
chrX	93501516	93651633	Hsf3	150117	-	NM_001310755	93503139	93651089	11
chrX	93650774	93769823	Heph	119049	+	NM_001159628	93658263	93769139	22
chrX	93908806	93914727	Gpr165	5921	+	NM_029536	93909335	93912825	5
chrX	94267934	94277443	Pgr15l	9509	+	NM_001033361	94271352	94273714	5
chrX	94529179	94572548	Eda2r	43369	-	NM_001161432	94534164	94557186	8
chrX	95344095	95518557	Ar	174462	+	NM_013476	95345120	95512219	8
chrX	95749618	96086364	Ophn1	336746	-	NM_001313754	95754932	96085574	26
chrX	96133119	96144359	Yipf6	11240	+	NM_207633	96133570	96140327	7
chrX	96237919	96270067	Stard8	32148	+	NM_199018	96259739	96268539	14
chrX	96331399	96344361	Efnb1	12962	+	NM_010110	96332224	96342866	5
chrX	96600669	96639136	Gm14812	38467	-	NR_033544	96639136	96639136	7
chrX	96661072	96666074	Pja1	5002	-	NM_008853	96661903	96663640	3
chrX	97016407	97041684	Tmem28	25277	+	NM_001081283	97016407	97041684	3
chrX	97170944	97596099	Eda	425155	+	NM_001177944	97171119	97591151	9
chrX	97576435	97576524	Mir676	89	+	NR_030525	97576524	97576524	1
chrX	97597560	97638056	Awat2	40496	-	NM_001290395	97598124	97600967	8
chrX	97624351	97625224	Otud6a	873	+	NM_001163191	97624351	97625224	1
chrX	97689629	97711464	Igbp1	21835	+	NM_008784	97689704	97711044	6
chrX	97720176	97741447	Dgat2l6	21271	+	NM_001114084	97720261	97740939	7
chrX	97767585	97773545	Awat1	5960	+	NM_001081136	97767675	97773227	7
chrX	97785492	97790208	P2ry4	4716	-	NM_020621	97788543	97789629	3
chrX	97800835	97813832	Arr3	12997	+	NM_133205	97801974	97813726	17
chrX	97818244	97821246	Pdzd11	3002	-	NM_028303	97818731	97820713	7
chrX	97821403	97922610	Kif4	101207	+	NM_008446	97821807	97921998	30
chrX	97925185	97934240	Gdpd2	9055	+	NM_023608	97927419	97933621	16
chrX	97963060	98013749	Dlg3	50689	+	NM_016747	97963410	98011664	21
chrX	98033986	98254978	Tex11	220992	-	NM_031384	98034243	98254734	30
chrX	98274548	98280744	Slc7a3	6196	-	NM_007515	98274800	98279579	13
chrX	98293124	98417902	Snx12	124778	-	NM_001110311	98297738	98417765	6
chrX	98449866	98456212	Foxo4	6346	+	NM_018789	98450159	98454861	3
chrX	98456711	98459331	Gm614	2620	-	NM_001033362	98456743	98459188	6
chrX	98459723	98463594	Il2rg	3871	-	NM_013563	98460190	98463508	8
chrX	98469429	98494273	Med12	24844	+	NM_021521	98469599	98492569	45
chrX	98494517	98516689	Nlgn3	22172	+	NM_172932	98497322	98515601	7
chrX	98571714	98580968	Gjb1	9254	+	NM_001302496	98579506	98580358	2
chrX	98599722	98615561	Zmym3	15839	-	NM_019831	98600949	98614278	25
chrX	98624989	98643932	Nono	18943	+	NM_023144	98632556	98643067	12
chrX	98644447	98648880	Itgb1bp2	4433	+	NM_013712	98644511	98648704	11
chrX	98728073	98797128	Taf1	69055	+	NM_001290729	98728160	98794864	38
chrX	98835389	98879690	Ogt	44301	+	NM_139144	98835624	98877669	22
chrX	98926873	98929486	Cxcr3	2613	-	NM_009910	98927289	98929397	2
chrX	99044723	99287394	Nhsl2	242671	+	NM_001163610	99044906	99278266	8
chrX	99261880	99266646	Rgag4	4766	-	NM_001278534	99264401	99266201	2
chrX	99314803	99323012	Pin4	8209	+	NM_027181	99314860	99322990	4
chrX	99338158	99352430	Ercc6l	14272	-	NM_146235	99338517	99352314	2
chrX	99380279	99384730	Rps4x	4451	-	NM_009094	99380368	99384639	7
chrX	99442716	99447520	Cited1	4804	-	NM_001276466	99442795	99443961	3
chrX	99447989	99453028	Gm14858	5039	+	NR_040285	99453028	99453028	3
chrX	99479976	99700497	Hdac8	220521	-	NM_027382	99480484	99700403	11
chrX	99709313	99839585	Phka1	130272	-	NM_008832	99711380	99839263	33
chrX	99902226	99903009	Gm9112	783	-	NM_001177365	99902352	99902906	3
chrX	99903219	99910548	Dmrtc1b	7329	+	NM_001039116	99903242	99910113	7
chrX	99986534	99993728	Gm5166	7194	+	NR_027707	99993728	99993728	8
chrX	99998301	100005281	Dmrtc1c1	6980	+	NM_001142691	99998779	100002599	9
chrX	99998301	100005289	Dmrtc1c2	6988	+	NM_001142690	99998779	100002599	9
chrX	100054525	100061692	1700031F05Rik	7167	-	NM_028496	100055079	100060417	7
chrX	100098560	100104026	Dmrtc1a	5466	-	NM_027591	100099150	100103975	7
chrX	100104243	100104990	1700011M02Rik	747	+	NR_073044	100104990	100104990	3
chrX	100123710	100124446	1700018G05Rik	736	+	NR_045422	100124446	100124446	3
chrX	100127385	100129562	Gm5126	2177	-	NR_026596	100129562	100129562	1
chrX	100379397	100382003	Nap1l2	2606	-	NM_008671	100380266	100381649	1
chrX	100427619	100451945	4930519F16Rik	24326	-	NM_029170	100428059	100451915	4
chrX	100516736	100525563	Cdx4	8827	+	NM_007674	100516898	100524979	3
chrX	100551814	100591457	Chic1	39643	+	NM_009767	100551923	100584849	6
chrX	100609805	100619922	Tsx	10117	+	NM_009440	100609891	100619628	7
chrX	100626855	100680296	Tsix	53441	+	NR_002844	100680296	100680296	4
chrX	100655711	100678572	Xist	22861	-	NR_001570	100678572	100678572	8
chrX	100688896	100701764	Jpx	12868	+	NR_015508	100701764	100701764	3
chrX	100740838	100743038	Gm9159	2200	+	NR_033398	100743038	100743038	1
chrX	100756248	100819093	Ftx	62845	-	NR_028381	100819093	100819093	11
chrX	100768259	100768335	Mir421	76	-	NR_030558	100768335	100768335	1
chrX	100768398	100768493	Mir374b	95	-	NR_030418	100768493	100768493	1
chrX	100768423	100768472	Mir374c	49	+	NR_037298	100768472	100768472	1
chrX	100825924	100827003	Zcchc13	1079	+	NM_029158	100826011	100826524	1
chrX	100892752	101017327	Slc16a2	124575	-	NM_009197	100895085	101017141	6
chrX	101152505	101176623	Rlim	24118	-	NM_011276	101157829	101161995	5
chrX	101272774	101396456	C77370	123682	-	NM_001077354	101278528	101284298	5
chrX	101311513	101311613	Mir672	100	-	NR_030430	101311613	101311613	1
chrX	101475903	101609185	Abcb7	133282	-	NM_009592	101479381	101609163	16
chrX	101678120	101701601	Uprt	23481	+	NM_001081189	101678299	101701601	7
chrX	101732308	101866403	Zdhhc15	134095	-	NM_175358	101740196	101866138	12
chrX	102012114	102037794	1700121L16Rik	25680	+	NR_045453	102037794	102037794	3
chrX	102050290	102052606	Magee2	2316	-	NM_053206	102050810	102052382	1
chrX	102236192	102265463	5530601H04Rik	29271	-	NR_015467	102265463	102265463	5
chrX	102275094	102312429	Pbdc1	37335	+	NM_001281871	102275152	102311657	6
chrX	102315716	102319300	Magee1	3584	+	NM_053201	102315949	102318706	1
chrX	102359716	102360844	E530001F21Rik	1128	-	NR_002167	102360844	102360844	1
chrX	102539620	102539708	Mir384	88	-	NR_029910	102539708	102539708	1
chrX	102568332	102587093	5330434G04Rik	18761	-	NR_015552	102587093	102587093	5
chrX	102574420	102574518	Mir325	98	-	NR_029759	102574518	102574518	1
chrX	102695110	102695976	Cypt2	866	+	NM_173436	102695130	102695844	2
chrX	102959815	102971871	Fgf16	12056	+	NM_030614	102959879	102969519	3
chrX	102992955	103124711	Atrx	131756	-	NM_009530	102995513	103124458	35
chrX	103163423	103207238	Magt1	43815	-	NM_025952	103166802	103207201	11
chrX	103211038	103217789	Cox7b	6751	+	NM_025379	103211169	103217162	3
chrX	103222562	103323499	Atp7a	100937	+	NM_001109757	103265126	103319954	23
chrX	103338613	103355832	Tlr13	17219	+	NM_205820	103342916	103354973	3
chrX	103382438	103399038	Pgk1	16600	+	NM_008828	103382589	103398618	11
chrX	103402212	103416497	Taf9b	14285	-	NM_001167988	103403832	103416478	8
chrX	103430584	103450711	Fnd3c2	20127	-	NM_001033424	103431037	103447746	20
chrX	103505164	103505274	Mir6382	110	+	NR_105803	103505274	103505274	1
chrX	103615381	103680568	Fndc3c1	65187	-	NM_001007580	103615798	103669247	27
chrX	103771847	103799018	Cysltr1	27171	-	NM_001281859	103773158	103776200	4
chrX	103778524	103905896	Gm5127	127372	+	NM_001033541	103904454	103905093	4
chrX	104032420	104035982	Zcchc5	3562	-	NM_199468	104033331	104034993	2
chrX	104115963	104129238	Lpar4	13275	+	NM_175271	104125550	104126663	3
chrX	104284673	104300309	P2ry10	15636	+	NM_172435	104297799	104298786	3
chrX	104344265	104369000	A630033H20Rik	24735	+	NM_001122596	104366374	104367433	2
chrX	104451216	104492108	Gpr174	40892	+	NM_001177781	104487922	104488930	5
chrX	104592533	104598699	Itm2a	6166	-	NM_008409	104593229	104598555	6
chrX	104737920	104739139	4933401B06Rik	1219	+	NR_033580	104739139	104739139	1
chrX	104863302	104880831	Tbx22	17529	+	NM_181319	104863408	104880799	9
chrX	104978090	105011673	2610002M06Rik	33583	-	NM_025921	104983147	105011489	8
chrX	104987928	105068250	Fam46d	80322	+	NM_001271008	105065652	105066825	6
chrX	105141073	105143775	Gm732	2702	-	NM_001033252	105141093	105143685	2
chrX	105937546	106029694	Brwd3	92148	-	NM_001081477	105938354	106029468	41
chrX	106029816	106082235	2810403D21Rik	52419	+	NR_015493	106082235	106082235	5
chrX	106196823	106197635	5730416F02Rik	812	+	NR_033596	106197635	106197635	1
chrX	106199875	106208719	Hmgn5	8844	-	NM_016710	106200447	106208605	6
chrX	106290745	106357806	Sh3bgrl	67061	+	NM_019989	106290931	106355501	4
chrX	106392094	106395784	Gm6377	3690	+	NM_001037917	106393153	106394065	2
chrX	107568091	107570495	Gm7134	2404	+	NR_033597	107570495	107570495	1
chrX	108009717	108014447	Pou3f4	4730	+	NM_008901	108009803	108010889	1
chrX	108305756	108319213	Cylc1	13457	+	NM_026134	108305796	108319213	5
chrX	108501445	108651568	Rps6ka6	150123	-	NM_025949	108503388	108600391	25
chrX	108688812	108810688	Hdx	121876	-	NM_001080549	108690881	108785098	10
chrX	109207128	109240935	Tex16	33807	+	NM_031382	109207137	109240392	4
chrX	109352657	109357461	4933403O08Rik	4804	+	NM_001177389	109354285	109357287	3
chrX	109424960	109486364	Apool	61404	+	NM_001313733	109447409	109485891	9
chrX	109497913	109520388	Satl1	22475	-	NM_028655	109498067	109520365	6
chrX	109608882	109671952	2010106E10Rik	63070	+	NM_026333	109608955	109671578	7
chrX	109714134	109748671	Zfp711	34537	+	NM_177747	109717902	109747165	9
chrX	109752035	109812260	Pof1b	60225	-	NM_181579	109754044	109812063	17
chrX	110154200	110299124	Chm	144924	-	NM_018818	110157052	110299098	15
chrX	110188432	110188502	Mir361	70	-	NR_029849	110188502	110188502	1
chrX	110411118	110949995	Dach2	538877	+	NM_001289734	110753519	110949057	16
chrX	111587941	111674738	Klhl4	86797	+	NM_172781	111588032	111673099	11
chrX	112018620	112019550	Ube2dnl1	930	+	NM_001276396	112019038	112019506	2
chrX	112021190	112022119	Ube2dnl2	929	+	NM_001081661	112021609	112022077	2
chrX	112040597	112042206	4930555B12Rik	1609	+	NR_130989	112042206	112042206	2
chrX	113562552	113592392	Cpxcr1	29840	+	NM_001033471	113591002	113591971	3
chrX	113794786	113795134	H2afb2	348	+	NM_001281530	113794786	113795134	1
chrX	114128365	114128713	Gm14920	348	+	NM_001102665	114128365	114128713	1
chrX	115540843	115541865	Tgif2lx1	1022	+	NM_153109	115540950	115541646	1
chrX	115593314	115594346	Tgif2lx2	1032	-	NM_001142750	115593535	115594231	1
chrX	117040804	117043774	Pabpc5	2970	+	NM_053114	117041598	117042744	2
chrX	117403935	118024227	Pcdh11x	620292	+	NR_073451	118024227	118024227	8
chrX	117426190	117426835	H2afb3	645	-	NM_001281531	117426356	117426704	1
chrX	119508169	119510994	Nap1l3	2825	-	NM_138742	119508993	119510628	1
chrX	120217131	120259263	Cldn34c1	42132	+	NM_028426	120231175	120256879	4
chrX	121240947	121249519	Vmn2r121	8572	-	NM_001100616	121241386	121249440	6
chrX	123346993	123350397	4932411N23Rik	3404	-	NM_177705	123348599	123350012	1
chrX	123574503	123598518	Gm382	24015	+	NM_001033241	123594725	123598478	3
chrX	123928824	123930430	4921511C20Rik	1606	+	NR_003646	123930430	123930430	1
chrX	124255709	124271086	Cldn34c4	15377	-	NM_001281537	124255738	124256377	2
chrX	125586059	125601682	4930558G05Rik	15623	+	NR_045441	125601682	125601682	4
chrX	126284277	127000369	Diaph2	716092	+	NM_172493	126284511	126995471	27
chrX	130117399	130223532	Pcdh19	106133	-	NM_001105245	130122526	130221803	6
chrX	130385546	130400116	Tnmd	14570	+	NM_022322	130385745	130399944	7
chrX	130425608	130432968	Tspan6	7360	-	NM_019656	130427236	130432833	8
chrX	130442963	130466985	Srpx2	24022	+	NM_026838	130445185	130466005	12
chrX	130470923	130516351	Sytl4	45428	-	NM_013757	130472440	130496773	17
chrX	130593714	130621361	Cstf2	27647	+	NM_133196	130593903	130615852	14
chrX	130609854	130609936	Mir3112	82	+	NR_037299	130609936	130609936	1
chrX	130620959	130646393	Nox1	25434	-	NM_172203	130621684	130646247	13
chrX	130683583	130696467	Xkrx	12884	-	NM_183319	130685089	130696449	3
chrX	130722039	130742569	Arl13a	20530	+	NM_028947	130724374	130742125	10
chrX	130757493	130811523	Trmt2b	54030	-	NM_001167994	130759117	130802084	14
chrX	130829763	130840508	Tmem35	10745	+	NM_026239	130830048	130839379	2
chrX	130842622	130897643	Cenpi	55021	+	NM_145924	130844694	130896541	23
chrX	130939318	130991112	Drp2	51794	+	NM_010078	130958375	130987239	23
chrX	130994654	131011029	Taf7l	16375	-	NM_028958	130995159	131011015	13
chrX	131071794	131076209	Timm8a1	4415	-	NM_013898	131072644	131076127	2
chrX	131076879	131117679	Btk	40800	-	NM_013482	131077274	131108596	19
chrX	131120192	131122601	Rpl36a	2409	+	NM_019865	131120255	131122496	5
chrX	131122707	131135544	Gla	12837	-	NM_013463	131124405	131135476	7
chrX	131135717	131141596	Hnrnph2	5879	+	NM_019868	131139446	131140796	4
chrX	131219100	131221001	B230119M05Rik	1901	-	NR_045454	131221001	131221001	3
chrX	131221057	131232311	Armcx4	11254	+	NM_001202500	131223883	131230954	6
chrX	131252476	131256451	Armcx1	3975	+	NM_030066	131254689	131256060	6
chrX	131282993	131285958	Armcx6	2965	-	NM_001007578	131283713	131284619	4
chrX	131291106	131295995	Armcx3	4889	+	NM_027870	131293131	131294271	5
chrX	131292169	131292270	Mir7093	101	+	NR_106061	131292270	131292270	1
chrX	131338680	131343760	Armcx2	5080	-	NM_001166398	131339066	131341421	6
chrX	131479064	131499293	Nxf2	20229	-	NM_001289735	131479291	131499201	22
chrX	131505911	131543748	Zmat1	37837	-	NM_175446	131507235	131543513	7
chrX	131556960	131594875	3632454L22Rik	37915	-	NR_040282	131594875	131594875	4
chrX	131702162	131712171	AV320801	10009	-	NM_177918	131704210	131711727	5
chrX	131703843	131712153	Gm15023	8310	-	NM_001099321	131704210	131711727	5
chrX	131743224	131745226	Tceal6	2002	-	NM_025355	131743480	131744083	3
chrX	131836854	131847175	Pramel3	10321	+	NM_031390	131841881	131845151	5
chrX	131968373	131978536	Gm5128	10163	+	NM_183320	131973076	131976345	5
chrX	131968373	131978536	Gm7903	10163	+	NM_001242937	131973076	131976345	5
chrX	132114325	132128394	Nxf7	14069	-	NM_130888	132114325	132128394	22
chrX	132147540	132162244	Prame	14704	-	NM_029459	132147682	132150344	10
chrX	132189236	132228329	Tcp11x2	39093	-	NM_027952	132189431	132227824	10
chrX	132253205	132255212	Tmsb15a	2007	-	NM_030106	132253254	132254304	3
chrX	132277230	132281865	Armcx5	4635	+	NM_001009575	132279715	132281536	4
chrX	132277230	132338007	Gprasp1	60777	+	NM_026081	132333598	132337642	11
chrX	132281254	132281308	Mir7646	54	+	NR_106104	132281308	132281308	1
chrX	132320652	132320756	Mir1970	104	-	NR_035497	132320756	132320756	1
chrX	132373572	132379269	Gprasp2	5697	+	NM_001163017	132376432	132378913	7
chrX	132420389	132425620	Bhlhb9	5231	+	NM_001098222	132423579	132425199	5
chrX	132528358	132529898	Arxes2	1540	+	NM_029823	132528497	132529040	1
chrX	132567905	132569485	Arxes1	1580	+	NM_029541	132568044	132568587	1
chrX	132601103	132602775	Bex2	1672	-	NM_009749	132601351	132601741	3
chrX	132606637	132619794	Nxf3	13157	-	NM_001024141	132607798	132619639	19
chrX	132639141	132649959	5730412P04Rik	10818	+	NR_045424	132649959	132649959	7
chrX	132673583	132674976	Bex4	1393	+	NM_212457	132674398	132674755	3
chrX	132703522	132706790	Tceal8	3268	-	NM_001168578	132705207	132705561	4
chrX	132717783	132717899	Mir6383	116	+	NR_105804	132717899	132717899	1
chrX	132735489	132738390	Tceal5	2901	-	NM_177919	132735723	132736326	3
chrX	132748510	132750052	Bex1	1542	-	NM_009052	132748730	132749117	3
chrX	132758579	132760639	Tceal7	2060	+	NM_001127169	132759804	132760101	3
chrX	132779618	132781678	Wbp5	2060	+	NM_011712	132780904	132781219	3
chrX	132804791	132806517	Ngfrap1	1726	+	NM_009750	132805829	132806204	3
chrX	132982645	133003580	Kir3dl2	20935	-	NM_177748	132983207	133003575	9
chrX	133052537	133068845	Kir3dl1	16308	+	NM_177749	133052569	133068552	9
chrX	133200913	133202916	Tceal3	2003	+	NM_001029978	133202075	133202678	3
chrX	133242603	133244405	Tceal1	1802	+	NM_146236	133243348	133243846	2
chrX	133267489	133278225	Morf4l2	10736	-	NM_001168228	133268149	133269016	4
chrX	133277495	133337900	BC065397	60405	+	NR_033324	133337900	133337900	10
chrX	133292212	133314260	Glra4	22048	-	NM_010297	133292234	133314242	9
chrX	133357284	133373121	Plp1	15837	+	NM_001290561	133357452	133370650	7
chrX	133392689	133403079	Rab9b	10390	-	NM_176971	133395582	133396188	3
chrX	133461863	133462912	H2bfm	1049	+	NM_027067	133461902	133462577	1
chrX	133489528	133492518	Tmsb15b2	2990	-	NM_001080967	133489983	133491373	3
chrX	133489528	133511413	Tmsb15l	21885	-	NM_207267	133489983	133510036	4
chrX	133508560	133511413	Tmsb15b1	2853	-	NM_001081983	133508740	133510036	3
chrX	133515654	133572841	Slc25a53	57187	-	NM_001082412	133517208	133549884	7
chrX	133527693	133531462	Zcchc18	3769	+	NM_025893	133529176	133530358	4
chrX	133584132	133617040	Fam199x	32908	+	NM_146261	133584411	133610189	6
chrX	133649935	133654865	Esx1	4930	-	NM_007957	133650088	133654567	5
chrX	134105292	135383616	Il1rapl2	1278324	+	NM_030688	134186258	135381163	11
chrX	134742703	134744119	Tex13a	1416	-	NM_026469	134742733	134743966	2
chrX	135448968	135543629	Nrk	94661	+	NM_013724	135449290	135541717	28
chrX	135613788	135619775	Serpina7	5987	-	NM_177920	135614823	135619733	5
chrX	135620781	135627942	4930513O06Rik	7161	+	NM_029174	135625237	135626283	4
chrX	135744582	135772874	Mum1l1	28292	+	NM_001164630	135769253	135771299	7
chrX	135774764	135891309	Platr21	116545	-	NR_045455	135891309	135891309	20
chrX	135868221	135872708	Trap1a	4487	+	NM_011635	135868492	135871581	3
chrX	136014905	136089119	D330045A20Rik	74214	+	NM_175326	136015034	136088063	14
chrX	136097878	136207684	Rnf128	109806	+	NM_001254761	136098016	136206407	7
chrX	136219534	136288757	Tbc1d8b	69223	+	NM_001081499	136219719	136286380	21
chrX	136314219	136316892	Ripply1	2673	-	NM_001037915	136314250	136316850	4
chrX	136335346	136345927	Cldn2	10581	+	NM_016675	136343246	136343939	2
chrX	136356173	136406193	Morc4	50020	-	NM_001193309	136357213	136405912	17
chrX	136424049	136533134	Rbm41	109085	-	NM_001172148	136424975	136533046	7
chrX	136542211	136597107	Nup62cl	54896	-	NM_001081668	136542313	136573643	9
chrX	136597417	136641336	Pih1h3b	43919	+	NM_177921	136605673	136640569	7
chrX	136845486	136845551	Mir3475	65	+	NR_037208	136845551	136845551	1
chrX	136902032	136929059	Frmpd3	27027	+	NM_177750	136923032	136928465	6
chrX	136991141	137010679	Prps1	19538	+	NM_021463	136991280	137009800	7
chrX	137074067	137135061	Tsc22d3	60994	-	NM_001077364	137075406	137132980	4
chrX	137212566	137302254	Mid2	89688	+	NM_011845	137212590	137298420	9
chrX	137342845	137347972	Tex13	5127	-	NM_031381	137344599	137347629	4
chrX	137442146	137474011	Vsig1	31865	+	NM_030181	137442213	137472595	7
chrX	137482963	137491250	Psmd10	8287	-	NM_001164177	137483840	137491206	5
chrX	137491455	137598813	Atg4a	107358	+	NM_174875	137491500	137597857	13
chrX	137599945	137908619	Col4a6	308674	-	NM_053185	137601260	137908362	45
chrX	137909961	138123778	Col4a5	213817	+	NM_007736	137910277	138122667	52
chrX	138145540	138159760	Irs4	14220	-	NM_010572	138156090	138159741	2
chrX	138513831	138631479	Gucy2f	117648	-	NM_001007576	138523397	138624393	20
chrX	138661312	138674243	Nxt2	12931	+	NM_001290532	138661382	138672370	5
chrX	138739295	138740741	Kcne1l	1446	-	NM_021487	138740136	138740568	1
chrX	138752535	138825078	Acsl4	72543	-	NM_207625	138755219	138786272	16
chrX	139115942	139278037	Tmem164	162095	+	NM_001199357	139205516	139268934	7
chrX	139173542	139173640	Mir652	98	+	NR_030523	139173640	139173640	1
chrX	139288016	139401271	Ammecr1	113255	-	NM_019496	139290075	139401256	6
chrX	139534136	139538878	Rgag1	4742	+	NM_001040434	139534136	139538840	2
chrX	139720216	139828805	Chrdl1	108589	-	NM_001114385	139722408	139824628	12
chrX	139953133	140232339	Pak3	279206	+	NM_001195048	140127856	140225867	16
chrX	140236779	140261955	Capn6	25176	-	NM_007603	140238186	140255003	13
chrX	140290384	140367762	Dcx	77378	-	NM_010025	140298093	140365847	7
chrX	140588237	140600817	A730046J19Rik	12580	+	NR_040271	140600817	140600817	3
chrX	140732332	140732442	Mir680-2	110	+	NR_030448	140732442	140732442	1
chrX	140752508	140808991	Alg13	56483	+	NR_037145	140808991	140808991	27
chrX	140811869	141122723	Trpc5	310854	-	NM_009428	140817040	140958384	11
chrX	140891124	140911606	Trpc5os	20482	+	NM_001195579	140908427	140908760	4
chrX	140987300	140990782	Mageb16-ps1	3482	-	NR_033647	140990782	140990782	1
chrX	141123449	141556953	Zcchc16	433504	+	NM_001033795	141554126	141555041	7
chrX	141473886	141473957	Mir3472	71	+	NR_037309	141473957	141473957	1
chrX	141724901	141783437	Lhfpl1	58536	-	NM_178358	141725688	141775652	4
chrX	141880966	141922182	Amot	41216	-	NM_153319	141884543	141922182	11
chrX	143397055	143631820	Htr2c	234765	+	NM_008312	143506995	143629138	6
chrX	143428932	143429051	Snora35	119	+	NR_028446	143429051	143429051	1
chrX	143433947	143434052	Gm22650	105	+	NR_128564	143434052	143434052	1
chrX	143436801	143436909	Mir764	108	+	NR_030433	143436909	143436909	1
chrX	143443983	143444070	Mir1912	87	+	NR_037300	143444070	143444070	1
chrX	143445143	143445229	Mir1264	86	+	NR_037205	143445229	143445229	1
chrX	143499447	143499545	Mir1298	98	+	NR_037210	143499545	143499545	1
chrX	143592752	143592864	Mir448	112	+	NR_029956	143592864	143592864	1
chrX	143818020	143863735	Il13ra2	45715	-	NM_008356	143818163	143832490	14
chrX	143906236	143988624	Lrch2	82388	-	NM_001081173	143907499	143988593	21
chrX	144427535	144467717	Gm15080	40182	+	NM_001198988	144427611	144467114	7
chrX	144615266	144659253	Gm15107	43987	+	NM_001081648	144615342	144658651	7
chrX	144923491	144955989	Gm15114	32498	+	NM_001082966	144923561	144955387	7
chrX	145317118	145358682	Luzp4	41564	+	NM_001114383	145317194	145358083	7
chrX	145522857	145739546	Gm15085	216689	+	NM_001122734	145522933	145738944	7
chrX	145522857	145739546	Ott	216689	+	NM_011022	145522933	145738944	7
chrX	145706919	145739546	Gm15093	32627	+	NM_001099920	145706989	145738944	7
chrX	146029143	146071164	Gm10439	42021	+	NM_001037716	146029188	146070708	7
chrX	146219021	146419525	Gm15127	200504	+	NM_001114400	146219091	146418925	7
chrX	146219046	146261237	Gm15097	42191	+	NM_001198987	146219091	146260634	7
chrX	146376197	146419525	Gm15091	43328	+	NM_001122735	146376273	146418925	7
chrX	146747493	146747907	Gm15104	414	-	NM_001101501	146747493	146747907	1
chrX	146832315	146893693	Tmem29	61378	-	NM_001164683	146832721	146833336	3
chrX	146981927	146981988	Mir3620	61	-	NR_106147	146981988	146981988	1
chrX	146981959	147005165	Alas2	23206	+	NM_009653	146986706	147005034	11
chrX	147006049	147022698	Apex2	16649	-	NM_029943	147006310	147022619	6
chrX	147024463	147078421	Pfkfb1	53958	+	NM_008824	147024599	147078165	14
chrX	147079252	147092126	Tro	12874	-	NM_001290770	147080247	147090471	13
chrX	147240963	147248882	Maged2	7919	-	NM_030700	147241259	147247258	13
chrX	147417675	147451865	Gnl3l	34190	-	NM_198110	147420646	147448582	16
chrX	147481712	147524229	Fgd1	42517	+	NM_008001	147482217	147523451	18
chrX	147521636	147531086	Tsr2	9450	-	NM_001164578	147524822	147531055	5
chrX	147632620	147754735	Wnk3	122115	+	NM_001271679	147632682	147749671	22
chrX	147747877	147776422	A230072E10Rik	28545	-	NR_015600	147776422	147776422	3
chrX	147778765	147908677	Fam120c	129912	+	NM_198105	147778792	147904273	16
chrX	147955214	148068400	Phf8	113186	+	NM_001113354	147957021	148065970	22
chrX	148237824	148369961	Huwe1	132137	+	NM_021523	148269790	148368926	83
chrX	148294104	148294180	Mir3113	76	+	NR_130340	148294180	148294180	1
chrX	148346888	148346971	Mirlet7f-2	83	+	NR_029732	148346971	148346971	1
chrX	148347756	148347864	Mir98	108	+	NR_029753	148347864	148347864	1
chrX	148436438	148438985	Hsd17b10	2547	+	NM_016763	148436450	148438872	6
chrX	148439126	148450838	Ribc1	11712	-	NM_025660	148439271	148444184	8
chrX	148450970	148496516	Smc1a	45546	+	NM_019710	148451074	148496352	25
chrX	148578810	148659780	Iqsec2	80970	+	NM_001114664	148579015	148658430	15
chrX	148667769	148713642	Kdm5c	45873	+	NM_013668	148668103	148707617	26
chrX	148729366	148762036	Kantr	32670	-	NR_040270	148762036	148762036	3
chrX	148771394	148777027	Tspyl2	5633	-	NM_029836	148771959	148776868	7
chrX	148778140	148803247	Gpr173	25107	-	NM_001313748	148780896	148782018	3
chrX	148803114	148851245	3010001F23Rik	48131	+	NR_045451	148851245	148851245	4
chrX	148997876	148998512	Cldn34a	636	+	NM_001199311	148997876	148998512	1
chrX	149044051	149204029	Shroom2	159978	-	NM_172441	149047070	149203993	10
chrX	149216463	149243189	Gpr143	26726	+	NM_010951	149216585	149242878	9
chrX	149441011	149444002	Usp51	2991	+	NM_001137547	149441954	149443940	2
chrX	149470708	149472106	Mageh1	1398	-	NM_023788	149471224	149471881	1
chrX	149472171	149507458	9530051G07Rik	35287	+	NR_040272	149507458	149507458	4
chrX	149553330	149567404	Foxr2	14074	+	NM_001034894	149564677	149565586	4
chrX	149574500	149606486	Rragb	31986	+	NM_001004154	149575026	149605856	11
chrX	149672587	149830677	Klf8	158090	+	NM_173780	149805389	149827411	7
chrX	149932774	149936101	Ubqln2	3327	+	NM_018798	149932996	149934913	1
chrX	149993135	149993978	Cypt3	843	+	NM_001310716	149993155	149993842	2
chrX	150119696	150130823	Kctd12b	11127	-	NM_175429	150123355	150124234	3
chrX	150158096	150175839	2210013O21Rik	17743	+	NM_027327	150160375	150175627	4
chrX	150266835	150268783	Spin2c	1948	+	NM_001005370	150267735	150268509	2
chrX	150478528	150489582	4921511M17Rik	11054	-	NM_001201358	150478648	150488206	3
chrX	150478528	150489582	Samt1	11054	-	NM_030036	150478648	150488206	3
chrX	150478528	150489584	Gm10057	11056	-	NM_001243016	150478648	150488206	3
chrX	150544175	150555228	Gm15140	11053	-	NM_001243017	150544295	150553853	3
chrX	150587113	150591430	Gm16445	4317	-	NM_001243032	150587231	150590052	3
chrX	150773767	150777935	4930524N10Rik	4168	-	NM_001256259	150773883	150777359	3
chrX	150916544	150919225	Samt4	2681	+	NM_029199	150917122	150919111	3
chrX	151009770	151013873	Samt2	4103	-	NM_001037167	151009848	151013333	3
chrX	151321345	151324810	Cldn34b1	3465	-	NM_001097980	151321634	151322264	2
chrX	151358554	151360658	Magea6	2104	-	NM_020019	151358623	151359601	2
chrX	151383005	151384112	Magea3	1107	-	NM_020017	151383085	151384048	1
chrX	151420317	151430393	Magea8	10076	-	NM_020020	151420691	151421654	4
chrX	151461743	151467835	Magea2	6092	-	NM_020016	151462166	151463129	4
chrX	151487603	151496096	Magea5	8493	-	NM_020018	151487974	151488937	3
chrX	151523061	151524333	Magea1	1272	-	NM_020015	151523308	151524271	1
chrX	151559523	151582392	Cldn34b2	22869	-	NM_001081671	151559743	151560373	3
chrX	151647668	151650992	Sat1	3324	-	NM_001291865	151648039	151648654	7
chrX	151696985	151732197	Acot9	35212	+	NM_001313718	151707530	151731977	16
chrX	151758460	151773003	Prdx4	14543	-	NM_016764	151758520	151772905	7
chrX	152004278	152057870	Ptchd1	53592	-	NM_001093750	152008083	152057853	3
chrX	152974025	152974660	4930503H13Rik	635	+	NR_033598	152974660	152974660	1
chrX	153596617	153853218	Phex	256601	-	NM_011077	153600102	153852688	22
chrX	153881885	153929978	Sms	48093	-	NM_009214	153884068	153929885	11
chrX	153978735	153979682	Gm6568	947	+	NR_040420	153979682	153979682	2
chrX	153985753	154036647	Mbtps2	50894	-	NM_172307	153988859	154036502	11
chrX	154004050	154006917	Yy2	2867	-	NM_001098723	154005563	154006700	1
chrX	154136904	154190523	Smpx	53619	+	NR_045569	154190523	154190523	7
chrX	154256366	154258992	Klhl34	2626	+	NM_001081667	154256366	154258301	1
chrX	154259504	154481129	Cnksr2	221625	-	NM_177751	154261552	154480772	22
chrX	155693713	155806176	Rps6ka3	112463	+	NM_148945	155694051	155801417	22
chrX	155810126	155823631	Eif1ax	13505	+	NM_025437	155810331	155823345	7
chrX	155852503	155936689	Map7d2	84186	+	NM_001081124	155852628	155934216	17
chrX	155970599	156031013	A830080D01Rik	60414	+	NM_001033472	155986206	156030110	12
chrX	156065203	156413852	Sh3kbp1	348649	+	NM_001135727	156065619	156411098	18
chrX	156426364	156561283	Map3k15	134919	+	NM_001163085	156426364	156560931	29
chrX	156560150	156576362	Pdha1	16212	-	NM_008810	156561714	156576244	11
chrX	156828621	156936008	Adgrg2	107387	+	NM_178712	156876127	156934421	28
chrX	156940365	157036810	Phka2	96445	+	NM_001177878	156940758	157036438	33
chrX	157061026	157157904	Ppef1	96878	-	NM_011147	157061435	157157784	16
chrX	157205944	157237595	Rs1	31651	+	NM_011302	157206117	157232603	6
chrX	157222239	157432613	Cdkl5	210374	-	NM_001024624	157222410	157366420	19
chrX	157340047	157344984	Gja6	4937	-	NM_001001496	157341014	157341866	2
chrX	157600681	157696145	Scml2	95464	+	NM_001290651	157609445	157694505	26
chrX	158154967	158217426	Rai2	62459	+	NM_001103367	158215484	158217074	2
chrX	158274361	158597373	Nhs	323012	-	NM_001290526	158274746	158597320	9
chrX	158849883	159081590	Reps2	231707	-	NM_001290633	158855474	159081439	18
chrX	159198303	159217022	Rbbp7	18719	+	NM_009031	159198623	159216348	12
chrX	159216848	159267386	Txlng	50538	-	NM_001290776	159219023	159267272	11
chrX	159294774	159326394	Syap1	31620	-	NM_025932	159295815	159326217	9
chrX	159312849	159312927	Mir3473a	78	-	NR_037311	159312927	159312927	1
chrX	159339491	159472473	Ctps2	132982	+	NM_001168568	159341404	159467768	19
chrX	159399923	159402531	S100g	2608	-	NM_009789	159400067	159402128	3
chrX	159951835	159987668	Grpr	35833	-	NM_008177	159952823	159987229	3
chrX	160198070	160199264	Rnf138rt1	1194	-	NM_028842	160198168	160198915	1
chrX	160346948	160371598	Ap1s2	24650	+	NM_001290379	160349260	160370112	6
chrX	160373374	160396598	Zrsr2	23224	-	NM_009453	160374220	160396258	11
chrX	160414753	160465942	Car5b	51189	-	NM_181315	160417122	160452876	8
chrX	160508634	160514425	Siah1b	5791	-	NM_001308385	160509165	160510014	4
chrX	160528118	160556791	Tmem27	28673	+	NM_020626	160528204	160556284	6
chrX	160577273	160626350	Ace2	49077	+	NM_001130513	160578593	160625532	19
chrX	160630773	160696125	Bmx	65352	-	NM_009759	160631667	160695982	19
chrX	160707362	160810945	Pir	103583	+	NM_027153	160709567	160810497	10
chrX	160811453	160840582	Figf	29129	+	NM_010216	160811761	160840062	7
chrX	160857718	160871847	Piga	14129	+	NM_011081	160860577	160869828	6
chrX	160874925	160897102	Asb11	22177	+	NM_026853	160876057	160896680	8
chrX	160935834	160977684	Asb9	41850	+	NM_027027	160944436	160977596	8
chrX	161374105	161418307	Mospd2	44202	-	NM_001290524	161375208	161418155	15
chrX	161418523	161435204	Fancb	16681	+	NM_001146081	161420455	161435116	9
chrX	161566948	161764913	Glra2	197965	-	NM_183427	161568215	161764801	9
chrX	162608385	162628444	Gemin8	20059	+	NM_001310722	162616759	162627432	5
chrX	162676874	162826965	Gpm6b	150091	+	NM_001177962	162677064	162823403	8
chrX	162827964	162878636	Ofd1	50672	-	NM_177429	162828947	162878226	23
chrX	162878686	162891072	Trappc2	12386	+	NM_025432	162884741	162890167	5
chrX	162895183	162917799	Rab9	22616	-	NM_019773	162895639	162896245	3
chrX	162937746	162948410	Tceanc	10664	-	NM_001007577	162940249	162941329	5
chrX	162960938	163023648	Egfl6	62710	-	NM_019397	162961792	163023455	12
chrX	163099956	163127744	Gm1720	27788	+	NR_046015	163127744	163127744	9
chrX	163501380	163508302	Gm8817	6922	-	NM_001101606	163501483	163506321	5
chrX	163645025	163647150	Tmsb4x	2125	-	NM_021278	163645432	163645968	3
chrX	163679054	163702261	Tlr8	23207	-	NM_133212	163680685	163701683	3
chrX	163742857	163768503	Tlr7	25646	-	NM_001290755	163743267	163746723	5
chrX	163784251	163820681	Prps2	36430	-	NM_001313758	163786837	163820523	7
chrX	163909237	165015165	Frmpd4	1105928	-	NM_001033330	163913229	164335490	20
chrX	165091030	165111834	Msl3	20804	-	NM_010832	165092800	165111667	12
chrX	165233030	165742372	Arhgap6	509342	+	NM_009707	165234152	165740943	13
chrX	165614045	165625141	Amelx	11096	-	NM_001081978	165614128	165623796	7
chrX	165749462	165758275	Hccs	8813	-	NM_008222	165750755	165757481	7
chrX	166123130	166428729	Mid1	305599	+	NM_001290512	166238682	166427143	10
chrX	166214309	166217567	4933400A11Rik	3258	-	NR_003635	166217567	166217567	3
chrX	166412974	166416849	G530011O06Rik	3875	-	NR_029457	166416849	166416849	2
chrX_random	10736	39191	Vamp7	28455	-	NM_011515	12475	32575	8
chrX_random	101351	106392	Spry3	5041	-	NM_001030293	104589	105456	2
chrX_random	159646	334187	Tmlhe	174541	+	NM_138758	216736	333326	8
chrX_random	268798	270075	Zf12	1277	+	NR_003547	270075	270075	1
chrY	61649	133852	Zfy1	72203	-	NM_009570	61857	96353	9
chrY	155155	180667	Uba1y	25512	+	NM_011667	157263	179965	26
chrY	234230	280254	Kdm5d	46024	+	NM_011419	234408	279608	26
chrY	347054	365037	Eif2s3y	17983	+	NM_012011	347059	364694	12
chrY	392206	395311	Tspy-ps	3105	-	NR_027507	395311	395311	4
chrY	433586	582181	Uty	148595	-	NM_009484	434989	581995	27
chrY	597157	623056	Ddx3y	25899	-	NM_012008	599730	622966	17
chrY	635403	796225	Usp9y	160822	-	NM_148943	635408	790708	47
chrY	1362122	1426357	Zfy2	64235	-	NM_009571	1362246	1389393	9
chrY	1855008	1855344	Gm6026	336	+	NM_001177569	1855008	1855344	1
chrY	1855008	1855344	Gm16501	336	+	NM_001113395	1855008	1855344	1
chrY	1918380	1919568	Sry	1188	-	NM_011564	1918380	1919568	1
chrY	2156898	2168120	Gm4064	11222	+	NM_001270518	2160042	2167759	9
chrY	2156898	2168120	Gm10256	11222	+	NM_001270510	2160042	2167759	9
chrY	2156898	2168120	Gm10352	11222	+	NM_001270511	2160042	2167759	9
chrY	2188491	2398856	Gm21677	210365	+	NM_001270513	2191650	2398495	9
chrY	2188491	2398856	Gm21693	210365	+	NM_001270514	2191650	2398495	9
chrY	2188491	2398856	Gm21704	210365	+	NM_001270515	2191650	2398495	9
chrY	2188491	2398856	Gm21708	210365	+	NM_001270516	2191650	2398495	9
chrY	2188491	2398856	Rbmy	210365	+	NM_011253	2191650	2398495	10
chrY	2387257	2398856	Gm3376	11599	+	NM_001270512	2390389	2398495	9
chrY_random	1294311	1320509	Sly	26198	+	NM_201530	1295737	1320319	10
chrY_random	2860158	2862495	Gm20867	2337	-	NM_001160142	2860286	2860970	2
chrY_random	3559697	3562029	Gm20816	2332	+	NM_001160144	3561214	3561898	2
chrY_random	6428618	6429305	Gm20822	687	+	NM_001199331	6428618	6429305	1
chrY_random	8474586	8476544	Gm21379	1958	-	NM_001293057	8474819	8476517	1
chrY_random	8474586	8476544	Rbm31y	1958	-	NM_028970	8474819	8476517	1
chrY_random	8781434	8783443	Gm20877	2009	-	NM_001199332	8781564	8782248	2
chrY_random	9328876	9331261	Ssty1	2385	-	NM_009220	9328995	9329694	3
chrY_random	9452829	9455268	Gm20831	2439	-	NM_001103152	9452951	9453650	3
chrY_random	13735461	13737796	Gm20823	2335	-	NM_001160143	13735593	13736277	2
chrY_random	14172529	14173524	Gm20809	995	-	NM_001160137	14172663	14173347	1
chrY_random	15940900	15967135	Gm20736	26235	-	NM_001037748	15941092	15965699	8
chrY_random	16925232	16925990	Gm20826	758	+	NM_001101623	16925232	16925916	1
chrY_random	17981233	17983607	LOC100040786	2374	-	NM_001160129	17981363	17982047	2
chrY_random	18284670	18287000	Ssty2	2330	-	NM_023546	18284810	18285494	2
chrY_random	18519132	18520125	Gm20854	993	+	NM_001160131	18519308	18519992	1
chrY_random	19988052	19988910	Gm20865	858	-	NM_001160141	19988100	19988784	1
chrY_random	25657922	25982665	Gm20871	324743	-	NR_038299	25982665	25982665	9
chrY_random	28838095	28839087	Gm20917	992	+	NM_001160136	28838271	28838955	1
chrY_random	32818620	32819619	Gm20806	999	-	NM_001160135	32818759	32819443	1
chrY_random	37863737	37889770	Gm20857	26033	+	NR_038297	37889770	37889770	9
chrY_random	37863737	37889770	Gm20858	26033	+	NR_038298	37889770	37889770	9
chrY_random	46075784	46078095	Gm21943	2311	-	NM_001017393	46075923	46076607	2
chrY_random	50814757	50817078	Gm20738	2321	-	NM_207162	50814884	50815568	2
chrY_random	52515005	52517353	Gm20747	2348	+	NM_001025241	52516537	52517221	2
chrY_random	54420148	54423069	Gm20815	2921	+	NM_001017394	54421678	54422362	2
